Id,Label,tf,ntf,df,idf,nidf,tdf,tf-idf,indegree,outdegree,Degree,weighted indegree,weighted outdegree,Weighted Degree,Eccentricity,closnesscentrality,harmonicclosnesscentrality,betweenesscentrality,Stopwords
1805,the,342334,2.352987109,46715,0.067977693,-0.561501328,15992132810,0.159950635,7195,8905,16100,289037,238675,527712,4,0.66129,0.748507,0.183184,Yes
17721,and,116892,3.427517912,31912,0.449060891,0.064715751,3730257504,1.539164246,8312,7226,15538,69227,79350,148577,4,0.623959,0.701899,0.160715,Yes
18368,a,130903,3.313617744,44705,0.111733989,-0.48090031,5852018615,0.37024373,4445,6503,10948,112387,105710,218097,4,0.600772,0.678018,0.097787,Yes
6661,of,179600,2.998044743,44345,0.120043042,-0.46592132,7964362000,0.359894412,4192,6633,10825,130460,138534,268994,4,0.609246,0.684323,0.076476,Yes
9562,is,123117,3.375641776,43450,0.140432154,-0.429579781,5349433650,0.474048644,8018,2608,10626,91189,99248,190437,4,0.528084,0.566696,0.071721,Yes
10000,in,149546,3.181166174,43800,0.132409188,-0.443810862,6550114800,0.421215629,6304,4489,10793,87747,130318,218065,4,0.564492,0.622373,0.06899,Yes
1594,to,77647,3.836603984,25594,0.669685056,0.374071773,1987297318,2.569316355,3934,4298,8232,46776,68946,115722,4,0.560446,0.616651,0.047713,Yes
6523,or,25048,4.967982914,12718,1.369024692,1.233013133,318560464,6.801291281,4281,3863,8144,15296,16803,32099,4,0.550811,0.603295,0.046801,Yes
17350,as,31129,4.750637038,17038,1.076596862,0.889825508,530375902,5.114520926,2742,3079,5821,21669,25259,46928,4,0.538382,0.581578,0.022662,Yes
561,was,52734,4.22351649,18987,0.968288471,0.757744951,1001260458,4.089582323,4265,1417,5682,42963,34744,77707,4,0.506044,0.530595,0.018245,Yes
11906,for,33694,4.671397762,18882,0.973780959,0.764520313,636210108,4.548918192,2894,2407,5301,19591,25460,45051,4,0.524324,0.560659,0.016537,Yes
270,with,22533,5.073795997,13996,1.273271431,1.122509933,315371868,6.460319488,2569,2515,5084,12792,17922,30714,4,0.526845,0.564217,0.015772,Yes
15875,by,29509,4.804081597,17215,1.066261908,0.877354846,507997435,5.122409212,2062,2745,4807,13714,21074,34788,4,0.531674,0.571409,0.015276,Yes
11710,from,24197,5.00254824,15254,1.187201241,1.021705002,369101038,5.939031481,2421,2157,4578,14149,20325,34474,4,0.519217,0.552856,0.012447,Yes
9536,it,52858,4.221129989,26222,0.645444252,0.341355312,1386042476,2.724504089,4072,839,4911,39953,44539,84492,4,0.49534,0.512628,0.011566,Yes
6580,on,28434,4.841191286,15977,1.140892817,0.966828906,454290018,5.523280365,2807,1616,4423,15680,25197,40877,4,0.51057,0.537251,0.010937,Yes
17446,are,34451,4.649238874,14682,1.225420752,1.06665118,505809582,5.697273795,2042,1928,3970,18633,21543,40176,4,0.515478,0.546213,0.011352,Yes
1808,that,27578,4.871758545,14948,1.207465494,1.045573414,412235944,5.882480336,2523,1747,4270,17246,21526,38772,4,0.512561,0.540974,0.010295,Yes
17752,an,21267,5.131620323,14608,1.230473681,1.072571047,310668336,6.31432375,1510,1473,2983,18209,13685,31894,4,0.497338,0.5259,0.013456,Yes
1738,this,15099,5.474082155,10201,1.589557251,1.481974312,154024899,8.701366979,2317,1456,3773,11166,12299,23465,4,0.506058,0.531336,0.007747,Yes
17270,at,16913,5.360694341,11346,1.483177746,1.362762552,191894898,7.950862552,2263,1265,3528,10601,14247,24848,4,0.501143,0.524534,0.007921,Yes
404,which,13849,5.560563871,9851,1.624470032,1.520776981,136426499,9.032969371,2556,680,3236,8727,9788,18515,4,0.485438,0.502836,0.006548,Yes
10461,his,15376,5.455969046,6502,2.039933183,1.972715129,99974752,11.1298123,1294,1511,2805,12275,11656,23931,4,0.50198,0.529721,0.006407,Yes
1757,they,19245,5.231525612,9506,1.660119827,1.560246342,182942970,8.684959394,2217,721,2938,13904,16741,30645,4,0.472793,0.494432,0.00519,Yes
15897,but,9413,5.946685186,7377,1.913675953,1.837055647,69439701,11.38002844,2275,647,2922,6067,8029,14096,4,0.491309,0.506281,0.004683,Yes
6438,other,16155,5.406547299,12794,1.363066694,1.226184045,206687070,7.369484554,1858,1063,2921,13044,4195,17239,4,0.497854,0.518529,0.004568,Yes
10719,he,27887,4.860616268,8279,1.798320817,1.711914699,230876473,8.740947418,2694,237,2931,20337,19376,39713,4,0.472089,0.484776,0.004436,Yes
15751,can,12703,5.646938712,7382,1.912998401,1.836324113,93773546,10.80258473,1801,694,2495,9040,12289,21329,4,0.483599,0.501765,0.004998,Yes
10770,has,15745,5.432254044,10988,1.515239237,1.398853946,173006060,8.231164473,2165,659,2824,13163,12310,25473,4,0.488067,0.504244,0.004151,Yes
17849,also,15524,5.446389685,11597,1.461296561,1.338046216,180031828,7.958790518,1473,930,2403,13259,10029,23288,4,0.49505,0.514164,0.004185,No
417,when,9131,5.977101681,6645,2.018178313,1.949429693,60675495,12.06285699,1776,790,2566,6405,7621,14026,4,0.48944,0.507694,0.003627,Yes
1800,their,9312,5.957473007,6061,2.110168202,2.047655587,56440032,12.57127011,951,1279,2230,7839,5821,13660,4,0.484061,0.513098,0.003681,Yes
6576,one,13109,5.615477881,9559,1.654559886,1.554100575,125308931,9.291144444,1135,1175,2310,11039,11963,23002,4,0.500564,0.522449,0.003394,No
5998,people,16292,5.398041331,10184,1.591126956,1.48372217,165917728,8.588969068,1190,913,2103,14057,12910,26967,4,0.496504,0.514811,0.003354,No
12102,first,11326,5.761675931,8040,1.827613922,1.743810058,91061040,10.53011915,686,1350,2036,10362,7990,18352,4,0.503589,0.527731,0.003016,No
2988,some,8245,6.079048664,6114,2.101298236,2.038210633,50409930,12.77389423,1326,839,2165,6179,4659,10838,4,0.488981,0.508291,0.002778,Yes
7947,may,6210,6.362616002,4707,2.362992243,2.314789894,29230470,15.03481226,1231,697,1928,4635,5849,10484,4,0.490847,0.506882,0.002846,No
376,who,8877,6.005313236,6362,2.061700212,1.995978348,56475474,12.38115557,1278,452,1730,5899,5959,11858,4,0.481239,0.495517,0.0031,Yes
1778,there,11168,5.775724352,8204,1.807421165,1.721832384,91622272,10.43916644,1675,341,2016,7116,10681,17797,4,0.484709,0.495897,0.002538,Yes
6826,not,13131,5.613801051,8505,1.771388779,1.682515708,111679155,9.944224192,511,1104,1615,11236,10602,21838,4,0.496379,0.518318,0.00287,Yes
8664,like,5485,6.486759805,4164,2.485566854,2.443046369,22839540,16.12327516,828,990,1818,2896,4211,7107,4,0.496851,0.516487,0.002467,No
16296,born,7312,6.199260064,5588,2.191421564,2.133931337,40859456,13.58519218,989,399,1388,4400,6875,11275,4,0.484868,0.497103,0.003213,No
452,were,12232,5.68472143,7247,1.931455415,1.856237619,88645304,10.97978599,965,824,1789,6590,7112,13702,4,0.494608,0.511849,0.002187,Yes
7331,most,8844,6.009037635,6965,1.971145398,1.898963224,61598460,11.84468688,981,665,1646,7504,6237,13741,4,0.476064,0.495808,0.002217,Yes
16808,because,5925,6.409596211,4744,2.355162344,2.306571655,28108200,15.09563963,1423,391,1814,3935,5573,9508,4,0.482063,0.494977,0.001956,Yes
10602,her,5338,6.513925847,1969,3.234517206,3.214641377,10510522,21.06940523,657,800,1457,4122,4230,8352,4,0.492113,0.509685,0.002342,Yes
18321,about,9247,5.964369586,6882,1.983133698,1.911843235,63637854,11.82814231,870,839,1709,6802,6769,13571,4,0.493852,0.51161,0.001748,Yes
8122,many,9802,5.906190452,7282,1.926637455,1.851042254,71378164,11.37908774,1015,693,1708,8029,4550,12579,4,0.484709,0.50254,0.0017,No
10744,have,11963,5.706958345,7819,1.855486336,1.77408273,93538697,10.58918323,659,837,1496,8205,9235,17440,4,0.491881,0.510234,0.001923,Yes
17906,all,6546,6.309922722,5206,2.262231199,2.208778776,34078476,14.27450404,873,693,1566,5102,4640,9742,4,0.490522,0.506586,0.001649,Yes
6993,new,7268,6.205295748,4785,2.34655698,2.297535794,34777380,14.56108005,764,763,1527,6395,5798,12193,4,0.487223,0.505615,0.00169,No
9389,john,2436,7.298419549,1702,3.380238975,3.363082989,4146072,24.67040221,561,509,1070,1877,1549,3426,4,0.481174,0.496578,0.002334,No
414,where,4324,6.724595999,3563,2.641440119,2.605170986,15406412,17.76261765,1014,481,1495,3085,3738,6823,4,0.484418,0.498329,0.001661,Yes
16839,be,15586,5.442403823,9839,1.625688925,1.522128974,153350654,8.847655622,154,1002,1156,15303,8795,24098,4,0.495561,0.515839,0.002142,Yes
10930,had,7029,6.23873245,4933,2.316095683,2.26551896,34674057,14.4495013,1003,500,1503,5574,5582,11156,4,0.484537,0.498775,0.001625,Yes
9669,into,5836,6.424731268,4656,2.373886295,2.326218978,27172416,15.2515815,733,623,1356,2832,4896,7728,4,0.479938,0.497812,0.001759,Yes
6571,only,5250,6.530548822,4345,2.443017247,2.398606391,22811250,15.9542434,680,852,1532,4411,4105,8516,4,0.49476,0.512469,0.001417,Yes
7373,more,6222,6.3606855,4898,2.323216047,2.273007405,30475356,14.77724662,634,759,1393,5195,4434,9629,4,0.489183,0.506915,0.001555,Yes
4326,river,4293,6.731791109,1933,3.252969805,3.233461129,8298369,21.89831321,435,581,1016,2749,2989,5738,4,0.487397,0.502314,0.001958,No
327,will,3340,6.982806091,2218,3.115437116,3.093018122,7408120,21.75449327,751,500,1251,2586,3081,5667,4,0.480341,0.495798,0.001566,Yes
3056,so,3792,6.855883314,3180,2.755161808,2.722856192,12058560,18.88906787,1016,391,1407,2789,3421,6210,4,0.484431,0.496648,0.001257,Yes
14365,county,4755,6.629580202,2187,3.129512264,3.107410241,10399185,20.74735255,525,410,935,3302,4174,7476,4,0.482942,0.495953,0.001881,No
7153,name,6061,6.386902095,4500,2.407965608,2.361933083,27274500,15.37944059,388,712,1100,5253,4746,9999,4,0.49184,0.507882,0.001522,No
3495,she,7040,6.237026693,2042,3.198113285,3.17749254,14375680,19.94671793,1273,160,1433,5349,5050,10399,4,0.468525,0.480677,0.001151,Yes
15113,city,12533,5.660331947,7605,1.883105596,1.804009921,95313465,10.65900276,535,660,1195,11035,11436,22471,4,0.491132,0.506399,0.001309,No
8299,made,8159,6.089655286,5939,2.130502236,2.069287452,48456301,12.9740242,748,474,1222,6852,7422,14274,4,0.485186,0.498747,0.001278,No
1792,then,3655,6.892680805,2968,2.82415468,2.794036232,10848040,19.46599675,816,521,1337,3093,2531,5624,4,0.486675,0.500671,0.001127,Yes
1139,two,7059,6.2344735,5450,2.216427397,2.160397735,38471550,13.81825787,573,658,1231,6195,2870,9065,4,0.489723,0.50538,0.001213,No
10100,if,3458,6.948086511,2399,3.036991021,3.012719312,8295742,21.10127635,925,220,1145,2545,3236,5781,4,0.471462,0.484015,0.001295,Yes
12810,english,3978,6.807997718,2881,2.853905549,2.824683284,11460618,19.42938247,426,629,1055,3460,2969,6429,4,0.489264,0.504511,0.001394,No
13117,each,3072,7.066448083,2384,3.043263256,3.019145217,7323648,21.5050618,590,568,1158,2316,2728,5044,4,0.482784,0.498803,0.00127,Yes
9610,iowa,1820,7.589940397,921,3.994338248,3.985095852,1676220,30.31678923,379,423,802,1360,1336,2696,4,0.473701,0.489479,0.001819,No
211,word,3046,7.074947644,2030,3.204007212,3.183508957,6183380,22.66818328,190,782,972,2909,2008,4917,4,0.488389,0.506793,0.001473,No
10146,i,2908,7.102237191,1929,3.241652812,3.221919781,5609532,23.02298716,496,404,900,2218,2359,4577,4,0.483758,0.496418,0.001547,Yes
16618,between,4673,6.646975635,3883,2.555434954,2.51584218,18145259,16.98591388,728,622,1350,2692,3941,6633,4,0.486475,0.502441,0.001018,Yes
6640,often,4529,6.678275734,3608,2.628889403,2.59215355,16340632,17.55644831,548,527,1075,3765,2428,6193,4,0.48569,0.500113,0.001258,No
1764,these,5028,6.573754608,4046,2.514314266,2.473024255,20343288,16.52848499,970,352,1322,3509,1948,5457,4,0.471099,0.486236,0.000975,Yes
16809,became,4778,6.624754849,3541,2.647633832,2.611592795,16918898,17.53992507,784,380,1164,3766,4154,7920,4,0.476077,0.490456,0.001087,No
828,very,5666,6.454293497,4303,2.452730551,2.408758664,24380798,15.83064285,439,451,890,5125,4972,10097,4,0.459145,0.478903,0.001408,Yes
13151,during,4357,6.716993151,3636,2.621158829,2.584132462,15842052,17.6063059,1059,275,1334,2722,4039,6761,4,0.471838,0.485358,0.000931,Yes
2112,system,2850,7.141457904,1756,3.34900451,3.33129904,5004600,23.91677473,398,375,773,1999,2334,4333,4,0.482718,0.495146,0.001509,No
14887,college,1529,7.764162971,802,4.132689676,4.124647585,1226258,32.08687616,341,340,681,1029,1289,2318,4,0.480419,0.492831,0.001672,No
181,would,2738,7.181549172,2027,3.205486138,3.185018503,5549926,23.02035632,625,392,1017,2166,2584,4750,4,0.452543,0.472588,0.001111,No
13939,de,3670,6.888312794,2569,2.968137106,2.942111883,9428230,20.4454568,373,210,583,1244,1922,3166,4,0.457878,0.473368,0.001937,No
1812,than,5071,6.565238862,4031,2.518028521,2.476894818,20441201,16.5314587,526,635,1161,3234,3986,7220,4,0.489399,0.504732,0.00096,Yes
6898,no,2947,7.107989195,2443,3.018816213,2.994093601,7199521,21.45771302,414,664,1078,2516,1725,4241,4,0.476,0.495723,0.001023,Yes
3271,since,2897,7.12510118,2417,3.029515904,3.005059758,7002049,21.58560734,771,401,1172,1845,2400,4245,4,0.483995,0.496526,0.000938,No
7222,music,4921,6.595265136,2265,3.094468246,3.07156849,11146065,20.40883854,538,510,1048,4037,3894,7931,4,0.48725,0.500868,0.001,No
16276,both,2482,7.279712212,2183,3.131342928,3.109281797,5418206,22.79527535,535,494,1029,1983,1584,3567,4,0.485544,0.49938,0.001006,Yes
2641,state,4760,6.628319168,3244,2.735235869,2.702269034,15441440,18.13001634,438,412,850,4183,3972,8155,4,0.484854,0.497343,0.001203,No
401,while,2101,7.446363477,1901,3.269662942,3.25048051,3994001,24.34709871,780,299,1079,1364,1411,2775,4,0.481318,0.492733,0.000893,Yes
6413,over,4095,6.778766011,3433,2.678317243,2.643384836,14058135,18.15568589,632,433,1065,2960,3357,6317,4,0.484576,0.497559,0.000901,Yes
12339,family,3159,7.038521377,2199,3.124040294,3.101815584,6946641,21.98862439,401,325,726,2514,2062,4576,4,0.482968,0.494367,0.001319,No
1630,time,6246,6.35683564,4646,2.376036371,2.328473928,29018916,15.10407268,342,667,1009,5943,5338,11281,4,0.4912,0.506558,0.000895,No
16778,before,3027,7.081204868,2657,2.934845338,2.907926795,8042739,20.7822411,809,331,1140,1862,2353,4215,4,0.482942,0.494456,0.000776,Yes
196,world,6790,6.273178692,4798,2.344052283,2.294905062,32578420,14.70465883,386,652,1038,6068,5313,11381,4,0.490562,0.505845,0.000843,No
17973,album,2942,7.109687276,1256,3.684110937,3.671481775,3695152,26.19287665,336,499,835,2643,2296,4939,4,0.486595,0.500207,0.001031,No
8906,later,3238,7.013821043,2781,2.88923243,2.861039267,9004878,20.26455922,531,442,973,2376,2175,4551,4,0.485743,0.498521,0.000882,No
9488,james,1177,8.02580807,851,4.073386156,4.064849996,1001627,32.69221548,331,334,665,940,936,1876,4,0.474309,0.488264,0.001282,No
3116,small,3315,6.990319275,2724,2.909941617,2.88233457,9030060,20.34142097,212,659,871,3089,2041,5130,4,0.480133,0.498624,0.000963,No
1796,them,4302,6.729464445,3369,2.697130261,2.662860373,14493438,18.15024219,384,580,964,3234,3797,7031,4,0.488779,0.503272,0.00087,Yes
323,william,1236,7.976896539,938,3.976048335,3.96663435,1159368,31.71652621,366,279,645,1009,927,1936,4,0.470462,0.484405,0.00129,No
1690,through,2607,7.230576763,2169,3.137776773,3.115858752,5654583,22.68793583,522,416,938,1505,2205,3710,4,0.478657,0.493,0.000881,Yes
68,you,2105,7.444461431,1243,3.694515193,3.682017671,2616515,27.50367586,435,414,849,1769,1940,3709,4,0.483244,0.49623,0.00093,Yes
11804,france,8506,6.047887544,7553,1.889965781,1.811432736,64245818,11.43030051,224,547,771,8239,4689,12928,4,0.48851,0.502441,0.001003,No
9480,january,2814,7.15416994,2012,3.212913753,3.192599205,5661768,22.98573099,358,490,848,2010,2413,4423,4,0.486595,0.500033,0.000881,No
7081,near,2109,7.442562997,1804,3.322036584,3.30384243,3804636,24.72446655,500,382,882,1467,1535,3002,4,0.47403,0.488963,0.000846,No
9146,king,3792,6.855883314,2070,3.184494398,3.163587784,7849440,21.83252201,487,367,854,3012,3219,6231,4,0.481867,0.494381,0.000872,No
1087,under,2262,7.372527521,1901,3.269662942,3.25048051,4300062,24.10568002,543,373,916,1362,1931,3293,4,0.475363,0.489794,0.000807,Yes
9962,include,1813,7.593793967,1660,3.405225403,3.388496585,3009580,25.85858012,243,606,849,871,1183,2054,4,0.480783,0.498136,0.000869,No
11048,group,3467,6.945487232,2511,2.991361925,2.965942063,8705637,20.77646606,369,358,727,2916,2927,5843,4,0.483152,0.495118,0.001,No
8929,large,2614,7.227895283,2188,3.129055121,3.106942874,5719432,22.61648275,213,625,838,2415,1543,3958,4,0.480328,0.498132,0.000863,No
17635,another,2230,7.386775313,1953,3.242676353,3.22296372,4355190,23.95292163,400,632,1032,1823,1902,3725,4,0.48851,0.50407,0.000699,No
10278,however,1999,7.496129843,1843,3.300648327,3.282056941,3684157,24.74208842,779,287,1066,1254,1727,2981,4,0.479653,0.491292,0.000664,No
544,water,2839,7.145325021,1532,3.485468934,3.470040837,4349348,24.90480838,361,396,757,2484,2228,4712,4,0.482495,0.495366,0.000908,No
4117,s,1229,7.949759998,834,4.054759307,4.046061766,1024986,32.23436334,442,417,859,886,919,1805,4,0.482168,0.495521,0.000786,Yes
11759,french,2635,7.219893716,1851,3.296316972,3.277644083,4877385,23.79905819,309,493,802,2290,1751,4041,4,0.484074,0.498324,0.000841,No
8950,language,3236,7.014438899,1600,3.442039376,3.425920482,5177600,24.14397489,299,377,676,2468,2585,5053,4,0.484233,0.496244,0.000966,No
16988,band,3350,6.979816553,1457,3.535663478,3.520996736,4880950,24.67828247,323,471,794,3032,2505,5537,4,0.485916,0.499193,0.000811,No
6797,now,2687,7.200351569,2379,3.045362774,3.021295953,6392373,21.92768263,431,443,874,2221,1906,4127,4,0.484921,0.497972,0.000715,Yes
16756,being,2554,7.251116141,2240,3.105567139,3.082923136,5720960,22.51882801,425,382,807,1996,1510,3506,4,0.481553,0.494446,0.000769,Yes
7296,movie,3545,6.922956691,1584,3.452089712,3.436133401,5615280,23.89866757,390,467,857,2912,2556,5468,4,0.485371,0.498742,0.00072,No
3686,see,1708,7.653453803,1432,3.552970937,3.538557852,2445856,27.19249893,383,441,824,1369,1425,2794,4,0.483678,0.497061,0.000738,No
14387,could,2203,7.398956831,1833,3.306089036,3.28759952,4038099,24.46161006,538,334,872,1743,2128,3871,4,0.455808,0.474086,0.000607,No
388,white,1568,7.738975976,1059,3.854717939,3.844081786,1660512,29.83156952,299,389,688,1377,1202,2579,4,0.481827,0.494756,0.000763,No
17578,any,2309,7.351962368,2054,3.192253894,3.171510643,4742686,23.4693305,307,544,851,2085,1841,3926,4,0.474524,0.492399,0.000609,Yes
3843,school,2435,7.298830142,1400,3.575570769,3.56148227,3409000,26.0974837,309,337,646,2083,2005,4088,4,0.483586,0.495033,0.000802,No
1063,up,4968,6.585759554,4092,2.503009157,2.461239649,20329056,16.48421647,450,378,828,3487,4604,8091,4,0.484048,0.496132,0.000624,Yes
11429,german,2771,7.169568632,1930,3.254523002,3.235044916,5348030,23.33352603,287,484,771,2177,1805,3982,4,0.481435,0.496301,0.000665,No
586,war,4237,6.744685439,2543,2.97830536,2.952546951,10774691,20.08773279,287,471,758,3723,3656,7379,4,0.48737,0.500221,0.000669,No
1064,until,2752,7.176448978,2403,3.035325048,3.011012356,6613056,21.78285534,666,297,963,1887,2476,4363,4,0.479329,0.49124,0.000525,Yes
6423,out,3216,7.020638547,2642,2.940506799,2.913742333,8496672,20.64423538,448,277,725,1993,2974,4967,4,0.48064,0.491799,0.000697,Yes
11129,great,2198,7.401229042,1716,3.372047004,3.354748589,3771768,24.95729222,226,464,690,2042,1540,3582,4,0.478838,0.494052,0.000724,No
9551,island,2425,7.302533088,1190,3.738089698,3.726128687,2885750,27.29752371,276,353,629,2003,2084,4087,4,0.48356,0.495338,0.000789,No
208,work,2651,7.213839971,2076,3.18160004,3.160632157,5503476,22.95155354,353,279,632,2184,2315,4499,4,0.481683,0.492601,0.000781,No
16516,black,1585,7.728192491,1042,3.870901062,3.860436709,1651570,29.91506852,321,351,672,1330,1189,2519,4,0.475427,0.489404,0.000726,No
16095,british,3082,7.062873749,2146,3.148437361,3.126754405,6613972,22.23701559,320,435,755,2840,2273,5113,4,0.47678,0.492005,0.000636,No
12575,even,1658,7.683164842,1505,3.503250107,3.488096165,2495290,26.91604805,472,316,788,1314,1301,2615,4,0.480445,0.49239,0.000608,No
3592,series,3080,7.063847301,1813,3.317060073,3.298774265,5584040,23.43120585,269,395,664,2631,2454,5085,4,0.484114,0.496493,0.00072,No
8572,little,1206,8.0014678,977,3.935311632,3.925503888,1178262,31.48826931,226,355,581,1086,935,2021,4,0.468562,0.484367,0.000822,No
12337,famous,3079,7.064172029,2565,2.970084527,2.944110619,7897635,20.98118804,218,527,745,2876,2210,5086,4,0.484167,0.499028,0.00064,No
6618,old,2467,7.285368792,2040,3.198603121,3.177992584,5032680,23.30300336,214,526,740,1727,1870,3597,4,0.486715,0.500793,0.000642,No
4304,robert,792,8.421970786,604,4.416224086,4.410175954,478368,37.19331024,260,212,472,610,512,1122,4,0.454874,0.471034,0.001006,No
1004,use,3855,6.839405891,2946,2.831594687,2.801702936,11356830,19.36642539,313,468,781,3098,3262,6360,4,0.484947,0.498479,0.000606,No
13957,david,846,8.356012818,624,4.383647916,4.377398554,527904,36.62981817,273,231,504,633,475,1108,4,0.471049,0.483921,0.000926,No
17392,around,2939,7.110707511,2520,2.987784104,2.962271922,7406280,21.24525887,511,340,851,1787,2456,4243,4,0.481867,0.493878,0.000519,No
8110,march,2331,7.342479538,1891,3.274937216,3.255856713,4407921,24.04615949,339,397,736,1837,2004,3841,4,0.484947,0.497132,0.000596,No
6851,north,6561,6.307633868,5306,2.24320475,2.188696884,34812666,14.14931425,431,339,770,6042,6112,12154,4,0.478373,0.491343,0.00056,No
9085,known,7098,6.228963844,6011,2.118451881,2.056471368,42666078,13.19576017,461,355,816,5847,6682,12529,4,0.482063,0.494282,0.000524,No
8683,life,2235,7.383641216,1723,3.367395833,3.35001602,3850905,24.86364266,322,313,635,1959,1893,3852,4,0.482731,0.493972,0.000673,No
2871,species,2009,7.491139813,1109,3.808584297,3.797442681,2227981,28.53063746,280,229,509,1689,1724,3413,4,0.478283,0.489193,0.000818,No
11873,form,2146,7.425171254,1780,3.335429641,3.317479859,3819880,24.76613629,308,208,516,1819,1932,3751,4,0.478129,0.488705,0.000797,No
3712,second,2984,7.095512216,2544,2.97830536,2.952546951,7591296,21.13260206,214,537,751,2786,2241,5027,4,0.484167,0.499202,0.000539,No
1587,today,1655,7.68497589,1493,3.511255487,3.496223367,2470915,26.98391376,444,330,774,1124,1354,2478,4,0.481945,0.493737,0.000515,No
2926,south,4466,6.692283745,3354,2.701889342,2.667785015,14978964,18.08181012,398,286,684,4016,3637,7653,4,0.478502,0.490428,0.000578,No
10507,high,2046,7.471425029,1661,3.403419805,3.386660481,3398406,25.42839592,327,321,648,1661,1613,3274,4,0.474613,0.488268,0.000599,No
6801,november,1935,7.528669572,1654,3.408846409,3.3921786,3200490,25.66407823,280,291,571,1645,1686,3331,4,0.482037,0.493061,0.000673,No
8493,long,2863,7.136906872,2348,3.058479103,3.034729777,6722324,21.82808053,260,431,691,2276,2317,4593,4,0.483402,0.496672,0.000544,No
8180,man,1386,7.862354998,1061,3.852831146,3.84217478,1470546,30.29232621,236,243,479,1215,1079,2294,4,0.480627,0.49116,0.000783,No
16592,big,1618,7.70758608,1310,3.642015868,3.628839704,2119580,28.07115081,209,473,682,1468,1216,2684,4,0.48094,0.495709,0.000546,No
13420,do,3646,6.895146222,2743,2.902990793,2.875188412,10000978,20.016546,277,357,634,2769,3323,6092,4,0.481723,0.49408,0.000582,Yes
11441,george,1115,8.079922493,859,4.064029362,4.055412515,957785,32.83704226,289,230,519,901,860,1761,4,0.461305,0.476476,0.000708,No
2970,song,1998,7.496630218,1054,3.859450555,3.848864935,2105892,28.93287366,274,338,612,1752,1646,3398,4,0.481161,0.493343,0.000597,No
11277,god,1422,7.836712567,767,4.177311483,4.169622149,1090674,32.73638939,249,242,491,1273,1158,2431,4,0.479433,0.490263,0.000743,No
17200,august,2055,7.468014551,1696,3.383181019,3.366075896,3485280,25.26564508,294,314,608,1729,1760,3489,4,0.483178,0.49431,0.000599,No
15354,charles,1147,8.05162706,845,4.080461657,4.071986009,969215,32.85435549,278,240,518,898,873,1771,4,0.473007,0.485559,0.000702,No
1956,team,3675,6.887223766,2299,3.079568759,3.056321074,8448825,21.20967915,205,450,655,2489,2656,5145,4,0.485916,0.498812,0.000552,No
18064,against,1846,7.575755762,1499,3.507244786,3.492151757,2767154,26.5700299,335,357,692,1076,1461,2537,4,0.474372,0.488761,0.000522,Yes
6651,official,2846,7.142862399,2466,3.0094456,2.984487208,7018236,21.49605582,337,350,687,1251,1253,2504,4,0.477434,0.490874,0.000514,No
11477,general,1504,7.780648673,1208,3.723076906,3.710933716,1816832,28.96795339,241,304,545,1324,949,2273,4,0.480055,0.491907,0.000646,No
17498,april,2106,7.443986485,1746,3.354715548,3.337111857,3677076,24.9724572,303,332,635,1676,1807,3483,4,0.482259,0.493996,0.000554,No
4659,red,1521,7.769408885,968,3.944566197,3.934849334,1472328,30.64694766,304,308,612,1284,1170,2454,4,0.479329,0.491432,0.000572,No
10092,ii,2319,7.34764084,1731,3.363343729,3.345892688,4014189,24.71264174,214,348,562,1824,1835,3659,4,0.483178,0.494967,0.000604,No
8239,main,2628,7.222553798,2293,3.082182001,3.058995724,6026004,22.26122532,192,460,652,2397,1624,4021,4,0.476652,0.492399,0.000514,No
17445,area,4031,6.794514368,2970,2.823144409,2.792995044,11972070,19.18189525,364,323,687,3452,3594,7046,4,0.48205,0.493681,0.000486,No
14813,common,2278,7.365479033,1900,3.270189119,3.25101688,4328200,24.08650939,155,432,587,2116,1732,3848,4,0.479032,0.493587,0.000567,No
9292,just,1570,7.737701279,1435,3.550878156,3.536434636,2252950,27.47563445,367,303,670,1264,1229,2493,4,0.478399,0.490681,0.000495,Yes
1865,term,1655,7.68497589,1301,3.648909806,3.63582483,2153155,28.04178388,122,396,518,1547,1194,2741,4,0.479148,0.492982,0.00064,No
67,young,1277,7.944263321,1029,3.883455548,3.873122552,1314033,30.85119347,237,305,542,1130,945,2075,4,0.479588,0.491564,0.0006,No
6125,paul,756,8.468490801,572,4.470659293,4.464933043,432432,37.8597371,233,186,419,593,450,1043,4,0.473929,0.485207,0.000769,No
4294,rock,2047,7.472401592,1282,3.663621647,3.650729151,2624254,27.37605222,282,258,540,1566,1709,3275,4,0.479303,0.490465,0.000594,No
9207,kentucky,1017,8.171919781,530,4.546921278,4.541617342,539010,37.15707593,201,253,454,769,767,1536,4,0.464006,0.478978,0.000687,No
6210,part,6922,6.254072153,5550,2.198245077,2.141157248,38417100,13.74798332,456,159,615,6338,6810,13148,4,0.475809,0.486067,0.000504,No
16334,book,2342,7.337771633,1389,3.583458941,3.569481995,3253038,26.29460337,275,272,547,2131,1911,4042,4,0.48064,0.491695,0.000564,No
12264,february,1961,7.515322351,1580,3.454618158,3.438702489,3098380,25.96256906,310,352,662,1491,1705,3196,4,0.484233,0.495775,0.000465,No
13575,different,4902,6.599133613,3658,2.615126455,2.577871769,17931516,17.25756889,307,440,747,4550,1536,6086,4,0.482207,0.496005,0.000412,No
14801,company,1850,7.573591259,1221,3.71237281,3.700098026,2258850,28.11599427,277,293,570,1456,1339,2795,4,0.481044,0.492409,0.000539,No
1707,three,3386,6.969127615,2806,2.880283024,2.851832685,9501116,20.07305996,331,366,697,2865,1324,4189,4,0.480159,0.493151,0.000437,No
10452,history,1872,7.561235475,1588,3.448938118,3.432931002,2972736,26.07823325,312,290,602,1466,1642,3108,4,0.479627,0.491339,0.000503,No
13948,day,2045,7.472890231,1448,3.541859711,3.527284293,2961160,26.46792884,225,380,605,1752,1744,3496,4,0.484762,0.496686,0.000499,No
8989,lake,1334,7.900594951,633,4.369327862,4.362987934,844422,34.52028965,256,193,449,1071,950,2021,4,0.476678,0.487348,0.000667,No
446,west,3470,6.944622304,2852,2.864022503,2.835098786,9896440,19.88955455,331,324,655,3108,3075,6183,4,0.479938,0.492184,0.000453,No
10606,henry,1182,8.021568979,777,4.164357934,4.156567825,918414,33.40468442,283,192,475,984,1010,1994,4,0.472579,0.48433,0.000617,No
11573,game,2878,7.13168129,1240,3.696931626,3.684464481,3568720,26.3653381,250,322,572,2415,2274,4689,4,0.48188,0.493536,0.00051,No
11995,florida,1124,8.071883147,618,4.393309827,4.387120838,694632,35.46228355,188,266,454,946,860,1806,4,0.478257,0.489874,0.000641,No
9309,june,2105,7.444461431,1704,3.379064577,3.361888245,3586920,25.15531592,278,333,611,1739,1864,3603,4,0.483389,0.494812,0.000475,No
3404,show,2133,7.431247459,1395,3.57914859,3.565110798,2975535,26.59753886,245,371,616,1829,1743,3572,4,0.484074,0.496028,0.000468,No
8567,live,3130,7.047743894,2332,3.065316737,3.041731239,7299160,21.60356731,305,268,573,2588,2783,5371,4,0.480094,0.491231,0.000497,No
10081,illinois,976,8.213069591,565,4.482972553,4.477316702,551440,36.81896555,209,264,473,797,775,1572,4,0.470649,0.484226,0.000602,No
3614,september,2189,7.40533208,1815,3.315957538,3.29765136,3973035,24.55576673,285,325,610,1815,1848,3663,4,0.482495,0.494038,0.000464,No
8229,major,1599,7.719398465,1325,3.630630546,3.617302384,2118675,28.02628386,206,374,580,1445,1022,2467,4,0.478193,0.491864,0.000484,No
16389,body,1915,7.539059276,1217,3.715654191,3.7034199,2330555,28.0125372,243,278,521,1684,1545,3229,4,0.480471,0.491695,0.000529,No
3747,sea,2007,7.492135829,1271,3.672239013,3.659457936,2550897,27.51291348,173,303,476,1740,1658,3398,4,0.480562,0.492235,0.000574,No
16428,blue,860,8.339599788,563,4.486518656,4.480882917,484180,37.41577003,199,245,444,713,632,1345,4,0.477987,0.489273,0.000606,No
7677,michael,603,8.694614981,496,4.613222357,4.608260165,299088,40.11019222,209,176,385,441,378,819,4,0.470449,0.482438,0.000698,No
15803,california,1242,7.972053915,872,4.04900886,4.040260882,1083024,32.27891694,176,263,439,1124,1033,2157,4,0.480536,0.491465,0.00061,No
9315,july,2107,7.443511764,1720,3.369718714,3.352379601,3624040,25.08254089,273,338,611,1758,1832,3590,4,0.482968,0.494606,0.000435,No
10487,him,2695,7.197378694,1838,3.303364981,3.284824532,4953410,23.77556873,223,393,616,1659,2422,4081,4,0.484801,0.496963,0.00043,Yes
106,year,3641,6.896243917,2556,2.973208309,2.947316502,9306396,20.50396971,194,383,577,3504,2887,6391,4,0.48508,0.496977,0.000459,No
8814,left,1420,7.838120027,1194,3.73473399,3.722732498,1695480,29.27329328,293,243,536,1158,1277,2435,4,0.477717,0.489071,0.00049,No
11241,good,1956,7.517875327,1536,3.482861371,3.467392651,3004416,26.18371756,196,413,609,1755,1448,3203,4,0.482968,0.496038,0.000426,No
8227,make,3667,6.889403009,2878,2.854947397,2.82575602,10553626,19.66888319,169,434,603,3293,2882,6175,4,0.483336,0.496681,0.000427,No
746,virginia,1083,8.10904193,520,4.565969473,4.560766062,563160,37.02563791,183,260,443,850,844,1694,4,0.4792,0.490437,0.00058,No
1736,thomas,653,8.614955048,520,4.565969473,4.560766062,339560,39.33562176,220,197,417,511,441,952,4,0.469877,0.482395,0.000608,No
13097,east,3602,6.907287652,2918,2.841144555,2.811541253,10510636,19.6246027,253,353,606,3326,2772,6098,4,0.480627,0.493221,0.000412,No
7873,mean,1781,7.611601894,1603,3.440166132,3.42401675,2854943,26.18517504,79,506,585,1702,1460,3162,4,0.483547,0.498202,0.000425,No
4391,richard,666,8.595242507,520,4.565969473,4.560766062,346320,39.2456149,198,156,354,527,463,990,4,0.46235,0.475879,0.000693,No
14369,country,2943,7.109347429,1975,3.231474607,3.211537573,5812425,22.97367569,211,413,624,2699,2473,5172,4,0.485783,0.498038,0.000393,No
10294,house,1469,7.804195001,1011,3.901103065,3.890951918,1485159,30.44496904,252,225,477,1253,1315,2568,4,0.478606,0.489348,0.000509,No
511,way,2633,7.221032885,2118,3.162043013,3.140656364,5576694,22.83321658,216,257,473,2477,2446,4923,4,0.48107,0.491723,0.000512,No
9031,la,2010,7.490144788,1621,3.42838305,3.41204056,3258210,25.67908543,179,103,282,1763,1263,3026,4,0.43986,0.456542,0.000845,No
2370,such,4683,6.644837968,3722,2.597781847,2.55986266,17430126,17.26183945,701,147,848,1736,4278,6014,4,0.466739,0.479076,0.000281,Yes
10999,guitar,949,8.241123379,474,4.658590963,4.653849836,449826,38.39202289,162,231,393,702,656,1358,4,0.476102,0.48763,0.000606,No
15265,children,1683,7.668198983,1239,3.697738403,3.685281383,2085237,28.35499386,253,326,579,1480,1410,2890,4,0.484325,0.495348,0.000409,No
8630,line,1348,7.890154886,846,4.079278925,4.070793191,1140408,32.18614254,263,210,473,1149,1109,2258,4,0.478322,0.48886,0.000498,No
8748,less,1057,8.133342191,931,3.983539007,3.97419568,984067,32.39948588,166,271,437,877,852,1729,4,0.474309,0.487085,0.000532,No
8441,love,1003,8.185781389,698,4.271579181,4.264584918,700094,34.96621337,216,247,463,877,870,1747,4,0.478786,0.489883,0.000502,No
17843,although,1171,8.030918814,1105,3.81219767,3.8010965,1293955,30.61544999,475,198,673,697,1006,1703,4,0.470238,0.482705,0.000344,No
13889,december,1845,7.576297621,1581,3.453985447,3.438059618,2916945,26.16842172,243,287,530,1557,1584,3141,4,0.481801,0.492822,0.000436,No
17090,b,915,8.253848895,526,4.545036263,4.539722275,481290,37.51404254,235,203,438,707,669,1376,4,0.476,0.487038,0.000525,No
18024,air,1464,7.807604483,881,4.038740658,4.029901887,1289784,31.53288967,263,246,509,1188,1155,2343,4,0.478683,0.489799,0.000451,No
6231,park,1246,7.968838478,684,4.291840367,4.284987073,852264,34.20098265,192,270,462,682,1000,1682,4,0.480914,0.491864,0.000496,No
262,without,1229,7.982576068,1101,3.815824147,3.804763423,1353129,30.46010652,459,223,682,813,753,1566,4,0.460515,0.475692,0.000333,No
12814,england,3426,6.957383498,2351,3.057202236,3.033422188,8054526,21.27012839,238,445,683,3163,2759,5922,4,0.486782,0.499319,0.00033,No
2973,son,1454,7.814458519,1156,3.767077235,3.755460249,1680824,29.43766879,172,226,398,1270,1238,2508,4,0.479096,0.489742,0.000564,No
8671,light,1367,7.876890137,793,4.143975063,4.136023692,1084031,32.6416363,231,279,510,1157,1065,2222,4,0.480159,0.491489,0.000438,No
10215,hurricane,1118,8.077235524,288,5.156837804,5.153963735,321984,41.6529935,228,188,416,942,802,1744,4,0.473575,0.484982,0.000535,No
13922,death,1579,7.731985163,1239,3.697738403,3.685281383,1956381,28.59085847,226,232,458,1425,1423,2848,4,0.479342,0.490043,0.000485,No
2933,sound,977,8.212045525,640,4.358330108,4.351919733,625280,35.79080526,229,194,423,813,775,1588,4,0.477588,0.488043,0.000525,No
11836,found,7804,6.134140476,7164,1.942974521,1.868651145,55907856,11.91847865,299,230,529,7337,7597,14934,4,0.479459,0.49008,0.000418,No
11122,green,912,8.280892187,615,4.398176016,4.392017213,560880,36.42082141,230,239,469,743,705,1448,4,0.47669,0.488221,0.000469,No
8496,london,2023,7.48419534,1255,3.684907433,3.672288397,2538865,27.57856704,200,330,530,1811,1619,3430,4,0.483244,0.494658,0.000408,No
3262,single,1335,7.899845607,958,3.954950506,3.945334613,1278930,31.24349838,138,422,560,1218,1030,2248,4,0.480003,0.494071,0.000371,No
7491,modern,1408,7.846606641,1221,3.71237281,3.700098026,1719168,29.12952914,191,379,570,1228,825,2053,4,0.464321,0.481607,0.000361,No
13589,did,2139,7.428438468,1771,3.340498646,3.322640488,3788169,24.81468865,409,196,605,1746,2065,3811,4,0.477704,0.488174,0.000339,Yes
15167,church,1918,7.537493922,999,3.913043506,3.903013573,1916082,29.49454164,215,281,496,1701,1588,3289,4,0.481736,0.492667,0.000411,No
7326,mother,1313,7.916462303,1013,3.89912678,3.888955429,1330069,30.86729017,178,250,428,1192,1078,2270,4,0.478928,0.490052,0.000472,No
12300,father,1911,7.541150233,1386,3.585621104,3.571674579,2648646,27.03970743,178,323,501,1786,1522,3308,4,0.483165,0.49446,0.000401,No
1474,town,3890,6.830367741,2507,2.992956186,2.967577352,9752230,20.44299138,292,268,560,3482,3450,6932,4,0.481253,0.492076,0.00035,No
5916,person,3377,6.971789157,2169,3.137776773,3.115858752,7324713,21.87591809,175,333,508,3228,2704,5932,4,0.481762,0.493672,0.000379,No
11925,food,1420,7.838120027,924,3.991086213,3.981813538,1312080,31.28261277,267,226,493,1168,1120,2288,4,0.478554,0.489325,0.000389,No
5375,power,1764,7.621192941,1120,3.79871432,3.787461467,1975680,28.95073476,284,267,551,1493,1388,2881,4,0.47964,0.490888,0.000342,No
18232,acid,281,9.458177508,159,5.750894082,5.749312864,44679,54.39297706,72,78,150,221,227,448,4,0.466763,0.477781,0.001243,No
10393,home,1805,7.598216307,1484,3.51730186,3.502361098,2678620,26.72522035,265,218,483,1580,1495,3075,4,0.479122,0.489611,0.000384,No
2872,special,1243,7.971249086,1050,3.863252841,3.852707645,1305150,30.79495068,190,317,507,1128,660,1788,4,0.460037,0.477105,0.000362,No
9535,italian,1069,8.122053266,788,4.150300194,4.142399221,842372,33.70895925,158,237,395,872,669,1541,4,0.46317,0.478043,0.000461,No
6674,october,1990,7.50064226,1673,3.397424583,3.380563566,3329270,25.4828664,276,280,556,1670,1741,3411,4,0.48188,0.492737,0.000324,No
7793,men,1087,8.10535529,806,4.127714542,4.119632128,876122,33.4565929,232,228,460,940,924,1864,4,0.476895,0.488188,0.000385,No
15365,character,1118,8.077235524,798,4.137689687,4.129687917,892164,33.42109412,165,208,373,889,918,1807,4,0.478386,0.488864,0.000464,No
10283,how,2196,7.401684105,1642,3.415519166,3.398963198,3605832,25.28059392,263,242,505,1606,1950,3556,4,0.469678,0.483095,0.000339,Yes
9477,japanese,1267,7.952124997,838,4.088780184,4.080375127,1061746,32.51449111,164,339,503,1023,893,1916,4,0.474169,0.488254,0.000338,No
10498,hill,498,8.8859321,365,4.919900931,4.916254363,181770,43.71790561,168,149,317,395,374,769,4,0.476767,0.486606,0.000525,No
507,we,1314,7.915700978,812,4.120297944,4.112155043,1066968,32.61504647,327,197,524,1062,1225,2287,4,0.461341,0.47587,0.000317,Yes
8870,law,1352,7.887191921,882,4.037606228,4.028757368,1192464,31.84537522,221,216,437,1093,1102,2195,4,0.479135,0.489583,0.000377,No
9834,information,1259,7.958459143,896,4.021857871,4.01286776,1128064,32.00779155,263,187,450,916,1062,1978,4,0.475337,0.486259,0.000358,No
5467,popular,2232,7.385878854,1856,3.293619371,3.27489554,4142592,24.32627366,146,414,560,2065,1737,3802,4,0.481697,0.495155,0.000284,No
10249,human,1355,7.884975444,1004,3.908050984,3.897970547,1360420,30.81488604,227,251,478,1199,802,2001,4,0.472516,0.485372,0.000332,No
5562,point,1196,8.009794243,888,4.030826541,4.021917148,1062048,32.28609122,201,179,380,789,1073,1862,4,0.47764,0.48778,0.000416,No
3560,several,2280,7.364601455,2062,3.18836662,3.16754169,4701360,23.48104945,308,286,594,1895,804,2699,4,0.453769,0.471542,0.000266,No
5303,president,2099,7.447315858,1134,3.7862918,3.774897356,2380266,28.19771096,241,238,479,1779,1902,3681,4,0.478993,0.489888,0.000328,No
3238,site,1268,7.951336042,1034,3.878608229,3.868224713,1311112,30.84011741,168,278,446,1079,988,2067,4,0.479822,0.491231,0.000347,No
4077,said,1801,7.600434832,1476,3.522707279,3.507847716,2658276,26.77410711,299,146,445,1450,1720,3170,4,0.47535,0.485498,0.000345,No
18065,again,1132,8.064790919,978,3.934288614,3.924470772,1107096,31.72921509,328,201,529,817,993,1810,4,0.475401,0.486564,0.000288,Yes
1579,together,1871,7.562303851,1587,3.450197564,3.43421077,2969277,26.09144232,359,218,577,1062,1714,2776,4,0.479045,0.489536,0.000262,No
7285,much,2124,7.435475795,1875,3.283434346,3.264516909,3982500,24.4138966,283,280,563,1839,1572,3411,4,0.475732,0.488292,0.000267,No
12566,every,1349,7.889413321,1182,3.744835086,3.732955033,1594518,29.54455181,348,302,650,979,1173,2152,4,0.417003,0.439792,0.000231,No
8967,land,1846,7.575755762,1319,3.635169131,3.621901772,2434874,27.53915349,275,275,550,1505,1543,3048,4,0.479848,0.491184,0.000272,No
15453,central,1590,7.725042882,1275,3.669096827,3.656275235,2027250,28.34393032,206,285,491,1434,1268,2702,4,0.473625,0.486841,0.000303,No
17397,army,1410,7.845187194,947,3.966499191,3.956994352,1335270,31.11792866,187,232,419,1101,1115,2216,4,0.478103,0.489123,0.000355,No
2558,still,1778,7.613287761,1624,3.427150763,3.410787944,2887472,26.09188496,230,281,511,1573,1121,2694,4,0.478618,0.490418,0.000286,No
3572,set,1557,7.746016006,1224,3.709918821,3.697613667,1905768,28.73709057,253,160,413,1354,1466,2820,4,0.476039,0.48625,0.000351,No
17373,art,1018,8.17093698,678,4.300650996,4.293858112,690204,35.14034826,208,191,399,867,800,1667,4,0.476268,0.487015,0.000363,No
12118,fire,809,8.40073326,559,4.493648811,4.488053297,452231,37.74994503,166,213,379,713,622,1335,4,0.477177,0.488085,0.000378,No
12989,either,888,8.307560434,824,4.105627754,4.097363867,731712,34.10775069,189,294,483,732,691,1423,4,0.479239,0.491113,0.000294,No
13301,down,1467,7.805557399,1230,3.705028836,3.692662938,1804410,28.91981524,236,250,486,976,1278,2254,4,0.479899,0.490756,0.000288,Yes
5686,place,2447,7.293914114,2028,3.204992919,3.184515078,4962516,23.37694309,227,227,454,1987,2245,4232,4,0.48025,0.490583,0.000308,No
15198,christian,936,8.254916701,694,4.277326324,4.270372339,649584,35.3089725,219,216,435,801,587,1388,4,0.468896,0.482034,0.00032,No
3819,science,1164,8.036055811,856,4.067527908,4.05894132,996384,32.68688128,175,202,377,823,997,1820,4,0.477807,0.488334,0.000368,No
429,what,2527,7.26174407,2003,3.217396949,3.197174241,5061581,23.36391321,359,216,575,2024,2122,4146,4,0.470687,0.483348,0.000241,Yes
12240,female,721,8.51589304,580,4.456770181,4.45096347,418180,37.95337816,130,232,362,639,439,1078,4,0.476243,0.487752,0.000377,No
5663,plant,910,8.283087578,540,4.528229145,4.522824675,491400,37.50771858,183,182,365,747,655,1402,4,0.475325,0.486151,0.000371,No
3026,software,794,8.419448716,428,4.760675089,4.756396032,339832,40.08225976,172,178,350,603,553,1156,4,0.476422,0.486874,0.000386,No
3420,short,1282,7.94035554,1126,3.793371476,3.782057943,1443532,30.12071821,199,254,453,1136,913,2049,4,0.477319,0.488968,0.000297,No
238,won,2178,7.410369874,1521,3.492674992,3.477358597,3312738,25.88201354,259,166,425,1785,2026,3811,4,0.474511,0.485254,0.000313,Yes
7879,me,530,8.823655171,355,4.947680495,4.944134285,188150,43.65662658,131,182,313,446,471,917,4,0.474081,0.48525,0.000421,Yes
6195,party,1645,7.691036514,827,4.101993589,4.093699453,1360415,31.54858248,169,286,455,1143,1310,2453,4,0.481932,0.492888,0.000288,No
14996,club,1238,7.975279724,697,4.273012873,4.26602868,862886,34.07847293,151,194,345,1062,936,1998,4,0.476524,0.487268,0.000379,No
2471,street,558,8.772173215,388,4.858792945,4.854915514,216504,42.62217333,152,151,303,427,431,858,4,0.474207,0.484771,0.000431,No
7721,metal,1204,8.003127551,705,4.261600481,4.254535725,848820,34.10613223,161,232,393,1112,944,2056,4,0.47678,0.488151,0.000331,No
14273,creek,339,9.27053207,154,5.782845682,5.781314541,52206,53.61005635,112,151,263,240,275,515,4,0.471587,0.482818,0.000492,No
11415,get,1958,7.516853354,1590,3.448308989,3.432291712,3113220,25.92043299,142,291,433,1764,1618,3382,4,0.476268,0.488907,0.000298,No
1745,third,1414,7.842354331,1272,3.67145254,3.658661335,1798608,28.79283173,137,272,409,1334,1076,2410,4,0.466175,0.481025,0.000315,No
8911,last,1676,7.672366896,1477,3.522030002,3.507160289,2475452,27.02230639,150,413,563,1569,1283,2852,4,0.476831,0.49163,0.000228,No
15251,chinese,935,8.255985648,550,4.509880006,4.504374991,514250,37.2335046,169,255,424,749,589,1338,4,0.473095,0.485883,0.000302,No
2659,star,966,8.223368343,577,4.461956018,4.456179481,557382,36.69230786,231,199,430,809,715,1524,4,0.478773,0.488977,0.000297,No
7310,mountain,942,8.248526903,638,4.361460001,4.355069754,600996,35.97562015,177,188,365,667,729,1396,4,0.474765,0.485869,0.000349,No
5955,period,1249,7.966433667,951,3.962284222,3.952739001,1187799,31.56527442,151,172,323,947,1083,2030,4,0.477627,0.487639,0.000393,No
3582,service,895,8.299708459,637,4.363028629,4.356648446,570115,36.21186562,190,186,376,701,677,1378,4,0.477833,0.488076,0.000336,No
5050,public,1148,8.0507556,937,3.977115002,3.967711111,1075676,32.01878088,208,234,442,1008,732,1740,4,0.476371,0.487921,0.000281,No
17181,australia,1670,7.675953272,1095,3.821288642,3.810288581,1828650,29.33203305,174,316,490,1474,1455,2929,4,0.482508,0.493864,0.000253,No
5639,play,1881,7.556973348,1357,3.606766624,3.593114123,2552517,27.25623925,183,253,436,1651,1635,3286,4,0.480211,0.491038,0.000281,No
16636,best,2394,7.315811291,1935,3.251935679,3.232406609,4632390,23.79054776,218,291,509,2158,1843,4001,4,0.47836,0.490432,0.00024,No
2978,something,1460,7.810340463,1116,3.802292141,3.79107974,1629360,29.69719616,251,218,469,1155,1276,2431,4,0.477563,0.488461,0.00026,No
8028,mary,626,8.657181806,394,4.843447375,4.839509711,246644,41.93060449,179,187,366,538,498,1036,4,0.473878,0.485189,0.000332,No
16881,bass,658,8.607327246,418,4.784316852,4.780138217,275044,41.18018079,167,130,297,454,452,906,4,0.472994,0.483452,0.000409,No
11919,football,3843,6.842523587,2390,3.040749639,3.016570135,9184770,20.80640113,226,151,377,2325,2140,4465,4,0.471649,0.482851,0.000321,No
239,women,1069,8.122053266,703,4.264441392,4.257396778,751507,34.63602014,217,202,419,875,838,1713,4,0.477897,0.488395,0.000288,No
16774,began,1585,7.728192491,1370,3.597232265,3.583447971,2171450,27.80010338,355,92,447,1142,1174,2316,4,0.470101,0.480583,0.000269,No
12098,fish,682,8.57150252,376,4.890209141,4.886452167,256432,41.91643997,154,151,305,548,541,1089,4,0.475987,0.486043,0.000393,No
17075,back,1731,7.640077622,1471,3.526100564,3.511291746,2546301,26.93968201,277,189,466,1240,1613,2853,4,0.477717,0.488043,0.000255,No
3043,society,738,8.491234256,527,4.550702001,4.545418171,388926,38.64107672,171,160,331,547,616,1163,4,0.477306,0.487203,0.000359,No
11771,free,996,8.19278492,774,4.168226411,4.160466535,770904,34.14938248,193,205,398,878,787,1665,4,0.476639,0.487541,0.000298,No
955,valley,821,8.386009068,555,4.50083017,4.495274879,455655,37.74400262,135,160,295,565,664,1229,4,0.474676,0.485264,0.0004,No
156,written,2168,7.414971815,1743,3.356435239,3.33886208,3778824,24.88787269,231,154,385,1833,1990,3823,4,0.474638,0.485137,0.000306,No
4611,region,7085,6.230797025,6329,2.066900759,2.001531243,44840965,12.8784391,240,214,454,6365,4697,11062,4,0.478451,0.489033,0.000258,No
16803,become,1627,7.70203907,1438,3.548789746,3.534315789,2339626,27.33291727,115,254,369,1507,1321,2828,4,0.472969,0.48578,0.000317,No
17950,alexander,418,9.061050745,338,4.996752389,4.993376765,141284,45.27582695,155,107,262,327,306,633,4,0.468871,0.479945,0.000445,No
1351,tree,625,8.658780528,377,4.887553097,4.883786086,235625,42.32024958,143,145,288,560,486,1046,4,0.475732,0.485752,0.000393,No
10024,important,2700,7.195525125,2340,3.061892076,3.038224667,6318000,22.03192136,167,452,619,2577,1866,4443,4,0.479886,0.494573,0.000182,No
15447,century,2857,7.138304985,2185,3.129969615,3.107877816,6242545,22.34267771,121,414,535,2611,2203,4814,4,0.484748,0.49731,0.00021,No
7619,military,1072,8.119250836,790,4.147765339,4.139844207,846880,33.67674719,214,221,435,870,653,1523,4,0.476921,0.488043,0.000258,No
1782,theory,732,8.500751663,440,4.733023557,4.728623981,322080,40.23425788,126,110,236,563,621,1184,4,0.473524,0.483466,0.000475,No
10091,iii,1029,8.160189442,784,4.155389264,4.147528606,806736,33.9087636,154,184,338,749,796,1545,4,0.476639,0.48716,0.000329,No
12593,european,1187,8.017347783,900,4.017403521,4.008373048,1068300,32.20892121,163,223,386,1068,753,1821,4,0.459501,0.474931,0.000288,No
4192,royal,1120,8.075448213,765,4.17992245,4.17225327,856800,33.75474728,165,211,376,1007,863,1870,4,0.473082,0.485081,0.000294,No
11897,force,926,8.265657943,582,4.453327836,4.44750101,538932,36.8096846,147,193,340,776,733,1509,4,0.478051,0.488362,0.000325,No
1718,though,957,8.232728786,913,4.003062404,3.993900746,873741,32.95612708,314,156,470,695,832,1527,4,0.472742,0.483766,0.000234,No
7639,might,840,8.363130286,729,4.228124552,4.22081807,612360,35.36035649,269,162,431,661,823,1484,4,0.452947,0.468523,0.000255,No
7991,material,665,8.596745137,484,4.637713377,4.632871772,321860,39.86923992,172,135,307,568,550,1118,4,0.475618,0.485494,0.000356,No
7194,my,604,8.692957979,434,4.74675375,4.742414435,262136,41.26333089,188,194,382,481,479,960,5,0.404858,0.42579,0.000285,Yes
454,went,1453,7.815146514,1179,3.747376384,3.735526688,1713087,29.28629548,282,80,362,1220,1425,2645,4,0.458623,0.471542,0.0003,No
9515,jack,331,9.294413802,246,5.314466748,5.312013791,81426,49.3948531,125,103,228,244,213,457,4,0.447061,0.462598,0.000473,No
2445,strong,778,8.439805653,663,4.323023294,4.316381418,515814,36.48547644,114,248,362,707,521,1228,4,0.468352,0.482226,0.000297,No
6622,oklahoma,859,8.340763255,412,4.798774935,4.794656548,353908,40.02544565,155,207,362,725,664,1389,4,0.471737,0.483945,0.000296,No
8590,list,1929,7.531775164,1445,3.543933684,3.529388705,2787405,26.6921117,252,117,369,1304,1818,3122,4,0.471036,0.481748,0.00029,No
3106,smith,354,9.227235264,235,5.36021277,5.357870075,83190,49.4599443,154,132,286,283,282,565,4,0.467821,0.479607,0.000373,No
1528,top,1211,7.997330434,970,3.942502213,3.932765155,1174670,31.52949293,136,206,342,1119,957,2076,4,0.473474,0.485254,0.000308,No
1538,took,1262,7.956079134,1129,3.79071072,3.779366847,1424798,30.15919446,284,143,427,958,1170,2128,4,0.465857,0.478367,0.000244,No
17803,america,2043,7.474357583,1605,3.438919249,3.422749542,3279015,25.70371216,90,378,468,1989,1657,3646,4,0.483652,0.495869,0.000221,No
17677,animal,780,8.435957028,577,4.460224416,4.454437821,450060,37.6262615,177,171,348,667,530,1197,4,0.473726,0.484785,0.000297,No
15774,came,1608,7.713785728,1426,3.557169683,3.542817466,2293008,27.43924473,389,88,477,1184,1567,2751,4,0.469392,0.479973,0.000216,No
1539,too,923,8.268902943,805,4.128956007,4.120883674,743015,34.14193648,249,194,443,678,832,1510,4,0.471963,0.483898,0.00023,Yes
12821,energy,1279,7.942698376,544,4.520849037,4.515404351,695776,35.90774031,221,211,432,1036,967,2003,4,0.47773,0.488451,0.000233,No
1131,type,1773,7.616103871,1519,3.493990782,3.478694694,2693187,26.61059672,193,124,317,1661,1682,3343,4,0.475197,0.484977,0.000316,No
11123,greek,1636,7.69652266,1157,3.766212557,3.754585455,1892852,28.98674029,168,232,400,1476,1128,2604,4,0.474651,0.486625,0.00025,No
16056,brown,553,8.781174176,393,4.845988672,4.842061048,217329,42.55347059,164,182,346,466,417,883,4,0.472377,0.483973,0.000289,No
13983,dark,555,8.777564064,420,4.779543573,4.775344854,233100,41.95274991,130,143,273,500,423,923,4,0.456312,0.470894,0.000366,No
152,wrote,1455,7.813770998,1050,3.863252841,3.852707645,1527750,30.18657301,220,158,378,1168,1241,2409,4,0.476895,0.486865,0.000264,No
1011,us,1025,8.164084286,825,4.104414898,4.096140928,845625,33.50878917,185,272,457,856,815,1671,4,0.479873,0.491146,0.000218,No
2894,spanish,1260,7.957665177,932,3.98246547,3.973112049,1174320,31.69112679,169,276,445,1015,896,1911,4,0.477845,0.48978,0.000223,No
14117,current,1032,8.157278231,826,4.103203511,4.094919457,852432,33.47097268,129,295,424,837,721,1558,4,0.476959,0.489475,0.000233,No
9478,japan,1759,7.624031433,1120,3.79871432,3.787461467,1970080,28.96151738,162,281,443,1418,1368,2786,4,0.476754,0.489066,0.00022,No
9742,instead,913,8.279796297,846,4.079278925,4.070793191,772398,33.77559853,374,121,495,587,831,1418,4,0.470462,0.481419,0.000196,No
16448,blood,903,8.289702817,402,4.823346196,4.819328215,363006,39.98410654,191,149,340,776,619,1395,4,0.473815,0.484428,0.000285,No
4071,saint,876,8.321166086,546,4.517179308,4.511714513,478296,37.58819927,201,141,342,716,689,1405,4,0.471976,0.482893,0.000282,No
15677,car,820,8.387227837,500,4.605190186,4.600187794,410000,38.62477932,163,183,346,734,600,1334,4,0.476793,0.487259,0.000278,No
7209,must,1033,8.156309708,809,4.123999367,4.11588671,835697,33.63661608,259,207,466,695,1000,1695,5,0.388748,0.409242,0.000205,No
11829,four,2220,7.391269702,1860,3.291466518,3.27270193,4129200,24.32811675,235,289,524,1893,876,2769,4,0.475669,0.488456,0.000181,No
6555,open,779,8.438521131,592,4.436291649,4.430364235,461168,37.43574083,164,184,348,657,647,1304,4,0.473575,0.484916,0.000272,No
13032,edward,709,8.532676651,465,4.677760879,4.673110174,329685,39.91382103,191,155,346,596,567,1163,4,0.468031,0.480236,0.000272,No
351,wife,816,8.392117822,676,4.303605208,4.29683246,551616,36.11636197,112,202,314,752,676,1428,4,0.47441,0.485874,0.000298,No
17123,award,1049,8.140939569,636,4.364599721,4.358229602,667164,35.53194257,171,123,294,790,894,1684,4,0.473752,0.483869,0.000315,No
12833,end,1756,7.625738403,1503,3.504579894,3.489446257,2639268,26.72500949,173,149,322,1644,1651,3295,4,0.476473,0.486386,0.000286,No
10119,idaho,493,8.896023003,252,5.290369197,5.287856092,124236,47.06324607,114,131,245,380,371,751,4,0.452762,0.467781,0.000375,No
13969,data,859,8.340763255,446,4.719479332,4.715019491,383114,39.3640598,207,170,377,664,683,1347,4,0.476179,0.486545,0.000241,No
16058,brother,818,8.389669841,639,4.35989383,4.353493519,522702,36.57806977,95,235,330,632,636,1268,4,0.479562,0.490231,0.000275,No
15255,china,1397,7.854449818,875,4.045574398,4.036796156,1222375,31.77576109,168,290,458,1261,1127,2388,4,0.481827,0.492897,0.000198,No
4268,roman,2116,7.439249384,1417,3.563501045,3.549240122,2998372,26.50977295,230,174,404,1579,1638,3217,4,0.458635,0.473297,0.000224,No
16786,been,5332,6.515050496,4396,2.431347969,2.386403822,23439472,15.84035479,55,360,415,5179,2519,7698,4,0.481096,0.493705,0.000218,Yes
695,voice,445,8.998457895,310,5.083225987,5.080131265,137950,45.74119501,137,97,234,355,375,730,4,0.473537,0.483236,0.000382,No
8281,magazine,538,8.808673617,370,4.906295279,4.902598528,199060,43.21795378,151,138,289,415,364,779,4,0.474233,0.484513,0.000301,No
13104,earth,1441,7.823439581,904,4.012968924,4.003898088,1302664,31.39521992,113,283,396,1365,1203,2568,4,0.477011,0.489278,0.000217,No
15693,capital,3212,7.021571818,2348,3.0580533,3.034293733,7541776,21.47234087,237,186,423,2645,2869,5514,4,0.474651,0.485752,0.000202,No
4165,rule,670,8.589254465,535,4.537531537,4.532177336,358450,38.97401302,151,135,286,577,585,1162,4,0.475312,0.485283,0.000298,No
8450,louis,677,8.578860904,467,4.673469027,4.668798229,316159,40.09304072,179,126,305,565,384,949,4,0.468748,0.480212,0.000279,No
949,van,392,9.125270338,264,5.243849181,5.241215769,103488,47.85154139,127,60,187,280,165,445,4,0.460993,0.473016,0.000455,No
12850,empire,1711,7.651698903,1095,3.821288642,3.810288581,1873545,29.23935011,108,298,406,1324,1368,2692,4,0.481867,0.493071,0.000209,No
2984,someone,1007,8.181801285,758,4.189114899,4.181516253,763306,34.27450566,186,116,302,849,785,1634,4,0.473815,0.483808,0.000278,No
7494,model,526,8.831230965,374,4.895542487,4.891805588,196724,43.2336664,144,120,264,447,440,887,4,0.473663,0.483757,0.000318,No
11212,got,1093,8.099850689,960,3.952865,3.943228913,1049280,32.01761629,262,162,424,880,862,1742,4,0.47488,0.485442,0.000197,No
7013,network,828,8.377519023,503,4.599208114,4.594175572,416484,38.52995347,172,188,360,669,618,1287,4,0.476575,0.487174,0.000232,No
17120,away,1031,8.158247693,899,4.01851525,4.009494868,926869,32.78404277,190,164,354,692,931,1623,4,0.476486,0.486667,0.000234,No
11425,germany,2689,7.199235705,1867,3.287174665,3.268328561,5020363,23.66514522,187,342,529,2331,2081,4412,4,0.479071,0.491883,0.000155,No
12542,example,2710,7.191828263,2177,3.134095223,3.112095428,5899670,22.53987461,91,437,528,2642,2320,4962,4,0.48585,0.498517,0.000155,No
10692,heart,649,8.621099461,415,4.791519764,4.787371254,269335,41.30816845,105,110,215,598,515,1113,4,0.473701,0.483611,0.000379,No
17240,attack,581,8.73178142,429,4.758341365,4.754052266,249249,41.54879673,118,137,255,516,486,1002,4,0.475579,0.48548,0.00031,No
6942,night,747,8.480466992,561,4.490077379,4.484461753,419067,38.077953,105,184,289,666,653,1319,4,0.474144,0.48532,0.000273,No
5891,peter,619,8.668426905,466,4.67561265,4.670951899,288454,40.53020649,189,134,323,465,376,841,4,0.469566,0.480996,0.000242,No
8900,latin,1040,8.149556185,810,4.122764037,4.114641298,842400,33.59869715,157,167,324,890,733,1623,4,0.474321,0.485128,0.000241,No
8077,mark,462,8.960967286,374,4.895542487,4.891805588,172788,43.86879607,126,129,255,327,316,643,4,0.472579,0.483128,0.000305,No
6286,paper,537,8.808673617,336,5.002687124,4.999331568,180432,44.06703809,123,147,270,467,413,880,4,0.476115,0.486067,0.000288,No
9367,joseph,405,9.09264511,321,5.048357161,5.045152094,130005,45.90292006,161,127,288,317,276,593,4,0.466874,0.478846,0.00027,No
2525,stone,538,8.808673617,384,4.869155732,4.865318455,206592,42.89080363,144,146,290,404,421,825,4,0.472239,0.483189,0.000264,No
15749,canada,1279,7.942698376,947,3.966499191,3.956994352,1211213,31.50470668,166,295,461,1166,1092,2258,4,0.478026,0.490245,0.000166,No
4026,same,3155,7.039788402,2562,2.971254802,2.945311683,8083110,20.91700509,23,512,535,3148,2670,5818,4,0.483349,0.498155,0.000143,Yes
11286,go,1439,7.82482847,1197,3.732224579,3.720192725,1722483,29.20401714,149,186,335,1199,1358,2557,4,0.475007,0.485987,0.000226,No
16577,bill,379,9.158995972,281,5.181443615,5.178639744,106499,47.4568212,123,111,234,309,259,568,4,0.472856,0.482982,0.000321,No
2424,study,1048,8.141893312,743,4.209102239,4.201654724,778664,34.27006138,110,170,280,959,947,1906,4,0.476243,0.486597,0.000268,No
5201,project,527,8.829331629,388,4.858792945,4.854915514,204476,42.89989422,142,126,268,384,404,788,4,0.474613,0.484583,0.000279,No
64,your,560,8.768595394,409,4.806083128,4.801994864,229040,42.14259838,165,196,361,495,414,909,4,0.406294,0.427314,0.000205,Yes
17869,almost,1001,8.187777398,955,3.958086944,3.948501339,955955,32.40793482,263,124,387,819,778,1597,4,0.468871,0.480273,0.000189,No
6579,once,941,8.249589038,868,4.05360657,4.044898941,816788,33.44058832,256,150,406,732,773,1505,4,0.472164,0.483217,0.00018,Yes
1822,texas,687,8.564197885,389,4.856218941,4.852331472,267243,41.58961998,138,181,319,581,536,1117,4,0.468512,0.481053,0.000229,No
669,von,403,9.097595615,295,5.132822928,5.129878657,118885,46.69634736,102,45,147,262,102,364,4,0.432561,0.449209,0.000494,No
10718,head,1127,8.069217663,889,4.029701049,4.020781566,1001903,32.51653488,200,161,361,944,1004,1948,4,0.476128,0.486362,0.000201,No
17414,arkansas,527,8.829331629,281,5.181443615,5.178639744,148087,45.74868399,136,170,306,420,413,833,4,0.466126,0.479039,0.000236,No
2408,style,667,8.593742131,520,4.565969473,4.560766062,346840,39.23876423,167,137,304,558,572,1130,4,0.472528,0.483254,0.000237,No
13694,design,508,8.86605073,369,4.90900164,4.905314926,187452,43.52345757,163,120,283,423,411,834,4,0.473663,0.483752,0.000253,No
7311,mount,502,8.877932058,298,5.122704798,5.119730438,149596,45.47902515,148,92,240,398,216,614,4,0.457913,0.471199,0.000298,No
1600,title,947,8.243233084,732,4.22401777,4.216681069,693204,34.81956303,124,179,303,858,799,1657,4,0.476166,0.486728,0.000236,No
1910,television,2089,7.452091416,1478,3.521353183,3.50647332,3087542,26.24144582,231,201,432,1551,1463,3014,4,0.477781,0.488296,0.000165,No
14148,culture,693,8.555502178,541,4.526379005,4.520964481,374913,38.72544544,160,177,337,546,575,1121,4,0.478051,0.488043,0.000211,No
13144,dutch,607,8.688003386,433,4.749060556,4.744731285,262831,41.25985419,119,193,312,516,421,937,4,0.472151,0.483992,0.000226,No
11267,goes,707,8.535501511,604,4.416224086,4.410175954,427028,37.69468736,239,81,320,592,678,1270,4,0.469429,0.479879,0.00022,No
15434,certain,973,8.216148095,820,4.110493944,4.102270387,797860,33.77242699,158,200,358,873,415,1288,4,0.462531,0.476912,0.000196,No
464,well,2635,7.219893716,2390,3.040749639,3.016570135,6297650,21.95388921,172,182,354,2483,2366,4849,4,0.47764,0.48785,0.000197,No
73,york,1968,7.5117591,1280,3.665182927,3.65231069,2519040,27.53197121,44,304,348,1945,1475,3420,4,0.480536,0.49223,0.0002,No
10780,harry,371,9.180330115,182,5.615791597,5.613979993,67522,51.55482072,126,82,208,282,161,443,4,0.457465,0.470668,0.000334,No
6488,original,1059,8.131451832,936,3.978182808,3.968789011,991224,32.34840188,109,333,442,933,720,1653,4,0.466175,0.482165,0.000157,No
10629,help,1244,7.970444904,1078,3.836935533,3.826107334,1341032,30.58208326,116,247,363,1152,1092,2244,4,0.477678,0.489085,0.000191,No
17365,arthur,389,9.132952834,231,5.377380574,5.375077971,89859,49.11136315,123,127,250,327,264,591,4,0.468401,0.479968,0.000273,No
8039,martin,448,8.991738945,335,5.005667752,5.002322229,150080,45.00965767,165,121,286,332,339,671,4,0.464042,0.476522,0.000238,No
3358,side,1114,8.080819757,824,4.105627754,4.097363867,917936,33.17683787,189,158,347,1027,992,2019,4,0.476729,0.486743,0.000196,No
12934,elizabeth,411,9.077938963,302,5.109371267,5.106356788,124122,46.3825605,116,111,227,354,322,676,4,0.467378,0.478903,0.000299,No
16858,battle,1812,7.594345691,1071,3.843450214,3.832692773,1940652,29.18848957,220,137,357,1658,1706,3364,4,0.474753,0.484883,0.00019,No
9924,indiana,450,8.987284595,254,5.282464017,5.279930862,114300,47.47500748,135,152,287,379,369,748,4,0.465967,0.478602,0.000235,No
2700,stage,520,8.842703366,405,4.815911217,4.811863115,210600,42.58567433,126,108,234,472,424,896,4,0.47422,0.483954,0.000287,No
8211,male,574,8.743902781,438,4.737579374,4.733199885,251412,41.42493346,141,174,315,509,398,907,4,0.470724,0.482597,0.000212,No
7225,museum,553,8.781174176,350,4.96186513,4.958369096,193550,43.57100194,143,113,256,432,440,872,4,0.473045,0.483193,0.00026,No
1793,themselves,589,8.718105994,530,4.546921278,4.541617342,312170,39.64054164,147,135,282,411,493,904,4,0.473486,0.483921,0.000236,Yes
12967,electric,822,8.384791782,522,4.562130696,4.556907182,429084,38.25251597,166,117,283,687,627,1314,4,0.459978,0.473307,0.000235,No
13095,eastern,1252,7.964034626,1002,3.910045003,3.899984768,1254504,31.13973379,134,209,343,1144,1076,2220,4,0.446027,0.463772,0.000193,No
9533,italy,1233,7.978515973,942,3.97179301,3.962338646,1161486,31.68901397,129,232,361,1060,945,2005,4,0.479861,0.490414,0.000182,No
443,western,1614,7.710061329,1303,3.647373707,3.634268468,2103042,28.12147497,174,279,453,1497,1273,2770,4,0.460121,0.47648,0.000145,No
11537,gas,582,8.73006173,326,5.032900903,5.029645675,189732,43.93753556,120,142,262,510,436,946,4,0.474676,0.48493,0.00025,No
6660,off,1096,8.09710971,953,3.960183381,3.950617968,1044488,32.0660393,225,203,428,718,997,1715,4,0.477306,0.487982,0.000153,Yes
9526,itself,670,8.589254465,605,4.414569826,4.408511633,405350,37.91786359,252,140,392,477,564,1041,4,0.476166,0.485987,0.000166,Yes
2905,space,977,8.212045525,595,4.431236879,4.425279286,581315,36.38951898,181,187,368,751,751,1502,4,0.477473,0.487808,0.000176,No
7111,natural,996,8.19278492,748,4.202395306,4.194897417,745008,34.42932089,194,178,372,832,490,1322,4,0.460718,0.475015,0.000174,No
10896,hall,710,8.531267207,459,4.690748074,4.686157646,325890,40.01802522,134,123,257,593,646,1239,4,0.475388,0.485104,0.000251,No
11259,golden,538,8.808673617,411,4.80120507,4.797096724,221118,42.29224843,108,127,235,465,404,869,4,0.426532,0.445275,0.000274,No
5239,process,656,8.610371388,519,4.567894401,4.562701042,340464,39.33126726,98,103,201,539,545,1084,4,0.473436,0.483283,0.00032,No
4837,race,578,8.736958309,331,5.017679909,5.014374518,191318,43.83926017,135,147,282,459,489,948,4,0.473423,0.484099,0.000228,No
2586,stephen,258,9.543572592,207,5.487079491,5.485017408,53406,52.36634144,110,89,199,210,179,389,4,0.45237,0.466706,0.000322,No
13448,district,3599,6.908120869,2271,3.091822742,3.068861595,8173329,21.35868521,175,188,363,2400,2781,5181,4,0.477768,0.488048,0.000175,No
16239,boy,617,8.668426905,408,4.80853111,4.804452887,251736,41.68240044,102,146,248,560,476,1036,4,0.469926,0.481489,0.000256,No
13398,dog,396,9.115117966,241,5.335001351,5.332598514,95436,48.62916666,113,131,244,349,298,647,4,0.473183,0.483616,0.00026,No
3726,season,1567,7.738975976,882,4.036473084,4.027614135,1382094,31.23816822,151,231,382,1379,1276,2655,4,0.479096,0.489827,0.000165,No
4361,right,1049,8.140939569,845,4.080461657,4.071986009,886405,33.21879176,172,195,367,947,929,1876,4,0.476358,0.487165,0.000171,No
8845,league,2432,7.300062934,1051,3.862300913,3.851745612,2556032,28.19503974,152,255,407,2022,1892,3914,4,0.479964,0.490897,0.000154,No
4820,radio,869,8.329189052,520,4.565969473,4.560766062,451880,38.03082294,200,159,359,650,443,1093,4,0.469603,0.481456,0.000174,No
17710,andrew,293,9.416359568,221,5.421635583,5.419433203,64753,51.0520701,97,102,199,234,220,454,4,0.461173,0.473955,0.00031,No
3295,similar,1429,7.831801999,1297,3.6519891,3.638944649,1853413,28.60165553,208,192,400,1214,1147,2361,4,0.473284,0.48486,0.000154,No
14536,control,988,8.201862138,820,4.1117142,4.103500726,810160,33.72371302,201,171,372,830,832,1662,4,0.476831,0.487057,0.000165,No
2960,soon,621,8.665201095,570,4.474161923,4.468455788,353970,38.7695128,194,95,289,499,310,809,4,0.463582,0.475677,0.000211,No
2704,stadium,739,8.491234256,320,5.051477288,5.048282254,236480,42.893277,127,107,234,547,597,1144,4,0.474258,0.483945,0.000259,No
3212,skin,521,8.840782136,333,5.011655794,5.008330337,173493,44.30695702,111,131,242,469,410,879,4,0.475873,0.485606,0.00025,No
7437,money,1305,7.922573858,886,4.033081334,4.024192118,1156230,31.95238474,192,182,374,1126,1126,2252,4,0.47836,0.488367,0.000161,No
18210,act,750,8.476458971,602,4.419540839,4.413512827,451500,37.46205659,169,119,288,596,660,1256,4,0.476013,0.485489,0.000209,No
15202,chris,267,9.509283519,203,5.506592305,5.504570303,54201,52.36374745,96,73,169,186,159,345,4,0.417366,0.435703,0.000355,No
12853,emperor,1491,7.789329863,892,4.026332152,4.0173824,1329972,31.36242927,167,190,357,1207,921,2128,4,0.474791,0.485902,0.000168,No
10912,hair,447,8.993973583,235,5.36021277,5.357870075,105045,48.20961205,121,114,235,376,329,705,4,0.472906,0.483071,0.000254,No
15474,cell,611,8.681435218,250,5.298337366,5.295844311,152750,45.99717261,123,139,262,541,469,1010,4,0.474664,0.484846,0.000227,No
242,woman,647,8.624185883,495,4.615240522,4.610288379,320265,39.80269215,102,153,255,586,499,1085,4,0.475834,0.485996,0.000233,No
3247,sir,478,8.926921445,389,4.856218941,4.852331472,185942,43.351085,177,109,286,354,414,768,4,0.420122,0.439055,0.000207,No
4760,range,725,8.510360522,576,4.463690624,4.457924144,417600,37.98761647,112,103,215,565,645,1210,4,0.474867,0.484339,0.000275,No
12642,etc,418,9.046798722,389,4.843447375,4.839509711,162602,43.81769352,172,115,287,192,328,520,4,0.475681,0.485146,0.000206,No
10303,hot,700,8.545451842,506,4.593261615,4.588198922,354200,39.25149593,147,177,324,623,557,1180,4,0.472679,0.484109,0.000182,No
17864,along,1190,8.014823591,1092,3.824032128,3.813062398,1299480,30.64894291,385,75,460,687,1134,1821,4,0.459026,0.471762,0.000127,No
17722,ancient,1390,7.859473151,1069,3.845319373,3.834582149,1485910,30.22218437,140,214,354,1286,981,2267,4,0.457689,0.473344,0.000162,No
11360,given,1725,7.643549848,1463,3.531553883,3.516826255,2523675,26.99360815,167,223,390,1549,1603,3152,4,0.474638,0.486423,0.000146,No
6631,oil,505,8.871973748,283,5.174351387,5.171527459,142915,45.90670966,135,117,252,438,351,789,4,0.471725,0.482273,0.000225,No
9145,kingdom,2170,7.414049731,1680,3.393249212,3.376317003,3645600,25.15771841,106,307,413,696,1897,2593,4,0.48264,0.493789,0.000137,No
11889,forest,422,9.051526863,281,5.181443615,5.178639744,118582,46.89997607,98,136,234,320,328,648,4,0.472956,0.483527,0.000241,No
2261,surface,744,8.484491143,546,4.517179308,4.511714513,406224,38.32596783,128,129,257,639,622,1261,4,0.475745,0.485475,0.000219,No
1109,uk,790,8.424499232,617,4.39492926,4.388750333,487430,37.02507818,112,227,339,710,588,1298,4,0.478618,0.489395,0.000166,No
15906,business,645,8.627281861,526,4.554497071,4.549233347,339270,39.29292997,147,162,309,516,462,978,4,0.477331,0.487254,0.000181,No
14384,council,948,8.242177675,653,4.338221155,4.331679938,619044,35.75638955,125,145,270,776,794,1570,4,0.47549,0.485569,0.000207,No
4894,queen,1086,8.106275677,761,4.185164926,4.177536052,826446,33.92610065,224,151,375,929,941,1870,4,0.473802,0.484447,0.000148,No
839,version,1101,8.092558041,798,4.137689687,4.129687917,878598,33.48449394,227,134,361,776,944,1720,4,0.475223,0.48516,0.000153,No
17053,bad,813,8.395801068,650,4.342825921,4.3363149,528450,36.46150251,158,197,355,709,497,1206,4,0.477049,0.487714,0.000155,No
18204,actor,1043,8.146675722,739,4.214500363,4.207093145,770777,34.33416779,130,190,320,681,893,1574,4,0.476819,0.487395,0.00017,No
263,within,832,8.372699737,769,4.174707315,4.166997826,639808,34.95357083,259,124,383,443,724,1167,4,0.466358,0.478358,0.000142,No
7390,moon,939,8.251716698,430,4.756013076,4.751713933,403770,39.24527251,110,176,286,713,688,1401,4,0.476307,0.486747,0.000188,No
1078,union,1494,7.787319812,1041,3.871861216,3.861406968,1555254,30.15142155,123,245,368,1256,1056,2312,4,0.48012,0.490822,0.000146,No
8539,local,977,8.212045525,829,4.099578129,4.091263826,809933,33.66592223,164,237,401,878,469,1347,4,0.440789,0.459871,0.000133,No
16847,bay,635,8.642907178,408,4.80853111,4.804452887,259080,41.55968805,124,153,277,486,540,1026,4,0.47549,0.485733,0.000191,No
769,village,1160,8.040356893,817,4.114159189,4.105965879,947720,33.0793082,121,143,264,1034,1049,2083,4,0.475503,0.485569,0.0002,No
15383,change,1206,8.0014678,956,3.957040371,3.94744467,1152936,31.66213111,168,183,351,1063,1034,2097,4,0.476665,0.48716,0.00015,No
17997,alabama,576,8.740424517,280,5.185008681,5.182214838,161280,45.31917699,114,170,284,461,354,815,4,0.467624,0.480198,0.000185,No
520,wave,377,9.16428699,177,5.643648552,5.641887036,66729,51.720015,74,110,184,294,287,581,4,0.473663,0.483564,0.000282,No
11858,fort,343,9.25880173,217,5.439900931,5.437738638,74431,50.36696415,104,96,200,282,276,558,4,0.46334,0.475523,0.000259,No
8469,lord,573,8.745646461,390,4.853651545,4.849754037,223470,42.44832046,132,121,253,487,433,920,4,0.472327,0.48279,0.000203,No
2509,storm,944,8.246406011,333,5.011655794,5.008330337,314352,41.32814847,84,195,279,411,701,1112,4,0.474575,0.48586,0.000184,No
10450,hit,659,8.605808643,519,4.567894401,4.562701042,342021,39.31042512,140,137,277,580,534,1114,4,0.475592,0.485503,0.000185,No
18320,above,720,8.517280965,644,4.352099558,4.345648926,463680,37.06805473,205,132,337,492,644,1136,4,0.469342,0.480752,0.000152,Yes
2507,story,1264,7.954495603,887,4.031953302,4.023053997,1121168,32.07215481,145,173,318,1168,1052,2220,4,0.477537,0.487588,0.000161,No
6846,northern,1553,7.748588354,1280,3.665182927,3.65231069,1987840,28.39999375,179,257,436,1443,1277,2720,4,0.444965,0.463772,0.000117,No
232,wood,473,8.937436789,340,4.990852667,4.987456976,160820,44.60543023,132,135,267,405,384,789,4,0.473448,0.483874,0.000191,No
7606,million,1843,7.57738222,1429,3.555068106,3.540685456,2633647,26.93810986,159,166,325,1662,934,2596,4,0.473486,0.484484,0.000156,No
558,washington,752,8.473795853,497,4.611208258,4.606236016,373744,39.07443742,144,161,305,657,566,1223,4,0.4685,0.480658,0.000166,No
101,yellow,454,8.978434979,337,4.999715354,4.996349764,152998,44.88961922,118,152,270,398,360,758,4,0.46626,0.478795,0.000186,No
5271,prince,821,8.386009068,519,4.567894401,4.562701042,426099,38.30640387,197,146,343,670,683,1353,4,0.473146,0.483869,0.000145,No
5452,port,647,8.624185883,396,4.838384073,4.83442633,256212,41.72712362,149,107,256,515,536,1051,4,0.472428,0.482621,0.000194,No
16129,bridge,557,8.773966937,253,5.286408795,5.283885665,140921,46.38277599,131,131,262,441,457,898,4,0.47341,0.483771,0.000189,No
12534,except,469,8.943799483,454,4.699500865,4.694950619,212926,42.03139341,192,86,278,283,433,716,4,0.461556,0.473945,0.000178,No
9925,india,1632,7.698970642,954,3.959134613,3.949559104,1556928,30.48126115,160,266,426,1493,1335,2828,4,0.481592,0.492273,0.000116,No
12594,europe,1794,7.603771876,1424,3.558573192,3.544241264,2554656,27.05857876,141,304,445,1687,1534,3221,4,0.481527,0.492977,0.000111,No
6995,never,789,8.425765857,695,4.275886439,4.268922385,548355,36.02761796,162,170,332,713,472,1185,4,0.456242,0.471387,0.000148,No
6554,opera,664,8.598250028,326,5.032900903,5.029645675,216464,43.27414033,121,127,248,610,490,1100,4,0.474613,0.484602,0.000198,No
8011,massachusetts,398,9.110080172,293,5.139625675,5.136701462,116614,46.82240196,84,115,199,348,336,684,4,0.467525,0.479062,0.000246,No
3794,scott,342,9.26172144,287,5.160316068,5.157452028,98154,47.79340997,98,87,185,241,268,509,4,0.448609,0.463608,0.000263,No
11040,growth,226,9.675997178,170,5.683999847,5.682308451,38420,54.99836648,81,67,148,185,190,375,4,0.466628,0.477466,0.000327,No
15668,carbon,431,9.030424087,223,5.412626513,5.410404089,96113,48.87831284,122,64,186,363,339,702,4,0.45341,0.467058,0.00026,No
13111,earl,350,9.238599023,248,5.306369538,5.303896532,86800,49.02342043,106,50,156,239,323,562,4,0.460085,0.47211,0.000309,No
343,wild,392,9.125270338,286,5.163806473,5.160952462,112112,47.12113004,104,114,218,331,255,586,4,0.460586,0.473687,0.000221,No
13227,drug,322,9.321980632,200,5.521480918,5.519488975,64400,51.47113817,70,85,155,272,227,499,4,0.465002,0.476588,0.00031,No
11506,gave,799,8.413171232,734,4.221289256,4.213932407,586466,35.51442933,213,116,329,632,716,1348,4,0.467821,0.479334,0.000146,No
9400,joe,209,9.754197925,162,5.732201949,5.730590684,33858,55.91303236,85,75,160,160,110,270,4,0.449916,0.464443,0.000299,No
3796,scotland,1212,7.996505011,802,4.132689676,4.124647585,972024,33.0470737,124,233,357,1053,970,2023,4,0.480562,0.49093,0.000133,No
2921,southern,1533,7.761550298,1315,3.63820634,3.624979512,2015895,28.2381215,124,255,379,1422,1320,2742,4,0.44482,0.463622,0.000125,No
4578,religious,640,8.635064001,524,4.5583066,4.553062981,335360,39.36126923,143,121,264,553,287,840,4,0.454257,0.468852,0.000179,No
14005,dance,443,9.002962407,254,5.282464017,5.279930862,112522,47.55782496,138,125,263,369,364,733,4,0.472541,0.48302,0.000179,No
5301,press,325,9.312706995,247,5.310409948,5.307946966,80275,49.45429187,85,105,190,163,205,368,4,0.472528,0.482644,0.000247,No
7110,nature,488,8.906216771,411,4.80120507,4.797096724,200568,42.76057312,108,114,222,424,383,807,4,0.472616,0.482888,0.000211,No
1563,tom,299,9.396088604,203,5.506592305,5.504570303,60697,51.74042921,115,72,187,215,165,380,4,0.442889,0.458533,0.000249,No
14906,cold,572,8.747393186,438,4.737579374,4.733199885,250536,41.44146953,106,146,252,514,467,981,4,0.472742,0.48356,0.000184,No
5374,powerful,487,8.908268054,418,4.784316852,4.780138217,203566,42.61997697,74,173,247,458,340,798,4,0.470126,0.482142,0.000184,No
3287,simple,656,8.610371388,556,4.49902999,4.493464643,364736,38.7383191,106,210,316,592,442,1034,4,0.470088,0.482804,0.000143,No
10308,hospital,262,9.528187674,208,5.482260205,5.480188101,54496,52.2360041,77,81,158,228,221,449,4,0.473234,0.482696,0.000284,No
9373,jones,308,9.366432394,170,5.683999847,5.682308451,52360,53.2388003,103,117,220,252,249,501,4,0.467624,0.479184,0.000203,No
8338,m,700,8.498023149,431,4.74675375,4.742414435,301700,40.33802325,138,152,290,543,542,1085,4,0.473183,0.484006,0.000154,Yes
12146,film,746,8.481806577,507,4.591287281,4.586214537,378222,38.94241065,172,191,363,540,572,1112,4,0.476819,0.487404,0.000123,No
8439,low,619,8.668426905,491,4.623354156,4.618442211,303929,40.07720756,117,171,288,529,429,958,4,0.474233,0.485123,0.000155,No
9894,industry,461,8.963134134,397,4.835862004,4.831894221,183017,43.34447979,119,108,227,334,357,691,4,0.474715,0.48432,0.000195,No
6857,normal,526,8.831230965,456,4.697305475,4.692745183,239856,41.48298956,108,219,327,484,363,847,4,0.473537,0.485541,0.000135,No
3408,should,911,8.28198928,732,4.22401777,4.216681069,666852,34.98326989,244,156,400,692,890,1582,4,0.432434,0.451252,0.00011,Yes
14356,court,802,8.409423569,485,4.635649393,4.63079774,388970,38.98313927,120,171,291,712,661,1373,4,0.476729,0.486987,0.000151,No
15011,close,775,8.443669148,726,4.232248269,4.224972006,562650,35.73570414,158,81,239,657,681,1338,4,0.468414,0.479109,0.000183,No
7625,miles,932,8.259199363,756,4.191756908,4.184178415,704592,34.62055598,120,137,257,765,666,1431,4,0.471574,0.482513,0.00017,No
2672,standard,550,8.786613899,395,4.840912519,4.836964816,217250,42.53522923,123,177,300,458,411,869,4,0.474499,0.485456,0.000145,No
13430,division,946,8.244289608,567,4.47943898,4.473763016,536382,36.92979224,145,161,306,730,790,1520,4,0.474753,0.485334,0.000142,No
6364,page,559,8.770382704,433,4.749060556,4.744731285,242047,41.65107856,128,152,280,419,396,815,4,0.47655,0.486494,0.000155,No
6353,pakistan,1732,7.639500088,1085,3.830463018,3.819564057,1879220,29.26282257,133,219,352,1524,1357,2881,4,0.478438,0.489113,0.000123,No
365,whose,426,9.042092831,397,4.835862004,4.831894221,169122,43.72631315,178,165,343,271,272,543,5,0.379814,0.398552,0.000126,No
11403,giant,283,9.45108528,222,5.417120902,5.414908501,62826,51.19767162,65,109,174,248,190,438,4,0.461412,0.474278,0.000245,No
790,video,1403,7.850164097,967,3.945599789,3.935893023,1356701,30.9736058,225,130,355,1053,955,2008,4,0.471963,0.482705,0.00012,No
4135,russia,871,8.3268902,619,4.391693012,4.385493961,539149,36.5691455,144,217,361,760,691,1451,4,0.476064,0.487358,0.000118,No
7857,media,458,8.969662993,365,4.919900931,4.916254363,167170,44.12985331,128,119,247,333,298,631,4,0.472818,0.483132,0.000172,No
6506,order,1420,7.838120027,1118,3.80050163,3.789269003,1587560,29.78878794,149,128,277,1259,1136,2395,4,0.475643,0.485376,0.000153,No
13366,don,179,9.903575326,133,5.921958484,5.920627626,23807,58.64856193,70,49,119,127,109,236,4,0.440898,0.456406,0.000356,Yes
11453,genus,765,8.456656344,475,4.65648348,4.651732306,363375,39.37828056,72,76,148,599,415,1014,4,0.469392,0.479757,0.000284,No
10651,held,1065,8.125802099,874,4.046717909,4.037949755,930810,32.88282888,135,116,251,895,1000,1895,4,0.468241,0.479626,0.000167,No
15278,chicago,539,8.806816606,330,5.02070563,5.017410272,177870,44.21643372,103,113,216,468,395,863,4,0.465002,0.477095,0.000194,No
16838,beach,459,8.967481967,251,5.294345345,5.291842265,115209,47.47694641,99,121,220,340,383,723,4,0.471449,0.482128,0.00019,No
15081,class,1131,8.065674701,629,4.375667028,4.369367352,711399,35.29270684,166,176,342,927,861,1788,4,0.476754,0.487081,0.000122,No
4317,road,631,8.649226315,470,4.66706559,4.662364651,296570,40.36650651,163,157,320,514,456,970,4,0.474283,0.484921,0.00013,No
12407,eye,332,9.291397208,205,5.496788305,5.494746262,68060,51.07284351,75,104,179,298,266,564,4,0.473158,0.4831,0.000232,No
9508,jackson,319,9.331341075,184,5.604862527,5.603030887,58696,52.30088391,107,140,247,266,259,525,4,0.46538,0.477912,0.000168,No
2275,support,525,8.833133915,466,4.67561265,4.670951899,244650,41.30031267,117,125,242,444,446,890,4,0.474892,0.484766,0.00017,No
9591,iron,470,8.943799483,270,5.221376325,5.218682755,126900,46.69894288,121,106,227,396,400,796,4,0.466579,0.478189,0.000181,No
6732,object,714,8.525649215,423,4.772426105,4.768197261,302022,40.68803088,99,129,228,645,576,1221,4,0.474727,0.484705,0.00018,No
7955,max,184,9.88159642,112,6.101299413,6.100188819,20608,60.29057843,88,54,142,131,121,252,4,0.450808,0.464748,0.000289,No
7114,native,776,8.442379657,642,4.355209981,4.348779477,498192,36.76833614,167,91,258,660,398,1058,4,0.454501,0.46849,0.000159,No
494,web,599,8.701270579,375,4.892872258,4.889125322,224625,42.57420543,140,81,221,495,342,837,4,0.471111,0.481128,0.000185,No
15987,built,2101,7.446363477,1590,3.448308989,3.432291712,3340590,25.67736211,222,167,389,1805,1966,3771,4,0.477524,0.487489,0.000105,No
2169,switzerland,1527,7.765471872,1281,3.664401982,3.651519616,1956087,28.45581052,80,161,241,1281,944,2225,4,0.476819,0.486846,0.000169,No
3045,social,738,8.491234256,539,4.530082713,4.524688297,397782,38.46599352,173,104,277,623,376,999,4,0.456735,0.470495,0.000146,No
6400,own,1487,7.792016231,1327,3.62912225,3.61577382,1973249,28.27817947,58,455,513,1093,982,2075,4,0.481618,0.495869,0.000078,Yes
17663,anne,260,9.535850546,163,5.726048083,5.724426802,42380,54.60273874,109,77,186,202,171,373,4,0.445077,0.460481,0.000215,No
7996,match,359,9.213209789,227,5.394848267,5.392585754,81493,49.70386886,87,88,175,295,315,610,4,0.471812,0.481799,0.000228,No
15798,call,641,8.63350272,542,4.524532283,4.519107705,347422,39.06256177,107,119,226,507,575,1082,4,0.472868,0.483165,0.000176,No
952,value,464,8.956647625,316,5.064056071,5.060901162,146624,45.35696578,124,85,209,382,410,792,4,0.473234,0.48279,0.00019,No
9763,inside,886,8.309815227,742,4.210449041,4.2030116,657412,34.98805355,281,127,408,599,807,1406,4,0.474994,0.484879,0.000097,No
12176,field,750,8.476458971,506,4.593261615,4.588198922,379500,38.93459362,140,157,297,595,620,1215,4,0.476141,0.486292,0.000133,No
2439,structure,452,8.982849998,376,4.890209141,4.886452167,169952,43.92801517,128,95,223,357,382,739,4,0.471725,0.48186,0.000177,No
1932,teeth,331,9.294413802,191,5.567524856,5.565623087,63221,51.74687987,99,99,198,278,280,558,4,0.473929,0.483569,0.000198,No
11261,gold,698,8.548313075,451,4.708330945,4.70382088,314798,40.24828697,139,157,296,562,555,1117,4,0.475223,0.485592,0.000132,No
12573,event,688,8.562743339,492,4.621319568,4.616397573,338496,39.57117335,108,124,232,513,576,1089,4,0.476205,0.485719,0.000168,No
10589,here,626,8.657181806,572,4.470659293,4.464933043,358072,38.70331029,209,132,341,384,556,940,4,0.475236,0.485137,0.000114,Yes
13088,eat,716,8.52285201,497,4.611208258,4.606236016,355852,39.30064557,66,162,228,614,528,1142,4,0.475605,0.485991,0.00017,No
8319,machine,531,8.821770156,356,4.944867553,4.941311308,189036,43.62248501,115,114,229,444,401,845,4,0.474867,0.484527,0.000169,No
12082,five,1327,7.905856143,1158,3.765348626,3.753711407,1536666,29.76830457,192,204,396,1118,538,1656,4,0.473562,0.485297,0.000097,No
11645,further,286,9.440540367,279,5.188586502,5.185802687,79794,48.98306032,129,85,214,224,130,354,4,0.463909,0.475753,0.000178,Yes
2572,steve,201,9.793227269,159,5.750894082,5.749312864,31959,56.31981275,67,54,121,136,98,234,5,0.393636,0.411702,0.000314,No
11678,full,639,8.636627723,555,4.50083017,4.495274879,354645,38.87199463,145,165,310,531,529,1060,4,0.459062,0.47349,0.000122,No
2731,square,905,8.288597234,583,4.451611098,4.445774213,527615,36.89761143,143,127,270,767,620,1387,4,0.472503,0.483029,0.00014,No
8732,level,707,8.535501511,545,4.51901249,4.513557748,385315,38.57203793,152,146,298,595,585,1180,4,0.47586,0.48586,0.000126,No
13962,daughter,773,8.446253129,645,4.350547967,4.344087271,498585,36.74582938,106,131,237,666,657,1323,4,0.461893,0.475072,0.000158,No
5424,possible,625,8.658780528,565,4.482972553,4.477316702,353125,38.81707545,104,139,243,572,505,1077,4,0.470874,0.482048,0.000154,No
11793,frank,256,9.551354733,191,5.567524856,5.565623087,48896,53.17740489,103,84,187,189,126,315,4,0.42881,0.446524,0.000198,No
5095,province,3127,7.04870282,2030,3.204007212,3.183508957,6347810,22.58409467,142,149,291,2251,2915,5166,4,0.476409,0.486325,0.000127,No
17363,article,386,9.140694808,322,5.045246739,5.04203164,124292,46.11706067,105,86,191,301,307,608,4,0.472063,0.481931,0.000193,No
4704,real,830,8.375106477,667,4.317008238,4.310326096,553610,36.15540366,145,187,332,728,607,1335,4,0.473676,0.485043,0.000111,No
15552,cat,281,9.458177508,155,5.776373167,5.774832011,43555,54.63396277,86,92,178,227,216,443,4,0.470362,0.48079,0.000207,No
16890,basic,461,8.963134134,390,4.853651545,4.849754037,179790,43.50392984,102,162,264,404,259,663,4,0.466874,0.47948,0.000139,No
1073,unit,693,8.555502178,471,4.66494019,4.660229205,326403,39.91090596,145,108,253,575,588,1163,4,0.474182,0.483926,0.000145,No
16348,bone,192,9.839036805,124,5.999516719,5.998285986,23808,59.02946581,69,76,145,157,157,314,4,0.467722,0.478494,0.000251,No
1902,temperature,577,8.738689911,353,4.953330227,4.949804088,203681,43.28561688,106,113,219,495,470,965,4,0.47234,0.482663,0.000166,No
4393,rice,191,9.844258749,121,6.024007739,6.022807042,23111,59.30189089,76,69,145,149,137,286,4,0.458445,0.471199,0.00025,No
16897,base,486,8.910323553,351,4.959012061,4.955505992,170586,44.18640197,112,113,225,437,424,861,4,0.471712,0.482189,0.000161,No
5987,per,645,8.627281861,443,4.726228514,4.721798806,285735,40.77450553,118,125,243,291,587,878,4,0.45616,0.470434,0.000149,No
9404,job,648,8.622641481,505,4.595239855,4.590187213,327240,39.62310579,109,105,214,586,555,1141,4,0.474943,0.484433,0.000169,No
3446,ship,574,8.743902781,340,4.990852667,4.987456976,195160,43.63953051,120,142,262,510,437,947,4,0.474613,0.484902,0.000138,No
11365,girl,461,8.963134134,348,4.967595804,4.96411984,160428,44.52522752,115,118,233,413,335,748,4,0.473625,0.48371,0.000155,No
1821,text,469,8.945929409,297,5.126066145,5.123101815,139293,45.85742588,122,108,230,365,365,730,4,0.474005,0.483799,0.000157,No
16896,baseball,563,8.763252549,285,5.167309104,5.16446512,160455,45.28243468,97,108,205,440,377,817,4,0.468512,0.479701,0.000176,No
3029,soft,298,9.399438691,249,5.302345388,5.299862357,74202,49.83907039,80,119,199,257,227,484,4,0.454048,0.468621,0.000181,No
5226,produce,459,8.967481967,365,4.919900931,4.916254363,167535,44.11912288,60,155,215,391,356,747,4,0.466604,0.479123,0.000167,No
5550,police,592,8.713025542,333,5.011655794,5.008330337,197136,43.66668495,142,132,274,512,360,872,4,0.470999,0.48202,0.000131,No
12252,feet,791,8.42323421,587,4.444773464,4.438896345,464317,37.4393679,132,119,251,594,640,1234,4,0.472893,0.48317,0.000143,No
8908,late,980,8.208979606,910,4.006353685,3.997222302,891800,32.88807569,102,199,301,922,868,1790,4,0.476128,0.487057,0.000119,No
10816,hard,902,8.291917657,762,4.183851729,4.176212778,687324,34.69215402,146,152,298,753,773,1526,4,0.471524,0.482785,0.00012,No
3289,simon,186,9.870785504,127,5.975611198,5.974350429,23622,58.98397639,77,63,140,136,113,249,4,0.453456,0.467091,0.000254,No
14841,comedy,378,9.161637982,295,5.132822928,5.129878657,111510,47.02506549,93,98,191,283,320,603,4,0.472654,0.482602,0.000186,No
17738,analysis,204,9.778412184,163,5.726048083,5.724426802,33252,55.99165834,76,59,135,128,170,298,4,0.471286,0.480837,0.000263,No
4797,railway,704,8.539753821,439,4.735298871,4.730909339,309056,40.43828663,150,93,243,562,345,907,4,0.467575,0.478715,0.000145,No
9028,label,351,9.235745954,263,5.247644252,5.245020866,92313,48.46590917,55,116,171,150,253,403,4,0.473335,0.483456,0.000206,No
13997,daniel,208,9.758994098,167,5.701804472,5.700143126,34736,55.64387619,94,77,171,153,117,270,4,0.463243,0.475086,0.000205,No
16401,bob,222,9.693854795,158,5.757203251,5.755632049,35076,55.80949235,89,64,153,161,135,296,4,0.457653,0.470457,0.000229,No
8012,mass,600,8.699602522,368,4.911715346,4.908038669,220800,42.72997121,133,126,259,517,494,1011,4,0.473828,0.483992,0.000134,No
8700,library,332,9.291397208,250,5.298337366,5.295844311,83000,49.22895702,85,91,176,239,267,506,4,0.467747,0.478804,0.000196,No
18213,across,703,8.541175286,635,4.366173285,4.35981323,446405,37.29225136,208,105,313,403,669,1072,4,0.469404,0.480316,0.00011,No
6178,past,534,8.816136338,490,4.625392893,4.620490996,261660,40.77809436,91,140,231,478,375,853,4,0.474207,0.48456,0.000149,No
10686,heat,471,8.941674083,272,5.213996218,5.211282594,128112,46.62185485,129,105,234,401,368,769,4,0.473133,0.483085,0.000147,No
4969,put,1154,8.04554273,1000,3.912043005,3.902002972,1154000,31.47450916,145,144,289,1039,1083,2122,4,0.468636,0.480471,0.000119,No
9006,lady,395,9.117646412,289,5.153371596,5.150487499,114155,46.98662005,91,88,179,345,321,666,4,0.471449,0.481522,0.000191,No
11733,friend,422,9.051526863,377,4.887553097,4.883786086,159094,44.23981815,63,138,201,380,355,735,4,0.475579,0.485517,0.00017,No
6803,novel,568,8.754410759,383,4.871763295,4.867936057,217544,42.649417,119,121,240,501,466,967,4,0.470637,0.481522,0.000142,No
9485,jane,231,9.654114467,137,5.899817358,5.89845646,31647,56.95751211,79,69,148,185,147,332,4,0.463062,0.474785,0.00023,No
3230,size,825,8.381148791,657,4.332114266,4.325532786,542025,36.30809424,127,123,250,741,726,1467,4,0.475337,0.485057,0.000136,No
6653,office,739,8.489881991,554,4.50083017,4.495274879,409406,38.21151701,125,134,259,567,606,1173,4,0.475771,0.485588,0.00013,No
3908,say,978,8.211022507,792,4.145236892,4.137295602,774576,34.03663342,117,154,271,756,913,1669,4,0.474068,0.48471,0.000124,No
3513,shape,544,8.79758293,436,4.742156041,4.737796639,237184,41.71951104,126,98,224,466,469,935,4,0.471963,0.482081,0.00015,No
13587,die,419,9.058661257,348,4.967595804,4.96411984,145812,44.99976766,97,88,185,333,279,612,4,0.470986,0.481156,0.000181,No
9738,institute,435,9.021186146,345,4.976253867,4.972808006,150075,44.89171245,103,76,179,290,370,660,4,0.471637,0.481438,0.000187,No
16760,behind,334,9.285391184,301,5.112688019,5.109683571,100534,47.47330826,135,92,227,256,290,546,4,0.464346,0.476213,0.000147,No
16139,brian,202,9.78826448,173,5.66650669,5.664785243,34946,55.46526616,63,54,117,148,110,258,4,0.401643,0.419948,0.000285,No
10072,image,371,9.180330115,248,5.306369538,5.303896532,92008,48.71422407,102,79,181,311,292,603,4,0.472528,0.482151,0.000184,No
17332,asia,1017,8.171919781,801,4.133937337,4.125905327,814617,33.7822043,92,197,289,965,872,1837,4,0.477691,0.48816,0.000115,No
7297,move,780,8.437238258,624,4.383647916,4.377398554,486720,36.9858819,105,159,264,656,680,1336,4,0.476639,0.486667,0.000125,No
18197,ad,447,8.993973583,291,5.146475017,5.143570862,130077,46.28726035,90,105,195,388,347,735,4,0.467821,0.479095,0.000169,No
11,zone,316,9.340789964,203,5.506592305,5.504570303,64148,51.43592214,73,95,168,211,254,465,4,0.468265,0.479255,0.000196,No
13967,date,547,8.792083375,455,4.699500865,4.694950619,248885,41.31840343,108,99,207,416,404,820,4,0.472843,0.482766,0.000159,No
3242,sister,576,8.740424517,481,4.643931014,4.639119554,277056,40.58992849,94,163,257,420,404,824,4,0.47474,0.485362,0.000128,No
1720,those,1293,7.931811799,1170,3.755039256,3.743280628,1512810,29.78426468,218,131,349,1035,752,1787,4,0.468995,0.480508,0.000094,Yes
1256,true,684,8.567113339,485,4.63358966,4.628727958,331740,39.69648779,89,191,280,583,509,1092,4,0.475567,0.486503,0.000117,No
8822,lee,343,9.25880173,210,5.472690753,5.470598608,72030,50.67055862,132,101,233,250,221,471,4,0.454606,0.468701,0.00014,No
14772,complete,397,9.112595897,362,4.928154072,4.924537613,143714,44.90827658,87,154,241,345,283,628,4,0.465832,0.478508,0.000135,No
7565,minor,408,9.085265003,305,5.099486508,5.096441938,124440,46.3301863,87,128,215,346,291,637,4,0.472541,0.48309,0.000151,No
13706,des,244,9.599363952,181,5.621301253,5.619499667,44164,53.96091661,65,38,103,132,76,208,4,0.455937,0.468626,0.000315,No
15382,channel,473,8.937436789,322,5.045246739,5.04203164,152306,45.09157381,92,117,209,397,367,764,4,0.472516,0.482851,0.000155,No
17827,always,907,8.286389727,793,4.143975063,4.136023692,719251,34.33859239,127,225,352,820,609,1429,4,0.473373,0.485522,0.000092,No
11695,fruit,550,8.786613899,307,5.092950537,5.089885907,168850,44.74978997,123,115,238,452,451,903,4,0.47379,0.483757,0.000136,No
7323,motion,324,9.315788662,224,5.408152232,5.405919787,72576,50.38120325,99,92,191,278,263,541,4,0.471386,0.481522,0.000169,No
1899,temple,326,9.309634796,200,5.521480918,5.519488975,65200,51.40297088,73,82,155,257,276,533,4,0.4704,0.480616,0.000208,No
15268,child,859,8.340763255,618,4.393309827,4.387120838,530862,36.64355717,113,199,312,781,716,1497,4,0.476601,0.487423,0.000103,No
14689,conference,377,9.16428699,201,5.516493376,5.514491414,75777,50.55472848,88,114,202,329,274,603,4,0.470026,0.480954,0.000157,No
4351,ring,375,9.169606151,235,5.36021277,5.357870075,88125,49.15103999,86,93,179,330,326,656,4,0.462025,0.474429,0.000177,No
1161,tv,634,8.644483223,486,4.63358966,4.628727958,308124,40.05498808,178,120,298,477,474,951,4,0.467267,0.478964,0.000106,No
12206,festival,435,9.021186146,259,5.262970223,5.26038694,112665,47.47823406,110,94,204,360,363,723,4,0.473562,0.483208,0.000154,No
4236,rose,279,9.465320396,193,5.557108095,5.555186288,53847,52.59980859,111,90,201,212,237,449,4,0.4702,0.480611,0.000156,No
8720,lewis,172,9.949037701,122,6.015777239,6.014566531,20984,59.85119455,76,74,150,134,145,279,4,0.433385,0.450407,0.000209,No
12469,experience,230,9.658452868,200,5.521480918,5.519488975,46000,53.32896321,87,79,166,180,187,367,4,0.471024,0.481039,0.000188,No
17012,ball,469,8.945929409,235,5.36021277,5.357870075,110215,47.95208506,83,126,209,421,397,818,4,0.475605,0.48532,0.000149,No
17613,anthony,150,10.08589688,128,5.96776802,5.966497239,19200,60.19029288,72,72,144,97,98,195,4,0.447952,0.462786,0.000216,No
8460,lost,834,8.370298775,654,4.336690933,4.33013965,545436,36.2993988,183,155,338,697,711,1408,4,0.476217,0.486287,0.000092,No
7080,nearby,315,9.340789964,302,5.109371267,5.106356788,95130,47.72556385,68,106,174,262,180,442,4,0.465551,0.47741,0.000178,No
13188,duke,689,8.561290906,445,4.721724002,4.717274205,306605,40.42405276,157,59,216,577,624,1201,4,0.455411,0.468603,0.000143,No
11439,georgia,448,8.991738945,300,5.11601581,5.113021391,134400,46.0018786,112,137,249,401,376,777,4,0.470562,0.481766,0.000124,No
16724,below,543,8.799422857,502,4.601198165,4.596175673,272586,40.4878883,164,130,294,372,453,825,4,0.47493,0.484883,0.000105,Yes
5593,plural,175,9.931746203,151,5.802518447,5.801017351,26425,57.62914056,64,54,118,125,106,231,4,0.451553,0.465382,0.000261,No
5300,pressure,522,8.838864589,318,5.057746901,5.05457193,165996,44.70473999,86,122,208,461,424,885,4,0.471299,0.482057,0.000148,No
2516,stop,633,8.646061755,545,4.51901249,4.513557748,344985,39.07166106,85,124,209,572,463,1035,4,0.472151,0.48271,0.000147,No
6157,path,169,9.966633462,137,5.899817358,5.89845646,23153,58.80131711,64,60,124,130,142,272,4,0.469293,0.479381,0.000247,No
18203,actress,696,8.551182517,508,4.589316837,4.584234042,353568,39.2440859,86,147,233,437,581,1018,4,0.470163,0.481658,0.000131,No
6350,palace,428,9.037408982,258,5.266838699,5.264265443,110424,47.59857537,76,107,183,330,383,713,4,0.472415,0.482616,0.000166,No
781,view,340,9.26758656,279,5.188586502,5.185802687,94860,48.08567453,80,78,158,300,292,592,4,0.472051,0.48179,0.000192,No
5670,plane,249,9.579079281,162,5.732201949,5.730590684,40338,54.90921692,60,83,143,211,217,428,4,0.471274,0.481292,0.000212,No
12749,episode,336,9.279421017,217,5.439900931,5.437738638,72912,50.47913103,90,98,188,286,270,556,4,0.47015,0.480724,0.000161,No
4156,run,878,8.318885584,703,4.264441392,4.257396778,617234,35.47540002,159,143,302,751,780,1531,4,0.476153,0.486015,0.0001,No
14770,complex,345,9.25298776,286,5.163806473,5.160952462,98670,47.78063809,87,104,191,291,206,497,4,0.471599,0.48194,0.000158,No
14572,content,222,9.693854795,150,5.80916299,5.807671909,33300,56.31318251,78,63,141,182,173,355,4,0.470874,0.480607,0.000214,No
3548,sexual,406,9.090179018,237,5.351738143,5.349375401,96222,48.64825778,101,49,150,340,153,493,4,0.44383,0.458894,0.000201,No
7850,medicine,439,9.012032764,333,5.011655794,5.008330337,146187,45.16520622,73,124,197,365,374,739,4,0.474689,0.484611,0.000153,No
11975,fluid,223,9.684886125,118,6.040674791,6.039494118,26314,58.50324747,56,63,119,181,137,318,4,0.468265,0.478649,0.000253,No
2104,table,419,9.058661257,303,5.106065479,5.10304097,126957,46.25411753,63,105,168,382,333,715,4,0.470824,0.481363,0.000179,No
2108,t,275,9.47976108,194,5.578051269,5.576169537,53350,52.87859332,80,106,186,154,168,322,4,0.470038,0.48079,0.000161,Yes
1051,upon,320,9.328211182,306,5.096213182,5.093158583,97920,47.53855279,92,80,172,154,249,403,4,0.465624,0.476973,0.000173,No
5473,pop,548,8.79025689,404,4.818383406,4.814345345,221392,42.35482794,138,90,228,422,364,786,4,0.462917,0.47503,0.00013,No
14844,come,1132,8.064790919,1024,3.888326479,3.878043999,1159168,31.35854007,157,92,249,830,1097,1927,4,0.463981,0.475931,0.000119,No
17988,alaska,473,8.937436789,233,5.368759831,5.366437182,110209,47.98295162,89,123,212,351,264,615,4,0.465429,0.477626,0.000139,No
1672,thus,280,9.461742574,269,5.225086905,5.222403361,75320,49.43842722,125,78,203,199,176,375,4,0.449415,0.464133,0.000145,No
12799,enough,661,8.602778338,585,4.448186437,4.442329435,386685,38.26676192,143,126,269,569,588,1157,4,0.473221,0.48356,0.000109,No
10135,ice,774,8.444960304,486,4.63358966,4.628727958,376164,39.13048075,159,100,259,585,608,1193,4,0.469417,0.480208,0.000113,No
2066,take,1279,7.942698376,1113,3.804983933,3.793801868,1423527,30.2218397,145,183,328,1061,1137,2198,4,0.473613,0.484935,0.000089,No
14136,cup,960,8.229598893,482,4.64185417,4.637032662,462720,38.20059794,94,149,243,756,635,1391,4,0.474511,0.484935,0.00012,No
8097,maria,268,9.505545197,194,5.551940125,5.550008299,51992,52.77421779,94,65,159,195,136,331,4,0.451886,0.465885,0.000183,No
1010,usa,539,8.804963038,441,4.728488402,4.724068738,237699,41.63416561,123,176,299,495,457,952,4,0.475656,0.486287,0.000097,No
5255,private,423,9.049159998,360,4.933694253,4.930097865,152280,44.64578868,104,126,230,358,243,601,4,0.439882,0.456988,0.000126,No
11635,future,431,9.030424087,377,4.887553097,4.883786086,162487,44.13667721,68,160,228,400,318,718,4,0.473903,0.48471,0.000127,No
13198,due,719,8.51867082,670,4.312520572,4.305808228,481730,36.73694315,290,18,308,448,714,1162,4,0.450362,0.46381,0.000094,No
3235,six,1001,8.187777398,859,4.064029362,4.055412515,859859,33.27536776,155,184,339,842,416,1258,4,0.471812,0.483616,0.000085,No
13025,effect,371,9.180330115,287,5.160316068,5.157452028,106477,47.373405,86,68,154,304,319,623,4,0.472843,0.482179,0.000187,No
11774,frederick,278,9.468911064,218,5.435303221,5.433130907,60604,51.46640281,113,77,190,233,232,465,4,0.444598,0.460082,0.000149,No
1941,technology,485,8.912383286,368,4.911715346,4.908038669,178480,43.77508976,111,133,244,379,345,724,4,0.47283,0.483386,0.000116,No
16570,billy,144,10.12671888,110,6.119317918,6.118227346,15840,61.96861228,74,49,123,96,115,211,4,0.410922,0.42929,0.00023,No
15863,c,462,8.95020292,467,5.27462084,5.272067634,215754,47.20892684,124,104,228,390,390,780,4,0.468364,0.47948,0.000124,No
12985,el,353,9.23006412,215,5.449160256,5.447018006,75895,50.29609857,122,29,151,251,120,371,5,0.371827,0.387179,0.000187,No
1607,tissue,188,9.860090215,124,5.999516719,5.998285986,23312,59.15577609,55,59,114,138,146,284,4,0.469231,0.479288,0.000247,No
11096,grew,547,8.792083375,523,4.56021682,4.554983253,286081,40.09380649,138,61,199,428,499,927,4,0.463473,0.47495,0.000141,No
6016,pennsylvania,349,9.241460255,252,5.290369197,5.287856092,87948,48.89073667,82,114,196,302,291,593,4,0.468859,0.480057,0.000143,No
13413,doctor,557,8.773966937,327,5.029838113,5.026572853,182139,44.13163331,120,115,235,496,465,961,4,0.473221,0.483344,0.000119,No
1774,therefore,366,9.193898844,357,4.942062502,4.938496222,130662,45.43682273,154,115,269,307,291,598,4,0.470101,0.48102,0.000103,No
13936,dead,582,8.73006173,411,4.80120507,4.797096724,239202,41.91481664,117,160,277,515,461,976,4,0.475643,0.485959,0.0001,No
6025,peninsula,395,9.117646412,306,5.096213182,5.093158583,120870,46.46546984,53,98,151,198,345,543,4,0.471136,0.481489,0.000183,No
11323,global,210,9.749424647,179,5.632412478,5.630630928,37590,54.91278104,61,73,134,172,92,264,5,0.392253,0.410556,0.000206,No
9386,johnson,258,9.543572592,141,5.871038394,5.869637441,36378,56.0306811,117,102,219,203,203,406,4,0.469777,0.480527,0.000126,No
11822,fox,313,9.350328987,187,5.588689667,5.586827973,58531,52.25608699,97,94,191,265,214,479,4,0.46223,0.474593,0.000144,No
3281,simply,482,8.918588063,466,4.67561265,4.670951899,224612,41.69986317,90,147,237,425,316,741,4,0.471099,0.482367,0.000116,No
5432,position,554,8.779367491,464,4.679913732,4.675273073,257056,41.08668248,137,94,231,461,496,957,4,0.474233,0.4837,0.000119,No
14081,cycle,239,9.620068625,177,5.643648552,5.641887036,42303,54.29228636,60,78,138,201,197,398,4,0.472264,0.48194,0.000199,No
13350,door,185,9.876176352,108,6.137667057,6.136596506,19980,60.61668225,62,65,127,170,159,329,4,0.470624,0.480461,0.000216,No
5655,plastic,273,9.487060382,198,5.531531254,5.52955935,54054,52.47797101,72,92,164,241,200,441,4,0.462097,0.474485,0.000167,No
5568,poetry,240,9.615893254,170,5.683999847,5.682308451,40800,54.65673579,75,88,163,185,199,384,4,0.472742,0.48247,0.000168,No
11894,ford,302,9.38610516,167,5.701804472,5.700143126,50434,53.51773637,86,97,183,267,230,497,4,0.46527,0.477011,0.000149,No
17653,annual,203,9.783326198,184,5.604862527,5.603030887,37352,54.83419839,51,88,139,174,141,315,4,0.432161,0.449547,0.000196,No
7616,milk,329,9.300474427,160,5.744624469,5.743033235,52640,53.42773296,92,97,189,272,268,540,4,0.470175,0.480729,0.000143,No
5474,poor,345,9.25298776,301,5.112688019,5.109683571,103845,47.30763967,68,129,197,320,263,583,4,0.467538,0.479349,0.000136,No
16548,bird,372,9.177638323,263,5.247644252,5.245020866,97836,48.16098099,95,96,191,282,291,573,4,0.47312,0.482926,0.00014,No
12266,feature,311,9.356739265,269,5.225086905,5.222403361,83659,48.8897758,93,75,168,234,236,470,4,0.471236,0.481137,0.000159,No
17979,albert,310,9.35995988,229,5.386076281,5.383793723,70990,50.4134579,118,94,212,249,238,487,4,0.458587,0.471776,0.000126,No
1689,throughout,463,8.958805123,439,4.735298871,4.730909339,203257,42.42261979,171,65,236,245,449,694,4,0.454548,0.468011,0.000113,No
12556,evil,308,9.366432394,225,5.403697882,5.401455414,69300,50.61337089,70,123,193,276,245,521,4,0.468475,0.479926,0.000138,No
2899,spain,1152,8.047277336,878,4.042151691,4.033343185,1011456,32.52831569,140,235,375,987,844,1831,4,0.474626,0.486635,0.000071,No
6692,ocean,1072,8.118318435,751,4.198392632,4.190864517,805072,34.0838883,79,201,280,944,896,1840,4,0.47764,0.488198,0.000095,No
10485,himself,581,8.73178142,526,4.554497071,4.549233347,305606,39.76887291,147,147,294,321,513,834,4,0.47655,0.486405,0.00009,Yes
8483,look,776,8.442379657,673,4.308052955,4.301310409,522248,36.37021863,128,101,229,649,700,1349,4,0.470287,0.480902,0.000115,No
569,warren,99,10.50141233,63,6.676663558,6.676043378,6237,70.11439699,57,51,108,75,70,145,4,0.44642,0.461105,0.000242,No
12305,fast,473,8.937436789,407,4.810985099,4.806916916,192511,42.99787521,106,129,235,410,371,781,4,0.472264,0.482893,0.000111,No
13318,double,273,9.487060382,191,5.567524856,5.565623087,52143,52.81944449,79,85,164,217,204,421,4,0.452809,0.466964,0.000159,No
8850,lead,767,8.454045376,622,4.386858191,4.380628954,477074,37.08669821,148,86,234,598,474,1072,4,0.47195,0.481865,0.000111,No
5837,philosophy,393,9.122722565,306,5.096213182,5.093158583,120258,46.491339,79,109,188,327,329,656,4,0.473878,0.483696,0.000138,No
15684,captain,345,9.25298776,268,5.228811304,5.226137786,92460,48.38212699,104,83,187,290,278,568,4,0.459692,0.472457,0.000137,No
11709,front,540,8.804963038,432,4.751372696,4.747053468,233280,41.83566097,67,102,169,495,476,971,4,0.471587,0.481893,0.000151,No
5276,prime,950,8.240070193,529,4.548809852,4.54351597,502550,37.48251248,158,54,212,806,105,911,4,0.464346,0.475485,0.00012,No
15633,carl,197,9.813328449,157,5.763552479,5.761991292,30929,56.55963351,90,45,135,157,96,253,4,0.425337,0.442656,0.000188,No
4579,religion,636,8.641333614,462,4.684233393,4.679612827,293832,40.47802348,125,147,272,549,546,1095,4,0.476396,0.486268,0.000093,No
10901,half,704,8.539753821,577,4.461956018,4.456179481,406208,38.10400595,121,104,225,621,635,1256,4,0.472403,0.482532,0.000112,No
4212,round,447,8.993973583,330,5.02070563,5.017410272,147510,45.1560938,109,140,249,391,375,766,4,0.471587,0.482611,0.000101,No
15740,cancer,355,9.224414388,234,5.364477169,5.362144497,83070,49.48416038,72,88,160,296,277,573,4,0.470287,0.480644,0.000157,No
6234,paris,831,8.373902382,574,4.467168888,4.461422524,476994,37.40763619,105,174,279,746,693,1439,4,0.476358,0.486771,0.00009,No
15577,case,528,8.827435894,446,4.719479332,4.715019491,235488,41.66090126,81,107,188,467,472,939,4,0.474816,0.484376,0.000133,No
6520,orange,426,9.042092831,280,5.185008681,5.182214838,119280,46.88332982,124,136,260,367,354,721,4,0.470325,0.481574,0.000096,No
16974,bank,510,8.862121452,358,4.939265298,4.935688982,182580,43.77236895,96,99,195,426,442,868,4,0.473549,0.483269,0.000128,No
9186,key,577,8.738689911,283,5.174351387,5.171527459,163291,45.21705226,132,145,277,485,463,948,4,0.474918,0.485151,0.00009,No
7169,n,332,9.288389687,188,5.615791597,5.613979993,62416,52.16166076,91,95,186,247,255,502,4,0.470549,0.480949,0.000134,No
8084,mario,404,9.095117299,96,6.255450093,6.25449966,38784,56.89405235,104,70,174,334,244,578,4,0.455119,0.468528,0.000143,No
2350,sugar,344,9.25589052,224,5.408152232,5.405919787,77056,50.05726498,116,93,209,287,282,569,4,0.466138,0.477583,0.000119,No
18022,aircraft,442,9.005222295,235,5.36021277,5.357870075,103870,48.26990754,121,111,232,338,330,668,4,0.470836,0.481475,0.000107,No
13451,distribution,257,9.547456092,179,5.632412478,5.630630928,46003,53.77521083,58,60,118,153,195,348,4,0.467181,0.477781,0.00021,No
12327,far,658,8.607327246,606,4.412918298,4.406850044,398748,37.9834319,92,109,201,599,612,1211,4,0.469206,0.480226,0.000123,No
1235,tube,224,9.684886125,133,5.929449156,5.92812831,29792,57.42603986,56,64,120,199,169,368,4,0.471061,0.480785,0.000205,No
9338,judge,197,9.813328449,145,5.843064542,5.841623533,28565,57.3399115,69,78,147,181,157,338,4,0.470874,0.480912,0.000167,No
6977,newspaper,341,9.2646497,248,5.306369538,5.303896532,84568,49.16165495,86,81,167,241,220,461,4,0.471224,0.481226,0.000147,No
7633,mike,196,9.818417518,166,5.707810496,5.706159166,32536,56.04166656,80,70,150,139,117,256,4,0.429619,0.446933,0.000163,No
4733,rather,466,8.952346543,455,4.699500865,4.694950619,212030,42.07156033,213,81,294,332,447,779,4,0.46808,0.478851,0.000083,No
11986,flow,339,9.27053207,239,5.343334732,5.340951943,81021,49.535556,86,69,155,279,307,586,4,0.459169,0.471748,0.000157,No
2147,symbol,648,8.622641481,503,4.599208114,4.594175572,325944,39.65732266,112,87,199,499,536,1035,4,0.471061,0.481217,0.000122,No
7221,musician,537,8.810534083,462,4.684233393,4.679612827,248094,41.27059796,107,143,250,386,439,825,4,0.474359,0.484733,0.000097,No
9089,knowledge,316,9.340789964,244,5.322630059,5.32019715,77104,49.71756944,90,87,177,270,278,548,4,0.471812,0.481762,0.000137,No
16211,brain,422,9.051526863,234,5.364477169,5.362144497,98748,48.5567092,62,112,174,386,329,715,4,0.471361,0.481907,0.000139,No
4017,san,920,8.272158507,524,4.5583066,4.553062981,482080,37.70703472,156,52,208,747,675,1422,4,0.414027,0.432163,0.000116,No
7339,moscow,271,9.494413356,192,5.562302912,5.560391124,52032,52.81080306,54,94,148,238,216,454,4,0.466714,0.478072,0.000163,No
15748,canadian,611,8.681435218,457,4.695114893,4.690544556,279227,40.76033579,94,167,261,555,387,942,4,0.434435,0.45304,0.000092,No
1747,thing,585,8.72492033,482,4.64185417,4.637032662,281970,40.49980782,88,126,214,522,519,1041,4,0.475924,0.48555,0.000112,No
5542,polish,364,9.19937831,234,5.364477169,5.362144497,85176,49.34985491,89,132,221,291,225,516,4,0.464966,0.47741,0.000108,No
17773,among,715,8.524249635,678,4.300650996,4.293858112,484770,36.65982268,230,76,306,459,547,1006,4,0.448892,0.463612,0.000078,No
14222,cross,482,8.918588063,347,4.970473504,4.967007574,167254,44.32960566,107,115,222,402,410,812,4,0.474727,0.48447,0.000107,No
315,wilson,181,9.898035146,120,6.032306541,6.031115857,21720,59.70798216,85,73,158,146,136,282,4,0.450899,0.465199,0.000149,No
7803,member,1448,7.818593604,1212,3.719771118,3.707587439,1754976,29.08337867,148,92,240,1291,1331,2622,4,0.472528,0.482414,0.000098,No
9599,ireland,966,8.223368343,593,4.434603885,4.428666412,572838,36.4673812,90,203,293,918,800,1718,4,0.479809,0.489808,0.00008,No
6141,patrick,184,9.88159642,144,5.849984985,5.84855399,26496,57.80719068,70,82,152,131,133,264,4,0.453932,0.467852,0.000153,No
12952,element,465,8.952346543,269,5.225086905,5.222403361,125085,46.77678869,90,100,190,288,397,685,4,0.474473,0.483987,0.000122,No
6359,pain,183,9.887046025,122,6.015777239,6.014566531,22326,59.47826644,71,59,130,163,144,307,4,0.469156,0.479245,0.000178,No
5592,plus,140,10.15488975,127,5.975611198,5.974350429,17780,60.68167293,74,53,127,79,111,190,4,0.454862,0.468011,0.000182,No
15562,cast,235,9.636946663,203,5.506592305,5.504570303,47705,53.06673634,98,101,199,171,188,359,4,0.465417,0.47718,0.000116,No
15558,castle,583,8.728344991,353,4.953330227,4.949804088,205799,43.23437508,104,120,224,410,461,871,4,0.475516,0.485137,0.000103,No
309,wind,551,8.784797368,283,5.174351387,5.171527459,155933,45.45562844,162,106,268,442,424,866,4,0.472944,0.482954,0.000086,No
16049,bruce,179,9.909146372,127,5.975611198,5.974350429,22733,59.21320602,72,72,144,131,122,253,4,0.430379,0.447651,0.00016,No
16671,berlin,569,8.752651743,295,5.132822928,5.129878657,167855,44.92581155,65,122,187,502,476,978,4,0.475134,0.484874,0.000123,No
13058,ed,159,10.02762798,120,5.95998588,5.958705086,19080,59.76452114,79,70,149,103,91,194,4,0.457394,0.470358,0.000153,No
5472,pope,949,8.241123379,497,4.611208258,4.606236016,471653,38.00153618,174,129,303,724,813,1537,4,0.464552,0.477053,0.000075,No
2292,super,483,8.916515524,253,5.286408795,5.283885665,122199,47.13634609,124,45,169,386,374,760,4,0.36972,0.384758,0.000134,No
11602,galaxy,123,10.28434782,67,6.615105665,6.61444546,8241,68.03204754,36,57,93,115,94,209,4,0.470537,0.480259,0.000243,No
7116,nation,421,9.053899344,330,5.02070563,5.017410272,138930,45.45696341,91,122,213,392,354,746,4,0.474651,0.48455,0.000106,No
8597,liquid,423,9.049159998,284,5.170824046,5.167990091,120132,46.79161412,88,127,215,383,346,729,4,0.468426,0.479959,0.000105,No
18075,africa,1111,8.083516388,779,4.161787238,4.153976973,865469,33.64187534,74,223,297,1061,956,2017,4,0.478799,0.489456,0.000076,No
10282,howard,181,9.898035146,129,5.95998588,5.958705086,23349,58.99214971,79,66,145,149,130,279,4,0.449734,0.464119,0.000155,No
9417,jim,195,9.823532619,152,5.795917763,5.794406652,29640,56.9363872,74,55,129,136,98,234,4,0.427591,0.444825,0.000174,No
17991,alan,187,9.86542356,125,5.991484547,5.990243802,23375,59.10853281,89,72,161,136,114,250,4,0.450624,0.464993,0.000139,No
4436,revolution,567,8.756172874,461,4.686400241,4.681789721,261387,41.03493067,76,133,209,446,486,932,4,0.473714,0.484053,0.000107,No
5844,philip,290,9.426651254,241,5.335001351,5.332598514,69890,50.29119717,90,70,160,236,249,485,4,0.453839,0.467542,0.000139,No
14976,coast,1035,8.154375472,826,4.103203511,4.094919457,854910,33.45906206,99,121,220,982,943,1925,4,0.474969,0.484752,0.000101,No
7866,meat,289,9.430105489,202,5.511530587,5.509518604,58378,51.97431484,81,95,176,220,229,449,4,0.471537,0.481724,0.000126,No
11825,fourth,541,8.803112899,506,4.593261615,4.588198922,273746,40.43500057,53,148,201,508,414,922,4,0.440526,0.457988,0.00011,No
13855,deep,360,9.210428146,302,5.109371267,5.106356788,108720,47.05949692,87,119,206,276,283,559,4,0.464103,0.476541,0.000107,No
9423,jewish,449,8.98950929,336,5.002687124,4.999331568,150864,44.97170238,98,119,217,398,303,701,4,0.443764,0.460148,0.000101,No
11012,guide,290,9.426651254,238,5.347527611,5.345154845,69020,50.40927786,87,74,161,201,228,429,4,0.470101,0.480264,0.000136,No
3017,sold,897,8.297476315,716,4.246118117,4.238942578,642252,35.23206451,114,107,221,777,813,1590,4,0.47441,0.484076,0.000099,No
2789,spoken,674,8.583302066,461,4.686400241,4.681789721,310714,40.22478887,80,90,170,559,617,1176,4,0.471174,0.481353,0.000128,No
10342,hope,201,9.793227269,131,5.944600961,5.943300141,26331,58.21682824,78,75,153,177,176,353,4,0.468463,0.479025,0.000142,No
6634,ohio,371,9.180330115,245,5.318540074,5.316097141,90895,48.8259536,97,118,215,330,316,646,4,0.468327,0.479724,0.000101,No
13043,edition,365,9.196634824,256,5.27462084,5.272067634,93440,48.5087617,80,77,157,257,300,557,4,0.453259,0.46718,0.000138,No
12717,era,322,9.321980632,259,5.262970223,5.26038694,83398,49.06130648,84,85,169,235,262,497,4,0.472453,0.482217,0.000128,No
11341,glass,299,9.396088604,197,5.536594555,5.534632671,58903,52.02233301,97,94,191,256,227,483,4,0.470474,0.480907,0.000113,No
11669,function,401,9.10257075,265,5.240068458,5.23742502,106265,47.69809388,106,97,203,320,347,667,4,0.469727,0.48041,0.000106,No
10568,hero,281,9.461742574,212,5.46321201,5.461099823,59572,51.69150566,67,90,157,244,236,480,4,0.470549,0.480898,0.000137,No
11198,governor,521,8.840782136,366,4.917164951,4.913508347,190686,43.47158405,119,83,202,443,480,923,4,0.460336,0.472945,0.000106,No
12275,fear,173,9.943240583,130,5.952263834,5.950973027,22490,59.18479131,62,60,122,150,157,307,4,0.469206,0.479311,0.000175,No
18058,age,1397,7.854449818,1055,3.858502238,3.847906512,1473835,30.3064122,119,181,300,1301,1263,2564,4,0.478618,0.488531,0.000071,No
794,victoria,510,8.862121452,320,5.051477288,5.048282254,163200,44.76680524,109,140,249,432,403,835,4,0.473916,0.484334,0.000085,No
13654,device,431,9.030424087,288,5.156837804,5.153963735,124128,46.56843232,81,77,158,340,325,665,4,0.46876,0.479273,0.000133,No
89,yet,262,9.528187674,251,5.294345345,5.291842265,65762,50.44551606,99,98,197,211,210,421,4,0.470225,0.480795,0.000106,No
16350,bond,184,9.88159642,86,6.365450988,6.364600644,15824,62.90081769,49,70,119,158,147,305,4,0.470999,0.480851,0.000175,No
11361,give,837,8.366708107,722,4.237773145,4.230537173,604314,35.45621093,88,151,239,712,726,1438,4,0.472931,0.483823,0.000087,No
7725,met,401,9.10257075,356,4.944867553,4.941311308,142756,45.01100675,93,135,228,330,351,681,4,0.468723,0.480363,0.00009,No
9430,jesus,522,8.838864589,273,5.210326489,5.207602838,142506,46.0533703,105,123,228,452,439,891,4,0.474296,0.484301,0.00009,No
2427,student,263,9.524378145,220,5.426170738,5.42397838,57860,51.68090199,73,70,143,231,204,435,4,0.468401,0.478889,0.000143,No
2849,speed,556,8.773966937,352,4.953330227,4.949804088,195712,43.46035564,115,112,227,489,472,961,4,0.472365,0.482644,0.00009,No
13006,egypt,546,8.793913202,342,4.984987547,4.981571788,186732,43.8375478,85,155,240,458,432,890,4,0.476409,0.486433,0.000085,No
7534,miss,167,9.978538365,98,6.234830806,6.233860354,16366,62.21449839,66,58,124,127,132,259,4,0.444976,0.460026,0.000164,No
15509,cause,626,8.657181806,513,4.579522439,4.57438939,321138,39.64575834,81,150,231,566,486,1052,4,0.472227,0.48324,0.000088,No
2160,sydney,301,9.389421913,196,5.541683625,5.53973176,58996,52.03320566,65,79,144,278,238,516,4,0.450876,0.465284,0.000141,No
2192,sweden,604,8.692957979,422,4.77479297,4.770574168,254888,41.50707465,82,154,236,514,482,996,4,0.471399,0.482701,0.000086,No
6497,organ,297,9.402800039,173,5.66650669,5.664785243,51381,53.28102932,84,82,166,271,224,495,4,0.469516,0.479973,0.000122,No
13215,dry,390,9.130385438,312,5.076795096,5.073680313,121680,46.35309602,98,127,225,330,282,612,4,0.465515,0.477748,0.00009,No
7687,mexico,708,8.534088084,480,4.64601218,4.641210768,339840,39.64947718,106,164,270,634,592,1226,4,0.471349,0.482865,0.000075,No
1717,thought,1288,7.935686271,1125,3.79425997,3.782956551,1449000,30.11005675,153,96,249,1070,1240,2310,4,0.473183,0.482968,0.000081,No
5570,poet,512,8.858207552,419,4.781927364,4.777738688,214528,42.35930509,88,111,199,388,391,779,4,0.472151,0.482489,0.000101,No
18283,academy,655,8.611896942,452,4.706116104,4.701595994,296060,40.52858689,114,89,203,528,502,1030,4,0.467402,0.478504,0.000099,No
3793,scottish,726,8.508982163,507,4.591287281,4.586214537,368082,39.06718157,108,166,274,633,531,1164,4,0.450499,0.466603,0.000073,No
11051,ground,689,8.561290906,541,4.526379005,4.520964481,372749,38.75164742,105,161,266,644,575,1219,4,0.476639,0.486733,0.000075,No
7671,michigan,346,9.250093402,222,5.417120902,5.414908501,76812,50.10887432,91,123,214,296,288,584,4,0.467156,0.478921,0.000093,No
286,winter,644,8.628833451,423,4.772426105,4.768197261,272412,41.18047002,109,136,245,591,366,957,4,0.472214,0.483001,0.000081,No
10867,hand,585,8.72492033,428,4.760675089,4.756396032,250380,41.53651087,96,155,251,543,447,990,4,0.476537,0.486541,0.000079,No
8866,lawrence,128,10.24450191,100,6.214628098,6.213637628,12800,63.66576944,58,52,110,109,104,213,4,0.452566,0.46619,0.00018,No
6971,next,1071,8.120184107,945,3.968613357,3.959128708,1012095,32.22587111,136,211,347,969,897,1866,4,0.472591,0.484668,0.000057,No
3023,soil,290,9.426651254,181,5.621301253,5.619499667,52490,52.99004651,83,97,180,255,238,493,4,0.473954,0.483555,0.000109,No
16456,block,237,9.628472036,138,5.892544599,5.891173687,32706,56.73620089,76,66,142,190,187,377,4,0.465356,0.476513,0.000138,No
16202,brand,289,9.430105489,209,5.477464032,5.475381908,60401,51.65306364,85,70,155,230,243,473,4,0.468438,0.478935,0.000125,No
8076,market,414,9.068253657,259,5.262970223,5.26038694,107226,47.72594897,121,104,225,349,330,679,4,0.472629,0.48271,0.000086,No
2928,source,625,8.658780528,471,4.66494019,4.660229205,294375,40.39269328,118,112,230,560,549,1109,4,0.464576,0.476752,0.000084,No
5251,prize,485,8.912383286,346,4.973359509,4.969903613,167810,44.32448617,59,78,137,443,420,863,4,0.473133,0.482588,0.000141,No
18010,airport,571,8.749142968,282,5.177891213,5.175077314,161022,45.3021105,90,117,207,259,475,734,4,0.474473,0.484311,0.000093,No
12141,final,595,8.707970772,483,4.639781631,4.634950074,287385,40.40308283,76,191,267,521,463,984,4,0.47025,0.482564,0.000072,No
11226,gordon,139,10.16205824,99,6.224678434,6.223697973,13761,63.2555448,65,55,120,114,90,204,4,0.440329,0.45604,0.000159,No
3632,sense,386,9.140694808,292,5.143044482,5.140130298,112712,47.01099999,89,86,175,326,345,671,4,0.472239,0.482053,0.000109,No
4602,regular,396,9.115117966,329,5.023740533,5.020455208,130284,45.79198759,81,133,214,355,273,628,4,0.450533,0.466058,0.000089,No
1883,tennessee,201,9.793227269,127,5.975611198,5.974350429,25527,58.52051853,56,83,139,173,166,339,4,0.460873,0.473363,0.000136,No
3009,solid,313,9.350328987,226,5.399263285,5.397010795,70738,50.484888,92,97,189,273,237,510,4,0.462085,0.474565,0.0001,No
3400,shown,663,8.599757187,560,4.4918615,4.48625593,371280,38.62891822,70,72,142,595,630,1225,4,0.468673,0.479119,0.000133,No
11176,grand,617,8.671663153,436,4.742156041,4.737796639,269012,41.12237981,158,81,239,502,339,841,4,0.435362,0.452223,0.000079,No
4136,russell,118,10.32584755,84,6.388981485,6.388151157,9912,65.97164884,49,59,108,93,93,186,4,0.459109,0.471527,0.000174,No
12957,electronic,382,9.151111569,292,5.143044482,5.140130298,111544,47.06457386,90,84,174,304,191,495,4,0.448359,0.463326,0.000108,No
1963,taylor,203,9.783326198,116,6.066208093,6.065057454,23548,59.34769256,100,82,182,164,143,307,4,0.452278,0.466476,0.000103,No
1537,tool,222,9.693854795,187,5.588689667,5.586827973,41514,54.17594613,65,40,105,174,160,334,4,0.46771,0.477813,0.000178,No
9595,irish,541,8.803112899,372,4.90090443,4.897187605,201252,43.143215,126,144,270,480,383,863,4,0.460073,0.473851,0.000069,No
5270,princess,389,9.132952834,234,5.364477169,5.362144497,91026,48.99351696,109,71,180,305,270,575,4,0.450487,0.464838,0.000103,No
10702,health,446,8.996213225,324,5.039054768,5.035819606,144504,45.33241115,107,92,199,381,260,641,4,0.472227,0.482175,0.000093,No
11126,greece,450,8.987284595,346,4.973359509,4.969903613,155700,44.6969973,77,124,201,407,372,779,4,0.472692,0.483137,0.000092,No
9842,influence,306,9.372947075,287,5.160316068,5.157452028,87822,48.3673694,77,57,134,266,283,549,4,0.459513,0.471809,0.000138,No
597,walter,156,10.04667617,135,5.914523506,5.913182634,21060,59.42130236,72,61,133,120,87,207,4,0.442172,0.457725,0.000139,No
1088,uncle,196,9.818417518,128,5.96776802,5.966497239,25088,58.59403807,40,83,123,163,172,335,4,0.468859,0.479499,0.00015,No
752,violin,291,9.42320891,156,5.769942277,5.768391106,45396,54.37137148,56,89,145,264,234,498,4,0.466972,0.478142,0.000126,No
4718,ray,185,9.876176352,130,5.952263834,5.950973027,24050,58.78560732,68,64,132,125,130,255,4,0.461725,0.473663,0.000138,No
2072,tail,277,9.472514671,211,5.467940151,5.465837985,58447,51.7951433,54,69,123,233,215,448,4,0.469367,0.479611,0.000148,No
5967,performance,335,9.282401646,287,5.160316068,5.157452028,96145,47.90012637,75,94,169,286,293,579,4,0.472994,0.48278,0.000107,No
9299,jupiter,423,9.049159998,176,5.649314289,5.647562791,74448,51.12154888,67,91,158,326,343,669,4,0.460539,0.47326,0.000114,No
17085,baby,341,9.2646497,239,5.343334732,5.340951943,81499,49.50412452,87,132,219,295,255,550,4,0.472591,0.483179,0.000082,No
15526,catholic,812,8.397031837,560,4.4918615,4.48625593,454720,37.71830403,118,138,256,731,643,1374,4,0.466775,0.47894,0.00007,No
300,wine,281,9.458177508,148,5.82258601,5.821114958,41588,55.07105204,97,78,175,228,219,447,4,0.467944,0.478691,0.000102,No
754,violent,121,10.30074163,110,6.119317918,6.118227346,13310,63.03351284,48,49,97,104,70,174,4,0.436915,0.452984,0.000184,No
9525,iv,517,8.848489303,422,4.77479297,4.770574168,218174,42.24970452,97,90,187,401,394,795,4,0.470512,0.480856,0.000095,No
8274,magic,270,9.498110218,189,5.578051269,5.576169537,51030,52.98094576,94,103,197,237,213,450,4,0.471061,0.481517,0.00009,No
15035,climate,594,8.709652858,355,4.947680495,4.944134285,210870,43.09257956,83,75,158,385,309,694,4,0.470711,0.480729,0.000112,No
5286,price,219,9.707460448,127,5.975611198,5.974350429,27813,58.00800935,71,68,139,192,187,379,4,0.470337,0.480311,0.000127,No
6096,peace,468,8.95020292,381,4.876998909,4.873191747,178308,43.65012988,98,97,195,397,399,796,4,0.471838,0.481973,0.000089,No
14837,comic,344,9.25589052,211,5.467940151,5.465837985,72584,50.6106554,81,55,136,269,238,507,4,0.451209,0.465096,0.000127,No
6130,pattern,189,9.854785162,144,5.849984985,5.84855399,27216,57.65034523,60,59,119,145,166,311,4,0.471274,0.480837,0.000145,No
5736,pink,212,9.739945903,135,5.914523506,5.913182634,28620,57.60713899,76,64,140,182,167,349,4,0.450464,0.464683,0.000123,No
1153,twelve,310,9.35995988,274,5.206670178,5.203936499,84940,48.73422397,73,68,141,255,135,390,4,0.455189,0.468565,0.000122,No
2469,strength,264,9.520583074,206,5.491922115,5.489870052,54384,52.28630074,77,65,142,215,229,444,4,0.469392,0.479546,0.000121,No
2794,split,418,9.061050745,365,4.919900931,4.916254363,152570,44.57947199,85,74,159,357,383,740,4,0.469082,0.479489,0.000108,No
13147,dust,160,10.02135836,94,6.276503502,6.275573088,15040,62.89909085,63,66,129,127,127,254,4,0.467255,0.47794,0.000133,No
1030,urban,391,9.127824617,304,5.102770583,5.099736044,118864,46.57719494,90,63,153,326,216,542,4,0.440471,0.456317,0.000112,No
11538,gary,122,10.29251113,88,6.34246147,6.341591108,10736,65.27985529,60,42,102,83,68,151,4,0.401843,0.419934,0.000168,No
7701,method,395,9.117646412,298,5.122704798,5.119730438,117710,46.70701102,84,76,160,322,334,656,4,0.46969,0.479982,0.000107,No
1845,territory,715,8.524249635,501,4.603192183,4.598179742,358215,39.23875929,135,136,271,572,623,1195,4,0.47535,0.48532,0.000063,No
12154,file,323,9.318879854,181,5.621301253,5.619499667,58463,52.384231,99,63,162,246,219,465,4,0.468253,0.478635,0.000105,No
1634,tim,160,10.02135836,118,6.04911366,6.047942998,18880,60.62033576,62,49,111,119,90,209,4,0.440504,0.456087,0.000153,No
5673,plan,249,9.579079281,199,5.526493459,5.524511536,49551,52.93871899,67,55,122,201,221,422,4,0.470999,0.480555,0.000139,No
9291,justice,278,9.468911064,197,5.536594555,5.534632671,54766,52.42552144,58,79,137,256,241,497,4,0.470936,0.480982,0.000122,No
13063,economy,377,9.16428699,309,5.086457007,5.083372316,116493,46.61375178,86,81,167,291,309,600,4,0.471637,0.481532,0.0001,No
1370,travel,419,9.058661257,356,4.944867553,4.941311308,149164,44.79388013,88,95,183,353,363,716,4,0.471737,0.48187,0.000091,No
7660,middle,1226,7.985020061,1060,3.853774097,3.843127838,1299560,30.77246348,106,125,231,1131,857,1988,4,0.469802,0.480982,0.000072,No
2512,store,373,9.174953758,290,5.149917361,5.147023235,108170,47.25025365,68,100,168,285,301,586,4,0.471061,0.481466,0.000099,No
8095,marie,177,9.920382445,135,5.914523506,5.913182634,23895,58.67433516,80,53,133,119,121,240,4,0.455633,0.46864,0.000125,No
3708,secret,313,9.350328987,243,5.326736841,5.324313956,76059,49.80674189,87,113,200,270,245,515,4,0.46876,0.479959,0.000083,No
6390,oxygen,367,9.191170329,202,5.511530587,5.509518604,74134,50.6574164,91,85,176,331,308,639,4,0.467218,0.478259,0.000094,No
11800,francis,277,9.472514671,237,5.351738143,5.349375401,65649,50.69441808,103,73,176,237,219,456,4,0.446611,0.461674,0.000094,No
17454,architecture,308,9.366432394,233,5.368759831,5.366437182,71764,50.286126,105,94,199,248,261,509,4,0.473347,0.483029,0.000083,No
12702,eric,141,10.14777229,113,6.092410465,6.09128986,15933,61.82439408,64,47,111,101,67,168,4,0.438621,0.454425,0.000148,No
195,worldwide,364,9.19937831,334,5.008657291,5.005321801,121576,46.07653325,85,134,219,203,286,489,4,0.469889,0.481212,0.000075,No
11870,format,242,9.607594451,162,5.732201949,5.730590684,39204,55.07267164,74,71,145,191,190,381,4,0.472289,0.481818,0.000113,No
13786,delta,186,9.870785504,104,6.175407385,6.174376875,19344,60.9561217,59,54,113,153,124,277,4,0.463315,0.474696,0.000145,No
17998,al,306,9.372947075,216,5.444519877,5.442367605,66096,51.03119665,74,57,131,212,125,337,4,0.454001,0.467396,0.000125,No
13684,despite,217,9.716634824,209,5.477464032,5.475381908,45353,53.22251776,124,38,162,146,173,319,4,0.439762,0.455369,0.000101,No
7690,metropolitan,408,9.085265003,306,5.096213182,5.093158583,124848,46.30044727,97,40,137,344,294,638,4,0.410618,0.428638,0.000119,No
15460,census,871,8.3268902,726,4.232248269,4.224972006,632346,35.24146664,51,117,168,728,723,1451,4,0.471386,0.482006,0.000097,No
4403,rhythm,188,9.860090215,135,5.914523506,5.913182634,25380,58.31773534,67,46,113,140,155,295,4,0.456277,0.469011,0.000144,No
3475,shell,204,9.778412184,118,6.04911366,6.047942998,24072,59.15072671,67,69,136,152,172,324,4,0.46897,0.479306,0.000119,No
13001,eight,512,8.858207552,467,4.673469027,4.668798229,239104,41.39855863,101,114,215,423,202,625,4,0.462639,0.475316,0.000075,No
14944,code,535,8.81426543,318,5.057746901,5.05457193,170130,44.58032367,110,117,227,427,431,858,4,0.473259,0.483419,0.000071,No
17892,alliance,189,9.854785162,136,5.907143398,5.905792513,25704,58.21362911,44,58,102,149,161,310,4,0.470549,0.480292,0.000158,No
4796,rain,325,9.312706995,225,5.403697882,5.401455414,73125,50.32305506,76,90,166,281,256,537,4,0.470537,0.48087,0.000097,No
1481,tour,437,9.016598982,267,5.232549626,5.229886135,116679,47.17980163,93,92,185,360,368,728,4,0.471662,0.481738,0.000087,No
2325,summer,660,8.604292342,523,4.56021682,4.554983253,345180,39.23743866,97,129,226,597,407,1004,4,0.474334,0.484428,0.000071,No
5436,portuguese,326,9.309634796,237,5.351738143,5.349375401,77262,49.82272764,71,113,184,279,215,494,4,0.467291,0.478865,0.000087,No
3699,section,268,9.505545197,232,5.373060913,5.370748287,62176,51.07387335,92,59,151,219,236,455,4,0.467353,0.477907,0.000106,No
13308,douglas,132,10.21373025,95,6.265921393,6.264980969,12540,63.9984309,65,61,126,114,97,211,4,0.445423,0.460429,0.000127,No
3201,sky,329,9.300474427,229,5.386076281,5.383793723,75341,50.09306471,60,112,172,305,252,557,4,0.470861,0.481522,0.000093,No
1458,trade,578,8.736958309,429,4.758341365,4.754052266,247962,41.57343013,128,110,238,490,390,880,4,0.474486,0.48417,0.000067,No
12317,farm,297,9.402800039,214,5.453822269,5.45169004,63558,51.28120024,79,96,175,273,227,500,4,0.47185,0.481978,0.000091,No
6789,nuclear,563,8.763252549,212,5.46321201,5.461099823,119356,47.87550657,159,55,214,457,321,778,4,0.435575,0.451932,0.000074,No
13954,davis,145,10.11979843,92,6.298009707,6.297099311,13340,63.73458878,77,63,140,118,118,236,4,0.457724,0.470504,0.000113,No
14019,damage,407,9.087718992,304,5.102770583,5.099736044,123728,46.37254514,93,93,186,347,358,705,4,0.473095,0.482813,0.000085,No
11835,foundation,324,9.315788662,271,5.217679463,5.214975866,87804,48.60679918,90,79,169,210,255,465,4,0.471562,0.481442,0.000093,No
10822,happy,247,9.587143841,184,5.604862527,5.603030887,45448,53.73462325,77,84,161,225,195,420,4,0.454618,0.468429,0.000097,No
499,wear,355,9.224414388,217,5.439900931,5.437738638,77035,50.17990041,65,101,166,271,252,523,4,0.469715,0.480475,0.000094,No
3919,saw,352,9.232901002,312,5.076795096,5.073680313,109824,46.87354653,96,94,190,308,317,625,4,0.468006,0.479048,0.000082,No
6331,palm,156,10.04667617,73,6.529338843,6.528618598,11388,65.59815296,57,48,105,133,111,244,4,0.461365,0.473053,0.000148,No
10984,gun,203,9.783326198,138,5.892544599,5.891173687,28014,57.64868595,65,80,145,185,150,335,4,0.458765,0.471654,0.000107,No
12019,flight,257,9.547456092,170,5.683999847,5.682308451,43690,54.26773897,73,72,145,196,198,394,4,0.469777,0.479973,0.000107,No
13122,dynasty,843,8.359565219,493,4.61928911,4.614357066,415599,38.61524858,66,152,218,315,632,947,4,0.472856,0.48378,0.000071,No
15059,clear,282,9.454625106,255,5.278534739,5.275991559,71910,49.90656707,67,103,170,250,226,476,4,0.466849,0.478349,0.000091,No
15909,bush,241,9.611735244,140,5.878155862,5.876764922,33740,56.49927786,53,86,139,200,179,379,4,0.469715,0.48017,0.000111,No
15656,card,350,9.238599023,174,5.660742985,5.659011521,60900,52.29733461,80,93,173,300,259,559,4,0.46664,0.477978,0.000089,No
4045,salmon,68,10.87702447,38,7.182212124,7.181842063,2584,78.12109704,30,38,68,53,54,107,4,0.446768,0.461124,0.000225,No
2565,stick,196,9.818417518,125,5.991484547,5.990243802,24500,58.82689683,70,69,139,156,165,321,4,0.470462,0.480433,0.00011,No
5422,post,297,9.402800039,233,5.368759831,5.366437182,69201,50.48137514,80,71,151,235,239,474,4,0.469404,0.479658,0.000101,No
2666,stanley,320,9.328211182,211,5.467940151,5.465837985,67520,51.00610045,71,56,127,272,276,548,4,0.450247,0.464364,0.00012,No
2756,spring,320,9.328211182,244,5.322630059,5.32019715,78080,49.65061723,66,107,173,281,275,556,4,0.471136,0.481663,0.000088,No
17056,bacteria,310,9.35995988,191,5.567524856,5.565623087,59210,52.11180928,84,83,167,251,268,519,4,0.455984,0.46949,0.000091,No
11160,grant,149,10.09258587,106,6.15635919,6.155308659,15794,62.13358378,51,64,115,124,111,235,4,0.467328,0.477964,0.000131,No
2426,studio,578,8.736958309,476,4.65438043,4.649619208,275128,40.66512777,119,81,200,443,395,838,4,0.471186,0.481203,0.000075,No
11555,garden,251,9.571079238,183,5.610312131,5.60849051,45933,53.69674196,72,72,144,193,206,399,4,0.468327,0.478879,0.000104,No
14783,competition,364,9.19937831,270,5.221376325,5.218682755,98280,48.03341611,95,99,194,288,325,613,4,0.472541,0.482546,0.000077,No
981,v,449,8.98950929,361,4.982067837,4.978642044,162089,44.7863451,117,90,207,375,336,711,4,0.467624,0.478687,0.000072,No
14339,cover,391,9.127824617,309,5.086457007,5.083372316,120819,46.42828749,108,111,219,307,328,635,4,0.47379,0.483691,0.000068,No
8769,lens,131,10.22133485,54,6.830814238,6.830284108,7074,69.82003965,39,47,86,116,103,219,4,0.467809,0.477997,0.000173,No
3066,snow,257,9.547456092,170,5.683999847,5.682308451,43690,54.26773897,88,81,169,223,214,437,4,0.469243,0.479729,0.000088,No
280,wisconsin,263,9.524378145,146,5.836191663,5.834740639,38398,55.58609632,66,84,150,227,179,406,4,0.46696,0.478067,0.000099,No
5207,programming,281,9.458177508,183,5.610312131,5.60849051,51423,53.06332801,86,58,144,205,213,418,4,0.467636,0.478081,0.000103,No
8057,marriage,307,9.36968443,242,5.330860558,5.328447698,74294,49.94848117,64,90,154,270,274,544,4,0.472139,0.482081,0.000096,No
5246,problem,457,8.971848786,336,5.002687124,4.999331568,153552,44.8833524,68,92,160,410,406,816,4,0.473815,0.483348,0.000092,No
13851,defeat,325,9.312706995,290,5.149917361,5.147023235,94250,47.95967143,91,65,156,203,287,490,4,0.466886,0.477663,0.000094,No
1462,track,544,8.79758293,409,4.806083128,4.801994864,222496,42.28191489,167,109,276,444,317,761,4,0.472465,0.482658,0.000053,No
15646,career,692,8.558392354,605,4.414569826,4.408511633,418660,37.78162064,95,120,215,533,557,1090,4,0.471099,0.481865,0.000068,No
3901,scale,465,8.954494772,234,5.364477169,5.362144497,108810,48.03618276,76,116,192,376,380,756,4,0.474791,0.484527,0.000076,No
12816,engine,401,9.10257075,228,5.390452655,5.38818012,91428,49.06697667,78,109,187,355,316,671,4,0.474385,0.484095,0.000078,No
8824,led,898,8.296362109,785,4.154114566,4.14624383,704930,34.46403869,198,62,260,695,841,1536,4,0.464224,0.475541,0.000056,No
14522,convention,201,9.793227269,150,5.80916299,5.807671909,30150,56.89045341,63,48,111,157,155,312,4,0.46363,0.474823,0.000131,No
15064,clay,178,9.914748627,130,5.952263834,5.950973027,23140,59.01519967,60,70,130,147,142,289,4,0.462205,0.474161,0.000111,No
1490,total,902,8.291917657,773,4.169519236,4.161769438,697246,34.57331017,75,134,209,847,637,1484,4,0.467181,0.479175,0.000069,No
2188,sweet,232,9.649794806,186,5.59405161,5.592199934,43152,53.98145017,76,106,182,191,196,387,4,0.448156,0.463561,0.000079,No
16408,board,392,9.125270338,271,5.217679463,5.214975866,106232,47.61273564,90,96,186,329,310,639,4,0.474271,0.483776,0.000077,No
4275,roger,164,9.99666575,138,5.892544599,5.891173687,22632,58.90579877,74,43,117,121,77,198,4,0.436819,0.452815,0.000121,No
14395,cotton,160,10.02135836,118,6.04911366,6.047942998,18880,60.62033576,66,58,124,134,116,250,4,0.450522,0.464612,0.000114,No
12253,feel,299,9.396088604,240,5.339159361,5.336766548,71760,50.16721443,66,90,156,270,237,507,4,0.469491,0.4801,0.00009,No
2318,sun,834,8.370298775,497,4.611208258,4.606236016,414498,38.59719083,94,181,275,772,634,1406,4,0.476217,0.486794,0.000051,No
11843,forward,131,10.22133485,118,6.04911366,6.047942998,15458,61.83001629,56,56,112,93,112,205,4,0.469045,0.479119,0.000125,No
5278,primary,292,9.419778375,220,5.426170738,5.42397838,64240,51.11332578,72,80,152,238,169,407,4,0.44393,0.45958,0.000092,No
11675,fully,159,10.02762798,151,5.802518447,5.801017351,24009,58.18549631,52,49,101,144,83,227,4,0.439283,0.455045,0.000138,No
11921,foot,290,9.426651254,217,5.439900931,5.437738638,62930,51.28004893,75,85,160,267,228,495,4,0.470674,0.48087,0.000086,No
4392,rich,428,9.037408982,388,4.858792945,4.854915514,166064,43.910899,94,139,233,391,361,752,4,0.468438,0.480231,0.000059,No
13510,director,530,8.823655171,425,4.767709115,4.763460186,225250,42.06862119,76,117,193,427,438,865,4,0.471675,0.482236,0.000071,No
7042,nelson,113,10.36914436,82,6.413079037,6.412268725,9266,66.49814232,56,44,100,96,68,164,4,0.435362,0.451519,0.000137,No
7513,mix,199,9.803227353,163,5.726048083,5.724426802,32437,56.13375119,57,55,112,181,168,349,4,0.46426,0.475457,0.000122,No
17951,alex,139,10.16205824,91,6.308938778,6.30803839,12649,64.11180332,61,50,111,100,75,175,4,0.442746,0.457998,0.000123,No
13600,dick,103,10.46180319,66,6.630143542,6.629493344,6798,69.36325685,48,41,89,70,74,144,4,0.442933,0.457988,0.000153,No
1962,tea,207,9.763813384,93,6.287198791,6.286278386,19251,61.3870357,69,68,137,179,158,337,4,0.471299,0.481039,0.000099,No
140,x,430,9.028106589,291,5.143044482,5.140130298,125130,46.43195378,128,98,226,304,331,635,4,0.469914,0.48055,0.00006,No
7569,minnesota,218,9.712037115,138,5.892544599,5.891173687,30084,57.22861185,52,70,122,179,160,339,4,0.462567,0.474443,0.000111,No
2375,successful,629,8.652400921,565,4.482972553,4.477316702,355385,38.78847585,61,185,246,580,469,1049,4,0.472089,0.483832,0.000055,No
364,why,457,8.971848786,416,4.789113024,4.784954472,190112,42.96719787,69,92,161,371,394,765,4,0.460945,0.473546,0.000084,Yes
10226,hungary,322,9.321980632,241,5.335001351,5.332598514,77602,49.73277926,60,115,175,271,252,523,4,0.469665,0.480691,0.000077,No
9437,jersey,401,9.10257075,263,5.247644252,5.245020866,105463,47.76705308,42,109,151,387,306,693,4,0.468043,0.479339,0.000089,No
13361,done,997,8.191781407,823,4.106842084,4.098588279,820531,33.64235262,71,118,189,873,925,1798,4,0.47341,0.48355,0.000071,No
13501,disc,190,9.849508105,97,6.245087306,6.244126864,18430,61.51103804,55,74,129,141,141,282,4,0.465808,0.476968,0.000104,No
3566,seven,820,8.387227837,711,4.253125854,4.246000672,583020,35.67193556,137,131,268,719,302,1021,4,0.469479,0.48087,0.00005,No
15615,carolina,571,8.749142968,270,5.221376325,5.218682755,154170,45.68256796,21,162,183,555,465,1020,4,0.471687,0.483109,0.000073,No
6856,norman,158,10.03393714,116,6.066208093,6.065057454,18328,60.86795071,66,60,126,131,118,249,4,0.443908,0.459162,0.000106,No
13241,drive,317,9.337630403,219,5.430726554,5.428544218,69423,50.71011739,82,98,180,252,251,503,4,0.468253,0.479288,0.000074,No
7532,mission,195,9.823532619,137,5.899817358,5.89845646,26715,57.95704826,83,70,153,152,165,317,4,0.46964,0.479832,0.000087,No
17691,angle,173,9.943240583,95,6.265921393,6.264980969,16435,62.30356388,41,47,88,160,153,313,4,0.467525,0.477813,0.000151,No
13421,dna,246,9.591200641,116,6.066208093,6.065057454,28536,58.18221895,82,64,146,199,163,362,4,0.47015,0.480086,0.000091,No
2513,storage,196,9.818417518,129,5.95998588,5.958705086,25284,58.51762977,68,62,130,165,151,316,4,0.467341,0.477931,0.000102,No
9930,independent,693,8.555502178,606,4.412918298,4.406850044,419958,37.75473211,104,161,265,602,489,1091,4,0.464103,0.477335,0.00005,No
2491,strange,155,10.05310706,140,5.878155862,5.876764922,21700,59.09373019,51,76,127,138,112,250,4,0.454234,0.467988,0.000104,No
3032,sodium,95,10.54265529,51,6.887972651,6.887472536,4845,72.61752128,40,27,67,77,85,162,4,0.410561,0.428333,0.000196,No
9462,jean,153,10.06609426,134,5.921958484,5.920627626,20502,59.61099228,63,38,101,107,61,168,4,0.451255,0.464828,0.00013,No
10323,horse,334,9.285391184,201,5.516493376,5.514491414,67134,51.22279896,78,104,182,283,221,504,4,0.472516,0.482611,0.000072,No
4262,rome,609,8.68471391,440,4.733023557,4.728623981,267960,41.10495552,81,153,234,562,521,1083,4,0.475197,0.485508,0.000056,No
16079,broken,267,9.509283519,233,5.368759831,5.366437182,62211,51.05305937,63,93,156,240,219,459,4,0.462687,0.474917,0.000084,No
17966,alcohol,201,9.793227269,118,6.04911366,6.047942998,23718,59.24034485,57,69,126,160,168,328,4,0.46549,0.476654,0.000104,No
14381,count,319,9.331341075,252,5.290369197,5.287856092,80388,49.36623938,94,74,168,261,264,525,4,0.449951,0.464476,0.000078,No
16099,britain,815,8.393344064,642,4.355209981,4.348779477,523230,36.55477584,75,191,266,777,678,1455,4,0.478838,0.488897,0.000049,No
13204,duck,97,10.5218212,59,6.74226084,6.741680684,5723,70.94086304,33,50,83,81,81,162,4,0.460778,0.472673,0.000157,No
14357,course,211,9.744674044,187,5.588689667,5.586827973,39457,54.45995914,44,61,105,180,192,372,4,0.471136,0.48078,0.000124,No
15530,cathedral,533,8.816136338,297,5.126066145,5.123101815,158301,45.19209802,87,113,200,431,476,907,4,0.471174,0.481785,0.000065,No
510,wayne,129,10.23671977,94,6.276503502,6.275573088,12126,64.2508075,52,48,100,97,74,171,4,0.457807,0.470283,0.00013,No
15927,burn,141,10.14777229,111,6.110268083,6.109167499,15651,62.00560912,43,69,112,116,118,234,4,0.467402,0.478105,0.000116,No
4249,room,322,9.321980632,245,5.318540074,5.316097141,78890,49.57932756,98,75,173,275,278,553,4,0.472202,0.481813,0.000075,No
6489,origin,310,9.35995988,280,5.185008681,5.182214838,86800,48.53147323,74,68,142,260,286,546,4,0.470325,0.480306,0.000091,No
13245,drink,309,9.3631909,195,5.546798726,5.54485688,60255,51.93573535,73,104,177,276,277,553,4,0.472742,0.482808,0.000073,No
14822,commercial,284,9.447557939,262,5.25145378,5.248840421,74408,49.61341386,80,92,172,235,158,393,4,0.431803,0.449355,0.000075,No
2711,st,340,9.26758656,824,5.364477169,5.362144497,280160,49.71575651,98,51,149,277,219,496,5,0.376551,0.392894,0.000086,No
1470,toxic,113,10.36914436,88,6.34246147,6.341591108,9944,65.76589857,39,45,84,87,80,167,4,0.453491,0.466791,0.000152,No
932,various,683,8.570037318,639,4.35989383,4.353493519,436437,37.36445282,118,114,232,587,156,743,5,0.410665,0.430034,0.000055,No
9438,jerry,155,10.05310706,105,6.165837934,6.164797414,16275,61.98582887,57,61,118,117,101,218,4,0.451633,0.465579,0.000108,No
1476,tower,375,9.169606151,196,5.541683625,5.53973176,73500,50.81505626,79,82,161,291,315,606,4,0.46247,0.474579,0.000079,No
4202,route,262,9.528187674,189,5.578051269,5.576169537,49518,53.14871935,93,62,155,222,214,436,4,0.460981,0.47302,0.000082,No
12195,few,1239,7.974472296,1157,3.766212557,3.754585455,1433523,30.0335577,68,151,219,1215,428,1643,4,0.470474,0.481996,0.000058,Yes
11789,franklin,166,9.984544389,104,6.175407385,6.174376875,17264,61.65862916,70,57,127,133,137,270,4,0.452855,0.466495,0.0001,No
15647,care,327,9.306572006,263,5.247644252,5.245020866,86001,48.8375791,65,68,133,262,277,539,4,0.471649,0.481302,0.000095,No
17529,appearance,217,9.716634824,208,5.482260205,5.480188101,45136,53.26912042,70,48,118,183,203,386,4,0.469727,0.479489,0.000107,No
18193,adam,202,9.78826448,139,5.885324351,5.883943426,28078,57.6071113,88,62,150,137,148,285,4,0.423268,0.441069,0.000084,No
5161,property,276,9.476131312,211,5.467940151,5.465837985,58236,51.81491887,66,68,134,229,235,464,4,0.472717,0.482086,0.000094,No
6225,parliament,669,8.590748117,460,4.688571795,4.683971321,307740,40.27833932,96,121,217,598,516,1114,4,0.47244,0.482879,0.000058,No
7212,muslim,365,9.196634824,277,5.195780778,5.193017018,101105,47.78369844,92,104,196,297,213,510,4,0.467821,0.479109,0.000064,No
61,youth,201,9.793227269,159,5.750894082,5.749312864,31959,56.31981275,59,72,131,165,147,312,4,0.465673,0.476846,0.000095,No
9605,iran,431,9.030424087,286,5.163806473,5.160952462,123266,46.63136236,88,106,194,387,344,731,4,0.468624,0.479724,0.000064,No
16558,biology,268,9.505545197,208,5.482260205,5.480188101,55744,52.11187215,59,73,132,227,203,430,4,0.471311,0.481137,0.000094,No
13364,donald,119,10.31740868,95,6.265921393,6.264980969,11305,64.64807179,59,41,100,89,86,175,4,0.439392,0.454988,0.000124,No
9222,kelly,230,9.658452868,106,6.15635919,6.155308659,24380,59.46090508,76,91,167,197,179,376,4,0.458872,0.471894,0.000074,No
2376,success,334,9.285391184,305,5.099486508,5.096441938,101870,47.35072706,76,80,156,286,298,584,4,0.472126,0.481879,0.000079,No
3873,scene,158,10.03393714,134,5.921958484,5.920627626,21172,59.4205592,51,50,101,132,131,263,4,0.465893,0.476626,0.000122,No
4029,sam,153,10.06609426,126,5.983516377,5.98226562,19278,60.23063984,69,51,120,107,84,191,4,0.44633,0.46103,0.000102,No
17668,ann,112,10.37803331,82,6.413079037,6.412268725,9184,66.55514784,51,41,92,89,53,142,4,0.423359,0.440764,0.000133,No
8447,louisiana,218,9.712037115,148,5.82258601,5.821114958,32264,56.54917144,60,82,142,188,181,369,4,0.462193,0.474349,0.000086,No
16178,bread,191,9.844258749,99,6.224678434,6.223697973,18909,61.27734514,56,71,127,160,164,324,4,0.471449,0.481203,0.000096,No
5797,piano,542,8.801266176,314,5.070405298,5.067270452,170188,44.62598665,88,115,203,453,411,864,4,0.469268,0.480377,0.00006,No
3818,scientific,356,9.221601446,300,5.11601581,5.113021391,106800,47.17785879,92,64,156,299,212,511,5,0.410049,0.428513,0.000078,No
8875,lava,89,10.60789581,44,7.03560865,7.035178566,3916,74.63300351,35,31,66,73,59,132,4,0.446431,0.460716,0.000183,No
15271,chief,399,9.10757076,315,5.067225645,5.064080768,125685,46.15011612,82,93,175,331,310,641,4,0.460025,0.472884,0.000069,No
9699,interest,283,9.45108528,242,5.330860558,5.328447698,68486,50.38241775,76,71,147,235,234,469,4,0.472164,0.481733,0.000082,No
7304,mouse,191,9.844258749,103,6.185069296,6.184048796,19673,60.88742253,44,79,123,173,149,322,4,0.465258,0.476668,0.000098,No
13256,dream,197,9.813328449,135,5.914523506,5.913182634,26595,58.04116178,51,77,128,159,166,325,4,0.470599,0.480682,0.000094,No
12482,expansion,137,10.17655125,104,6.175407385,6.174376875,14248,62.84434975,53,34,87,122,114,236,4,0.462675,0.473837,0.000138,No
3985,santa,364,9.19937831,229,5.386076281,5.383793723,83356,49.54855331,86,22,108,293,249,542,4,0.381299,0.397682,0.000111,No
10681,heavy,479,8.92483158,392,4.848536444,4.844618859,187768,43.27237118,109,125,234,393,380,773,4,0.453607,0.468387,0.000051,No
17517,apple,305,9.376220401,156,5.769942277,5.768391106,47580,54.10025049,90,93,183,259,214,473,4,0.466395,0.477799,0.000065,No
15351,charlie,140,10.15488975,100,6.214628098,6.213637628,14000,63.1088632,64,51,115,106,96,202,4,0.454886,0.468025,0.000103,No
17444,arena,166,9.984544389,100,6.214628098,6.213637628,16600,62.05023011,41,56,97,101,148,249,4,0.470599,0.480264,0.000122,No
11180,grammar,182,9.89252549,137,5.899817358,5.89845646,24934,58.36409361,68,49,117,133,159,292,4,0.464127,0.475231,0.000101,No
14857,columbia,336,9.279421017,226,5.399263285,5.397010795,75936,50.1020372,75,104,179,301,247,548,4,0.457135,0.470767,0.000066,No
15191,christopher,262,9.528187674,234,5.364477169,5.362144497,61308,51.11374524,107,64,171,207,224,431,4,0.451496,0.465518,0.000069,No
11095,grey,228,9.667186548,161,5.738393919,5.73679267,36708,55.47412451,70,87,157,208,191,399,4,0.464309,0.476095,0.000075,No
15758,campaign,189,9.854785162,148,5.82258601,5.821114958,27972,57.38033422,67,58,125,152,156,308,4,0.46615,0.476968,0.000094,No
13065,economic,373,9.174953758,308,5.089698501,5.086623841,114884,46.69774839,91,72,163,320,180,500,4,0.403845,0.422483,0.000072,No
13559,digital,376,9.166943034,245,5.318540074,5.316097141,92120,48.75475388,99,93,192,289,211,500,4,0.421189,0.439712,0.000061,No
15007,cloth,146,10.11292556,108,6.137667057,6.136596506,15768,62.06977003,50,56,106,124,117,241,4,0.463921,0.475199,0.00011,No
16307,border,697,8.549746767,540,4.528229145,4.522824675,376380,38.71521249,119,92,211,611,598,1209,4,0.47195,0.481973,0.000055,No
3088,snake,129,10.23671977,73,6.529338843,6.528618598,9417,66.83901204,42,50,92,116,97,213,4,0.464394,0.475452,0.000126,No
16828,bear,264,9.520583074,144,5.849984985,5.84855399,38016,55.69526803,84,90,174,235,206,441,4,0.464346,0.47618,0.000066,No
15759,camp,250,9.575071259,157,5.763552479,5.761991292,39250,55.18642569,67,80,147,158,209,367,4,0.471249,0.481226,0.000078,No
6511,orchestra,588,8.719805229,230,5.381718975,5.379426395,135240,46.92754126,72,129,201,551,481,1032,4,0.475936,0.485621,0.000057,No
5068,psychology,176,9.926048182,111,6.110268083,6.109167499,19536,60.6508154,50,52,102,144,147,291,4,0.471775,0.481067,0.000112,No
14642,connecticut,171,9.954868621,116,6.066208093,6.065057454,19836,60.38830459,49,71,120,156,145,301,4,0.456207,0.469424,0.000095,No
14578,contain,295,9.409556821,265,5.240068458,5.23742502,78175,49.3067219,44,104,148,196,230,426,4,0.438242,0.455265,0.000077,No
10504,highway,200,9.798214811,133,5.929449156,5.92812831,26600,58.09801654,61,62,123,126,177,303,4,0.466126,0.477006,0.000092,No
373,whole,540,8.804963038,498,4.609198207,4.604215916,268920,40.58381985,57,198,255,511,435,946,4,0.469355,0.481992,0.000044,No
4386,rick,59,11.01899473,53,6.849506371,6.848986246,3127,75.47467462,25,30,55,33,39,72,5,0.39796,0.415683,0.000204,No
3730,search,234,9.641211062,163,5.726048083,5.724426802,38142,55.20603812,76,50,126,200,212,412,4,0.466493,0.477053,0.000089,No
14346,cousin,141,10.14777229,121,6.024007739,6.022807042,17061,61.13025879,36,59,95,127,118,245,4,0.464139,0.475438,0.000118,No
15529,catherine,178,9.914748627,125,5.991484547,5.990243802,22250,59.40406319,79,51,130,143,151,294,4,0.457524,0.47011,0.000086,No
5849,phil,104,10.45214128,79,6.450350432,6.449570143,8216,67.41997401,57,40,97,79,75,154,4,0.435319,0.451439,0.000115,No
16815,beautiful,352,9.232901002,296,5.12943883,5.126484529,104192,47.35960091,76,126,202,311,253,564,4,0.466677,0.47863,0.000055,No
7796,memorial,185,9.876176352,133,5.929449156,5.92812831,24605,58.56028554,53,69,122,145,170,315,4,0.456523,0.469673,0.000091,No
1189,turkish,325,9.312706995,195,5.546798726,5.54485688,63375,51.65571129,73,106,179,272,209,481,4,0.444731,0.460706,0.000062,No
14282,create,551,8.784797368,505,4.595239855,4.590187213,278255,40.36825098,44,125,169,497,439,936,4,0.462073,0.475067,0.000065,No
2400,subject,276,9.476131312,235,5.36021277,5.357870075,64860,50.79408007,60,62,122,255,245,500,4,0.471324,0.480935,0.00009,No
5766,pig,71,10.8338523,41,7.106226218,7.105826145,2911,76.98780525,33,36,69,55,58,113,4,0.459109,0.4711,0.000159,No
4227,ross,156,10.04667617,105,6.165837934,6.164797414,16380,61.94617704,69,63,132,133,116,249,4,0.463001,0.474621,0.000083,No
8582,literature,461,8.963134134,365,4.919900931,4.916254363,168265,44.09773197,102,131,233,374,374,748,4,0.475007,0.484977,0.000047,No
6189,pass,492,8.898053461,312,5.076795096,5.073680313,153504,45.17359418,76,87,163,322,428,750,4,0.472856,0.482536,0.000067,No
8608,lion,199,9.803227353,115,6.074866156,6.073725528,22885,59.55329406,46,84,130,179,166,345,4,0.454431,0.468279,0.000084,No
792,victory,253,9.563142689,206,5.491922115,5.489870052,52118,52.52003482,77,63,140,193,218,411,4,0.458138,0.470842,0.000078,No
17942,alfred,174,9.937476878,140,5.878155862,5.876764922,24360,58.41403796,68,60,128,140,110,250,4,0.447602,0.462293,0.000085,No
7133,narrow,165,9.990586703,147,5.829365697,5.82790466,24255,58.23878343,41,85,126,151,131,282,4,0.458469,0.471509,0.000086,No
9388,johnny,155,10.05310706,108,6.137667057,6.136596506,16740,61.70262403,83,41,124,104,88,192,4,0.406369,0.424525,0.000087,No
2241,susan,58,11.03608917,50,6.907775279,6.907285168,2900,76.23482392,31,26,57,41,32,73,4,0.429307,0.44582,0.000189,No
13697,desert,264,9.520583074,188,5.583356321,5.581484608,49632,53.15680769,44,87,131,181,213,394,4,0.462242,0.474504,0.000082,No
1443,train,482,8.918588063,324,5.039054768,5.035819606,156168,44.94125371,119,125,244,406,283,689,4,0.471913,0.482569,0.000044,No
15109,civil,725,8.510360522,578,4.460224416,4.454437821,419050,37.95811779,108,41,149,491,543,1034,5,0.408877,0.426973,0.000072,No
11778,fred,70,10.84803694,59,6.74226084,6.741680684,4130,73.14029462,32,29,61,49,40,89,4,0.42601,0.442867,0.000175,No
16398,bobby,82,10.68981293,65,6.645411014,6.644770822,5330,71.03820059,42,38,80,60,57,117,4,0.414762,0.432685,0.000133,No
3168,sleep,191,9.844258749,130,5.952263834,5.950973027,24830,58.59562532,64,62,126,173,155,328,4,0.466052,0.47695,0.000084,No
11480,gene,139,10.16205824,82,6.413079037,6.412268725,11398,65.1700827,59,49,108,111,89,200,4,0.458149,0.470579,0.000098,No
11769,freedom,300,9.392749703,218,5.435303221,5.433130907,65400,51.05244272,82,65,147,249,255,504,4,0.46907,0.479292,0.000072,No
6197,partner,180,9.903575326,143,5.856953654,5.855532673,25740,58.0047817,51,64,115,138,143,281,4,0.468772,0.479067,0.000092,No
12426,extra,223,9.689360406,197,5.536594555,5.534632671,43931,53.64606007,71,89,160,192,131,323,4,0.432835,0.45027,0.000066,No
10211,husband,336,9.279421017,270,5.221376325,5.218682755,90720,48.45134921,41,114,155,321,281,602,4,0.473688,0.483686,0.000068,No
5552,pole,225,9.680431775,126,5.983516377,5.98226562,28350,57.92302207,50,71,121,201,192,393,4,0.470051,0.480147,0.000087,No
2996,solution,210,9.749424647,134,5.921958484,5.920627626,28140,57.735688,57,64,121,187,180,367,4,0.472063,0.481532,0.000087,No
3015,soldier,187,9.86542356,161,5.738393919,5.73679267,30107,56.61168657,67,75,142,162,153,315,4,0.466383,0.477443,0.000074,No
16961,bar,196,9.818417518,131,5.944600961,5.943300141,25676,58.36657421,71,62,133,168,147,315,4,0.469293,0.479414,0.000079,No
4375,ridge,123,10.28434782,92,6.298009707,6.297099311,11316,64.77092241,48,54,102,101,102,203,4,0.45809,0.470645,0.000103,No
15393,champion,419,9.058661257,285,5.167309104,5.16446512,119415,46.80890279,69,106,175,310,352,662,4,0.458741,0.472128,0.00006,No
16605,bible,451,8.985064838,294,5.136218517,5.133284275,132594,46.1492564,47,122,169,410,372,782,4,0.469529,0.480715,0.000062,No
13271,drama,237,9.624261504,201,5.516493376,5.514491414,47637,53.09217484,71,83,154,187,189,376,4,0.467969,0.478827,0.000068,No
14306,crane,81,10.70208302,26,7.561701746,7.56145172,2106,80.92595988,38,40,78,60,61,121,4,0.456078,0.468748,0.000134,No
14866,colony,386,9.140694808,286,5.163806473,5.160952462,110396,47.20077902,61,86,147,355,340,695,4,0.471775,0.481738,0.000071,No
1540,tony,201,9.793227269,147,5.829365697,5.82790466,29547,57.08830311,74,50,124,146,120,266,4,0.436743,0.452834,0.000084,No
15698,cape,301,9.389421913,201,5.516493376,5.514491414,60501,51.79668379,76,62,138,267,254,521,4,0.459371,0.471786,0.000075,No
16203,branch,409,9.082817021,301,5.112688019,5.109683571,123109,46.43760977,109,69,178,337,359,696,4,0.469678,0.479846,0.000058,No
13722,depression,392,9.125270338,191,5.567524856,5.565623087,74872,50.80516942,43,89,132,161,319,480,4,0.469094,0.47979,0.000078,No
13621,dialect,198,9.808265147,138,5.892544599,5.891173687,27324,57.79563982,58,41,99,152,172,324,4,0.465576,0.476203,0.000104,No
6823,note,537,8.808673617,302,5.106065479,5.10304097,162174,44.97766427,121,89,210,407,389,796,4,0.472202,0.4821,0.000049,No
16718,ben,186,9.870785504,141,5.871038394,5.869637441,26226,57.95176067,72,49,121,133,113,246,4,0.413583,0.431656,0.000085,No
6717,observatory,130,10.22899773,78,6.463089458,6.462319176,10140,66.11092737,38,44,82,100,110,210,4,0.458268,0.470593,0.000125,No
13480,disney,528,8.827435894,231,5.377380574,5.375077971,121968,47.46848229,78,105,183,486,316,802,4,0.465112,0.477034,0.000056,No
16543,birth,482,8.918588063,376,4.890209141,4.886452167,181232,43.61376087,82,86,168,414,433,847,4,0.474068,0.483409,0.000061,No
7938,mayor,340,9.26758656,245,5.318540074,5.316097141,83300,49.2900305,47,64,111,281,317,598,4,0.46855,0.478907,0.000092,No
6380,pacific,644,8.628833451,411,4.80120507,4.797096724,264684,41.42879891,69,101,170,602,565,1167,4,0.468525,0.479579,0.00006,No
5220,professor,338,9.273486282,266,5.236301975,5.233648511,89908,48.55877454,84,66,150,280,281,561,4,0.452716,0.466565,0.000068,No
17176,author,472,8.939553192,416,4.789113024,4.784954472,196352,42.81253062,87,121,208,369,397,766,4,0.471537,0.482222,0.000049,No
18056,agent,182,9.89252549,137,5.899817358,5.89845646,24934,58.36409361,55,69,124,130,156,286,4,0.458374,0.471138,0.000082,No
13057,eddie,79,10.72708432,62,6.692663899,6.692053725,4898,71.79277,39,29,68,53,44,97,4,0.441754,0.456768,0.000149,No
7583,mineral,148,10.0993199,108,6.137667057,6.136596506,15984,61.98626307,46,46,92,128,107,235,4,0.445345,0.46011,0.00011,No
130,y,225,9.667186548,155,5.763552479,5.761991292,34875,55.71733699,51,52,103,101,105,206,4,0.465881,0.476616,0.000098,Yes
13050,edible,77,10.75272676,65,6.645411014,6.644770822,5005,71.45628881,25,34,59,64,57,121,4,0.411799,0.429647,0.000171,No
15822,calcium,104,10.45214128,59,6.74226084,6.741680684,6136,70.47106284,40,29,69,90,94,184,4,0.444164,0.458805,0.000146,No
4271,roll,217,9.716634824,170,5.683999847,5.682308451,36890,55.22935085,36,74,110,207,190,397,4,0.470474,0.480536,0.000091,No
4243,root,147,10.10609959,109,6.128450402,6.12736984,16023,61.9347301,47,52,99,128,115,243,4,0.469057,0.479053,0.000101,No
10650,helen,88,10.61919536,60,6.725453722,6.72486356,5280,71.41890698,45,39,84,72,62,134,4,0.449666,0.46357,0.000119,No
16743,bell,219,9.707460448,141,5.871038394,5.869637441,30879,56.99287299,70,79,149,174,154,328,4,0.449131,0.463856,0.000067,No
12047,flat,360,9.210428146,291,5.146475017,5.143570862,104760,47.40123835,82,135,217,303,288,591,4,0.469529,0.480973,0.000046,No
11195,grace,147,10.10609959,96,6.255450093,6.25449966,14112,63.21820162,55,61,116,111,122,233,4,0.466101,0.476973,0.000086,No
9199,kernel,72,10.81986606,30,7.418600903,7.418310866,2160,80.26826811,28,32,60,41,48,89,4,0.453202,0.466284,0.000166,No
16282,boston,336,9.279421017,235,5.36021277,5.357870075,78960,49.73967104,58,68,126,282,207,489,4,0.448507,0.463143,0.000079,No
15002,cloud,148,10.0993199,87,6.353890166,6.353029813,12876,64.16996941,54,53,107,119,110,229,4,0.466236,0.476936,0.000093,No
1190,turkey,444,9.000707615,343,4.982067837,4.978642044,152292,44.84213592,91,116,207,385,348,733,4,0.469752,0.480757,0.000048,No
7795,memory,332,9.291397208,199,5.526493459,5.524511536,66068,51.3488459,82,92,174,273,269,542,4,0.471399,0.48156,0.000057,No
6426,our,458,8.969662993,346,4.973359509,4.969903613,158468,44.60935874,130,138,268,410,296,706,4,0.425001,0.444064,0.000037,Yes
10782,harrison,152,10.07265166,96,6.255450093,6.25449966,14592,63.00896974,63,55,118,134,123,257,4,0.459644,0.471856,0.000084,No
6437,otherwise,134,10.19869238,132,5.936996362,5.935685529,17688,60.54959954,61,54,115,103,109,212,4,0.452647,0.466241,0.000086,No
9252,karl,171,9.954868621,147,5.829365697,5.82790466,25137,58.03056966,78,44,122,123,98,221,4,0.435298,0.451486,0.000081,No
14504,cook,190,9.849508105,145,5.843064542,5.841623533,27550,57.55131156,56,71,127,173,138,311,4,0.464455,0.475912,0.000077,No
4992,pure,134,10.1912574,121,6.015777239,6.014566531,16214,61.3083343,48,71,119,109,107,216,4,0.443609,0.45912,0.000082,No
14756,compound,161,10.01512781,122,6.015777239,6.014566531,19642,60.24877794,46,41,87,101,109,210,4,0.463013,0.474222,0.000112,No
6849,northeast,378,9.161637982,359,4.936475896,4.932889544,135702,45.22620506,49,108,157,320,340,660,4,0.458161,0.471711,0.000062,No
1840,test,310,9.35995988,202,5.511530587,5.509518604,62620,51.58770517,81,81,162,265,238,503,4,0.472089,0.48186,0.00006,No
6892,noble,163,10.00278198,116,6.066208093,6.065057454,18908,60.67895698,63,60,123,146,132,278,4,0.464881,0.476025,0.000079,No
6361,paid,271,9.494413356,225,5.403697882,5.401455414,60975,51.30494135,59,74,133,221,243,464,4,0.465258,0.476569,0.000073,No
4041,salt,364,9.19937831,213,5.458506119,5.456383911,77532,50.21486279,105,89,194,303,306,609,4,0.461508,0.473955,0.00005,No
7140,napoleon,214,9.730556162,130,5.952263834,5.950973027,27820,57.91883753,80,51,131,176,169,345,4,0.455107,0.468208,0.000074,No
9032,l,163,9.96073374,153,5.914523506,5.913182634,24939,58.91299384,46,42,88,82,89,171,4,0.461652,0.473156,0.00011,No
6432,otto,135,10.1912574,112,6.101299413,6.100188819,15120,62.17991278,60,27,87,99,99,198,4,0.431572,0.447951,0.000111,No
3551,sex,412,9.075508828,262,5.25145378,5.248840421,107944,47.65961514,97,104,201,321,287,608,4,0.471787,0.482081,0.000048,No
803,vice,239,9.620068625,154,5.782845682,5.781314541,36806,55.63137231,63,23,86,212,221,433,5,0.361057,0.373861,0.000112,No
12511,execution,115,10.35160005,86,6.365450988,6.364600644,9890,65.89260276,40,37,77,97,98,195,4,0.453132,0.466349,0.000125,No
17416,arizona,204,9.778412184,131,5.944600961,5.943300141,26724,58.12875846,59,71,130,174,163,337,4,0.463739,0.475349,0.000073,No
17768,amount,651,8.618022535,534,4.539402445,4.534058297,347634,39.12067257,74,43,117,605,634,1239,4,0.469665,0.47933,0.000081,No
588,want,736,8.495302059,601,4.42120335,4.415185398,442336,37.55945792,62,93,155,673,702,1375,4,0.473499,0.483137,0.000061,No
7870,meant,440,9.00975745,399,4.830836867,4.826849006,175560,43.52466846,89,74,163,381,408,789,4,0.455574,0.468997,0.000058,No
12161,figure,338,9.273486282,256,5.27462084,5.272067634,86528,48.914124,95,68,163,257,262,519,4,0.472919,0.482217,0.000058,No
2870,specific,318,9.334480795,289,5.153371596,5.150487499,91902,48.10404819,65,120,185,288,174,462,4,0.445043,0.461265,0.000051,No
6749,o,170,9.86542356,121,5.96776802,5.966497239,20570,58.87455923,80,65,145,128,106,234,4,0.450796,0.464969,0.000065,Yes
7528,missouri,223,9.689360406,156,5.769942277,5.768391106,34788,55.90705024,61,88,149,204,191,395,4,0.462639,0.474818,0.000063,No
12366,fair,158,10.03393714,132,5.936996362,5.935685529,20856,59.57144832,62,74,136,142,140,282,4,0.461701,0.473832,0.000069,No
14534,controlled,276,9.476131312,252,5.290369197,5.287856092,69552,50.13223319,73,59,132,235,251,486,4,0.46061,0.472701,0.000071,No
12388,face,338,9.273486282,275,5.203027187,5.200283481,92950,48.25020124,93,106,199,281,299,580,4,0.471938,0.482226,0.000047,No
14980,coal,167,9.978538365,118,6.04911366,6.047942998,19706,60.36131273,64,59,123,134,123,257,4,0.466236,0.477048,0.000076,No
16666,bernard,94,10.5532374,74,6.515733191,6.515002939,6956,68.76207917,45,37,82,76,64,140,4,0.453978,0.467016,0.000114,No
11798,francisco,315,9.343959539,225,5.403697882,5.401455414,70875,50.49193437,53,75,128,278,236,514,4,0.462013,0.474105,0.000073,No
8786,lemon,74,10.79246708,51,6.887972651,6.887472536,3774,74.33821812,34,39,73,64,68,132,4,0.450727,0.46442,0.000128,No
2566,stewart,103,10.46180319,73,6.529338843,6.528618598,7519,68.30865793,48,48,96,90,78,168,4,0.461616,0.473279,0.000097,No
2012,tape,111,10.38700198,48,6.948597273,6.948127172,5328,72.17509361,35,48,83,89,74,163,4,0.466824,0.477269,0.000112,No
10480,hindu,248,9.583103431,168,5.695834305,5.694162942,41664,54.58376927,52,64,116,222,133,355,4,0.458943,0.471476,0.00008,No
5653,plate,171,9.954868621,104,6.175407385,6.174376875,17784,61.4753692,49,64,113,129,112,241,4,0.469964,0.47994,0.000082,No
17214,audience,180,9.903575326,150,5.80916299,5.807671909,27000,57.53148326,28,57,85,163,133,296,4,0.469243,0.479283,0.000109,No
1571,told,409,9.082817021,371,4.903596222,4.899889434,151739,44.53846723,94,84,178,338,379,717,4,0.473259,0.482785,0.000052,No
8172,manchester,317,9.337630403,194,5.551940125,5.550008299,61498,51.84196491,56,80,136,282,230,512,4,0.455843,0.469363,0.000068,No
15862,ca,195,9.818417518,163,5.719931856,5.718300559,31785,56.16067914,69,73,142,139,143,282,4,0.444865,0.460185,0.000065,No
15084,clark,96,10.53218399,84,6.388981485,6.388151157,8064,67.28992849,47,49,96,78,79,157,4,0.438437,0.454303,0.000096,No
12379,factory,154,10.05957957,123,6.007613929,6.006393208,18942,60.43407037,57,54,111,127,129,256,4,0.46974,0.479593,0.000083,No
16241,box,243,9.603470734,188,5.583356321,5.581484608,45684,53.61959903,90,74,164,219,206,425,4,0.471274,0.481133,0.000056,No
1748,thin,249,9.579079281,215,5.449160256,5.447018006,53535,52.19793811,50,103,153,238,170,408,4,0.455832,0.469753,0.00006,No
17898,allen,140,10.15488975,106,6.15635919,6.155308659,14840,62.51714887,73,62,135,122,101,223,4,0.460002,0.47226,0.000068,No
3777,screen,248,9.583103431,179,5.632412478,5.630630928,44392,53.97599135,60,73,133,209,192,401,4,0.471649,0.481386,0.000069,No
8052,marsh,65,10.92214491,37,7.208880372,7.208520314,2405,78.73643604,35,36,71,53,53,106,4,0.435084,0.451162,0.000129,No
4272,role,713,8.527050757,571,4.472409075,4.466692882,407123,38.13645918,91,61,152,612,680,1292,4,0.470101,0.480011,0.00006,No
6515,orbit,293,9.416359568,186,5.59405161,5.592199934,54498,52.67560141,63,73,136,213,263,476,4,0.472001,0.48163,0.000067,No
16404,boat,205,9.773522198,145,5.843064542,5.841623533,29725,57.107321,37,75,112,183,163,346,4,0.469206,0.479607,0.000081,No
13854,deer,141,10.14777229,63,6.676663558,6.676043378,8883,67.75326142,38,50,88,123,101,224,4,0.455551,0.468546,0.000103,No
16698,benjamin,155,10.05310706,120,6.032306541,6.031115857,18600,60.64342348,80,44,124,111,103,214,4,0.434286,0.450576,0.000073,No
11184,graham,115,10.35160005,82,6.413079037,6.412268725,9430,66.38562927,54,50,104,94,87,181,4,0.452658,0.466227,0.000087,No
2769,spot,152,10.07265166,119,6.040674791,6.039494118,18088,60.84561294,36,47,83,129,135,264,4,0.468661,0.478663,0.000109,No
3755,sculpture,80,10.71450554,64,6.660915201,6.660285015,5120,71.36841284,35,41,76,67,67,134,4,0.455738,0.468518,0.000119,No
7170,mythology,640,8.635064001,483,4.639781631,4.634950074,309120,40.06481133,67,143,210,596,528,1124,4,0.475032,0.485189,0.000043,No
11128,greater,402,9.100080089,337,4.999715354,4.996349764,135474,45.49781014,80,104,184,342,335,677,4,0.444731,0.460697,0.000049,No
5579,po,87,10.63062406,36,7.236279346,7.235929291,3132,76.92616531,29,27,56,67,65,132,4,0.454129,0.466941,0.000161,No
458,welsh,189,9.854785162,129,5.95998588,5.958705086,24381,58.73438042,54,80,134,175,148,323,4,0.456078,0.46949,0.000067,No
8809,legal,370,9.183029172,299,5.119354711,5.116370322,110630,47.01118365,113,111,224,331,215,546,4,0.467439,0.478945,0.00004,No
17857,alpha,141,10.14777229,68,6.600290579,6.599620368,9588,66.97824582,70,42,112,118,73,191,4,0.447568,0.461861,0.00008,No
8238,maine,108,10.41440095,70,6.571303042,6.570612818,7560,68.43618465,53,63,116,96,95,191,4,0.45643,0.469467,0.000077,No
5266,principle,133,10.20618305,101,6.204677767,6.203677287,13433,63.32607705,33,39,72,105,119,224,4,0.463981,0.47495,0.000124,No
615,walk,217,9.716634824,187,5.588689667,5.586827973,40579,54.30325664,60,64,124,195,205,400,4,0.467833,0.478353,0.000072,No
8510,logic,180,9.903575326,118,6.04911366,6.047942998,21240,59.90785279,53,57,110,128,140,268,4,0.466996,0.477593,0.000081,No
14008,dan,99,10.49136199,78,6.450350432,6.449570143,7722,67.67296135,38,31,69,70,63,133,4,0.411722,0.42952,0.000129,No
9895,industrial,294,9.41295241,258,5.266838699,5.264265443,75852,49.57650203,70,69,139,259,186,445,4,0.448756,0.463368,0.000064,No
10580,heritage,275,9.47976108,230,5.381718975,5.379426395,63250,51.01741008,47,54,101,246,206,452,4,0.467279,0.477752,0.000088,No
4020,samuel,198,9.808265147,152,5.795917763,5.794406652,30096,56.84789819,87,56,143,153,125,278,4,0.442547,0.457946,0.000062,No
1203,tunnel,142,10.14070512,66,6.630143542,6.629493344,9372,67.23433056,40,63,103,105,122,227,4,0.469256,0.47941,0.000086,No
7301,mouth,346,9.250093402,282,5.177891213,5.175077314,97572,47.89597735,46,84,130,303,306,609,4,0.471537,0.481522,0.000068,No
9187,kevin,130,10.22899773,99,6.224678434,6.223697973,12870,63.67222155,52,44,96,85,77,162,4,0.429536,0.446374,0.000092,No
4734,rate,264,9.520583074,199,5.526493459,5.524511536,52536,52.61544009,65,48,113,223,239,462,4,0.465039,0.475931,0.000078,No
7530,mississippi,310,9.35995988,189,5.578051269,5.576169537,58590,52.21033609,59,82,141,264,262,526,4,0.459323,0.472124,0.000062,No
3002,solo,333,9.288389687,250,5.298337366,5.295844311,83250,49.21302215,75,66,141,298,204,502,4,0.446678,0.461589,0.000062,No
3618,separate,482,8.918588063,433,4.749060556,4.744731285,208706,42.35491479,76,148,224,439,280,719,4,0.462049,0.475499,0.000039,No
16268,bought,304,9.379504476,267,5.232549626,5.229886135,81168,49.07872264,90,66,156,242,265,507,4,0.470275,0.480226,0.000056,No
11734,friedrich,152,10.07265166,120,6.032306541,6.031115857,18240,60.76132248,61,30,91,116,77,193,4,0.424168,0.441337,0.000096,No
14053,d,251,9.56710309,417,5.701804472,5.700143126,104667,54.54975118,78,70,148,197,201,398,4,0.469268,0.479546,0.000059,Yes
11345,gland,79,10.72708432,45,7.013135794,7.012695706,3555,75.23049905,19,24,43,62,57,119,4,0.451656,0.464913,0.000203,No
2258,surgery,111,10.38700198,75,6.502310171,6.501569912,8325,67.53950859,47,41,88,99,94,193,4,0.462965,0.474194,0.000099,No
11891,foreign,343,9.25880173,251,5.294345345,5.291842265,86093,49.01929384,79,51,130,294,168,462,4,0.411541,0.429727,0.000067,No
4744,rare,237,9.628472036,223,5.412626513,5.410404089,52851,52.11532302,53,75,128,215,166,381,4,0.464248,0.475823,0.000068,No
15911,bus,194,9.828674018,128,5.96776802,5.966497239,24832,58.65524649,59,69,128,162,132,294,4,0.462687,0.474485,0.000068,No
11963,fly,259,9.539704116,202,5.511530587,5.509518604,52318,52.57837102,57,88,145,223,231,454,4,0.468179,0.479062,0.00006,No
5368,practice,297,9.402800039,269,5.225086905,5.222403361,79893,49.13044735,70,88,158,265,257,522,4,0.472277,0.482132,0.000055,No
10286,houston,176,9.926048182,111,6.110268083,6.109167499,19536,60.6508154,48,54,102,162,134,296,4,0.44614,0.460913,0.000085,No
6880,noise,76,10.76579884,62,6.692663899,6.692053725,4712,72.05187322,35,41,76,60,68,128,4,0.456911,0.469415,0.000114,No
4859,quite,419,9.058661257,395,4.840912519,4.836964816,165505,43.85218669,76,112,188,370,348,718,4,0.432213,0.450181,0.000046,No
3410,shot,283,9.45108528,241,5.335001351,5.332598514,68203,50.42155273,65,64,129,251,259,510,4,0.468302,0.47872,0.000067,No
2174,switch,97,10.5218212,60,6.725453722,6.72486356,5820,70.76402154,37,38,75,79,81,160,4,0.454025,0.467077,0.000115,No
3131,slow,186,9.870785504,172,5.672303807,5.670592378,31992,55.99009419,53,70,123,165,138,303,4,0.463884,0.475452,0.00007,No
3685,seed,111,10.38700198,78,6.463089458,6.462319176,8658,67.13212297,41,45,86,96,77,173,4,0.46808,0.478189,0.0001,No
4285,rod,115,10.35160005,68,6.600290579,6.599620368,7820,68.32356828,51,49,100,93,87,180,4,0.467144,0.477565,0.000086,No
12909,else,306,9.372947075,279,5.188586502,5.185802687,85374,48.63234668,25,99,124,305,258,563,4,0.470238,0.480818,0.000069,No
7400,month,342,9.26172144,234,5.364477169,5.362144497,80028,49.68429321,49,75,124,314,310,624,4,0.471574,0.481377,0.000069,No
9023,labour,227,9.67158216,140,5.878155862,5.876764922,31780,56.85106736,59,52,111,193,184,377,4,0.461209,0.47302,0.000077,No
16823,beat,258,9.543572592,213,5.458506119,5.456383911,54954,52.09364939,81,93,174,217,213,430,4,0.470437,0.480846,0.000049,No
611,wall,364,9.19937831,253,5.286408795,5.283885665,92092,48.63167441,85,89,174,334,302,636,4,0.471149,0.481306,0.000049,No
17700,angeles,509,8.864084161,365,4.919900931,4.916254363,185785,43.61041591,2,79,81,2,406,408,4,0.46386,0.475598,0.000105,No
10224,hunt,167,9.978538365,129,5.95998588,5.958705086,21543,59.47194776,61,60,121,147,134,281,4,0.46855,0.478809,0.00007,No
12644,et,211,9.744674044,172,5.672303807,5.670592378,36292,55.27475168,46,31,77,75,127,202,4,0.430275,0.446876,0.00011,No
12306,fashion,229,9.662810174,172,5.672303807,5.670592378,39388,54.81039494,72,74,146,177,147,324,4,0.467722,0.478457,0.000058,No
1572,tokyo,231,9.654114467,157,5.763552479,5.761991292,36267,55.64199537,54,76,130,191,182,373,4,0.466935,0.477889,0.000065,No
16182,brazil,717,8.520062608,575,4.463690624,4.457924144,412275,38.03092358,94,128,222,647,365,1012,4,0.472227,0.482832,0.000038,No
3679,seen,1070,8.12111825,932,3.98246547,3.973112049,997240,32.342073,80,116,196,945,973,1918,4,0.474486,0.484306,0.000043,No
5669,planet,509,8.864084161,312,5.076795096,5.073680313,158808,45.001139,86,110,196,463,404,867,4,0.474309,0.484057,0.000043,No
1353,treaty,591,8.71471616,369,4.90900164,4.905314926,218079,42.78055592,72,70,142,551,537,1088,4,0.468587,0.479025,0.000059,No
2537,stock,243,9.603470734,120,6.032306541,6.031115857,29160,57.93107933,85,61,146,171,208,379,4,0.469231,0.479334,0.000057,No
6597,olympic,361,9.207654219,212,5.46321201,5.461099823,76532,50.30336711,86,48,134,283,206,489,5,0.396865,0.414861,0.000062,No
1973,tax,174,9.937476878,101,6.204677767,6.203677287,17574,61.65884185,53,64,117,142,140,282,4,0.470387,0.480245,0.000071,No
4298,robot,90,10.59672251,53,6.849506371,6.848986246,4770,72.58231832,32,37,69,79,66,145,4,0.455399,0.468171,0.00012,No
9797,injury,121,10.30074163,91,6.308938778,6.30803839,11011,64.98674832,48,45,93,105,96,201,4,0.467932,0.478043,0.000089,No
2613,steam,171,9.954868621,104,6.175407385,6.174376875,17784,61.4753692,49,46,95,131,114,245,4,0.450362,0.46426,0.000087,No
6503,ordinary,172,9.949037701,151,5.802518447,5.801017351,25972,57.72947479,51,76,127,154,122,276,4,0.409368,0.428173,0.000065,No
15841,caesar,230,9.658452868,130,5.952263834,5.950973027,29900,57.4896597,48,68,116,189,157,346,4,0.45924,0.471818,0.000071,No
13968,database,317,9.337630403,248,5.306369538,5.303896532,78616,49.54891753,44,75,119,250,158,408,4,0.468463,0.479039,0.000069,No
14880,collins,82,10.68981293,54,6.830814238,6.830284108,4428,73.02012636,38,44,82,68,69,137,4,0.442503,0.457688,0.0001,No
12442,expression,116,10.34294199,94,6.276503502,6.275573088,10904,64.9175116,38,40,78,102,95,197,4,0.468018,0.478039,0.000105,No
2810,spirit,197,9.813328449,139,5.885324351,5.883943426,27383,57.75462088,56,68,124,148,172,320,4,0.459299,0.471842,0.000066,No
15314,cheese,221,9.698369476,100,6.214628098,6.213637628,22100,60.27175945,66,66,132,175,180,355,4,0.464188,0.475602,0.000062,No
1939,ted,91,10.58567267,72,6.543132165,6.542421927,6552,69.26345534,40,26,66,61,40,101,4,0.424026,0.441205,0.000124,No
1917,telephone,178,9.914748627,113,6.092410465,6.09128986,20114,60.4047183,59,42,101,148,86,234,4,0.458516,0.470743,0.000081,No
2464,stress,131,10.22133485,78,6.463089458,6.462319176,10218,66.06140154,54,55,109,111,106,217,4,0.464431,0.475598,0.000075,No
3626,sent,656,8.610371388,555,4.50083017,4.495274879,364080,38.75381932,107,83,190,554,593,1147,4,0.468673,0.47933,0.000043,No
1068,universal,196,9.818417518,152,5.795917763,5.794406652,29792,56.9067405,52,66,118,153,139,292,4,0.449279,0.463758,0.000069,No
2627,status,298,9.399438691,253,5.286408795,5.283885665,75394,49.68927537,86,70,156,232,264,496,4,0.469964,0.480062,0.000052,No
8779,length,690,8.55984058,521,4.564048242,4.55883478,359490,39.06752535,91,102,193,605,630,1235,4,0.473448,0.483254,0.000042,No
1452,traffic,180,9.903575326,129,5.95998588,5.958705086,23220,59.02516911,79,58,137,147,125,272,4,0.464188,0.475457,0.000059,No
11686,fuel,263,9.524378145,148,5.82258601,5.821114958,38924,55.45651095,71,70,141,230,206,436,4,0.469616,0.479799,0.000057,No
9926,index,108,10.41440095,69,6.58569178,6.585011562,7452,68.58603473,28,43,71,69,85,154,4,0.466432,0.476879,0.000113,No
4559,renaissance,223,9.689360406,181,5.621301253,5.619499667,40363,54.46681379,41,67,108,204,152,356,4,0.462025,0.473955,0.000074,No
6354,pair,169,9.966633462,133,5.929449156,5.92812831,22477,59.09664637,38,35,73,157,151,308,4,0.465686,0.47618,0.000109,No
13755,denmark,356,9.221601446,267,5.232549626,5.229886135,95052,48.2524872,68,88,156,323,274,597,4,0.470238,0.48063,0.000051,No
3331,signal,286,9.440540367,132,5.936996362,5.935685529,37752,56.04845381,77,73,150,215,210,425,4,0.471963,0.481611,0.000053,No
9408,joan,109,10.4051843,96,6.255450093,6.25449966,10464,65.08911106,48,26,74,85,79,164,4,0.432382,0.448665,0.000107,No
5538,politician,587,8.721507358,532,4.543154795,4.537830753,312284,39.62315797,98,105,203,434,510,944,4,0.465515,0.477353,0.000039,No
4120,ryan,103,10.46180319,79,6.450350432,6.449570143,8137,67.48229672,48,39,87,76,65,141,4,0.425459,0.442609,0.000091,No
359,wide,535,8.81426543,485,4.635649393,4.63079774,259475,40.85984419,71,125,196,427,452,879,4,0.451197,0.466401,0.00004,No
6973,newton,167,9.978538365,99,6.224678434,6.223697973,16533,62.11319256,53,71,124,137,116,253,4,0.45717,0.470204,0.000063,No
14865,colorado,223,9.689360406,138,5.892544599,5.891173687,30774,57.09498833,59,71,130,188,185,373,4,0.46276,0.47457,0.00006,No
8741,let,410,9.080375018,370,4.906295279,4.902598528,151700,44.55100108,103,87,190,350,373,723,4,0.446442,0.461875,0.000041,No
13138,dwarf,141,10.14777229,80,6.43777165,6.436981353,11280,65.32904074,47,33,80,122,81,203,4,0.448122,0.462213,0.000097,No
17706,andy,110,10.38700198,80,6.42534913,6.424548825,8800,66.74011411,47,43,90,79,65,144,4,0.419536,0.437281,0.000086,No
14758,composition,136,10.18387729,119,6.040674791,6.039494118,16184,61.51749083,36,37,73,96,115,211,4,0.452428,0.465786,0.000106,No
4708,read,468,8.948063881,372,4.90090443,4.897187605,174096,43.85360592,78,110,188,430,405,835,4,0.471186,0.481715,0.000041,No
4487,rest,471,8.941674083,440,4.733023557,4.728623981,207240,42.32115408,36,68,104,461,449,910,4,0.46024,0.472593,0.000074,No
3302,silver,313,9.350328987,234,5.364477169,5.362144497,73242,50.15962637,75,96,171,269,238,507,4,0.464467,0.476372,0.000045,No
7969,matthew,162,10.00893584,123,6.007613929,6.006393208,19926,60.12982238,59,63,122,129,126,255,4,0.463606,0.475109,0.000063,No
7385,moore,126,10.26025027,84,6.388981485,6.388151157,10584,65.55254901,67,61,128,98,100,198,4,0.460634,0.472748,0.00006,No
5556,poland,627,8.655585637,435,4.744452253,4.740102895,272745,41.06601278,97,143,240,542,510,1052,4,0.477524,0.487029,0.000032,No
10566,heroes,101,10.48141166,87,6.353890166,6.353029813,8787,66.59773847,45,41,86,82,83,165,4,0.462748,0.474011,0.000089,No
16528,bit,255,9.555268632,220,5.426170738,5.42397838,56100,51.84851904,35,67,102,240,202,442,4,0.466947,0.477738,0.000075,No
14730,concept,276,9.476131312,237,5.351738143,5.349375401,65412,50.71377339,53,49,102,249,241,490,4,0.465783,0.476508,0.000075,No
10406,holmes,73,10.80607274,38,7.182212124,7.181842063,2774,77.61150662,37,41,78,66,59,125,4,0.441172,0.456467,0.000098,No
11953,focus,198,9.808265147,159,5.750894082,5.749312864,31482,56.40629399,59,41,100,169,186,355,4,0.461496,0.473053,0.000076,No
9371,jordan,165,9.990586703,107,6.14696945,6.145908909,17655,61.41183125,64,69,133,141,135,276,4,0.460252,0.472593,0.000057,No
3332,sign,359,9.213209789,273,5.210326489,5.207602838,98007,48.00383101,91,52,143,297,314,611,4,0.470063,0.479813,0.000053,No
7731,message,211,9.744674044,146,5.836191663,5.834740639,30806,56.87178541,52,70,122,182,181,363,4,0.470449,0.480438,0.000062,No
8919,larvae,87,10.63062406,53,6.849506371,6.848986246,4611,72.81452721,32,38,70,73,78,151,4,0.461532,0.473016,0.000108,No
16536,bishop,312,9.35352899,227,5.394848267,5.392585754,70824,50.46086966,74,74,148,244,283,527,4,0.468389,0.478978,0.000051,No
15747,canal,167,9.978538365,98,6.234830806,6.233860354,16366,62.21449839,35,63,98,138,131,269,4,0.468154,0.478593,0.000077,No
6087,peak,250,9.575071259,186,5.59405161,5.592199934,46500,53.5634428,53,63,116,139,195,334,4,0.467538,0.478109,0.000065,No
14149,cultural,318,9.334480795,279,5.188586502,5.185802687,88722,48.43276106,86,77,163,262,166,428,4,0.436057,0.452791,0.000046,No
832,vertical,114,10.36033373,94,6.276503502,6.275573088,10716,65.02667093,46,51,97,104,74,178,4,0.449051,0.463279,0.000077,No
692,volcanic,167,9.978538365,120,6.032306541,6.031115857,20040,60.19360225,52,39,91,146,113,259,4,0.423237,0.440562,0.000082,No
15372,chapel,150,10.08589688,90,6.319988614,6.319098235,13500,63.74275346,36,45,81,134,132,266,4,0.464832,0.47572,0.000092,No
13118,e,264,9.465320396,196,5.572774212,5.570882462,51744,52.74809341,74,78,152,184,194,378,4,0.468463,0.47909,0.000049,No
12346,false,163,10.00278198,114,6.083599836,6.08246922,18582,60.85292279,45,54,99,136,108,244,4,0.456007,0.468955,0.000075,No
3724,seat,755,8.469814428,696,4.274448624,4.2674745,525480,36.20378663,57,52,109,734,736,1470,4,0.468686,0.478776,0.000068,No
9908,individual,299,9.396088604,261,5.255277877,5.252674543,78039,49.37905657,74,87,161,273,154,427,4,0.467636,0.47864,0.000046,No
3845,scholar,115,10.35160005,109,6.128450402,6.12736984,12535,63.43926748,47,41,88,91,84,175,4,0.464747,0.475579,0.000084,No
7058,need,752,8.473795853,645,4.350547967,4.344087271,485040,36.86565533,97,120,217,599,689,1288,4,0.472315,0.48278,0.000034,No
14726,concert,328,9.303518569,235,5.36021277,5.357870075,77080,49.86883904,89,78,167,298,268,566,4,0.472227,0.481921,0.000044,No
10114,identity,171,9.954868621,116,6.066208093,6.065057454,19836,60.38830459,55,58,113,129,140,269,4,0.469392,0.479428,0.000065,No
18133,adult,298,9.399438691,249,5.302345388,5.299862357,74202,49.83907039,76,103,179,259,208,467,4,0.464954,0.476889,0.000041,No
7678,mice,147,10.10609959,70,6.571303042,6.570612818,10290,66.41024298,52,47,99,119,103,222,4,0.456946,0.469584,0.000074,No
9374,jonathan,90,10.59672251,74,6.515733191,6.515002939,6660,69.04541655,48,35,83,66,51,117,5,0.367257,0.381616,0.000088,No
1355,treat,160,10.02135836,118,6.04911366,6.047942998,18880,60.62033576,35,74,109,150,123,273,4,0.459002,0.471711,0.000067,No
11534,gases,192,9.839036805,113,6.092410465,6.09128986,21696,59.9434508,56,74,130,178,170,348,4,0.469082,0.479494,0.000056,No
15884,button,76,10.76579884,51,6.887972651,6.887472536,3876,74.15452796,37,28,65,69,64,133,4,0.44776,0.461781,0.000112,No
496,weather,392,9.125270338,275,5.203027187,5.200283481,107800,47.47902965,118,84,202,321,243,564,4,0.469429,0.479926,0.000036,No
5841,phillip,59,11.01899473,37,7.208880372,7.208520314,2183,79.43461485,29,33,62,51,46,97,4,0.421329,0.438736,0.000117,No
1386,transport,328,9.303518569,243,5.326736841,5.324313956,79704,49.55739511,94,113,207,299,255,554,4,0.470724,0.481433,0.000035,No
14478,copy,165,9.990586703,131,5.944600961,5.943300141,21615,59.39005132,51,43,94,147,140,287,4,0.465527,0.476213,0.000077,No
10365,honey,108,10.41440095,65,6.645411014,6.644770822,7020,69.20797478,56,43,99,97,79,176,4,0.449882,0.463819,0.000073,No
3099,smooth,88,10.61919536,77,6.475992862,6.475232589,6776,68.76983337,34,46,80,86,66,152,4,0.442503,0.45773,0.00009,No
13223,drum,118,10.32584755,65,6.645411014,6.644770822,7670,68.61950106,39,40,79,101,95,196,4,0.452566,0.465917,0.000091,No
12529,exchange,240,9.615893254,142,5.863971227,5.86256026,34080,56.38732136,42,72,114,221,195,416,4,0.471236,0.481057,0.000063,No
5905,peru,165,9.990586703,114,6.083599836,6.08246922,18810,60.77873163,46,58,104,153,138,291,4,0.466935,0.477551,0.000069,No
1330,tribe,257,9.547456092,199,5.526493459,5.524511536,51143,52.76395365,57,60,117,149,204,353,4,0.470487,0.480273,0.000061,No
8103,margaret,173,9.943240583,131,5.944600961,5.943300141,22663,59.10859752,61,62,123,133,119,252,4,0.446151,0.461068,0.000058,No
3110,smell,141,10.14777229,109,6.128450402,6.12736984,15369,62.19011915,43,47,90,129,127,256,4,0.466077,0.476691,0.000079,No
15679,capture,189,9.854785162,169,5.689899569,5.68821819,31941,56.07273785,42,64,106,141,153,294,4,0.458611,0.471222,0.000067,No
2608,steel,271,9.494413356,188,5.583356321,5.581484608,50948,53.01069283,69,96,165,195,188,383,4,0.468933,0.479762,0.000043,No
17432,argument,110,10.39605181,79,6.450350432,6.449570143,8690,67.05817729,32,45,77,95,98,193,4,0.459252,0.471354,0.000092,No
3769,script,148,10.0993199,86,6.365450988,6.364600644,12728,64.28672586,48,49,97,109,103,212,4,0.468921,0.478898,0.000073,No
8119,map,248,9.583103431,178,5.638014734,5.636243201,44144,54.02967834,74,62,136,176,209,385,4,0.467599,0.478133,0.000052,No
5677,plain,178,9.914748627,141,5.871038394,5.869637441,25098,58.20986985,60,66,126,140,162,302,4,0.455224,0.468589,0.000056,No
12245,fell,167,9.978538365,150,5.80916299,5.807671909,25050,57.96695577,71,41,112,135,161,296,4,0.457276,0.469748,0.000063,No
10143,ian,113,10.36914436,89,6.331161914,6.330281545,10057,65.64873185,42,45,87,70,66,136,4,0.440198,0.45574,0.000081,No
13931,deal,225,9.680431775,192,5.562302912,5.560391124,43200,53.84549385,47,40,87,188,213,401,4,0.455481,0.468302,0.000081,No
3504,sharp,182,9.89252549,139,5.885324351,5.883943426,25298,58.22072116,59,69,128,168,121,289,4,0.448541,0.46319,0.000055,No
12135,find,787,8.428303929,679,4.299177157,4.292374205,534373,36.23477172,69,132,201,740,699,1439,4,0.474245,0.484428,0.000035,No
12162,fight,527,8.829331629,452,4.706116104,4.701595994,238204,41.55185977,80,105,185,478,461,939,4,0.474613,0.484184,0.000038,No
5678,plague,124,10.27625061,57,6.776747016,6.776186871,7068,69.63955067,23,42,65,110,101,211,4,0.464917,0.475701,0.000108,No
17281,astronomy,187,9.86542356,155,5.776373167,5.774832011,28985,56.98636794,47,61,108,156,159,315,4,0.464649,0.475865,0.000065,No
9458,jeff,97,10.5218212,83,6.400957676,6.400137356,8051,67.34973217,38,27,65,65,53,118,4,0.424452,0.441454,0.000108,No
18202,actual,172,9.949037701,167,5.701804472,5.700143126,28724,56.72746765,31,84,115,161,99,260,4,0.395742,0.414498,0.000061,No
13959,dave,117,10.33435824,105,6.165837934,6.164797414,12285,63.71997808,45,31,76,75,43,118,5,0.397096,0.414805,0.000092,No
6185,passenger,165,9.990586703,134,5.921958484,5.920627626,22110,59.16383969,62,47,109,132,113,245,4,0.419933,0.437675,0.000064,No
17928,algorithm,145,10.11979843,69,6.58569178,6.585011562,10005,66.64587336,36,47,83,121,111,232,4,0.451714,0.465387,0.000084,No
7613,mill,102,10.47155936,59,6.74226084,6.741680684,6018,70.60198464,42,38,80,87,81,168,4,0.454001,0.467058,0.000087,No
7131,nasa,149,10.09258587,121,6.024007739,6.022807042,18029,60.79781539,41,47,88,112,109,221,4,0.448077,0.462382,0.000079,No
6839,northwest,1413,7.843061795,1366,3.600156244,3.586412503,1930158,28.23624789,50,104,154,1352,1327,2679,4,0.469479,0.480353,0.000045,No
5969,perfect,175,9.931746203,128,5.96776802,5.966497239,22400,59.27035738,66,95,161,152,136,288,4,0.461833,0.474321,0.000043,No
15818,calculus,69,10.86242567,42,7.082128666,7.08171859,2898,76.92909624,24,35,59,59,58,117,4,0.464321,0.475133,0.000117,No
11997,florence,229,9.662810174,146,5.836191663,5.834740639,33434,56.39401217,50,73,123,202,190,392,4,0.462398,0.474368,0.000056,No
15173,chuck,99,10.50141233,66,6.630143542,6.629493344,6534,69.62587113,55,33,88,79,72,151,4,0.40356,0.421418,0.000078,No
9490,jam,89,10.60789581,68,6.600290579,6.599620368,6052,70.01519476,33,44,77,72,70,142,4,0.447828,0.462148,0.000089,No
17702,angel,190,9.849508105,114,6.083599836,6.08246922,21660,59.92046589,51,67,118,154,136,290,4,0.466812,0.477616,0.000058,No
13483,disk,201,9.78826448,102,6.185069296,6.184048796,20502,60.5410941,52,64,116,173,140,313,4,0.467427,0.478043,0.000059,No
14603,constant,157,10.04028637,120,6.032306541,6.031115857,18840,60.56608516,37,83,120,114,126,240,4,0.46276,0.474809,0.000057,No
14017,dame,79,10.72708432,54,6.830814238,6.830284108,4266,73.27472033,19,41,60,75,68,143,4,0.455236,0.468096,0.000114,No
7775,mental,217,9.716634824,159,5.750894082,5.749312864,34503,55.87933771,59,41,100,190,81,271,4,0.416915,0.434745,0.000068,No
1788,theodore,71,10.8338523,62,6.692663899,6.692053725,4402,72.50733218,42,28,70,52,55,107,5,0.410096,0.427921,0.000097,No
9734,instrument,428,9.037408982,254,5.282464017,5.279930862,108712,47.73978775,66,88,154,301,359,660,4,0.474207,0.483569,0.000044,No
12073,flag,489,8.904169688,192,5.562302912,5.560391124,93888,49.52768899,94,89,183,402,437,839,4,0.472377,0.482231,0.000037,No
17856,alphabet,444,9.000707615,265,5.240068458,5.23742502,117660,47.16432407,53,91,144,398,336,734,4,0.473448,0.483062,0.000047,No
12582,evans,59,11.01899473,35,7.264450223,7.264110172,2065,80.04693875,32,35,67,52,52,104,4,0.4563,0.468852,0.000101,No
9771,insect,81,10.70208302,60,6.725453722,6.72486356,4860,71.9763641,30,35,65,75,54,129,4,0.452462,0.465777,0.000104,No
2854,spectrum,137,10.17655125,72,6.543132165,6.542421927,9864,66.58651982,36,49,85,92,110,202,4,0.465551,0.476325,0.000079,No
17667,anna,165,9.990586703,110,6.119317918,6.118227346,18150,61.13557623,75,47,122,129,87,216,4,0.440067,0.45565,0.000055,No
11663,funeral,81,10.70208302,63,6.676663558,6.676043378,5103,71.45420771,26,36,62,76,63,139,4,0.45214,0.465593,0.000108,No
5861,phase,98,10.5115647,62,6.692663899,6.692053725,6076,70.35036958,48,40,88,84,86,170,4,0.463678,0.474739,0.000076,No
736,virus,170,9.96073374,78,6.463089458,6.462319176,13260,64.37711323,36,53,89,133,128,261,4,0.465307,0.476222,0.000075,No
9203,kept,425,9.044443008,376,4.890209141,4.886452167,159800,44.22921787,83,102,185,370,374,744,4,0.469765,0.480522,0.000036,No
7846,medium,156,10.04667617,122,6.015777239,6.014566531,19032,60.43856584,47,57,104,129,122,251,4,0.467009,0.477579,0.000064,No
721,visual,169,9.966633462,116,6.066208093,6.065057454,19604,60.45967257,51,45,96,137,102,239,4,0.402663,0.420826,0.000069,No
7588,mind,281,9.458177508,216,5.444519877,5.442367605,60696,51.49523544,59,88,147,259,236,495,4,0.47331,0.482902,0.000045,No
297,wing,139,10.16205824,100,6.214628098,6.213637628,13900,63.1534127,49,54,103,118,110,228,4,0.466456,0.477114,0.000064,No
1892,ten,655,8.611896942,568,4.477676865,4.471990844,372040,38.5612917,110,117,227,575,283,858,4,0.471161,0.481855,0.000029,No
15017,clock,120,10.30904043,74,6.515733191,6.515002939,8880,67.17095693,29,54,83,101,102,203,4,0.464066,0.475288,0.000079,No
13212,du,158,10.03393714,130,5.952263834,5.950973027,20540,59.72464117,43,33,76,54,49,103,4,0.405015,0.422925,0.000086,No
15043,cleveland,156,10.04667617,82,6.413079037,6.412268725,12792,64.43012834,50,55,105,134,115,249,4,0.457712,0.470335,0.000062,No
14310,craig,68,10.87702447,49,6.927977986,6.92749788,3332,75.3557861,31,36,67,44,51,95,4,0.433015,0.449317,0.000097,No
17568,apart,262,9.528187674,244,5.322630059,5.32019715,63928,50.71501812,79,65,144,163,240,403,4,0.470063,0.480062,0.000045,No
10118,idea,754,8.471139809,607,4.411269493,4.405191179,457678,37.36848061,83,83,166,722,705,1427,4,0.473638,0.483057,0.000039,No
9357,journey,130,10.22899773,112,6.101299413,6.100188819,14560,62.41017783,42,41,83,113,117,230,4,0.465576,0.476213,0.000078,No
13495,discovery,277,9.472514671,194,5.551940125,5.550008299,53738,52.59083429,47,54,101,224,227,451,4,0.45435,0.467631,0.000064,No
2328,sum,107,10.42370334,78,6.463089458,6.462319176,8346,67.36932718,26,31,57,99,97,196,4,0.455481,0.468119,0.000113,No
1756,thick,214,9.730556162,192,5.562302912,5.560391124,41088,54.12430088,52,104,156,178,155,333,4,0.458836,0.472138,0.000041,No
2455,string,320,9.328211182,176,5.649314289,5.647562791,56320,52.69799672,76,69,145,276,233,509,4,0.46964,0.47979,0.000044,No
6466,orthodox,278,9.468911064,157,5.763552479,5.761991292,43646,54.57456583,46,45,91,209,190,399,4,0.442348,0.45757,0.00007,No
9217,ken,58,11.03608917,50,6.907775279,6.907285168,2900,76.23482392,28,25,53,42,32,74,5,0.366347,0.380468,0.00012,No
16886,basin,157,10.04028637,114,6.083599836,6.08246922,17898,61.08108452,34,54,88,121,134,255,4,0.469653,0.479541,0.000072,No
1746,think,835,8.369100453,707,4.258767618,4.251682721,590345,35.642054,76,105,181,659,783,1442,4,0.469777,0.480597,0.000035,No
7015,netherlands,628,8.653992011,428,4.760675089,4.756396032,268784,41.19884418,56,162,218,585,516,1101,4,0.477036,0.487048,0.000029,No
12383,fact,346,9.250093402,320,5.051477288,5.048282254,110720,46.72663674,28,79,107,337,310,647,4,0.468624,0.479217,0.000059,No
9467,jay,74,10.79246708,58,6.759355274,6.758785123,4292,72.9501193,38,27,65,60,42,102,4,0.44887,0.462678,0.000097,No
15855,cable,166,9.984544389,108,6.137667057,6.136596506,17928,61.28180918,57,40,97,128,128,256,4,0.460873,0.472532,0.000065,No
1076,unique,228,9.667186548,217,5.439900931,5.437738638,49476,52.5885371,47,103,150,207,168,375,4,0.459811,0.472908,0.000042,No
4697,reason,456,8.974039368,418,4.784316852,4.780138217,190608,42.93464778,62,88,150,443,407,850,4,0.468908,0.479621,0.000042,No
3203,skull,146,10.11292556,105,6.165837934,6.164797414,15330,62.35466002,41,57,98,121,115,236,4,0.468698,0.478874,0.000064,No
1336,triangle,160,10.02135836,78,6.463089458,6.462319176,12480,64.76893558,35,60,95,144,139,283,4,0.466395,0.477184,0.000066,No
6344,pale,71,10.8338523,59,6.74226084,6.741680684,4189,73.04465811,27,35,62,60,56,116,4,0.411665,0.429553,0.000101,No
10608,henri,70,10.84803694,61,6.70892442,6.708324252,4270,72.7786599,34,19,53,47,31,78,5,0.387373,0.404204,0.000118,No
5437,portugal,402,9.100080089,312,5.076795096,5.073680313,125424,46.19924197,69,126,195,354,309,663,4,0.470861,0.481785,0.000032,No
6105,pay,354,9.227235264,268,5.228811304,5.226137786,94872,48.24747205,62,83,145,334,320,654,4,0.467414,0.478396,0.000043,No
16619,betty,55,11.08919899,35,7.264450223,7.264110172,1925,80.55693409,33,21,54,47,35,82,4,0.432045,0.448181,0.000115,No
436,wet,114,10.36033373,94,6.276503502,6.275573088,10716,65.02667093,44,50,94,95,79,174,4,0.444019,0.459096,0.000066,No
13511,direct,264,9.520583074,234,5.364477169,5.362144497,61776,51.07295054,83,76,159,228,187,415,4,0.447421,0.462415,0.000039,No
12788,entire,275,9.47976108,266,5.236301975,5.233648511,73150,49.63889167,26,129,155,259,217,476,4,0.403845,0.423558,0.00004,No
9646,invasion,226,9.675997178,191,5.567524856,5.565623087,43166,53.8713548,67,36,103,198,204,402,4,0.466224,0.476602,0.00006,No
1480,tournament,188,9.860090215,125,5.991484547,5.990243802,23500,59.07657815,52,62,114,158,155,313,4,0.467156,0.477813,0.000054,No
9158,kill,437,9.016598982,357,4.942062502,4.938496222,156009,44.56059573,50,116,166,397,369,766,4,0.469504,0.480555,0.000037,No
579,warfare,88,10.61919536,66,6.630143542,6.629493344,5808,70.40678956,29,45,74,61,75,136,4,0.455317,0.468241,0.000083,No
5225,product,331,9.294413802,237,5.351738143,5.349375401,78447,49.74126886,90,76,166,289,286,575,4,0.473259,0.482621,0.000037,No
2167,sword,165,9.990586703,91,6.308938778,6.30803839,15015,63.02999987,43,50,93,140,136,276,4,0.46615,0.476828,0.000066,No
4199,row,138,10.16927849,111,6.110268083,6.109167499,15318,62.1370178,35,49,84,131,119,250,4,0.471049,0.480489,0.000073,No
14463,cork,108,10.41440095,32,7.354062381,7.35375234,3456,76.58815425,47,43,90,90,79,169,4,0.453491,0.466734,0.000068,No
13839,definition,233,9.645493724,191,5.567524856,5.565623087,44503,53.70152606,65,42,107,190,194,384,4,0.468562,0.478489,0.000057,No
8411,ludwig,96,10.53218399,82,6.413079037,6.412268725,7872,67.54372833,53,28,81,81,76,157,5,0.410779,0.428565,0.000075,No
1212,tuna,34,11.57017165,17,7.98658494,7.986424931,578,92.40615868,16,21,37,24,29,53,4,0.439131,0.454378,0.000164,No
12003,floor,199,9.803227353,154,5.782845682,5.781314541,30646,56.69055096,36,65,101,182,172,354,4,0.47025,0.480194,0.00006,No
4984,purple,129,10.23671977,103,6.185069296,6.184048796,13287,63.31482116,45,56,101,103,102,205,4,0.452024,0.465781,0.00006,No
16057,brought,428,9.037408982,408,4.80853111,4.804452887,174624,43.45666224,96,82,178,368,398,766,4,0.454664,0.468438,0.000034,No
9282,k,116,10.32584755,91,6.377147028,6.376306692,10556,65.84944803,56,50,106,95,87,182,4,0.452393,0.46596,0.000057,No
2336,sulfur,68,10.87702447,34,7.29343776,7.293107712,2312,79.330901,33,28,61,54,57,111,4,0.42215,0.439407,0.000099,No
8650,lime,91,10.58567267,34,7.29343776,7.293107712,3094,77.20594477,31,36,67,61,69,130,4,0.453109,0.46626,0.00009,No
12629,ethnic,250,9.575071259,195,5.546798726,5.54485688,48750,53.11099306,70,27,97,210,142,352,5,0.402152,0.419945,0.000062,No
10260,huge,242,9.607594451,226,5.399263285,5.397010795,54692,51.87393198,46,112,158,222,150,372,4,0.398147,0.417399,0.000038,No
4193,roy,76,10.76579884,63,6.676663558,6.676043378,4788,71.87961677,39,36,75,51,42,93,4,0.421149,0.438614,0.00008,No
951,valve,56,11.07118049,25,7.600922459,7.600682435,1400,84.15118441,30,25,55,48,39,87,4,0.438567,0.453984,0.000109,No
3589,serious,206,9.768656009,188,5.583356321,5.581484608,38728,54.54188728,54,82,136,188,129,317,4,0.456617,0.469983,0.000044,No
10046,impact,103,10.46180319,93,6.287198791,6.286278386,9579,65.77543636,36,36,72,80,89,169,4,0.450522,0.464223,0.000083,No
17255,atlantic,794,8.419448716,533,4.54127686,4.535942765,423202,38.23504763,79,91,170,742,720,1462,4,0.462711,0.474912,0.000035,No
7231,muscle,118,10.32584755,81,6.42534913,6.424548825,9558,66.34717559,42,43,85,103,78,181,4,0.466714,0.477105,0.00007,No
11872,formal,216,9.72125377,174,5.660742985,5.659011521,37584,55.02951908,61,84,145,194,132,326,4,0.454466,0.468293,0.000041,No
15699,capacity,168,9.966633462,125,5.991484547,5.990243802,21000,59.71493037,51,48,99,124,158,282,4,0.469119,0.479029,0.00006,No
770,villa,120,10.30904043,76,6.489064944,6.488314678,9120,66.89603289,40,39,79,67,66,133,4,0.446162,0.460645,0.000075,No
2343,suit,105,10.44257183,56,6.794446593,6.793896453,5880,70.95149658,39,41,80,86,83,169,4,0.465405,0.47603,0.000074,No
5292,pretty,82,10.68981293,77,6.475992862,6.475232589,6314,69.22715224,38,44,82,68,70,138,4,0.429994,0.446778,0.000072,No
3705,secretary,478,8.926921445,296,5.12943883,5.126484529,141488,45.79009749,83,61,144,371,467,838,4,0.470949,0.480649,0.000041,No
1486,touch,202,9.78826448,154,5.782845682,5.781314541,31108,56.60402298,67,61,128,170,173,343,4,0.468191,0.478555,0.000046,No
12340,familiar,70,10.84803694,68,6.600290579,6.599620368,4760,71.60019599,25,29,54,61,50,111,4,0.433237,0.449435,0.000109,No
501,weapon,191,9.844258749,132,5.936996362,5.935685529,25212,58.44532838,49,58,107,165,152,317,4,0.469032,0.479147,0.000055,No
14817,committee,210,9.749424647,176,5.649314289,5.647562791,36960,55.07756397,47,54,101,149,156,305,4,0.465881,0.476696,0.000058,No
6173,pastor,68,10.87702447,47,6.969650683,6.969190586,3196,75.80906104,27,23,50,59,57,116,4,0.443542,0.458171,0.000117,No
1297,triple,133,10.20618305,92,6.298009707,6.297099311,12236,64.27863992,48,38,86,114,111,225,4,0.453236,0.466429,0.000068,No
9393,johannes,78,10.73982335,72,6.543132165,6.542421927,5616,70.27208361,44,15,59,56,44,100,5,0.38574,0.402336,0.000099,No
8616,link,247,9.587143841,182,5.615791597,5.613979993,44954,53.83940182,86,76,162,188,205,393,4,0.461989,0.474095,0.000036,No
4299,robinson,94,10.5532374,63,6.676663558,6.676043378,5922,70.46041553,48,43,91,76,75,151,4,0.461305,0.472936,0.000064,No
8833,leather,98,10.5115647,77,6.475992862,6.475232589,7546,68.07281796,38,44,82,84,67,151,4,0.457276,0.469776,0.000071,No
8806,legend,260,9.535850546,210,5.472690753,5.470598608,54600,52.18676111,59,62,121,232,212,444,4,0.468624,0.478931,0.000048,No
10696,heard,229,9.662810174,208,5.482260205,5.480188101,47632,52.97403968,54,69,123,203,196,399,4,0.470599,0.480522,0.000047,No
1988,taste,162,10.00893584,131,5.944600961,5.943300141,21222,59.49912963,58,65,123,135,132,267,4,0.459181,0.471687,0.000047,No
1453,tradition,272,9.490730111,233,5.368759831,5.366437182,63376,50.95345058,81,60,141,216,210,426,4,0.471174,0.48078,0.000041,No
14674,conflict,160,10.02135836,124,5.999516719,5.998285986,19840,60.12330704,47,43,90,131,140,271,4,0.461472,0.473072,0.000064,No
5770,pierce,61,10.98565831,40,7.13091883,7.130528762,2440,78.33783773,37,34,71,55,51,106,4,0.449905,0.463636,0.000081,No
9943,increase,183,9.887046025,167,5.701804472,5.700143126,30561,56.37400324,41,46,87,164,158,322,4,0.464747,0.475663,0.000066,No
3113,smart,94,10.5532374,71,6.557118407,6.556418176,6674,69.19882718,35,56,91,83,71,154,4,0.448654,0.463044,0.000063,No
7688,mexican,175,9.931746203,141,5.871038394,5.869637441,24675,58.30966328,52,58,110,148,109,257,4,0.431688,0.448538,0.000052,No
12561,everything,298,9.399438691,268,5.228811304,5.226137786,79864,49.14789128,104,69,173,223,269,492,4,0.464139,0.475616,0.000033,No
898,velocity,86,10.64218488,44,7.03560865,7.035178566,3784,74.87424801,37,37,74,75,72,147,4,0.457194,0.469584,0.000077,No
17464,archbishop,167,9.978538365,131,5.944600961,5.943300141,21877,59.31842875,53,27,80,122,148,270,4,0.445904,0.460218,0.000071,No
15274,chicken,95,10.54265529,67,6.615105665,6.61444546,6365,69.7407787,44,42,86,71,68,139,4,0.44549,0.460162,0.000066,No
10966,gustav,90,10.59672251,78,6.463089458,6.462319176,7020,68.48756552,38,23,61,71,48,119,4,0.429942,0.446416,0.000093,No
2957,sophia,49,11.20471188,27,7.523961418,7.52370139,1323,84.30381988,22,31,53,27,39,66,4,0.451553,0.464941,0.000107,No
14823,commerce,132,10.21373025,117,6.057624349,6.056463699,15444,61.87094109,31,60,91,127,104,231,4,0.456312,0.46933,0.000062,No
9561,isaac,142,10.14070512,101,6.204677767,6.203677287,14342,62.9198076,62,32,94,107,94,201,4,0.437174,0.452942,0.00006,No
2374,succession,108,10.41440095,85,6.377147028,6.376306692,9180,66.41416607,19,45,64,89,86,175,4,0.465893,0.476522,0.000088,No
17921,alice,115,10.35160005,76,6.489064944,6.488314678,8740,67.17220499,62,35,97,97,59,156,4,0.461436,0.472884,0.000058,No
12779,entry,110,10.39605181,93,6.287198791,6.286278386,10230,65.36204438,42,32,74,70,90,160,4,0.457689,0.469898,0.000076,No
17143,avenue,77,10.75272676,54,6.830814238,6.830284108,4158,73.44987901,36,40,76,60,67,127,4,0.445636,0.460242,0.000074,No
13821,del,284,9.447557939,197,5.536594555,5.534632671,55948,52.30729785,54,24,78,86,50,136,5,0.355134,0.366487,0.000072,No
5117,protein,144,10.12671888,94,6.276503502,6.275573088,13536,63.5603865,51,51,102,130,103,233,4,0.461185,0.472978,0.000055,No
476,weight,348,9.244329698,262,5.25145378,5.248840421,91176,48.54617014,86,83,169,299,303,602,4,0.472629,0.482301,0.000033,No
15776,cambridge,273,9.487060382,182,5.615791597,5.613979993,49686,53.27735398,43,93,136,245,207,452,4,0.470999,0.481297,0.000041,No
7045,neither,88,10.61919536,84,6.388981485,6.388151157,7392,67.84584256,36,46,82,73,70,143,4,0.441644,0.457049,0.000068,No
193,worn,244,9.599363952,137,5.899817358,5.89845646,33428,56.63449407,40,47,87,179,239,418,4,0.452774,0.46626,0.000064,No
6168,pat,57,11.05348091,50,6.907775279,6.907285168,2850,76.35496217,32,26,58,40,34,74,4,0.39707,0.414761,0.000096,No
4782,ralph,87,10.63062406,71,6.557118407,6.556418176,6177,69.70626069,39,25,64,57,40,97,5,0.366151,0.380316,0.000087,No
17530,appear,305,9.376220401,279,5.188586502,5.185802687,85095,48.64933061,58,63,121,239,280,519,4,0.454338,0.467805,0.000046,No
1467,toy,136,10.18387729,79,6.450350432,6.449570143,10744,65.68957728,44,44,88,102,102,204,4,0.455002,0.467992,0.000063,No
9795,ink,105,10.44257183,42,7.082128666,7.08171859,4410,73.95563728,45,33,78,93,80,173,4,0.465344,0.47587,0.000071,No
8129,mantle,74,10.79246708,38,7.182212124,7.181842063,2812,77.51378794,17,29,46,55,63,118,4,0.457724,0.469861,0.00012,No
433,whale,150,10.08589688,49,6.927977986,6.92749788,7350,69.87487158,23,41,64,96,96,192,4,0.459228,0.47126,0.000086,No
14332,cowboy,44,11.31234254,32,7.354062381,7.35375234,1408,83.19167274,22,25,47,34,40,74,4,0.441194,0.456204,0.000117,No
14854,column,95,10.54265529,70,6.571303042,6.570612818,6650,69.27898275,36,37,73,81,78,159,4,0.464516,0.475321,0.000075,No
13701,descent,151,10.07925234,139,5.885324351,5.883943426,20989,59.31966924,43,53,96,121,134,255,4,0.469727,0.479569,0.000057,No
7413,monster,122,10.29251113,72,6.543132165,6.542421927,8784,67.34526065,47,54,101,113,98,211,4,0.459287,0.47157,0.000054,No
3481,sheffield,98,10.5115647,51,6.887972651,6.887472536,4998,72.40337017,35,45,80,82,83,165,4,0.463122,0.474372,0.000068,No
13825,degree,374,9.17227638,275,5.203027187,5.200283481,102850,47.72360337,75,76,151,287,346,633,4,0.470824,0.480813,0.000036,No
9263,kansas,217,9.716634824,133,5.929449156,5.92812831,28861,57.61429216,69,74,143,195,197,392,4,0.462085,0.474114,0.000038,No
9449,jennifer,49,11.20471188,44,7.03560865,7.035178566,2156,78.83196782,24,24,48,34,28,62,5,0.365676,0.379546,0.000113,No
14581,contact,209,9.754197925,159,5.750894082,5.749312864,33231,56.09535912,67,56,123,178,178,356,4,0.467255,0.477781,0.000044,No
7149,nancy,90,10.59672251,61,6.70892442,6.708324252,5490,71.0926104,38,39,77,63,62,125,4,0.451645,0.465171,0.00007,No
7693,metro,84,10.66571538,59,6.74226084,6.741680684,4956,71.91103513,31,30,61,69,57,126,4,0.447072,0.461237,0.000088,No
14557,continuous,90,10.59672251,83,6.400957676,6.400137356,7470,67.82917228,30,50,80,74,61,135,5,0.399959,0.418138,0.000067,No
662,vote,231,9.654114467,166,5.707810496,5.706159166,38346,55.10385588,54,65,119,210,209,419,4,0.470624,0.480485,0.000045,No
3360,sick,182,9.89252549,144,5.849984985,5.84855399,26208,57.87112558,58,61,119,154,161,315,4,0.464394,0.475649,0.000045,No
5832,phoenix,143,10.13368755,76,6.489064944,6.488314678,10868,65.75815661,54,55,109,120,115,235,4,0.460037,0.472175,0.000049,No
7104,naval,177,9.920382445,148,5.82258601,5.821114958,26196,57.76228004,59,50,109,139,106,245,5,0.389012,0.406566,0.000049,No
2703,staff,191,9.844258749,143,5.856953654,5.855532673,27313,57.65736725,62,59,121,161,146,307,4,0.469256,0.479339,0.000044,No
2774,sport,412,9.075508828,309,5.086457007,5.083372316,127308,46.16218547,86,104,190,347,328,675,4,0.471099,0.481574,0.000028,No
13486,dish,99,10.50141233,73,6.529338843,6.528618598,7227,68.56727942,40,37,77,84,75,159,4,0.468488,0.478339,0.000069,No
10830,hans,105,10.44257183,95,6.265921393,6.264980969,9975,65.43233421,49,20,69,70,45,115,5,0.386076,0.40281,0.000077,No
5378,powder,110,10.39605181,81,6.42534913,6.424548825,8910,66.79826246,43,44,87,90,92,182,4,0.461761,0.473321,0.000061,No
7546,miranda,68,10.87702447,34,7.29343776,7.293107712,2312,79.330901,35,33,68,52,52,104,4,0.44482,0.459425,0.000078,No
11478,genera,159,10.02762798,133,5.929449156,5.92812831,21147,59.45831023,45,48,93,133,121,254,4,0.459966,0.471992,0.000057,No
7544,mirror,74,10.79246708,53,6.849506371,6.848986246,3922,73.92307205,19,31,50,60,62,122,4,0.460133,0.471795,0.000106,No
9474,jason,117,10.33435824,90,6.319988614,6.319098235,10530,65.31302642,47,53,100,79,72,151,4,0.430818,0.447702,0.000053,No
16911,barry,73,10.80607274,57,6.776747016,6.776186871,4161,73.23002117,40,27,67,53,36,89,4,0.428934,0.445571,0.000079,No
1067,universe,410,9.080375018,268,5.228811304,5.226137786,109880,47.47956753,33,114,147,333,334,667,4,0.475605,0.48509,0.000036,No
7757,mercury,154,10.05957957,90,6.319988614,6.319098235,13860,63.57642837,64,62,126,133,124,257,4,0.458694,0.471213,0.000042,No
15812,calendar,624,8.660381809,400,4.828333737,4.824335836,249600,41.81521366,58,93,151,200,402,602,4,0.471174,0.481405,0.000035,No
699,vocal,127,10.25234509,104,6.175407385,6.174376875,13208,63.31240759,54,34,88,110,79,189,4,0.430776,0.447303,0.00006,No
9471,java,137,10.17655125,91,6.308938778,6.30803839,12467,64.20323881,43,48,91,100,103,203,4,0.448609,0.462828,0.000058,No
12949,elephant,89,10.60789581,60,6.725453722,6.72486356,5340,71.34291234,26,46,72,69,67,136,4,0.464091,0.475156,0.000073,No
10616,hence,85,10.65388092,85,6.377147028,6.376306692,7225,67.94136505,45,28,73,66,73,139,4,0.440865,0.456059,0.000072,No
8955,lane,80,10.71450554,61,6.70892442,6.708324252,4880,71.88280788,38,36,74,54,50,104,4,0.451209,0.464767,0.000071,No
9358,journal,137,10.17655125,113,6.092410465,6.09128986,15481,61.99972735,45,44,89,98,102,200,4,0.464321,0.475278,0.000059,No
6796,nowadays,110,10.39605181,109,6.128450402,6.12736984,11990,63.7116879,54,38,92,68,90,158,4,0.449745,0.463608,0.000057,No
15768,camera,179,9.909146372,96,6.255450093,6.25449966,17184,61.98617059,58,53,111,163,129,292,4,0.468302,0.478471,0.000047,No
7752,meridian,55,11.08919899,29,7.452502454,7.452222421,1595,82.6422827,21,28,49,49,44,93,4,0.460288,0.471865,0.000106,No
9398,joey,58,11.03608917,35,7.264450223,7.264110172,2030,80.17112041,32,27,59,43,37,80,4,0.441523,0.456542,0.000088,No
748,virgin,202,9.78826448,115,6.074866156,6.073725528,23230,59.46239661,42,43,85,157,111,268,4,0.444542,0.459392,0.000061,No
6566,ontario,332,9.291397208,223,5.412626513,5.410404089,74036,50.29086287,71,86,157,271,297,568,4,0.463812,0.475692,0.000033,No
9429,jet,102,10.47155936,66,6.630143542,6.629493344,6732,69.42794169,41,27,68,78,70,148,4,0.439523,0.454871,0.000076,No
17939,algae,110,10.39605181,63,6.676663558,6.676043378,6930,69.41094028,33,43,76,92,95,187,4,0.451312,0.464969,0.000068,No
742,virtual,118,10.32584755,93,6.287198791,6.286278386,10974,64.92065625,40,36,76,79,89,168,4,0.420152,0.437802,0.000068,No
11999,flora,96,10.53218399,46,6.991156888,6.990706795,4416,73.63215062,49,40,89,73,75,148,4,0.461749,0.473194,0.000058,No
8184,mammal,105,10.44257183,93,6.287198791,6.286278386,9765,65.65452497,35,32,67,85,85,170,4,0.463146,0.47417,0.000077,No
3625,sentence,163,10.00278198,95,6.265921393,6.264980969,15485,62.67664557,32,60,92,156,142,298,4,0.469355,0.479428,0.000056,No
10640,hell,106,10.43309308,79,6.450350432,6.449570143,8374,67.29710647,29,54,83,96,93,189,4,0.470325,0.48002,0.000062,No
7259,multiple,402,9.100080089,350,4.96186513,4.958369096,140700,45.15337007,62,43,105,329,154,483,4,0.413612,0.431581,0.000049,No
10252,hull,91,10.58567267,43,7.058598169,7.058178089,3913,74.72000973,42,42,84,80,75,155,4,0.463364,0.474508,0.000061,No
17253,atlas,105,10.44257183,43,7.058598169,7.058178089,4515,73.70991837,43,41,84,84,79,163,4,0.464091,0.475072,0.000061,No
11025,guard,179,9.909146372,121,6.024007739,6.022807042,21659,59.69277443,47,62,109,122,127,249,4,0.466996,0.477677,0.000047,No
217,wool,99,10.50141233,69,6.58569178,6.585011562,6831,69.15906484,42,39,81,86,83,169,4,0.451599,0.465143,0.000063,No
8448,louise,77,10.75272676,62,6.692663899,6.692053725,4774,71.96438617,45,36,81,65,51,116,4,0.414753,0.432647,0.000063,No
2191,swedish,394,9.120181268,286,5.163806473,5.160952462,112684,47.09485107,66,138,204,352,282,634,4,0.455166,0.46988,0.000025,No
4213,rough,85,10.65388092,79,6.450350432,6.449570143,6715,68.7212654,37,48,85,76,58,134,4,0.443387,0.458519,0.00006,No
16784,beer,135,10.1912574,81,6.42534913,6.424548825,10935,65.48238686,48,52,100,102,110,212,4,0.468933,0.478968,0.000051,No
836,vertebrae,51,11.16470654,26,7.561701746,7.56145172,1326,84.42418097,25,26,51,40,46,86,4,0.455773,0.468265,0.0001,No
9157,kim,133,10.20618305,69,6.58569178,6.585011562,9177,67.21477581,67,57,124,93,87,180,4,0.452728,0.466382,0.000041,No
5778,picture,438,9.014313267,332,5.014663315,5.011347892,145416,45.20374605,71,104,175,406,344,750,4,0.47175,0.482053,0.000029,No
4142,rural,316,9.340789964,267,5.232549626,5.229886135,84372,48.87614703,50,37,87,228,214,442,4,0.444453,0.459209,0.000058,No
1210,tune,150,10.08589688,93,6.287198791,6.286278386,13950,63.41203869,39,45,84,143,133,276,4,0.466579,0.477039,0.00006,No
5914,personal,350,9.238599023,307,5.092950537,5.089885907,107450,47.05172785,93,87,180,282,188,470,4,0.411703,0.430614,0.000028,No
3611,sequel,219,9.707460448,186,5.59405161,5.592199934,40734,54.30403475,28,41,69,197,184,381,4,0.449222,0.463242,0.000073,No
2452,strip,152,10.07265166,119,6.040674791,6.039494118,18088,60.84561294,34,51,85,115,128,243,4,0.469181,0.479128,0.000059,No
4267,romance,129,10.23671977,91,6.308938778,6.30803839,11739,64.58283833,39,46,85,89,87,176,4,0.463074,0.474368,0.000059,No
17187,aurora,47,11.24638458,26,7.561701746,7.56145172,1222,85.04180588,21,25,46,33,42,75,4,0.434892,0.450867,0.000109,No
3535,shah,194,9.828674018,132,5.936996362,5.935685529,25608,58.35280189,42,35,77,78,89,167,4,0.450087,0.463828,0.000065,No
8640,lincoln,252,9.56710309,128,5.96776802,5.966497239,32256,57.09425187,83,102,185,227,208,435,4,0.460228,0.473199,0.000027,No
14097,cut,368,9.188449239,305,5.099486508,5.096441938,112240,46.85637292,91,87,178,308,335,643,4,0.471762,0.48171,0.000028,No
7094,nazi,220,9.702904631,166,5.707810496,5.706159166,36520,55.38234089,53,30,83,204,171,375,5,0.39125,0.408589,0.00006,No
12132,finger,116,10.34294199,76,6.489064944,6.488314678,8816,67.11602226,42,37,79,105,88,193,4,0.453816,0.466908,0.000063,No
9542,israel,372,9.177638323,215,5.449160256,5.447018006,79980,50.01042199,85,114,199,334,302,636,4,0.471399,0.481963,0.000025,No
11839,foster,49,11.20471188,37,7.208880372,7.208520314,1813,80.77342754,19,27,46,33,41,74,4,0.455271,0.467861,0.000108,No
12554,evolution,209,9.754197925,158,5.757203251,5.755632049,33022,56.15690001,54,54,108,180,175,355,4,0.470911,0.480452,0.000046,No
17141,average,556,8.775763883,449,4.712775396,4.708285421,249644,41.35820411,60,131,191,500,371,871,4,0.472063,0.482799,0.000026,No
12958,electron,163,10.00278198,80,6.43777165,6.436981353,13040,64.39562623,32,55,87,147,117,264,4,0.467082,0.477621,0.000057,No
717,vitamin,123,10.28434782,46,6.991156888,6.990706795,5658,71.89948911,51,33,84,106,117,223,4,0.455434,0.468086,0.000059,No
17717,anderson,102,10.47155936,77,6.475992862,6.475232589,7854,67.8137437,53,50,103,69,76,145,4,0.463013,0.474405,0.000048,No
8638,linda,65,10.92214491,42,7.082128666,7.08171859,2730,77.35203554,33,32,65,50,42,92,4,0.434211,0.450313,0.000076,No
11864,formula,392,9.125270338,234,5.364477169,5.362144497,91728,48.95230439,75,55,130,309,339,648,4,0.458079,0.470626,0.000038,No
16114,bright,191,9.844258749,167,5.701804472,5.700143126,31897,56.13003856,64,77,141,171,138,309,4,0.463751,0.47548,0.000035,No
7454,moment,129,10.23671977,100,6.214628098,6.213637628,12900,63.61740633,30,47,77,119,117,236,4,0.466322,0.476884,0.000064,No
7077,nebraska,87,10.63062406,59,6.74226084,6.741680684,5133,71.6744403,37,51,88,80,80,160,4,0.458149,0.470621,0.000056,No
11471,genesis,105,10.44257183,58,6.759355274,6.758785123,6090,70.58505295,32,46,78,79,80,159,4,0.46229,0.473767,0.000063,No
3506,shark,89,10.60789581,29,7.452502454,7.452222421,2581,79.05536954,25,29,54,69,70,139,4,0.45252,0.465706,0.000091,No
1715,thousand,230,9.658452868,200,5.521480918,5.519488975,46000,53.32896321,43,43,86,225,101,326,4,0.460085,0.47195,0.000057,No
14106,curve,77,10.75272676,58,6.759355274,6.758785123,4466,72.6815003,25,34,59,66,63,129,4,0.466726,0.476954,0.000083,No
15361,charge,480,8.922746073,338,4.996752389,4.993376765,162240,44.58475276,68,85,153,436,434,870,4,0.47278,0.482452,0.000032,No
16927,baron,124,10.27625061,100,6.214628098,6.213637628,12400,63.8630758,50,44,94,76,77,153,4,0.452105,0.465645,0.000052,No
15307,chemistry,291,9.42320891,224,5.408152232,5.405919787,65184,50.9621483,57,91,148,222,237,459,4,0.471687,0.481743,0.000033,No
9312,jump,151,10.07925234,102,6.194825471,6.193814981,15402,62.43920913,51,60,111,121,125,246,4,0.468228,0.478583,0.000044,No
15264,chile,201,9.793227269,145,5.843064542,5.841623533,29145,57.22245901,50,72,122,173,161,334,4,0.455002,0.468509,0.00004,No
15080,classic,180,9.903575326,140,5.878155862,5.876764922,25200,58.21475936,61,78,139,139,123,262,4,0.466432,0.477532,0.000035,No
13505,dirty,77,10.75272676,64,6.660915201,6.660285015,4928,71.6230011,41,35,76,55,49,104,4,0.43848,0.454064,0.000064,No
5546,policy,185,9.876176352,153,5.789360363,5.787839237,28305,57.17674391,62,59,121,150,146,296,4,0.469802,0.479748,0.00004,No
4793,rainfall,112,10.37803331,84,6.388981485,6.388151157,9408,66.30506265,35,47,82,95,97,192,4,0.466567,0.477076,0.000059,No
7233,murray,94,10.5532374,62,6.692663899,6.692053725,5828,70.62927093,40,38,78,70,73,143,4,0.450968,0.464608,0.000062,No
2686,stalin,86,10.64218488,50,6.907775279,6.907285168,4300,73.51382163,27,43,70,63,68,131,4,0.454594,0.467645,0.000069,No
4716,raymond,80,10.71450554,61,6.70892442,6.708324252,4880,71.88280788,45,34,79,64,58,122,4,0.39771,0.415578,0.000061,No
6394,oxford,309,9.3631909,216,5.444519877,5.442367605,66744,50.97807897,69,77,146,286,236,522,4,0.46871,0.479255,0.000033,No
4127,ruth,58,11.03608917,41,7.106226218,7.105826145,2378,78.42494618,32,34,66,50,42,92,4,0.430421,0.446994,0.000073,No
11526,gate,152,10.07265166,96,6.255450093,6.25449966,14592,63.00896974,46,56,102,126,126,252,4,0.468043,0.478358,0.000047,No
4842,rabbit,68,10.87702447,35,7.264450223,7.264110172,2380,79.01560285,30,33,63,53,44,97,4,0.446128,0.460523,0.000076,No
165,wright,98,10.5115647,65,6.645411014,6.644770822,6370,69.85366783,44,40,84,91,70,161,4,0.45822,0.470471,0.000057,No
13432,divine,105,10.44257183,87,6.353890166,6.353029813,9135,66.35095444,30,51,81,88,83,171,4,0.443586,0.458707,0.000059,No
9344,juan,223,9.689360406,162,5.732201949,5.730590684,36126,55.5413706,60,46,106,175,145,320,4,0.442569,0.457796,0.000045,No
18119,advice,93,10.56393268,80,6.43777165,6.436981353,7440,68.00818634,38,30,68,79,85,164,4,0.465319,0.475799,0.00007,No
17451,arctic,170,9.96073374,118,6.04911366,6.047942998,20060,60.25361053,28,44,72,159,146,305,4,0.447128,0.461561,0.000066,No
14256,crew,122,10.29251113,95,6.265921393,6.264980969,11590,64.49206569,41,52,93,108,87,195,4,0.464479,0.475574,0.000051,No
17070,background,160,10.02135836,130,5.952263834,5.950973027,20800,59.64976894,57,46,103,138,110,248,4,0.468364,0.478414,0.000046,No
11524,gates,108,10.41440095,82,6.413079037,6.412268725,8856,66.78837642,48,43,91,97,91,188,4,0.450247,0.464105,0.000052,No
11809,frame,82,10.68981293,53,6.849506371,6.848986246,4346,73.21994177,42,41,83,74,69,143,4,0.465478,0.476123,0.000057,No
13042,editor,121,10.30074163,98,6.234830806,6.233860354,11858,64.22338125,37,49,86,94,108,202,4,0.46626,0.476875,0.000055,No
8805,legendary,98,10.5115647,86,6.365450988,6.364600644,8428,66.9108499,23,52,75,89,66,155,4,0.444564,0.459575,0.000063,No
9395,johann,200,9.798214811,143,5.856953654,5.855532673,28600,57.38769004,81,40,121,156,147,303,4,0.395857,0.4137,0.000039,No
16006,buddhism,186,9.870785504,113,6.092410465,6.09128986,21018,60.13687691,37,65,102,143,151,294,4,0.471524,0.481118,0.000046,No
10432,hockey,739,8.491234256,339,4.993798177,4.99041252,250521,42.40351015,64,78,142,441,541,982,4,0.462965,0.474875,0.000033,No
1980,taught,321,9.325091054,282,5.177891213,5.175077314,90522,48.28430703,71,85,156,277,302,579,4,0.465771,0.47717,0.00003,No
14434,corpus,64,10.93764909,29,7.452502454,7.452222421,1856,81.51285672,28,12,40,55,16,71,4,0.448836,0.462364,0.000117,No
10291,household,118,10.32584755,90,6.319988614,6.319098235,10620,65.25923896,40,39,79,105,81,186,4,0.449506,0.463429,0.000059,No
3383,shrub,61,10.98565831,53,6.849506371,6.848986246,3233,75.2463366,20,27,47,52,53,105,4,0.463436,0.474302,0.000099,No
10790,harold,104,10.45214128,64,6.660915201,6.660285015,6656,69.62082672,46,40,86,86,59,145,4,0.437346,0.453167,0.000054,No
3640,send,200,9.798214811,169,5.689899569,5.68821819,33800,55.75085823,27,62,89,185,152,337,4,0.459347,0.471767,0.000052,No
11043,grow,595,8.707970772,470,4.66706559,4.662364651,279650,40.64067074,70,115,185,480,511,991,4,0.466493,0.478283,0.000025,No
14657,congress,324,9.315788662,250,5.298337366,5.295844311,81000,49.35819116,48,92,140,245,250,495,4,0.471888,0.481912,0.000033,No
3485,sheep,161,10.01512781,101,6.204677767,6.203677287,16261,62.14064087,60,45,105,136,122,258,4,0.466211,0.476771,0.000044,No
14914,coin,96,10.53218399,47,6.969650683,6.969190586,4512,73.40564331,30,41,71,82,67,149,4,0.459704,0.471645,0.000065,No
12368,failure,168,9.972568198,121,6.024007739,6.022807042,20328,60.074828,46,50,96,144,142,286,4,0.469765,0.479532,0.000048,No
8924,larry,78,10.73982335,63,6.676663558,6.676043378,4914,71.70618718,33,28,61,57,53,110,4,0.42911,0.445689,0.000075,No
16291,borough,336,9.279421017,206,5.491922115,5.489870052,69216,50.9618575,35,41,76,306,312,618,4,0.467698,0.477809,0.00006,No
554,waste,157,10.04028637,108,6.137667057,6.136596506,16956,61.62393491,66,54,120,135,121,256,4,0.46642,0.47709,0.000038,No
6201,particular,376,9.166943034,353,4.953330227,4.949804088,132728,45.40689602,27,171,198,368,286,654,4,0.443132,0.460636,0.000023,No
4258,ron,90,10.59672251,76,6.489064944,6.488314678,6840,68.76282054,36,30,66,60,55,115,4,0.411627,0.429422,0.000069,No
13653,devil,126,10.26025027,85,6.377147028,6.376306692,10710,65.43112452,30,61,91,108,99,207,4,0.457937,0.470617,0.00005,No
1555,tommy,84,10.66571538,61,6.70892442,6.708324252,5124,71.55547836,38,33,71,52,45,97,4,0.421489,0.438825,0.000064,No
2057,talk,444,9.000707615,381,4.876998909,4.873191747,169164,43.89644122,86,56,142,390,420,810,4,0.468723,0.478865,0.000032,No
5217,profile,189,9.854785162,172,5.672303807,5.670592378,32508,55.8993354,55,71,126,68,154,222,4,0.462494,0.474372,0.000036,No
12010,float,39,11.43297053,34,7.29343776,7.293107712,1326,83.38565898,22,21,43,35,37,72,4,0.422824,0.439905,0.000105,No
10184,hydrogen,301,9.389421913,157,5.763552479,5.761991292,47257,54.11642594,92,63,155,254,217,471,4,0.462386,0.474133,0.000029,No
13114,eagle,128,10.24450191,68,6.600290579,6.599620368,8704,67.61668947,40,62,102,90,108,198,4,0.463388,0.474875,0.000044,No
2911,soviet,600,8.699602522,346,4.973359509,4.969903613,207600,43.26625093,67,73,140,537,488,1025,4,0.420241,0.438403,0.000032,No
11567,gang,118,10.32584755,72,6.543132165,6.542421927,8496,67.56338526,33,44,77,107,95,202,4,0.467858,0.478006,0.000058,No
13929,dean,95,10.54265529,69,6.58569178,6.585011562,6555,69.43067825,45,39,84,78,73,151,4,0.447523,0.461772,0.000053,No
18224,acoustic,128,10.24450191,78,6.463089458,6.462319176,9984,66.21113231,56,50,106,99,95,194,4,0.449188,0.463373,0.000042,No
14617,consider,134,10.19869238,126,5.983516377,5.98226562,16884,61.02404287,37,41,78,94,112,206,4,0.438947,0.454688,0.000057,No
7238,murder,196,9.818417518,163,5.726048083,5.724426802,31948,56.22073081,56,71,127,179,173,352,4,0.470101,0.480198,0.000035,No
15732,candy,63,10.95339745,45,7.013135794,7.012695706,2835,76.81766373,28,38,66,50,53,103,4,0.462796,0.474011,0.000067,No
15756,campbell,56,11.07118049,42,7.082128666,7.08171859,2352,78.40752469,35,33,68,48,44,92,4,0.44137,0.456509,0.000065,No
2594,stem,101,10.48141166,61,6.70892442,6.708324252,6161,70.31899865,34,30,64,84,67,151,4,0.462001,0.47325,0.000069,No
9688,internal,176,9.926048182,142,5.863971227,5.86256026,24992,58.20606094,55,55,110,146,115,261,4,0.430651,0.44759,0.00004,No
9466,jazz,247,9.587143841,147,5.829365697,5.82790466,36309,55.88696744,73,68,141,189,180,369,4,0.458931,0.471542,0.000031,No
15193,christmas,245,9.599363952,155,5.782845682,5.781314541,37975,55.51164038,79,77,156,219,204,423,4,0.459062,0.47179,0.000028,No
6718,observation,59,11.01899473,51,6.887972651,6.887472536,3009,75.89853437,31,25,56,49,49,98,4,0.455469,0.467988,0.000078,No
12468,experiment,125,10.26821844,90,6.319988614,6.319098235,11250,64.89502363,33,51,84,110,116,226,4,0.468834,0.478865,0.000052,No
17179,austria,519,8.842703366,372,4.898219865,4.894493003,193068,43.31350528,82,126,208,415,413,828,4,0.466383,0.4784,0.000021,No
11148,grass,178,9.914748627,144,5.849984985,5.84855399,25632,58.00113059,56,65,121,144,141,285,4,0.468933,0.479208,0.000036,No
15201,christ,261,9.53201177,206,5.491922115,5.489870052,53766,52.34906624,39,67,106,248,228,476,4,0.469814,0.479912,0.000041,No
11660,fungi,117,10.33435824,82,6.413079037,6.412268725,9594,66.27505621,42,43,85,99,92,191,4,0.464844,0.475687,0.000051,No
5258,prison,318,9.334480795,226,5.399263285,5.397010795,71868,50.39931944,54,95,149,287,276,563,4,0.472465,0.482424,0.000029,No
4308,rob,69,10.86242567,62,6.692663899,6.692053725,4278,72.69856416,28,26,54,50,49,99,4,0.437518,0.453087,0.00008,No
7495,mode,118,10.32584755,75,6.502310171,6.501569912,8850,67.14186356,51,39,90,79,97,176,4,0.465112,0.475818,0.000048,No
1274,trophy,300,9.392749703,153,5.789360363,5.787839237,45900,54.37801283,38,60,98,203,237,440,4,0.454187,0.467636,0.000044,No
7445,monarchy,109,10.4051843,91,6.308938778,6.30803839,9919,65.64567069,25,49,74,82,98,180,4,0.468649,0.478696,0.000058,No
424,wheel,235,9.636946663,121,6.024007739,6.022807042,28435,58.05304128,53,57,110,174,201,375,4,0.468253,0.478546,0.000039,No
5743,pine,58,11.03608917,48,6.948597273,6.948127172,2784,76.68533909,30,22,52,48,35,83,4,0.423682,0.440642,0.000082,No
1325,tribute,71,10.8338523,62,6.692663899,6.692053725,4402,72.50733218,19,20,39,52,62,114,4,0.444208,0.458753,0.000109,No
7762,merchant,80,10.71450554,63,6.676663558,6.676043378,5040,71.5371487,33,31,64,63,58,121,4,0.426297,0.443261,0.000066,No
18096,affair,65,10.92214491,54,6.830814238,6.830284108,3510,74.60714294,15,23,38,57,58,115,4,0.439762,0.454946,0.000111,No
9169,kid,79,10.72708432,59,6.74226084,6.741680684,4661,72.32480057,28,40,68,66,64,130,4,0.445714,0.460336,0.000062,No
4748,rapid,105,10.44257183,76,6.489064944,6.488314678,7980,67.76252677,36,32,68,79,73,152,4,0.410665,0.42853,0.000062,No
3939,sauce,122,10.29251113,57,6.776747016,6.776186871,6954,69.74974411,41,45,86,100,94,194,4,0.45575,0.468617,0.000049,No
11712,frog,71,10.8338523,45,7.013135794,7.012695706,3195,75.97927736,23,31,54,67,57,124,4,0.460885,0.472368,0.000078,No
5158,prophet,116,10.34294199,94,6.276503502,6.275573088,10904,64.9175116,25,36,61,106,64,170,4,0.452682,0.465946,0.000069,No
4799,rail,541,8.803112899,381,4.876998909,4.873191747,206121,42.932772,70,98,168,494,436,930,4,0.464333,0.476316,0.000025,No
935,variable,111,10.38700198,72,6.543132165,6.542421927,7992,67.96352673,27,44,71,87,78,165,4,0.461377,0.473006,0.000059,No
16964,baptist,122,10.29251113,75,6.502310171,6.501569912,9150,66.92509982,44,27,71,104,82,186,4,0.400131,0.417897,0.000059,No
14287,crazy,108,10.41440095,77,6.475992862,6.475232589,8316,67.44358622,48,41,89,77,81,158,4,0.454583,0.467579,0.000047,No
1027,urdu,123,10.28434782,97,6.245087306,6.244126864,11931,64.22665003,35,38,73,115,102,217,4,0.449347,0.463284,0.000057,No
15147,cinema,80,10.71450554,72,6.543132165,6.542421927,5760,70.10642585,24,41,65,57,64,121,4,0.464358,0.475264,0.000064,No
2534,stockholm,94,10.5532374,75,6.502310171,6.501569912,7050,68.62042285,27,37,64,91,75,166,4,0.457701,0.469983,0.000065,No
14712,concrete,77,10.75272676,59,6.74226084,6.741680684,4543,72.49768853,31,35,66,61,61,122,4,0.454886,0.467706,0.000063,No
10834,hannibal,47,11.24638458,24,7.641744454,7.641514432,1128,85.94199696,31,23,54,34,32,66,4,0.442326,0.457143,0.000077,No
12259,federal,579,8.7352297,338,4.996752389,4.993376765,195702,43.64777987,83,90,173,477,305,782,4,0.420809,0.439299,0.000024,No
9505,jacob,106,10.43309308,80,6.43777165,6.436981353,8480,67.16587087,57,44,101,82,64,146,4,0.451656,0.465279,0.000041,No
17249,atom,246,9.591200641,128,5.96776802,5.966497239,31488,57.23806046,44,71,115,232,192,424,4,0.469243,0.47956,0.000036,No
333,wilhelm,147,10.10609959,115,6.074866156,6.073725528,16905,61.39320237,54,38,92,122,86,208,4,0.445971,0.4605,0.000045,No
17685,angry,144,10.12671888,136,5.907143398,5.905792513,19584,59.81998057,48,46,94,125,125,250,4,0.455902,0.468734,0.000044,No
7022,nervous,133,10.20618305,80,6.43777165,6.436981353,10640,65.70507588,25,14,39,123,125,248,4,0.435436,0.451031,0.000106,No
17404,armenia,396,9.112595897,191,5.562302912,5.560391124,75636,50.68701869,66,106,172,341,295,636,4,0.473878,0.483654,0.000024,No
1644,tiger,159,10.02762798,78,6.463089458,6.462319176,12402,64.80945665,38,58,96,118,107,225,4,0.466297,0.477072,0.000043,No
2841,spent,371,9.180330115,343,4.982067837,4.978642044,127253,45.7370274,81,48,129,333,338,671,4,0.456606,0.469302,0.000032,No
15040,client,129,10.23671977,78,6.463089458,6.462319176,10062,66.16083564,31,40,71,80,101,181,4,0.466665,0.477011,0.000058,No
13054,edgar,91,10.58567267,67,6.615105665,6.61444546,6097,70.02534325,36,35,71,71,77,148,4,0.458055,0.470236,0.000058,No
16559,biography,179,9.909146372,156,5.769942277,5.768391106,27924,57.17520258,57,64,121,95,160,255,4,0.458268,0.470936,0.000034,No
2053,tall,391,9.127824617,350,4.96186513,4.958369096,136850,45.29103468,56,96,152,314,332,646,4,0.467525,0.478734,0.000027,No
6188,passage,97,10.5218212,75,6.502310171,6.501569912,7275,68.416145,30,35,65,86,80,166,4,0.465893,0.476344,0.000063,No
12185,fiction,454,8.978434979,334,5.008657291,5.005321801,151636,44.96990382,57,121,178,425,354,779,4,0.468129,0.479626,0.000023,No
17291,asteroid,270,9.498110218,125,5.991484547,5.990243802,33750,56.9077806,56,68,124,237,212,449,4,0.468958,0.479273,0.000033,No
3663,self,70,10.84803694,59,6.74226084,6.741680684,4130,73.14029462,36,32,68,53,46,99,4,0.461965,0.473241,0.00006,No
2023,tank,86,10.64218488,54,6.830814238,6.830284108,4644,72.69478801,37,38,75,77,67,144,4,0.463545,0.474598,0.000054,No
11104,gregory,123,10.28434782,100,6.214628098,6.213637628,12300,63.91339695,30,26,56,107,92,199,4,0.438275,0.45374,0.000072,No
12030,fleet,251,9.571079238,163,5.726048083,5.724426802,40913,54.80445993,71,68,139,216,195,411,4,0.464418,0.475832,0.000029,No
18273,access,238,9.624261504,197,5.536594555,5.534632671,46886,53.28563384,82,52,134,183,212,395,4,0.461821,0.473527,0.00003,No
18032,aid,116,10.34294199,89,6.331161914,6.330281545,10324,65.48284039,39,43,82,112,95,207,4,0.46403,0.475058,0.000049,No
13409,doctrine,80,10.71450554,58,6.759355274,6.758785123,4640,72.42314954,28,22,50,69,67,136,4,0.455364,0.467866,0.00008,No
5774,piece,619,8.668426905,482,4.64185417,4.637032662,298358,40.23757358,104,56,160,588,583,1171,4,0.468908,0.479029,0.000025,No
8463,lose,168,9.972568198,153,5.789360363,5.787839237,25704,57.73479104,42,53,95,149,156,305,4,0.465283,0.476213,0.000042,No
3223,skeleton,83,10.67769157,64,6.660915201,6.660285015,5312,71.12319809,29,28,57,77,64,141,4,0.457889,0.469983,0.00007,No
8304,mad,74,10.79246708,63,6.676663558,6.676043378,4662,72.05767168,34,37,71,56,61,117,4,0.446465,0.460885,0.000056,No
12978,elder,129,10.23671977,110,6.119317918,6.118227346,14190,62.64174273,21,39,60,126,95,221,4,0.449643,0.463556,0.000066,No
5431,positive,217,9.716634824,162,5.732201949,5.730590684,35154,55.69771307,53,57,110,183,122,305,4,0.455212,0.468406,0.000036,No
15898,busy,71,10.8338523,70,6.571303042,6.570612818,4970,71.19252658,31,37,68,67,59,126,4,0.449017,0.462979,0.000058,No
6656,offensive,69,10.86242567,62,6.692663899,6.692053725,4278,72.69856416,33,35,68,56,54,110,4,0.447478,0.461678,0.000058,No
5398,potassium,71,10.8338523,37,7.208880372,7.208520314,2627,78.0999452,28,26,54,50,58,108,4,0.413603,0.431286,0.000073,No
158,write,624,8.660381809,504,4.597222016,4.592179424,314496,39.81369792,55,132,187,583,495,1078,4,0.476332,0.485954,0.000021,No
8453,lou,41,11.38296011,38,7.182212124,7.181842063,1558,81.75483412,24,12,36,27,20,47,5,0.330356,0.33472,0.000109,No
3431,shock,83,10.67769157,56,6.794446593,6.793896453,4648,72.54900511,38,36,74,77,69,146,4,0.462013,0.473358,0.000053,No
4750,rape,61,10.98565831,41,7.106226218,7.105826145,2501,78.06657312,31,22,53,53,56,109,4,0.458777,0.470551,0.000074,No
727,vision,107,10.42370334,96,6.255450093,6.25449966,10272,65.20495604,51,42,93,88,88,176,4,0.459418,0.471443,0.000042,No
9641,inventor,122,10.29251113,102,6.194825471,6.193814981,12444,63.76031012,32,32,64,101,103,204,4,0.451014,0.464533,0.000061,No
12127,finish,104,10.45214128,91,6.308938778,6.30803839,9464,65.94191942,27,39,66,91,89,180,4,0.460634,0.472377,0.000059,No
10760,hate,75,10.77904406,56,6.794446593,6.793896453,4200,73.23763922,37,35,72,62,62,124,4,0.452485,0.465777,0.000054,No
16440,bloom,42,11.35886256,23,7.684304068,7.684084048,966,87.28495377,26,32,58,35,38,73,4,0.456465,0.468908,0.000067,No
1839,testament,180,9.903575326,139,5.885324351,5.883943426,25020,58.28575303,11,57,68,180,156,336,4,0.471499,0.480978,0.000057,No
2923,southeast,445,8.998457895,404,4.818383406,4.814345345,179780,43.3580202,58,103,161,384,400,784,4,0.469206,0.4801,0.000024,No
10307,host,352,9.232901002,245,5.318540074,5.316097141,86240,49.10555397,67,101,168,318,290,608,4,0.470674,0.481203,0.000023,No
12476,expedition,102,10.47155936,83,6.400957676,6.400137356,8466,67.0280083,34,35,69,80,83,163,4,0.462929,0.474072,0.000056,No
17481,arabic,300,9.392749703,218,5.435303221,5.433130907,65400,51.05244272,70,73,143,247,218,465,4,0.459133,0.47179,0.000027,No
812,via,179,9.909146372,157,5.763552479,5.761991292,28103,57.11188513,91,52,143,105,109,214,4,0.439697,0.455556,0.000027,No
17726,ancestry,124,10.27625061,97,6.245087306,6.244126864,12028,64.17608225,44,38,82,100,99,199,4,0.467858,0.477879,0.000047,No
16780,beetle,31,11.66254497,12,8.334891634,8.334781631,372,97.20604853,17,19,36,29,21,50,4,0.412287,0.42998,0.000107,No
10334,horizontal,89,10.60789581,82,6.413079037,6.412268725,7298,68.02927423,36,26,62,81,43,124,4,0.439272,0.45458,0.000062,No
16875,bat,87,10.63062406,38,7.182212124,7.181842063,3306,76.35139701,31,30,61,77,63,140,4,0.459632,0.471382,0.000063,No
3340,sierra,120,10.30904043,65,6.645411014,6.644770822,7800,68.50781085,48,13,61,106,109,215,4,0.432951,0.448834,0.000063,No
9068,korea,391,9.127824617,229,5.386076281,5.383793723,89539,49.16315967,56,111,167,374,312,686,4,0.468809,0.479954,0.000023,No
11632,g,249,9.571079238,153,5.782845682,5.781314541,38097,55.34807424,60,68,128,156,172,328,4,0.470051,0.480081,0.00003,No
11887,forever,131,10.22133485,116,6.066208093,6.065057454,15196,62.00474421,66,62,128,91,105,196,4,0.466077,0.476983,0.00003,No
3264,singapore,186,9.870785504,100,6.214628098,6.213637628,18600,61.34326094,55,65,120,160,142,302,4,0.469082,0.479311,0.000032,No
13005,egyptian,223,9.689360406,150,5.80916299,5.807671909,33450,56.28707387,40,76,116,203,163,366,4,0.434796,0.451651,0.000033,No
13270,dramatic,83,10.67769157,76,6.489064944,6.488314678,6308,69.28823405,30,37,67,70,55,125,5,0.399923,0.417842,0.000057,No
16825,beast,43,11.33533206,33,7.323290723,7.322970678,1419,83.01193213,9,26,35,41,34,75,4,0.465832,0.476114,0.000109,No
15143,cinnamon,28,11.76432767,15,8.111748083,8.111608076,420,95.4292624,22,13,35,23,22,45,4,0.410789,0.428286,0.000109,No
11503,gay,141,10.14777229,96,6.255450093,6.25449966,13536,63.47888309,46,57,103,104,107,211,4,0.456994,0.469809,0.000037,No
13385,dollar,103,10.46180319,53,6.849506371,6.848986246,5459,71.65818759,26,43,69,74,84,158,4,0.446611,0.46111,0.000055,No
12975,eleanor,62,10.96939779,50,6.907775279,6.907285168,3100,75.77413489,34,14,48,47,49,96,5,0.384379,0.400948,0.000079,No
17575,anyone,212,9.739945903,196,5.541683625,5.53973176,41552,53.97569872,70,52,122,178,188,366,4,0.462507,0.474053,0.000031,No
17694,anger,41,11.38296011,30,7.418600903,7.418310866,1230,84.44563815,26,25,51,36,34,70,4,0.445546,0.459847,0.000074,No
13876,declaration,167,9.978538365,135,5.914523506,5.913182634,22545,59.01829971,35,18,53,121,161,282,4,0.455247,0.467683,0.000071,No
18017,airline,128,10.24450191,70,6.571303042,6.570612818,8960,67.31972659,32,35,67,89,104,193,4,0.451771,0.465223,0.000056,No
8787,lemma,26,11.83843564,3,9.721185996,9.721165996,78,115.0836347,11,12,23,12,12,24,4,0.417651,0.43483,0.000163,No
7841,meet,284,9.447557939,258,5.266838699,5.264265443,73272,49.75876377,67,89,156,205,262,467,4,0.472881,0.482607,0.000024,No
15736,candidate,150,10.08589688,115,6.074866156,6.073725528,17250,61.27047363,43,53,96,133,127,260,4,0.468933,0.478987,0.000039,No
12006,flood,98,10.5115647,76,6.489064944,6.488314678,7448,68.21022599,46,39,85,95,69,164,4,0.461173,0.472753,0.000044,No
2600,stefan,56,11.07118049,46,6.991156888,6.990706795,2576,77.40035971,23,10,33,28,10,38,4,0.423389,0.44014,0.000113,No
12303,fat,213,9.735240012,147,5.829365697,5.82790466,31311,56.75027418,66,83,149,173,181,354,4,0.470799,0.480945,0.000025,No
16748,belgium,332,9.288389687,261,5.25145378,5.248840421,86652,48.77754914,60,95,155,262,257,519,4,0.468006,0.479067,0.000024,No
6546,opinion,78,10.73982335,61,6.70892442,6.708324252,4758,72.05266314,30,32,62,60,62,122,4,0.451415,0.464861,0.00006,No
2759,spread,370,9.183029172,318,5.057746901,5.05457193,117660,46.44543734,77,66,143,310,334,644,4,0.468191,0.478658,0.000026,No
7406,monte,150,10.08589688,97,6.245087306,6.244126864,14550,62.98730659,41,18,59,121,43,164,4,0.404397,0.422211,0.000063,No
9434,jesse,74,10.79246708,45,7.013135794,7.012695706,3330,75.68903722,37,16,53,54,57,111,4,0.415724,0.433065,0.00007,No
15624,carmen,58,11.03608917,36,7.236279346,7.235929291,2088,79.8602241,33,24,57,46,39,85,4,0.44929,0.462941,0.000065,No
10256,hughes,63,10.95339745,45,7.013135794,7.012695706,2835,76.81766373,29,37,66,53,52,105,4,0.438231,0.453895,0.000056,No
14849,combat,118,10.32584755,93,6.287198791,6.286278386,10974,64.92065625,43,54,97,99,85,184,4,0.463691,0.474983,0.000038,No
11497,gear,67,10.89183956,32,7.354062381,7.35375234,2144,80.09926756,27,36,63,52,59,111,4,0.466175,0.476551,0.000058,No
46,z,64,10.73982335,44,6.969650683,6.969190586,2816,74.85281715,27,31,58,50,50,100,4,0.450316,0.463927,0.000063,No
17467,arch,61,10.98565831,46,6.991156888,6.990706795,2806,76.80246078,29,28,57,51,52,103,4,0.446735,0.460927,0.000064,No
9327,juice,93,10.56393268,56,6.794446593,6.793896453,5208,71.77607644,27,38,65,89,80,169,4,0.466358,0.476743,0.000056,No
11214,gospel,146,10.11292556,87,6.353890166,6.353029813,12702,64.25641823,39,26,65,125,120,245,4,0.449643,0.463293,0.000056,No
14820,commission,143,10.13368755,116,6.066208093,6.065057454,16588,61.47305741,49,49,98,102,113,215,4,0.468908,0.478889,0.000037,No
7099,navy,387,9.138107484,257,5.270722199,5.268158968,99459,48.16442598,49,102,151,319,290,609,4,0.473676,0.483456,0.000024,No
2646,start,845,8.35719555,766,4.178616114,4.170936857,647270,34.921512,94,87,181,727,743,1470,4,0.4717,0.481691,0.00002,No
13999,dangerous,246,9.591200641,218,5.435303221,5.433130907,53628,52.13108374,50,84,134,219,181,400,4,0.463025,0.475034,0.000027,No
7867,measure,369,9.185735533,280,5.185008681,5.182214838,103320,47.62811848,63,76,139,336,316,652,4,0.467279,0.478161,0.000026,No
13591,dictionary,147,10.10609959,127,5.975611198,5.974350429,18669,60.39012188,45,39,84,99,102,201,4,0.454932,0.467837,0.000043,No
11787,franz,142,10.14070512,114,6.083599836,6.08246922,16188,61.691992,67,19,86,105,81,186,5,0.403047,0.421142,0.000042,No
13903,debut,253,9.55919791,217,5.435303221,5.433130907,54901,51.9571392,45,50,95,202,233,435,4,0.468339,0.478461,0.000038,No
4399,ribbon,28,11.76432767,24,7.641744454,7.641514432,672,89.8999857,15,19,34,22,21,43,4,0.451576,0.464758,0.000106,No
9171,kick,58,11.03608917,32,7.354062381,7.35375234,1856,81.16008818,27,23,50,49,41,90,4,0.459133,0.470856,0.000072,No
1227,tuesday,102,10.47155936,81,6.42534913,6.424548825,8262,67.28342484,29,29,58,96,88,184,4,0.45822,0.47026,0.000062,No
5477,pool,91,10.58567267,50,6.907775279,6.907285168,4550,73.12344798,26,37,63,41,74,115,4,0.465563,0.476091,0.000057,No
16668,bermuda,84,10.66571538,42,7.082128666,7.08171859,3528,75.53596862,28,35,63,69,63,132,4,0.446577,0.460904,0.000057,No
2812,spiral,55,11.08919899,29,7.452502454,7.452222421,1595,82.6422827,23,29,52,49,43,92,4,0.451427,0.464805,0.000069,No
14173,crystal,158,10.03393714,91,6.308938778,6.30803839,14378,63.30349514,61,58,119,137,122,259,4,0.450808,0.464875,0.00003,No
1461,tract,38,11.45894602,34,7.29343776,7.293107712,1292,83.57510957,14,17,31,35,32,67,4,0.451335,0.464495,0.000115,No
8027,maryland,158,10.03393714,113,6.092410465,6.09128986,17854,61.13086367,42,66,108,145,130,275,4,0.462687,0.474447,0.000033,No
7704,methane,65,10.92214491,33,7.323290723,7.322970678,2145,79.98604247,23,31,54,54,58,112,4,0.448813,0.462692,0.000066,No
12138,financial,195,9.823532619,152,5.795917763,5.794406652,29640,56.9363872,65,43,108,167,99,266,4,0.424249,0.441557,0.000033,No
17441,argentina,285,9.444042997,215,5.449160256,5.447018006,61275,51.46210376,69,93,162,233,222,455,4,0.471524,0.481658,0.000022,No
17586,antonio,152,10.07265166,126,5.983516377,5.98226562,19152,60.26987615,55,26,81,130,71,201,4,0.42194,0.439102,0.000044,No
14598,constitution,357,9.218796396,251,5.294345345,5.291842265,89607,48.80749178,57,85,142,278,299,577,4,0.473158,0.482733,0.000025,No
2473,stream,167,9.978538365,104,6.175407385,6.174376875,17368,61.62153951,56,35,91,137,122,259,4,0.455551,0.468255,0.000039,No
16768,beginning,591,8.71471616,558,4.495439322,4.489853864,329778,39.1764777,113,64,177,528,574,1102,4,0.472139,0.481583,0.00002,No
7356,morris,54,11.10754813,37,7.208880372,7.208520314,1998,80.0729857,34,26,60,46,31,77,4,0.434988,0.450871,0.000059,No
7629,mild,75,10.77904406,66,6.630143542,6.629493344,4950,71.46660939,32,29,61,70,45,115,4,0.443476,0.458228,0.000058,No
6539,opposite,386,9.140694808,334,5.008657291,5.005321801,128924,45.7826077,59,72,131,356,324,680,4,0.469703,0.479903,0.000027,No
10877,hamilton,180,9.903575326,111,6.110268083,6.109167499,19980,60.51350022,74,57,131,145,125,270,4,0.4452,0.460209,0.000027,No
2253,surprise,61,10.98565831,45,7.013135794,7.012695706,2745,77.04391354,25,32,57,49,47,96,4,0.458789,0.470758,0.000062,No
9918,indigenous,115,10.35160005,88,6.34246147,6.341591108,10120,65.65462446,39,23,62,93,56,149,5,0.382087,0.398655,0.000057,No
3942,saturn,462,8.960967286,167,5.701804472,5.700143126,77154,51.09368334,63,84,147,381,331,712,4,0.463848,0.475654,0.000024,No
2498,straight,240,9.615893254,182,5.615791597,5.613979993,43680,54.00085253,77,70,147,203,184,387,4,0.455937,0.469227,0.000024,No
3315,silicon,69,10.86242567,38,7.182212124,7.181842063,2622,78.01624537,31,25,56,51,56,107,4,0.44651,0.460688,0.000063,No
1661,tibetan,141,10.14777229,78,6.463089458,6.462319176,10998,65.58596009,40,46,86,125,117,242,4,0.440865,0.456336,0.000041,No
14984,co,52,11.08919899,85,6.991156888,6.990706795,4420,77.52632991,22,29,51,36,40,76,4,0.444943,0.459462,0.000069,No
305,windsor,96,10.53218399,49,6.927977986,6.92749788,4704,72.9667388,45,45,90,84,87,171,4,0.441062,0.456486,0.000039,No
10086,ill,80,10.71450554,89,6.475992862,6.475232589,7120,69.38706142,30,35,65,61,70,131,4,0.45003,0.46381,0.000054,No
14802,companion,84,10.66571538,69,6.58569178,6.585011562,5796,70.24111409,27,27,54,68,77,145,4,0.463267,0.474166,0.000065,No
11738,friction,53,11.12624026,36,7.236279346,7.235929291,1908,80.51258262,28,26,54,48,47,95,4,0.453445,0.466406,0.000065,No
8203,mall,88,10.61919536,45,7.013135794,7.012695706,3960,74.47385911,16,34,50,50,75,125,4,0.463557,0.474508,0.00007,No
7069,neck,188,9.860090215,154,5.782845682,5.781314541,28952,57.01938012,41,68,109,166,166,332,4,0.470026,0.480081,0.000032,No
795,victor,96,10.53218399,75,6.502310171,6.501569912,7200,68.48352705,43,38,81,81,71,152,4,0.454071,0.467119,0.000043,No
272,witch,98,10.5115647,59,6.74226084,6.741680684,5782,70.87171104,24,36,60,89,63,152,4,0.449643,0.46349,0.000058,No
4346,riot,57,11.05348091,37,7.208880372,7.208520314,2109,79.68322157,25,33,58,40,48,88,4,0.445334,0.459843,0.00006,No
5607,plot,103,10.46180319,94,6.276503502,6.275573088,9682,65.66354435,28,32,60,89,85,174,4,0.466763,0.476945,0.000058,No
10771,harvey,56,11.07118049,42,7.082128666,7.08171859,2352,78.40752469,34,22,56,43,34,77,4,0.428861,0.445346,0.000062,No
10774,harvard,127,10.25234509,97,6.245087306,6.244126864,12319,64.02679018,36,27,63,114,52,166,4,0.411818,0.429567,0.000055,No
12354,fall,420,9.056277466,358,4.939265298,4.935688982,150360,44.73135702,97,76,173,361,391,752,4,0.46061,0.473034,0.00002,No
4075,sail,111,10.38700198,94,6.276503502,6.275573088,10434,65.19405428,28,36,64,74,103,177,4,0.465563,0.4761,0.000054,No
8970,lance,29,11.72923635,25,7.600922459,7.600682435,725,89.15301598,19,13,32,24,23,47,4,0.392443,0.409892,0.000108,No
312,win,427,9.039748164,361,4.930920326,4.927313903,154147,44.57427796,52,98,150,395,396,791,4,0.474144,0.483715,0.000023,No
12196,fever,125,10.26821844,89,6.331161914,6.330281545,11125,65.00975352,37,49,86,96,101,197,4,0.461412,0.473109,0.00004,No
11670,fun,168,9.972568198,153,5.789360363,5.787839237,25704,57.73479104,39,47,86,133,139,272,4,0.467451,0.477748,0.00004,No
676,volume,283,9.45108528,205,5.496788305,5.494746262,58015,51.95061504,84,97,181,234,235,469,4,0.4718,0.481926,0.000019,No
6748,oak,120,10.30904043,82,6.413079037,6.412268725,9840,66.1126911,50,38,88,107,89,196,4,0.442867,0.457894,0.000039,No
9038,kurt,82,10.68981293,72,6.543132165,6.542421927,5904,69.94485882,33,14,47,46,23,69,5,0.326389,0.330542,0.000073,No
13607,diary,76,10.76579884,51,6.887972651,6.887472536,3876,74.15452796,23,36,59,68,66,134,4,0.465307,0.475907,0.000058,No
2721,squid,71,10.8338523,40,7.13091883,7.130528762,2840,77.25532137,27,33,60,59,59,118,4,0.448518,0.46249,0.000057,No
9518,j,97,10.5115647,78,6.450350432,6.449570143,7566,67.80327589,48,47,95,69,70,139,4,0.460885,0.472664,0.000036,No
10418,holiday,180,9.903575326,125,5.991484547,5.990243802,22500,59.33711853,55,55,110,156,132,288,4,0.454781,0.468025,0.000031,No
9152,kind,1071,8.120184107,942,3.97179301,3.962338646,1008882,32.25169047,97,58,155,1039,1041,2080,4,0.467427,0.47794,0.000022,No
406,whether,341,9.2646497,293,5.139625675,5.136701462,99913,47.61683147,89,59,148,255,314,569,4,0.453445,0.467053,0.000023,No
13719,depth,112,10.37803331,89,6.331161914,6.330281545,9968,65.70500921,32,31,63,99,91,190,4,0.458789,0.470734,0.000054,No
8335,mac,174,9.937476878,111,6.110268083,6.109167499,19314,60.72064779,47,32,79,112,62,174,4,0.449051,0.462899,0.000043,No
1614,tiny,158,10.02762798,153,5.782845682,5.781314541,24174,57.98822513,52,54,106,146,64,210,4,0.414598,0.432854,0.000032,No
14071,cylinder,85,10.65388092,41,7.106226218,7.105826145,3485,75.70888792,32,32,64,70,62,132,4,0.459966,0.471687,0.000053,No
10682,heaven,197,9.813328449,140,5.878155862,5.876764922,27580,57.68427414,53,82,135,181,165,346,4,0.457559,0.470725,0.000025,No
14468,core,201,9.793227269,130,5.952263834,5.950973027,26130,58.29187249,67,68,135,159,150,309,4,0.466812,0.477654,0.000025,No
5306,presentation,63,10.95339745,46,6.991156888,6.990706795,2898,76.57692003,27,24,51,47,49,96,4,0.451427,0.464711,0.000066,No
15350,charlotte,158,10.03393714,90,6.319988614,6.319098235,14220,63.4143685,57,45,102,122,108,230,4,0.447568,0.461951,0.000033,No
2175,swiss,243,9.603470734,206,5.491922115,5.489870052,50058,52.74151331,49,67,116,217,167,384,5,0.4006,0.419058,0.000029,No
3950,satellite,219,9.707460448,153,5.789360363,5.787839237,33507,56.19998674,56,60,116,157,184,341,4,0.46317,0.474701,0.000029,No
5388,pottery,55,11.08919899,33,7.323290723,7.322970678,1815,81.2094281,29,29,58,39,42,81,4,0.456066,0.468556,0.000058,No
8994,laid,104,10.45214128,95,6.265921393,6.264980969,9880,65.49229563,29,30,59,84,96,180,4,0.444386,0.458988,0.000057,No
17616,anthem,177,9.920382445,91,6.308938778,6.30803839,16107,62.5870855,33,51,84,73,158,231,4,0.466947,0.477443,0.00004,No
4103,sacred,150,10.08589688,110,6.119317918,6.118227346,16500,61.71880952,52,60,112,137,111,248,4,0.454222,0.46764,0.00003,No
2448,stroke,71,10.8338523,49,6.927977986,6.92749788,3479,75.05669024,22,32,54,64,57,121,4,0.445904,0.460312,0.000062,No
4973,push,73,10.80607274,66,6.630143542,6.629493344,4818,71.64581337,25,37,62,67,68,135,4,0.458587,0.470711,0.000054,No
15138,circle,367,9.191170329,216,5.444519877,5.442367605,79272,50.04150955,57,82,139,308,324,632,4,0.472969,0.482546,0.000024,No
7822,melbourne,280,9.461742574,159,5.750894082,5.749312864,44520,54.41347938,57,88,145,239,250,489,4,0.465331,0.476898,0.000023,No
14855,columbus,223,9.689360406,153,5.789360363,5.787839237,34119,56.09519907,46,69,115,203,142,345,4,0.463642,0.475231,0.000029,No
3047,soccer,254,9.55919791,184,5.604862527,5.603030887,46736,53.57799015,41,60,101,184,196,380,4,0.456617,0.469565,0.000033,No
8750,leslie,42,11.35886256,34,7.29343776,7.293107712,1428,82.84515709,29,20,49,39,25,64,5,0.358853,0.371178,0.000068,No
15229,chocolate,205,9.773522198,81,6.42534913,6.424548825,16605,62.79829235,60,68,128,168,168,336,4,0.463485,0.475086,0.000026,No
10302,hotel,170,9.96073374,117,6.057624349,6.056463699,19890,60.33838324,63,65,128,132,143,275,4,0.470637,0.480494,0.000026,No
5174,proof,117,10.33435824,72,6.543132165,6.542421927,8424,67.61907182,50,35,85,95,110,205,4,0.455762,0.468438,0.000039,No
1447,tragedy,60,11.00218762,50,6.907775279,6.907285168,3000,76.00063962,24,35,59,53,56,109,4,0.463207,0.47426,0.000056,No
5046,puck,62,10.96939779,24,7.641744454,7.641514432,1488,83.82533474,28,31,59,54,51,105,4,0.461689,0.472992,0.000056,No
8834,least,608,8.686357295,568,4.477676865,4.471990844,345344,38.89470111,17,115,132,605,445,1050,4,0.472202,0.482597,0.000025,No
5628,plaza,80,10.71450554,39,7.156236638,7.155856573,3120,76.67553712,30,30,60,68,69,137,4,0.440155,0.455425,0.000055,No
18002,ajax,49,11.20471188,21,7.775275846,7.77507583,1029,87.11972564,30,25,55,37,40,77,4,0.452531,0.465603,0.00006,No
1186,turn,363,9.202129343,327,5.029838113,5.026572853,118701,46.28522089,64,100,164,316,313,629,4,0.473613,0.483344,0.00002,No
17887,allow,314,9.347139191,289,5.153371596,5.150487499,90746,48.16928161,40,86,126,248,238,486,4,0.459181,0.472067,0.000026,No
17315,assault,57,11.05348091,39,7.156236638,7.155856573,2223,79.10132506,20,26,46,47,47,94,4,0.462856,0.473804,0.000071,No
9903,indonesia,213,9.735240012,142,5.863971227,5.86256026,30246,57.08716731,55,81,136,177,180,357,4,0.466898,0.477945,0.000024,No
15342,chase,92,10.5747436,65,6.645411014,6.644770822,5980,70.2735176,42,51,93,60,83,143,4,0.45783,0.470344,0.000035,No
10296,hour,257,9.547456092,193,5.557108095,5.555186288,49601,53.05624554,41,84,125,244,204,448,4,0.471374,0.4814,0.000026,No
15464,cemetery,69,10.86242567,58,6.759355274,6.758785123,4002,73.42299426,23,33,56,48,58,106,4,0.447106,0.461359,0.000058,No
7533,missile,63,10.95339745,36,7.236279346,7.235929291,2268,79.26184374,25,30,55,46,48,94,4,0.459692,0.471434,0.000059,No
4800,raid,62,10.96939779,49,6.927977986,6.92749788,3038,75.99574643,26,29,55,50,56,106,4,0.449871,0.463523,0.000059,No
1501,torsion,21,12.05200974,7,8.873888135,8.873828135,147,106.9481862,13,14,27,14,17,31,4,0.431929,0.447951,0.00012,No
5427,possession,63,10.95339745,58,6.759355274,6.758785123,3654,74.03790482,28,14,42,51,56,107,4,0.450624,0.463866,0.000077,No
15301,cherry,63,10.95339745,41,7.106226218,7.105826145,2583,77.83732014,36,25,61,56,38,94,4,0.434775,0.450669,0.000053,No
14835,command,178,9.914748627,147,5.829365697,5.82790466,26166,57.79669555,53,48,101,150,147,297,4,0.464759,0.475706,0.000032,No
10988,gum,79,10.72708432,28,7.487593774,7.487323743,2212,80.3200498,33,42,75,57,63,120,4,0.465295,0.475987,0.000043,No
16746,belief,224,9.684886125,176,5.649314289,5.647562791,39424,54.71296558,62,42,104,206,208,414,4,0.461616,0.473161,0.000031,No
10592,hercules,117,10.33435824,32,7.354062381,7.35375234,3744,75.99951519,53,34,87,82,90,172,4,0.466003,0.476405,0.000037,No
905,vehicle,207,9.763813384,155,5.776373167,5.774832011,32085,56.39942964,59,75,134,182,165,347,4,0.470126,0.480297,0.000024,No
14318,crack,39,11.43297053,24,7.641744454,7.641514432,936,87.36783915,28,20,48,35,35,70,4,0.440559,0.455575,0.000067,No
15098,clan,66,10.90687744,43,7.058598169,7.058178089,2838,76.98726509,21,30,51,43,48,91,4,0.462242,0.473433,0.000063,No
2935,soul,213,9.735240012,149,5.815851978,5.814370912,31737,56.61871488,69,77,146,184,171,355,4,0.466972,0.477954,0.000022,No
9185,keyboard,173,9.943240583,126,5.983516377,5.98226562,21798,59.49554287,36,61,97,132,125,257,4,0.467575,0.478109,0.000033,No
10743,haven,71,10.8338523,39,7.156236638,7.155856573,2769,77.52961076,18,40,58,68,67,135,4,0.446836,0.461232,0.000055,Yes
16284,boss,64,10.93764909,48,6.948597273,6.948127172,3072,76.00131867,25,30,55,51,49,100,4,0.462567,0.473687,0.000058,No
8957,landscape,67,10.89183956,60,6.725453722,6.72486356,4020,73.25256289,26,29,55,57,51,108,4,0.448269,0.462209,0.000058,No
6039,penalty,98,10.5115647,62,6.692663899,6.692053725,6076,70.35036958,18,41,59,93,78,171,4,0.455317,0.468176,0.000054,No
14152,cult,96,10.53218399,72,6.543132165,6.542421927,6912,68.91347181,26,33,59,77,70,147,4,0.428003,0.444839,0.000054,No
8425,lucas,69,10.86242567,47,6.969650683,6.969190586,3243,75.7073125,24,30,54,54,54,108,4,0.433533,0.44966,0.000059,No
17573,anything,331,9.294413802,311,5.080005372,5.076900619,102941,47.21567204,93,84,177,287,263,550,4,0.471286,0.48133,0.000018,No
12562,everyone,269,9.501820798,226,5.399263285,5.397010795,60794,51.30283217,78,60,138,231,214,445,4,0.450339,0.464486,0.000023,No
14252,crime,318,9.334480795,233,5.368759831,5.366437182,74094,50.11458553,58,93,151,251,261,512,4,0.471261,0.48148,0.000021,No
10413,hollow,80,10.71450554,70,6.571303042,6.570612818,5600,70.40826287,23,43,66,72,64,136,4,0.442845,0.457955,0.000048,No
775,vii,235,9.636946663,189,5.578051269,5.576169537,44415,53.75538257,32,67,99,207,194,401,4,0.468908,0.479222,0.000032,No
15414,chain,276,9.476131312,202,5.511530587,5.509518604,55752,52.22798757,70,74,144,236,209,445,4,0.470711,0.48071,0.000022,No
12655,estate,129,10.23671977,110,6.119317918,6.118227346,14190,62.64174273,31,50,81,107,98,205,4,0.463678,0.474908,0.000039,No
6455,oscar,113,10.36914436,97,6.245087306,6.244126864,10961,64.75621181,45,32,77,88,44,132,4,0.437842,0.453463,0.000041,No
17213,audio,201,9.793227269,132,5.936996362,5.935685529,26532,58.14235467,75,62,137,143,109,252,4,0.451484,0.465462,0.000023,No
7075,nebula,85,10.65388092,43,7.058598169,7.058178089,3655,75.20146436,23,27,50,76,68,144,4,0.457182,0.469387,0.000063,No
15248,chip,70,10.84803694,42,7.082128666,7.08171859,2940,76.82719335,31,33,64,56,57,113,4,0.458291,0.470387,0.000049,No
6835,norway,340,9.26758656,257,5.270722199,5.268158968,87380,48.84687421,58,107,165,304,281,585,4,0.470662,0.481287,0.000019,No
9854,infinite,71,10.84803694,52,6.887972651,6.887472536,3692,74.72098173,31,24,55,66,33,99,4,0.435106,0.450979,0.000057,No
17282,astronomer,148,10.0993199,123,6.007613929,6.006393208,18204,60.67281492,32,60,92,121,130,251,4,0.451002,0.465058,0.000034,No
9024,laboratory,141,10.14777229,118,6.04911366,6.047942998,16638,61.38502796,35,49,84,101,107,208,4,0.466972,0.477429,0.000037,No
12342,fame,319,9.331341075,244,5.322630059,5.32019715,77836,49.66727649,31,84,115,297,283,580,4,0.472516,0.482236,0.000027,No
8557,lizard,54,11.10754813,36,7.236279346,7.235929291,1944,80.37732112,19,26,45,37,50,87,4,0.457041,0.469241,0.000069,No
354,width,93,10.56393268,78,6.463089458,6.462319176,7254,68.27564196,31,32,63,79,88,167,4,0.464941,0.475551,0.000049,No
10529,hey,34,11.57017165,28,7.487593774,7.487323743,952,86.63274523,25,21,46,28,32,60,5,0.397274,0.414805,0.000067,No
14200,cruel,44,11.31234254,41,7.106226218,7.105826145,1804,80.38806516,26,20,46,40,30,70,4,0.404075,0.421756,0.000067,No
14366,countryside,76,10.76579884,71,6.557118407,6.556418176,5396,70.59261772,20,36,56,69,68,137,4,0.463134,0.474236,0.000055,No
17826,am,258,9.543572592,205,5.496788305,5.494746262,52890,52.45899821,38,72,110,200,185,385,4,0.460849,0.473152,0.000028,Yes
14274,creed,84,10.66571538,27,7.523961418,7.52370139,2268,80.24843101,21,34,55,37,67,104,4,0.467427,0.477471,0.000056,No
18149,adobe,78,10.73982335,31,7.38581108,7.385511041,2418,79.3223063,33,11,44,49,35,84,5,0.381414,0.397609,0.00007,No
481,weekend,71,10.8338523,61,6.70892442,6.708324252,4331,72.68349626,26,31,57,60,60,120,4,0.444843,0.459387,0.000054,No
17261,athens,198,9.808265147,118,6.04911366,6.047942998,23364,59.33131068,57,71,128,175,172,347,4,0.469665,0.479856,0.000024,No
12926,elliott,48,11.22533117,35,7.264450223,7.264110172,1680,81.54585949,27,21,48,41,33,74,4,0.444175,0.458655,0.000064,No
11596,galileo,59,11.01899473,41,7.106226218,7.105826145,2419,78.30346927,35,17,52,50,23,73,5,0.405209,0.422833,0.000059,No
9685,interpretation,53,11.12624026,52,6.868554566,6.868044446,2756,76.42118836,32,19,51,47,52,99,4,0.450808,0.464115,0.00006,No
10658,height,352,9.232901002,294,5.136218517,5.133284275,103488,47.42219709,71,68,139,308,327,635,4,0.470175,0.480198,0.000022,No
17841,altitude,161,10.01512781,129,5.95998588,5.958705086,20769,59.69002035,20,30,50,146,149,295,4,0.45319,0.46627,0.000061,No
10454,historic,269,9.501820798,232,5.373060913,5.370748287,62408,51.05386193,52,75,127,231,148,379,5,0.416495,0.43494,0.000024,No
3424,shop,141,10.14777229,103,6.185069296,6.184048796,14523,62.76467479,42,53,95,118,104,222,4,0.467648,0.478015,0.000032,No
11182,grain,133,10.20618305,78,6.463089458,6.462319176,10374,65.96347407,47,51,98,109,108,217,4,0.469703,0.479499,0.000031,No
4846,r,288,9.42320891,198,5.521480918,5.519488975,57024,52.03006818,80,58,138,198,260,458,4,0.459704,0.471955,0.000022,No
4092,safe,182,9.89252549,162,5.732201949,5.730590684,29484,56.7059539,61,65,126,153,159,312,4,0.468092,0.478555,0.000024,No
1794,theme,217,9.716634824,161,5.738393919,5.73679267,34937,55.75787819,66,42,108,169,181,350,4,0.467464,0.477673,0.000028,No
4140,rush,117,10.33435824,77,6.475992862,6.475232589,9009,66.92523022,36,50,86,109,85,194,4,0.45428,0.467532,0.000035,No
13880,decision,141,10.14777229,107,6.14696945,6.145908909,15087,62.37804623,40,46,86,127,122,249,4,0.465551,0.476274,0.000035,No
11275,goddess,329,9.300474427,206,5.491922115,5.489870052,67774,51.07748119,66,54,120,309,266,575,4,0.469429,0.479363,0.000025,No
6499,oregon,164,9.99666575,104,6.175407385,6.174376875,17056,61.7334835,44,63,107,150,146,296,4,0.459644,0.471997,0.000028,No
1549,tone,95,10.54265529,52,6.868554566,6.868044446,4940,72.4128031,37,34,71,86,79,165,4,0.466126,0.476476,0.000042,No
12443,express,181,9.898035146,133,5.929449156,5.92812831,24073,58.68989614,44,62,106,89,127,216,4,0.467858,0.478335,0.000028,No
16793,bee,77,10.75272676,49,6.927977986,6.92749788,3773,74.49465425,23,30,53,63,47,110,4,0.42964,0.446219,0.000056,No
2951,soprano,56,11.07118049,39,7.156236638,7.155856573,2184,79.22798743,23,30,53,34,43,77,4,0.444776,0.459354,0.000056,No
14698,conductor,297,9.402800039,146,5.836191663,5.834740639,43362,54.87654319,50,79,129,265,270,535,4,0.471161,0.481147,0.000023,No
6288,papal,74,10.79246708,66,6.630143542,6.629493344,4884,71.55560594,22,22,44,64,41,105,5,0.338688,0.345416,0.000067,No
120,yankee,29,11.72923635,16,8.047209562,8.047059554,464,94.38762289,17,11,28,25,24,49,4,0.412449,0.429966,0.000105,No
16274,bottle,67,10.89183956,43,7.058598169,7.058178089,2881,76.88111876,22,26,48,60,49,109,4,0.451094,0.464476,0.000061,No
608,wallace,83,10.67769157,61,6.70892442,6.708324252,5063,71.63582572,35,33,68,63,59,122,4,0.446375,0.460725,0.000043,No
15752,campus,132,10.21373025,90,6.319988614,6.319098235,11880,64.55065892,38,43,81,102,106,208,4,0.465075,0.475865,0.000036,No
5082,prussia,193,9.833841988,137,5.899817358,5.89845646,26441,58.01787166,39,69,108,181,155,336,4,0.460921,0.473138,0.000027,No
9831,infrared,53,11.12624026,34,7.29343776,7.293107712,1802,81.14854086,26,25,51,38,34,72,4,0.446196,0.460439,0.000057,No
6961,nicholas,142,10.14070512,112,6.101299413,6.100188819,15904,61.87147819,53,35,88,120,105,225,4,0.451909,0.465326,0.000033,No
1881,tennis,278,9.468911064,133,5.929449156,5.92812831,36974,56.14542671,68,64,132,175,132,307,4,0.459537,0.471941,0.000022,No
2916,southwest,915,8.277608112,876,4.044432193,4.035643864,801540,33.47822473,50,88,138,855,865,1720,4,0.469939,0.480381,0.000021,No
7206,mustard,50,11.18450917,18,7.929426526,7.929256515,900,88.68674371,26,20,46,37,36,73,4,0.449985,0.463448,0.000063,No
9100,knight,170,9.96073374,104,6.175407385,6.174376875,17680,61.5115887,41,52,93,139,144,283,4,0.467846,0.478142,0.000031,No
279,wisdom,70,10.84803694,55,6.812465099,6.811924964,3850,73.90187301,29,35,64,60,58,118,4,0.465783,0.47626,0.000045,No
6241,parent,138,10.16927849,107,6.14696945,6.145908909,14766,62.51024422,36,54,90,123,118,241,4,0.466775,0.477372,0.000032,No
7319,motor,250,9.575071259,185,5.599442459,5.597600801,46250,53.61506056,61,54,115,208,159,367,4,0.461713,0.473457,0.000025,No
10117,ideal,57,11.05348091,47,6.969650683,6.969190586,2679,77.03890077,18,29,47,53,49,102,4,0.419051,0.436534,0.000061,No
6522,oracle,43,11.33533206,28,7.487593774,7.487323743,1204,84.87436177,12,15,27,37,33,70,5,0.389541,0.406547,0.000106,No
11163,granite,48,11.22533117,41,7.106226218,7.105826145,1968,79.76974264,26,27,53,40,40,80,4,0.449951,0.463556,0.000054,No
9643,invention,86,10.64218488,72,6.543132165,6.542421927,6192,69.6332222,27,26,53,81,81,162,4,0.447151,0.461246,0.000054,No
16080,broke,221,9.698369476,206,5.491922115,5.489870052,45526,53.26268981,72,34,106,174,214,388,4,0.448881,0.462819,0.000027,No
7113,nato,53,11.10754813,40,7.106226218,7.105826145,2120,78.93274974,23,27,50,43,39,82,4,0.437346,0.452946,0.000057,No
32,zero,239,9.620068625,135,5.914523506,5.913182634,32265,56.89812201,66,92,158,192,198,390,4,0.473057,0.482794,0.000018,No
10257,hugh,79,10.72708432,69,6.58569178,6.585011562,5451,70.64527106,43,36,79,60,46,106,4,0.427107,0.444158,0.000036,No
1604,titanic,55,11.08919899,29,7.452502454,7.452222421,1595,82.6422827,20,29,49,37,44,81,4,0.438502,0.453965,0.000058,No
4348,rio,168,9.972568198,114,6.083599836,6.08246922,19152,60.66911425,44,22,66,128,109,237,4,0.444898,0.459284,0.000043,No
5008,punk,295,9.409556821,197,5.536594555,5.534632671,58115,52.09690106,67,51,118,189,250,439,4,0.450179,0.464209,0.000024,No
17251,atmospheric,87,10.63062406,67,6.615105665,6.61444546,5829,70.32270143,40,19,59,78,54,132,5,0.349257,0.359067,0.000048,No
4089,safety,182,9.89252549,147,5.829365697,5.82790466,26754,57.66714875,65,58,123,148,117,265,4,0.467132,0.47771,0.000023,No
12614,eugene,74,10.79246708,56,6.794446593,6.793896453,4144,73.32884122,42,27,69,63,35,98,4,0.415063,0.43267,0.000041,No
6385,p,102,10.47155936,69,6.58569178,6.585011562,7038,68.96246242,50,44,94,81,89,170,4,0.456935,0.469509,0.00003,No
3981,sap,52,11.14528846,31,7.38581108,7.385511041,1612,82.31699499,24,20,44,48,43,91,4,0.451576,0.464767,0.000064,No
17767,amp,67,10.89183956,63,6.676663558,6.676043378,4221,72.72114825,32,35,67,43,50,93,4,0.416974,0.434745,0.000042,No
8010,massacre,139,10.16205824,103,6.185069296,6.184048796,14317,62.85303443,38,59,97,87,111,198,4,0.458576,0.471096,0.000029,No
15356,charity,99,10.50141233,80,6.43777165,6.436981353,7920,67.60569456,43,54,97,83,80,163,4,0.462796,0.474307,0.000029,No
17690,angles,105,10.44257183,65,6.645411014,6.644770822,6825,69.39518184,32,42,74,91,92,183,4,0.466763,0.477137,0.000038,No
2850,speech,269,9.501820798,209,5.477464032,5.475381908,56221,52.04588166,71,77,148,238,226,464,4,0.471249,0.48117,0.000019,No
10773,harvest,40,11.40765272,34,7.29343776,7.293107712,1360,83.20100512,28,25,53,38,34,72,4,0.434679,0.450576,0.000053,No
6820,nothing,192,9.839036805,182,5.615791597,5.613979993,34944,55.25398022,65,52,117,147,171,318,4,0.456254,0.469133,0.000024,No
6376,pack,62,10.96939779,48,6.948597273,6.948127172,2976,76.22192759,22,29,51,53,45,98,4,0.463376,0.474293,0.000055,No
6921,nine,417,9.063445956,361,4.930920326,4.927313903,150537,44.69112988,100,87,187,356,183,539,4,0.456958,0.470358,0.000015,No
7512,mixture,176,9.926048182,148,5.82258601,5.821114958,26048,57.79526929,22,28,50,169,169,338,4,0.448393,0.462312,0.000056,No
13995,danish,196,9.818417518,141,5.871038394,5.869637441,27636,57.64430622,44,83,127,157,125,282,4,0.429848,0.447383,0.000022,No
4331,ritual,52,11.14528846,41,7.106226218,7.105826145,2132,79.20094105,19,30,49,45,39,84,4,0.462302,0.473466,0.000057,No
15226,choir,181,9.898035146,96,6.255450093,6.25449966,17376,61.91666487,40,63,103,168,154,322,4,0.469491,0.479602,0.000027,No
5288,prey,185,9.876176352,125,5.991484547,5.990243802,23125,59.172958,53,58,111,150,147,297,4,0.469194,0.479273,0.000025,No
14460,corn,95,10.54265529,67,6.615105665,6.61444546,6365,69.7407787,31,44,75,64,63,127,4,0.448665,0.462828,0.000037,No
16199,brandon,43,11.33533206,28,7.487593774,7.487323743,1204,84.87436177,22,20,42,37,35,72,4,0.429058,0.445496,0.000066,No
17659,annie,39,11.43297053,29,7.452502454,7.452222421,1131,85.20424094,23,19,42,26,27,53,4,0.435255,0.450975,0.000066,No
13037,edmund,105,10.44257183,84,6.388981485,6.388151157,8820,66.71739806,51,33,84,84,69,153,4,0.421069,0.438435,0.000033,No
12495,exist,342,9.26172144,312,5.076795096,5.073680313,106704,47.01986199,49,83,132,248,307,555,4,0.471011,0.4811,0.000021,No
8086,marine,241,9.611735244,180,5.626841433,5.625049865,43380,54.08371012,63,69,132,181,140,321,4,0.417258,0.435548,0.000021,No
3018,solar,469,8.945929409,245,5.318540074,5.316097141,114905,47.57928406,93,33,126,397,386,783,5,0.389841,0.407129,0.000022,No
15887,butterfly,49,11.20471188,41,7.106226218,7.105826145,2009,79.62321732,23,23,46,42,37,79,4,0.444364,0.458852,0.00006,No
1248,trust,139,10.16205824,94,6.276503502,6.275573088,13066,63.78219416,61,54,115,114,117,231,4,0.464735,0.475781,0.000024,No
3526,shall,50,11.18450917,41,7.106226218,7.105826145,2050,79.47965231,25,26,51,41,45,86,4,0.395213,0.412737,0.000054,No
8083,marion,50,11.18450917,36,7.236279346,7.235929291,1800,80.93423271,27,24,51,43,40,83,4,0.395424,0.412944,0.000054,No
15311,chef,51,11.16470654,29,7.452502454,7.452222421,1479,83.20500292,23,27,50,43,39,82,4,0.449415,0.463143,0.000055,No
13602,dice,52,11.14528846,26,7.561701746,7.56145172,1352,84.2773472,31,19,50,42,41,83,4,0.459549,0.471128,0.000055,No
2886,sparta,58,11.03608917,35,7.264450223,7.264110172,2030,80.17112041,21,28,49,49,47,96,4,0.458635,0.470556,0.000056,No
14436,corps,120,10.30904043,82,6.413079037,6.412268725,9840,66.1126911,35,48,83,99,89,188,4,0.467759,0.477997,0.000033,No
8462,loss,147,10.10609959,132,5.936996362,5.935685529,19404,59.9998765,49,34,83,131,134,265,4,0.466052,0.476433,0.000033,No
9090,know,711,8.529859748,614,4.399803356,4.393654614,436554,37.52970554,58,103,161,667,668,1335,4,0.475656,0.484912,0.000017,No
5971,perennial,50,11.18450917,44,7.03560865,7.035178566,2200,78.68982948,13,13,26,44,24,68,5,0.373989,0.389252,0.000105,No
14455,cornell,126,10.26025027,50,6.907775279,6.907285168,6300,70.87550317,49,42,91,102,75,177,4,0.445669,0.460293,0.00003,No
247,wolf,130,10.22899773,90,6.319988614,6.319098235,11700,64.64714917,45,56,101,101,101,202,4,0.463448,0.474856,0.000027,No
17340,ash,108,10.41440095,69,6.58569178,6.585011562,7452,68.58603473,50,44,94,98,82,180,4,0.459739,0.471729,0.000029,No
1150,twice,261,9.53201177,247,5.310409948,5.307946966,64467,50.61889012,98,62,160,170,241,411,4,0.465197,0.476302,0.000017,No
5981,perception,57,11.05348091,42,7.082128666,7.08171859,2394,78.28217401,18,28,46,44,52,96,4,0.453514,0.466481,0.000059,No
6193,pascal,56,11.07118049,26,7.561701746,7.56145172,1456,83.71696482,24,22,46,39,41,80,4,0.433692,0.449651,0.000059,No
7046,neil,81,10.70208302,65,6.645411014,6.644770822,5265,71.1197404,43,20,63,54,49,103,5,0.385615,0.402284,0.000043,No
1145,twin,208,9.758994098,165,5.71385281,5.712211497,34320,55.76145585,74,30,104,175,83,258,4,0.453769,0.466767,0.000026,No
12470,expensive,194,9.828674018,176,5.649314289,5.647562791,34144,55.52526858,36,64,100,188,143,331,4,0.467279,0.477926,0.000027,No
13919,debate,90,10.59672251,70,6.571303042,6.570612818,6300,69.63427485,32,39,71,79,78,157,4,0.463364,0.474438,0.000038,No
1417,transfer,116,10.34294199,93,6.287198791,6.286278386,10788,65.02813235,34,53,87,99,102,201,4,0.463303,0.474696,0.000031,No
4694,rebellion,160,10.02135836,146,5.836191663,5.834740639,23360,58.48656812,43,44,87,108,133,241,4,0.457476,0.469959,0.000031,No
907,vegetable,93,10.56393268,80,6.43777165,6.436981353,7440,68.00818634,40,37,77,82,65,147,4,0.449279,0.463209,0.000035,No
3717,sebastian,90,10.59672251,73,6.529338843,6.528618598,6570,69.18959187,26,23,49,80,69,149,4,0.416984,0.434431,0.000055,No
1817,texture,42,11.35886256,36,7.236279346,7.235929291,1512,82.19590253,22,17,39,38,34,72,4,0.443343,0.457885,0.000069,No
5394,potential,178,9.914748627,112,6.101299413,6.100188819,19936,60.49284998,48,48,96,122,139,261,4,0.465918,0.476593,0.000028,No
10139,ibm,49,11.20471188,30,7.418600903,7.418310866,1470,83.12328566,25,23,48,42,31,73,4,0.435319,0.45113,0.000056,No
3307,silly,35,11.54118412,26,7.561701746,7.56145172,910,87.27099208,29,19,48,32,28,60,4,0.433723,0.449632,0.000056,No
180,wound,47,11.24638458,28,7.487593774,7.487323743,1316,84.20835913,23,21,44,43,33,76,4,0.445949,0.460138,0.000061,No
320,willie,55,11.08919899,36,7.236279346,7.235929291,1980,80.24454163,27,20,47,33,43,76,4,0.429411,0.445815,0.000057,No
13823,deity,50,11.18450917,40,7.13091883,7.130528762,2000,79.75582706,23,20,43,46,32,78,4,0.447388,0.461345,0.000062,No
5769,pierre,132,10.21373025,100,6.214628098,6.213637628,13200,63.47453503,50,36,86,89,67,156,4,0.44845,0.462476,0.000031,No
4921,quality,237,9.628472036,199,5.526493459,5.524511536,47163,53.21168773,58,75,133,197,195,392,4,0.468698,0.479231,0.00002,No
7430,monkey,74,10.79246708,46,6.991156888,6.990706795,3404,75.45183059,36,34,70,65,56,121,4,0.445859,0.460326,0.000038,No
11002,guinea,227,9.67158216,138,5.892544599,5.891173687,31326,56.99022922,30,72,102,219,190,409,4,0.456347,0.469579,0.000026,No
18158,admiral,84,10.66571538,75,6.502310171,6.501569912,6300,69.35178958,31,37,68,71,58,129,4,0.443764,0.458664,0.000039,No
13760,den,44,11.31234254,40,7.13091883,7.130528762,1760,80.66739646,20,14,34,28,24,52,4,0.437745,0.453186,0.000078,No
17367,arthritis,24,11.91847835,8,8.740356743,8.740286741,192,104.1717526,10,15,25,15,21,36,4,0.435116,0.45074,0.000106,No
16042,brunswick,62,10.96939779,37,7.208880372,7.208520314,2294,79.07707643,15,34,49,58,54,112,4,0.456888,0.469293,0.000054,No
10446,hitler,203,9.783326198,127,5.975611198,5.974350429,25781,58.46135358,54,72,126,97,153,250,4,0.462543,0.474438,0.000021,No
17129,avoid,137,10.17655125,127,5.975611198,5.974350429,17399,60.81111361,15,40,55,129,85,214,4,0.432066,0.448773,0.000048,No
4369,rifle,54,11.10754813,28,7.487593774,7.487323743,1512,83.16880823,19,29,48,42,43,85,4,0.460897,0.472377,0.000055,No
11030,guam,47,11.24638458,26,7.561701746,7.56145172,1222,85.04180588,24,24,48,40,36,76,4,0.441249,0.456251,0.000055,No
10736,hawk,67,10.89183956,39,7.156236638,7.155856573,2613,77.9445813,29,26,55,63,56,119,4,0.451714,0.46496,0.000048,No
16034,bryan,99,10.50141233,73,6.529338843,6.528618598,7227,68.56727942,39,21,60,70,31,101,5,0.389328,0.406387,0.000044,No
13013,egg,171,9.954868621,107,6.14696945,6.145908909,18297,61.19227329,39,52,91,127,125,252,4,0.467021,0.477513,0.000029,No
3541,shadow,137,10.17655125,80,6.43777165,6.436981353,10960,65.51431314,38,35,73,109,114,223,4,0.458848,0.470865,0.000036,No
439,westminster,149,10.09258587,109,6.128450402,6.12736984,16241,61.85191194,30,41,71,143,141,284,4,0.443664,0.458608,0.000037,No
5648,platinum,94,10.5532374,66,6.630143542,6.629493344,6204,69.96947876,36,35,71,72,68,140,4,0.456242,0.468762,0.000037,No
5010,punjab,405,9.09264511,277,5.195780778,5.193017018,112185,47.24339069,43,58,101,369,360,729,4,0.468241,0.478551,0.000026,No
4255,ronnie,28,11.76432767,22,7.728755831,7.728545813,616,90.92361605,19,16,35,20,22,42,4,0.425643,0.442322,0.000075,No
3260,singular,75,10.77904406,64,6.660915201,6.660285015,4800,71.79829846,19,22,41,37,38,75,4,0.422391,0.439525,0.000064,No
7650,midnight,70,10.84803694,55,6.812465099,6.811924964,3850,73.90187301,26,31,57,59,63,122,4,0.456089,0.468607,0.000046,No
7986,mathematician,217,9.716634824,188,5.583356321,5.581484608,40796,54.25143447,42,67,109,183,171,354,4,0.455645,0.468931,0.000024,No
13613,diamond,98,10.5115647,74,6.515733191,6.515002939,7252,68.490551,43,47,90,85,73,158,4,0.455282,0.468251,0.000029,No
4798,railroad,108,10.41440095,82,6.413079037,6.412268725,8856,66.78837642,48,42,90,98,76,174,4,0.461377,0.472983,0.000029,No
7392,mood,41,11.38296011,33,7.323290723,7.322970678,1353,83.36072618,22,20,42,35,29,64,4,0.449905,0.463411,0.000062,No
10265,hudson,151,10.07925234,91,6.308938778,6.30803839,13741,63.58938594,51,42,93,138,122,260,4,0.439425,0.455026,0.000028,No
17587,anton,83,10.67769157,56,6.794446593,6.793896453,4648,72.54900511,39,23,62,69,36,105,4,0.399968,0.417624,0.000042,No
10115,identify,99,10.50141233,83,6.400957676,6.400137356,8217,67.21909585,19,30,49,91,94,185,4,0.456946,0.469246,0.000053,No
17728,ancestor,94,10.5532374,76,6.489064944,6.488314678,7144,68.48064283,25,34,59,85,86,171,4,0.455504,0.468213,0.000044,No
16613,beyond,143,10.13368755,134,5.921958484,5.920627626,19162,60.01127695,61,47,108,99,125,224,4,0.433989,0.450416,0.000024,No
3636,senior,135,10.1912574,126,5.983516377,5.98226562,17010,60.97955555,37,59,96,111,91,202,4,0.429338,0.446505,0.000027,No
17483,arab,204,9.778412184,145,5.843064542,5.841623533,29580,57.1358935,45,51,96,132,99,231,4,0.428396,0.445496,0.000027,No
5585,plymouth,138,10.16927849,56,6.794446593,6.793896453,7728,69.09461961,56,40,96,119,104,223,4,0.439088,0.454674,0.000027,No
16134,brick,61,10.98565831,43,7.058598169,7.058178089,2623,77.54334765,18,29,47,56,40,96,4,0.457147,0.469391,0.000055,No
9872,infantry,53,11.12624026,39,7.156236638,7.155856573,2067,79.62200822,25,22,47,43,37,80,4,0.460049,0.47157,0.000055,No
9376,jon,83,10.67769157,66,6.630143542,6.629493344,5478,70.79462781,32,23,55,54,35,89,4,0.396051,0.413526,0.000047,No
8127,manuel,77,10.75272676,66,6.630143542,6.629493344,5082,71.29212186,35,12,47,53,27,80,4,0.437432,0.452744,0.000055,No
14983,coach,223,9.689360406,149,5.815851978,5.814370912,33227,56.35188588,63,73,136,198,194,392,4,0.470811,0.480738,0.000019,No
12166,fifth,330,9.297439523,311,5.080005372,5.076900619,102630,47.23104272,43,109,152,302,236,538,4,0.454455,0.468776,0.000017,No
12845,empress,119,10.31740868,93,6.287198791,6.286278386,11067,64.86759941,39,37,76,81,86,167,4,0.455972,0.468621,0.000034,No
5114,protestant,232,9.649794806,183,5.610312131,5.60849051,42456,54.13836086,65,58,123,215,111,326,4,0.447151,0.461866,0.000021,No
9319,julie,37,11.48561426,34,7.29343776,7.293107712,1258,83.76961277,24,17,41,34,19,53,5,0.388076,0.404932,0.000063,No
307,window,110,10.39605181,85,6.377147028,6.376306692,9350,66.29715091,47,39,86,99,74,173,4,0.453086,0.46634,0.00003,No
813,vi,302,9.38610516,249,5.302345388,5.299862357,75198,49.7683714,51,61,112,270,233,503,4,0.46549,0.476522,0.000023,No
12841,en,78,10.73982335,62,6.692663899,6.692053725,4836,71.87802802,28,18,46,28,23,51,4,0.391207,0.408644,0.000056,No
15346,chart,273,9.487060382,187,5.588689667,5.586827973,51051,53.02023633,50,67,117,160,221,381,4,0.462507,0.474316,0.000022,No
1365,travis,31,11.66254497,25,7.600922459,7.600682435,775,88.64610002,23,17,40,28,22,50,4,0.435202,0.45089,0.000064,No
3423,shore,168,9.972568198,149,5.815851978,5.814370912,25032,57.99898048,39,43,82,164,147,311,4,0.457052,0.469607,0.000031,No
16598,bid,47,11.24638458,31,7.38581108,7.385511041,1457,83.06367181,21,22,43,40,44,84,4,0.443586,0.458237,0.000059,No
6982,newman,37,11.48561426,26,7.561701746,7.56145172,962,86.85078944,22,21,43,29,25,54,4,0.409708,0.427342,0.000059,No
4770,ran,275,9.47976108,247,5.310409948,5.307946966,67925,50.34141754,64,51,115,233,255,488,4,0.46235,0.473917,0.000022,No
9750,inspiration,51,11.16470654,38,7.182212124,7.181842063,1938,80.18729071,29,17,46,45,42,87,4,0.447331,0.461237,0.000055,No
13090,easy,361,9.207654219,331,5.017679909,5.014374518,119491,46.20106158,74,59,133,331,316,647,4,0.463327,0.4748,0.000019,No
10959,guy,102,10.47155936,89,6.331161914,6.330281545,9078,66.29713783,47,40,87,84,59,143,4,0.458398,0.470603,0.000029,No
15650,cardinal,119,10.31740868,76,6.489064944,6.488314678,9044,66.95033501,49,38,87,105,60,165,4,0.431898,0.448393,0.000029,No
13663,detroit,245,9.595273967,178,5.638014734,5.636243201,43610,54.098296,46,51,97,201,202,403,4,0.46454,0.475607,0.000026,No
8049,marshall,127,10.25234509,85,6.377147028,6.376306692,10795,65.38071202,51,46,97,108,79,187,4,0.437066,0.453054,0.000026,No
6740,oath,70,10.84803694,47,6.969650683,6.969190586,3290,75.60702803,16,29,45,69,68,137,4,0.465149,0.475645,0.000056,No
6260,parallel,181,9.898035146,126,5.983516377,5.98226562,22806,59.2250554,52,53,105,150,114,264,4,0.463739,0.475025,0.000024,No
13328,dorothy,38,11.45894602,30,7.418600903,7.418310866,1140,85.00934727,21,21,42,25,24,49,4,0.439501,0.454697,0.00006,No
6233,parish,145,10.11979843,89,6.331161914,6.330281545,12905,64.07008243,43,41,84,122,127,249,4,0.452612,0.466011,0.00003,No
598,walt,203,9.783326198,117,6.057624349,6.056463699,23751,59.263715,38,4,42,189,201,390,5,0.325575,0.329067,0.00006,No
3187,slang,128,10.24450191,94,6.276503502,6.275573088,12032,64.29965214,41,31,72,105,99,204,4,0.459454,0.471246,0.000035,No
15065,claw,28,11.76432767,16,8.047209562,8.047059554,448,94.67001009,17,17,34,24,23,47,4,0.454094,0.466725,0.000074,No
10197,hybrid,58,11.03608917,43,7.058598169,7.058178089,2494,77.89931878,24,20,44,48,37,85,4,0.422251,0.439435,0.000057,No
5162,proper,145,10.11292556,124,5.991484547,5.990243802,17980,60.59143719,49,65,114,124,85,209,4,0.441227,0.457002,0.000022,No
872,venus,144,10.12671888,77,6.475992862,6.475232589,11088,65.58055917,48,52,100,118,108,226,4,0.467205,0.477649,0.000025,No
14499,cool,122,10.29251113,108,6.137667057,6.136596506,13176,63.17200651,40,56,96,94,95,189,4,0.457099,0.469866,0.000026,No
13857,dee,44,11.31234254,29,7.452502454,7.452222421,1276,84.30526057,22,21,43,40,33,73,4,0.412066,0.429689,0.000058,No
11516,gaul,56,11.07118049,45,7.013135794,7.012695706,2520,77.64369216,19,28,47,45,47,92,4,0.448077,0.462035,0.000053,No
1278,troll,42,11.35886256,13,8.254848927,8.254728922,546,93.7656944,22,25,47,31,33,64,4,0.45207,0.465218,0.000053,No
853,vermont,76,10.76579884,52,6.868554566,6.868044446,3952,73.94547675,37,46,83,74,65,139,4,0.454606,0.467711,0.00003,No
9133,kirby,87,10.63062406,24,7.641744454,7.641514432,2088,81.23651244,47,45,92,66,68,134,4,0.452543,0.466007,0.000027,No
6992,newark,44,11.31234254,32,7.354062381,7.35375234,1408,83.19167274,19,21,40,38,43,81,4,0.405292,0.423009,0.000062,No
12229,ferdinand,198,9.808265147,146,5.836191663,5.834740639,28908,57.24291527,75,49,124,165,144,309,4,0.461881,0.473504,0.00002,No
2830,spice,82,10.68981293,44,7.03560865,7.035178566,3608,75.20934032,27,40,67,70,55,125,4,0.461077,0.472706,0.000037,No
7522,mit,54,11.10754813,32,7.354062381,7.35375234,1728,81.68560186,17,25,42,45,30,75,4,0.451071,0.464434,0.000059,No
2245,survival,67,10.89183956,55,6.812465099,6.811924964,3685,74.20027685,36,23,59,60,58,118,4,0.439283,0.454542,0.000042,No
3156,slide,94,10.5532374,41,7.106226218,7.105826145,3854,74.99369226,37,38,75,75,80,155,4,0.456148,0.46879,0.000033,No
12360,faith,208,9.763813384,174,5.66650669,5.664785243,36192,55.32671386,61,69,130,178,175,353,4,0.468772,0.47917,0.000019,No
17084,babylon,61,10.98565831,39,7.156236638,7.155856573,2379,78.61597051,14,30,44,51,49,100,4,0.439621,0.454965,0.000056,No
18052,aggressive,43,11.33533206,41,7.106226218,7.105826145,1763,80.55143388,20,24,44,36,31,67,4,0.458374,0.470307,0.000056,No
8982,lamb,35,11.54118412,24,7.641744454,7.641514432,840,88.19477971,23,21,44,30,31,61,4,0.411036,0.42868,0.000056,No
14020,dam,183,9.887046025,87,6.353890166,6.353029813,15921,62.8212045,33,49,82,116,152,268,4,0.466444,0.477034,0.00003,No
14879,collision,48,11.22533117,31,7.38581108,7.385511041,1488,82.9081753,20,21,41,46,34,80,4,0.453259,0.466152,0.00006,No
11333,glen,65,10.92214491,45,7.013135794,7.012695706,2925,76.5984854,27,23,50,48,41,89,4,0.436175,0.451918,0.000049,No
6764,nut,51,11.16470654,27,7.523961418,7.52370139,1377,84.00282129,27,22,49,42,42,84,4,0.456347,0.46864,0.00005,No
17007,ballet,105,10.44257183,68,6.600290579,6.599620368,7140,68.92400845,37,42,79,81,73,154,4,0.464917,0.475706,0.000031,No
8648,limestone,95,10.54265529,77,6.475992862,6.475232589,7315,68.27416038,33,41,74,80,72,152,4,0.463981,0.474987,0.000033,No
5816,photography,74,10.79246708,51,6.887972651,6.887472536,3774,74.33821812,30,31,61,65,60,125,4,0.456817,0.46918,0.00004,No
17380,arrow,65,10.92214491,48,6.948597273,6.948127172,3120,75.89358632,14,32,46,58,51,109,4,0.443941,0.458683,0.000053,No
18038,agriculture,209,9.754197925,181,5.621301253,5.619499667,37829,54.83128502,41,65,106,172,154,326,4,0.465637,0.476687,0.000023,No
9840,influenza,56,11.07118049,26,7.561701746,7.56145172,1456,83.71696482,29,24,53,47,45,92,4,0.44954,0.463148,0.000046,No
2444,stronghold,39,11.43297053,35,7.264450223,7.264110172,1365,83.05424532,22,20,42,32,36,68,4,0.443941,0.458434,0.000058,No
15233,chlorine,40,11.40765272,29,7.452502454,7.452222421,1160,85.01555992,22,20,42,36,32,68,4,0.439207,0.454453,0.000058,No
12244,fellow,84,10.66571538,82,6.413079037,6.412268725,6888,68.40007571,16,29,45,73,49,122,5,0.400835,0.418711,0.000054,No
11571,gamma,63,10.95339745,38,7.182212124,7.181842063,2394,78.66962398,31,14,45,41,23,64,5,0.356245,0.367847,0.000054,No
7173,mystic,45,11.28986969,36,7.236279346,7.235929291,1620,81.69665084,18,26,44,33,33,66,4,0.439784,0.45504,0.000055,No
4479,result,506,8.869995508,457,4.695114893,4.690544556,231242,41.64564801,48,62,110,481,473,954,4,0.467095,0.477748,0.000022,No
4214,rouge,56,11.07118049,39,7.156236638,7.155856573,2184,79.22798743,5,34,39,25,46,71,4,0.455096,0.467861,0.000062,No
8452,loud,116,10.34294199,100,6.214628098,6.213637628,11600,64.27753789,26,52,78,101,88,189,4,0.453607,0.466997,0.000031,No
14582,consumption,31,11.66254497,28,7.487593774,7.487323743,868,87.32439913,22,13,35,29,24,53,4,0.449575,0.462997,0.000069,No
2247,survey,84,10.66571538,63,6.676663558,6.676043378,5292,71.21139319,30,37,67,58,68,126,4,0.462965,0.474124,0.000036,No
4643,reef,60,11.00218762,35,7.264450223,7.264110172,2100,79.92484427,11,32,43,53,47,100,4,0.46276,0.473856,0.000056,No
1942,technique,156,10.04667617,126,5.983516377,5.98226562,19656,60.1144514,34,49,83,108,118,226,4,0.467883,0.478114,0.000029,No
9226,keith,60,11.00218762,48,6.948597273,6.948127172,2880,76.44977086,33,32,65,44,39,83,5,0.364302,0.37802,0.000037,No
9101,knife,80,10.71450554,67,6.615105665,6.61444546,5360,70.87758631,21,39,60,77,71,148,4,0.467784,0.477846,0.00004,No
2067,taiwan,263,9.524378145,126,5.983516377,5.98226562,33138,56.98927261,58,82,140,225,212,437,4,0.465637,0.477011,0.000017,No
1133,tyler,85,10.65388092,40,7.13091883,7.130528762,3400,75.97196007,31,41,72,69,63,132,4,0.458991,0.471072,0.000033,No
6871,non,27,11.80069531,25,7.600922459,7.600682435,675,89.69617003,16,17,33,25,18,43,5,0.341503,0.349326,0.000072,No
5892,pete,82,10.68981293,64,6.660915201,6.660285015,5248,71.20393744,39,27,66,54,43,97,4,0.444999,0.459439,0.000036,No
16165,breast,63,10.95339745,41,7.106226218,7.105826145,2583,77.83732014,27,17,44,50,52,102,4,0.442746,0.45735,0.000054,No
15402,chamber,200,9.798214811,160,5.744624469,5.743033235,32000,56.28706455,67,41,108,145,178,323,4,0.466677,0.477044,0.000022,No
17925,ali,226,9.658452868,158,5.750894082,5.749312864,35708,55.54473944,40,55,95,67,126,193,4,0.455026,0.46818,0.000025,No
2621,stay,315,9.343959539,290,5.149917361,5.147023235,91350,48.12061945,53,72,125,286,281,567,4,0.468451,0.478973,0.000019,No
4983,purpose,245,9.595273967,232,5.373060913,5.370748287,56840,51.5559915,43,52,95,207,224,431,4,0.468253,0.478443,0.000025,No
6255,paramount,65,10.92214491,48,6.948597273,6.948127172,3120,75.89358632,22,21,43,46,28,74,4,0.428882,0.445346,0.000055,No
13556,dignity,33,11.60002462,18,7.929426526,7.929256515,594,91.9815429,22,21,43,27,27,54,4,0.44204,0.456848,0.000055,No
718,vital,56,11.07118049,50,6.907775279,6.907285168,2800,76.47722687,24,19,43,51,36,87,4,0.43821,0.453552,0.000055,No
12823,enemy,215,9.725894149,178,5.638014734,5.636243201,38270,54.83473451,56,62,118,193,149,342,4,0.466211,0.47709,0.00002,No
4307,robbery,48,11.22533117,32,7.354062381,7.35375234,1536,82.55178565,20,20,40,34,40,74,4,0.449529,0.463105,0.000059,No
17026,balance,125,10.26821844,94,6.276503502,6.275573088,11750,64.448509,44,50,94,100,113,213,4,0.464382,0.475452,0.000025,No
5920,persia,125,10.26821844,104,6.175407385,6.174376875,13000,63.41043199,32,49,81,111,93,204,4,0.465441,0.476245,0.000029,No
9552,islamic,314,9.347139191,225,5.403697882,5.401455414,70650,50.50911625,56,74,130,263,186,449,5,0.398971,0.417509,0.000018,No
2145,symmetry,30,11.6953348,23,7.684304068,7.684084048,690,89.87050875,15,15,30,23,24,47,4,0.455493,0.4678,0.000078,No
8656,lily,64,10.93764909,42,7.082128666,7.08171859,2688,77.46183819,26,31,57,40,45,85,4,0.457594,0.469805,0.000041,No
17865,alone,225,9.680431775,209,5.477464032,5.475381908,47025,53.02421686,95,84,179,163,187,350,4,0.467046,0.478128,0.000013,No
18269,accident,177,9.920382445,143,5.856953654,5.855532673,25311,58.10322021,37,56,93,151,151,302,4,0.462362,0.473997,0.000025,No
5629,playwright,57,11.05348091,54,6.830814238,6.830284108,3078,75.50427477,19,24,43,47,42,89,4,0.429838,0.446271,0.000054,No
7521,mitchell,72,10.81986606,52,6.868554566,6.868044446,3744,74.31684041,41,39,80,56,59,115,4,0.438697,0.454331,0.000029,No
5750,pilot,185,9.876176352,115,6.074866156,6.073725528,21275,59.99644947,63,59,122,150,133,283,4,0.465637,0.476593,0.000019,No
9539,issue,165,9.990586703,147,5.829365697,5.82790466,24255,58.23878343,66,56,122,140,145,285,4,0.466849,0.477461,0.000019,No
9304,junior,172,9.949037701,135,5.914523506,5.913182634,23220,58.84381734,66,56,122,154,117,271,4,0.447546,0.462134,0.000019,No
3895,scandal,51,11.16470654,40,7.13091883,7.130528762,2040,79.61461613,17,25,42,37,38,75,4,0.444053,0.458627,0.000055,No
9369,jose,77,10.75272676,56,6.794446593,6.793896453,4312,73.05882767,19,23,42,69,45,114,4,0.428903,0.445397,0.000055,No
15917,burrow,46,11.26789078,22,7.728755831,7.728545813,1012,87.08677657,22,20,42,39,36,75,4,0.446813,0.46089,0.000055,No
15310,chelsea,81,10.70208302,47,6.969650683,6.969190586,3807,74.58978024,27,37,64,65,64,129,4,0.449392,0.463303,0.000036,No
14281,creature,80,10.71450554,66,6.630143542,6.629493344,5280,71.03870973,28,36,64,59,64,123,4,0.458339,0.470495,0.000036,No
9456,jeffrey,29,11.72923635,27,7.523961418,7.52370139,783,88.25032174,23,13,36,23,17,40,5,0.337677,0.345058,0.000064,No
2550,sting,36,11.51301324,27,7.523961418,7.52370139,972,86.62346742,20,19,39,29,28,57,4,0.445882,0.46004,0.000059,No
725,visit,227,9.67158216,208,5.482260205,5.480188101,47216,53.02212999,40,75,115,183,206,389,4,0.46471,0.476175,0.00002,No
12432,extent,66,10.90687744,65,6.645411014,6.644770822,4290,72.48068344,19,27,46,48,60,108,4,0.451369,0.464744,0.00005,No
3817,scientist,183,9.887046025,169,5.689899569,5.68821819,30927,56.25629892,54,67,121,142,132,274,4,0.46223,0.474119,0.000019,No
6791,nu,41,11.38296011,23,7.684304068,7.684084048,943,87.47012669,23,18,41,28,32,60,4,0.445445,0.459683,0.000056,No
10332,hormone,51,11.16470654,33,7.323290723,7.322970678,1683,81.76239186,17,20,37,41,26,67,4,0.447151,0.46111,0.000062,No
12134,fine,157,10.04028637,135,5.914523506,5.913182634,21195,59.38350975,42,67,109,135,105,240,4,0.463691,0.47525,0.000021,No
7027,neptune,181,9.898035146,78,6.463089458,6.462319176,14118,63.9718866,50,70,120,143,150,293,4,0.453584,0.467326,0.000019,No
10789,harp,40,11.40765272,30,7.418600903,7.418310866,1200,84.62882279,17,23,40,36,36,72,4,0.457901,0.469894,0.000057,No
12981,elastic,45,11.28986969,23,7.684304068,7.684084048,1035,86.75479157,18,20,38,37,34,71,4,0.405709,0.423403,0.00006,No
16043,bruno,40,11.40765272,28,7.487593774,7.487323743,1120,85.41586951,20,20,40,21,27,48,4,0.436378,0.451965,0.000057,No
6810,noun,97,10.5218212,62,6.692663899,6.692053725,6014,70.41901289,25,42,67,95,78,173,4,0.458055,0.470368,0.000034,No
16655,berry,61,10.98565831,45,7.013135794,7.012695706,2745,77.04391354,35,34,69,57,48,105,4,0.45442,0.467321,0.000033,No
17410,arm,127,10.25234509,98,6.234830806,6.233860354,12446,63.921637,40,51,91,106,113,219,4,0.466886,0.477386,0.000025,No
3510,share,306,9.372947075,256,5.27462084,5.272067634,78336,49.43874197,75,67,142,250,265,515,4,0.46739,0.478076,0.000016,No
1003,useful,266,9.513035869,242,5.330860558,5.328447698,64372,50.7126677,51,75,126,230,225,455,4,0.467759,0.478513,0.000018,No
3711,secondary,198,9.808265147,150,5.80916299,5.807671909,29700,56.97781089,66,42,108,171,116,287,4,0.414133,0.432084,0.000021,No
6501,ore,59,11.01899473,53,6.969650683,6.969190586,3127,76.79854416,17,22,39,52,39,91,4,0.448926,0.462659,0.000058,No
7369,morgan,96,10.53218399,58,6.759355274,6.758785123,5568,71.19077337,51,36,87,83,77,160,4,0.46158,0.473002,0.000026,No
2315,sunday,203,9.783326198,166,5.707810496,5.706159166,33698,55.84137196,50,69,119,181,154,335,4,0.468475,0.478926,0.000019,No
9491,jake,48,11.22533117,42,7.082128666,7.08171859,2016,79.49923964,27,21,48,35,26,61,4,0.430265,0.44659,0.000047,No
14063,cyrillic,139,10.16205824,84,6.388981485,6.388151157,11676,64.92520198,22,33,55,108,92,200,4,0.452589,0.465805,0.000041,No
5834,phoebe,38,11.45894602,23,7.684304068,7.684084048,874,88.0540255,18,23,41,29,30,59,4,0.451599,0.464828,0.000055,No
7359,morphine,33,11.60002462,22,7.728755831,7.728545813,726,89.65375789,20,21,41,27,28,55,4,0.434467,0.450327,0.000055,No
10421,hold,437,9.016598982,389,4.856218941,4.852331472,169993,43.78657876,52,109,161,373,369,742,4,0.472717,0.48287,0.000014,No
7503,mobile,252,9.56710309,159,5.750894082,5.749312864,40068,55.01939654,74,51,125,204,158,362,4,0.456465,0.469265,0.000018,No
5110,proton,45,11.28986969,27,7.523961418,7.52370139,1215,84.94454395,9,24,33,44,40,84,4,0.4563,0.46865,0.000068,No
17937,algebra,88,10.61919536,51,6.887972651,6.887472536,4488,73.14472724,25,41,66,74,72,146,4,0.468686,0.478565,0.000034,No
13716,derby,145,10.11979843,77,6.475992862,6.475232589,11165,65.53574243,58,60,118,107,108,215,4,0.456958,0.469847,0.000019,No
16813,beauty,188,9.860090215,162,5.732201949,5.730590684,30456,56.52002834,54,58,112,148,157,305,4,0.455469,0.468626,0.00002,No
6834,norwegian,156,10.04667617,109,6.128450402,6.12736984,17004,61.57055661,42,82,124,131,117,248,4,0.44126,0.45735,0.000018,No
12080,fix,56,11.07118049,52,6.868554566,6.868044446,2912,76.04300728,18,24,42,55,45,100,4,0.442978,0.457702,0.000053,No
12241,felt,148,10.0993199,126,5.983516377,5.98226562,18648,60.42944604,57,49,106,130,131,261,4,0.469057,0.478982,0.000021,No
18188,add,204,9.778412184,169,5.689899569,5.68821819,34476,55.63818327,49,68,117,173,162,335,4,0.467538,0.478194,0.000019,No
2877,speak,477,8.929015686,394,4.843447375,4.839509711,187938,43.24721759,65,93,158,413,406,819,4,0.469479,0.480151,0.000014,No
7464,molecule,121,10.30074163,89,6.331161914,6.330281545,10769,65.21566311,33,46,79,106,106,212,4,0.467562,0.477813,0.000028,No
7431,monk,101,10.48141166,82,6.413079037,6.412268725,8282,67.2181214,30,37,67,87,74,161,4,0.454606,0.467537,0.000033,No
4388,richmond,112,10.37803331,76,6.489064944,6.488314678,8512,67.34373211,45,40,85,99,99,198,4,0.442657,0.457744,0.000026,No
12310,farther,134,10.19869238,124,5.999516719,5.998285986,16616,61.18722543,50,35,85,107,123,230,4,0.437572,0.453289,0.000026,No
634,wagner,123,10.28434782,76,6.489064944,6.488314678,9348,66.73580092,44,52,96,105,100,205,4,0.459739,0.471889,0.000023,No
16367,bolivia,108,10.4051843,72,6.529338843,6.528618598,7776,67.93897399,34,42,76,89,87,176,4,0.443964,0.458885,0.000029,No
14246,crisis,96,10.53218399,76,6.489064944,6.488314678,7296,68.34402589,37,39,76,83,82,165,4,0.464978,0.475696,0.000029,No
10564,heroin,37,11.48561426,28,7.487593774,7.487323743,1036,85.99961386,18,18,36,28,30,58,4,0.42757,0.444182,0.000061,No
5943,permanent,199,9.803227353,169,5.689899569,5.68821819,33631,55.77937909,51,78,129,171,115,286,4,0.432909,0.450008,0.000017,No
13774,democrat,53,11.12624026,46,6.991156888,6.990706795,2438,77.78529125,14,25,39,48,42,90,4,0.411455,0.429173,0.000056,No
16265,boulevard,38,11.45894602,22,7.728755831,7.728545813,836,88.56339585,19,20,39,32,37,69,4,0.449313,0.462932,0.000056,No
8278,magenta,34,11.57017165,18,7.929426526,7.929256515,612,91.74482602,19,20,39,27,31,58,4,0.43795,0.453303,0.000056,No
17818,ambassador,75,10.77904406,56,6.794446593,6.793896453,4200,73.23763922,30,26,56,61,66,127,4,0.465649,0.475978,0.000039,No
2060,tale,90,10.59672251,75,6.502310171,6.501569912,6750,68.90317653,13,24,37,80,75,155,4,0.448167,0.462035,0.000059,No
14606,conspiracy,44,11.31234254,37,7.208880372,7.208520314,1628,81.54932412,18,19,37,36,34,70,4,0.460861,0.472156,0.000059,No
11965,flute,81,10.70208302,46,6.991156888,6.990706795,3726,74.81994144,30,36,66,77,66,143,4,0.449108,0.463044,0.000033,No
8588,lit,70,10.84803694,55,6.812465099,6.811924964,3850,73.90187301,30,34,64,49,59,108,4,0.42496,0.442036,0.000034,No
6198,partition,65,10.92214491,47,6.969650683,6.969190586,3055,76.12353471,17,24,41,58,54,112,4,0.443686,0.458308,0.000053,No
37,zealand,432,9.028106589,302,5.109371267,5.106356788,130464,46.1279484,9,146,155,429,357,786,4,0.471161,0.4824,0.000014,No
14403,cost,227,9.67158216,188,5.583356321,5.581484608,42676,53.99988939,57,57,114,179,207,386,4,0.46907,0.479156,0.000019,No
17725,anchor,35,11.54118412,29,7.452502454,7.452222421,1015,86.01070295,20,20,40,29,26,55,4,0.451921,0.465049,0.000054,No
4133,rust,32,11.63079627,23,7.684304068,7.684084048,736,89.37457513,21,19,40,26,28,54,4,0.41589,0.4333,0.000054,No
10938,habitat,116,10.34294199,102,6.194825471,6.193814981,11832,64.07272046,48,42,90,102,87,189,4,0.464321,0.475222,0.000024,No
1589,toby,20,12.1007999,11,8.421903011,8.421803008,220,101.9117632,14,10,24,17,19,36,4,0.423046,0.43982,0.00009,No
3934,saul,29,11.72923635,16,8.047209562,8.047059554,464,94.38762289,21,18,39,24,22,46,4,0.44558,0.459796,0.000055,No
12450,explosive,65,10.92214491,48,6.948597273,6.948127172,3120,75.89358632,27,28,55,53,36,89,4,0.41268,0.430417,0.000039,No
5289,previous,260,9.535850546,231,5.377380574,5.375077971,60060,51.27789748,41,93,134,234,159,393,4,0.427241,0.445299,0.000016,No
13263,draw,98,10.5115647,83,6.400957676,6.400137356,8134,67.28408075,27,40,67,83,66,149,4,0.454932,0.467823,0.000032,No
787,vienna,282,9.454625106,182,5.615791597,5.613979993,51324,53.09520423,38,81,119,257,241,498,4,0.467661,0.478541,0.000018,No
15585,cartoon,208,9.758994098,122,6.015777239,6.014566531,25376,58.70793457,69,50,119,178,175,353,4,0.456195,0.469053,0.000018,No
11653,fur,189,9.854785162,138,5.892544599,5.891173687,26082,58.06976108,53,49,102,163,164,327,4,0.467267,0.477644,0.000021,No
6955,nickname,230,9.658452868,210,5.472690753,5.470598608,48300,52.85772571,36,61,97,209,204,413,4,0.458339,0.470969,0.000022,No
14869,colonial,160,10.02135836,135,5.914523506,5.913182634,21600,59.27155959,45,52,97,144,91,235,4,0.431793,0.448538,0.000022,No
16250,bow,157,10.04028637,87,6.353890166,6.353029813,13659,63.79487684,45,52,97,138,138,276,4,0.467784,0.478095,0.000022,No
1302,trio,103,10.46180319,55,6.812465099,6.811924964,5665,71.2706691,33,49,82,93,87,180,4,0.467846,0.478067,0.000026,No
2331,sulphur,19,12.1520932,16,8.047209562,8.047059554,304,97.79044058,16,12,28,17,16,33,4,0.4069,0.424413,0.000076,No
1007,usage,119,10.31740868,111,6.110268083,6.109167499,13209,63.04213298,50,35,85,93,97,190,4,0.460395,0.472067,0.000025,No
14471,cord,65,10.92214491,35,7.264450223,7.264110172,2275,79.34337801,17,28,45,56,49,105,4,0.457949,0.47003,0.000047,No
1652,tide,57,11.05348091,38,7.182212124,7.181842063,2166,79.38844461,16,21,37,55,42,97,4,0.449563,0.463143,0.000057,No
12435,extension,86,10.64218488,74,6.515733191,6.515002939,6364,69.34163725,23,20,43,78,71,149,4,0.46317,0.473964,0.000049,No
16526,bite,37,11.48561426,27,7.523961418,7.52370139,999,86.41731859,20,19,39,34,28,62,4,0.458197,0.470053,0.000054,No
17490,aquatic,54,11.10754813,49,6.927977986,6.92749788,2646,76.95284893,23,16,39,45,21,66,4,0.429983,0.446271,0.000054,No
8585,literal,50,11.18450917,37,7.208880372,7.208520314,1850,80.62778864,23,16,39,42,22,64,4,0.430254,0.44651,0.000054,No
8840,leap,164,9.99666575,118,6.04911366,6.047942998,19352,60.47096734,25,14,39,161,128,289,4,0.443287,0.457791,0.000054,No
10677,hebrew,240,9.615893254,156,5.769942277,5.768391106,37440,55.48314902,48,57,105,210,195,405,4,0.463569,0.474964,0.00002,No
10409,hollywood,223,9.689360406,177,5.643648552,5.641887036,39471,54.68334482,62,69,131,204,166,370,4,0.463606,0.475194,0.000016,No
18137,adrian,53,11.12624026,45,7.013135794,7.012695706,2385,78.02983385,25,26,51,36,33,69,4,0.434871,0.450773,0.000041,No
12726,equinox,27,11.80069531,23,7.684304068,7.684084048,621,90.68013099,11,15,26,26,21,47,4,0.431814,0.447965,0.00008,No
14922,cohen,49,11.20471188,28,7.487593774,7.487323743,1372,83.89633091,22,30,52,38,41,79,4,0.452094,0.465354,0.00004,No
14250,criminal,155,10.05310706,129,5.95998588,5.958705086,19995,59.91637613,49,55,104,128,106,234,4,0.450888,0.464856,0.00002,No
11875,fork,82,10.68981293,44,7.03560865,7.035178566,3608,75.20934032,25,38,63,62,70,132,4,0.45184,0.465331,0.000033,No
7802,membrane,97,10.5218212,50,6.907775279,6.907285168,4850,72.68237637,21,40,61,79,75,154,4,0.465331,0.475983,0.000034,No
12120,finnish,182,9.89252549,104,6.175407385,6.174376875,18928,61.09037497,47,62,109,147,123,270,4,0.436078,0.4525,0.000019,No
17910,alive,201,9.793227269,176,5.649314289,5.647562791,35376,55.32501875,64,74,138,171,175,346,4,0.465331,0.476616,0.000015,No
13993,danny,72,10.81986606,50,6.907775279,6.907285168,3600,74.74120328,38,31,69,49,37,86,4,0.432477,0.448749,0.00003,No
13277,dragon,158,10.03393714,86,6.365450988,6.364600644,13588,63.87053511,37,57,94,130,116,246,4,0.460586,0.472635,0.000022,No
2323,summit,52,11.14528846,39,7.156236638,7.155856573,2028,79.75832161,13,26,39,42,45,87,4,0.458943,0.470772,0.000053,No
576,warm,289,9.430105489,239,5.343334732,5.340951943,69071,50.38821019,78,81,159,249,205,454,4,0.463945,0.475682,0.000013,No
8266,magnesium,38,11.45894602,24,7.641744454,7.641514432,912,87.56633718,20,15,35,31,29,60,4,0.438296,0.453528,0.000059,No
18083,afghanistan,271,9.494413356,171,5.678134728,5.676433315,46341,53.9105582,53,76,129,235,222,457,4,0.463255,0.475058,0.000016,No
2434,stuart,101,10.48141166,87,6.353890166,6.353029813,8787,66.59773847,33,43,76,82,78,160,4,0.440712,0.456209,0.000027,No
5748,pin,38,11.45894602,21,7.775275846,7.77507583,798,89.0964662,20,18,38,31,24,55,4,0.441941,0.456711,0.000054,No
2843,spencer,74,10.79246708,47,6.969650683,6.969190586,3478,75.21972558,44,32,76,51,57,108,4,0.410817,0.428689,0.000027,No
4646,reed,90,10.59672251,56,6.794446593,6.793896453,5040,71.99886514,37,45,82,80,70,150,4,0.453839,0.467063,0.000025,No
16829,bean,57,11.05348091,42,7.082128666,7.08171859,2394,78.28217401,32,32,64,46,49,95,4,0.451083,0.46457,0.000032,No
17183,austin,107,10.42370334,64,6.660915201,6.660285015,6848,69.43140405,48,41,89,97,85,182,4,0.450876,0.46457,0.000023,No
3280,simpson,99,10.50141233,40,7.13091883,7.130528762,3960,74.88471891,30,43,73,53,86,139,4,0.446678,0.461157,0.000028,No
3775,screw,22,12.00548972,14,8.180740955,8.180610949,308,98.21380147,10,14,24,19,16,35,4,0.432382,0.448496,0.000085,No
11210,gothic,133,10.20618305,85,6.377147028,6.376306692,11305,65.0863299,42,43,85,116,119,235,4,0.435843,0.451918,0.000024,No
17346,ascension,36,11.51301324,23,7.684304068,7.684084048,828,88.46949447,18,16,34,31,32,63,4,0.445501,0.459683,0.00006,No
2476,strawberry,32,11.63079627,24,7.641744454,7.641514432,768,88.87957293,21,16,37,27,22,49,4,0.389507,0.406423,0.000055,No
16469,blind,139,10.16205824,89,6.331161914,6.330281545,12371,64.33763613,44,69,113,101,120,221,4,0.454257,0.46787,0.000018,No
11838,fought,462,8.960967286,384,4.869155732,4.865318455,177408,43.63234522,82,63,145,382,428,810,4,0.462422,0.47418,0.000014,No
765,vincent,89,10.60789581,70,6.571303042,6.570612818,6230,69.70769799,44,37,81,68,67,135,4,0.4475,0.461735,0.000025,No
14253,cricket,121,10.30074163,78,6.463089458,6.462319176,9438,66.57461464,46,46,92,90,100,190,4,0.447005,0.461476,0.000022,No
9092,knot,37,11.48561426,15,8.111748083,8.111608076,555,93.1684095,16,20,36,32,30,62,4,0.458185,0.470049,0.000056,No
14360,courage,41,11.38296011,34,7.29343776,7.293107712,1394,83.02091109,18,18,36,30,35,65,4,0.440767,0.455716,0.000056,No
126,yale,50,11.18450917,37,7.208880372,7.208520314,1850,80.62778864,20,16,36,42,21,63,4,0.427066,0.443628,0.000056,No
6806,nova,114,10.36033373,92,6.298009707,6.297099311,10488,65.24948239,41,15,56,84,95,179,4,0.442062,0.456763,0.000036,No
15930,burlington,34,11.57017165,18,7.929426526,7.929256515,612,91.74482602,18,20,38,27,34,61,4,0.394581,0.411981,0.000053,No
13134,dwight,40,11.40765272,33,7.323290723,7.322970678,1320,83.54155736,23,10,33,30,33,63,5,0.342386,0.350077,0.000061,No
17949,alexandra,76,10.76579884,57,6.776747016,6.776186871,4332,72.95709515,34,33,67,53,44,97,4,0.457583,0.469823,0.00003,No
12061,flame,101,10.48141166,65,6.645411014,6.644770822,6565,69.65328849,35,42,77,94,82,176,4,0.466187,0.476673,0.000026,No
11171,grandfather,117,10.33435824,104,6.175407385,6.174376875,12168,63.81887221,22,58,80,109,103,212,4,0.460826,0.472837,0.000025,No
1752,thieves,32,11.63079627,25,7.600922459,7.600682435,800,88.40478062,14,23,37,26,30,56,4,0.445021,0.459406,0.000054,No
934,variant,50,11.18450917,44,7.03560865,7.035178566,2200,78.68982948,20,17,37,38,45,83,4,0.45252,0.465537,0.000054,No
16745,believe,662,8.601266621,489,4.627435795,4.622543947,323718,39.80180904,62,71,133,415,630,1045,4,0.466481,0.477447,0.000015,No
6878,nolan,28,11.76432767,18,7.929426526,7.929256515,504,93.28437187,17,18,35,25,21,46,4,0.429671,0.445961,0.000057,No
12358,fake,65,10.92214491,51,6.887972651,6.887472536,3315,75.23143542,21,36,57,54,39,93,4,0.442922,0.457974,0.000035,No
7484,module,31,11.66254497,20,7.824066011,7.823875996,620,91.24852172,14,17,31,29,26,55,4,0.459299,0.470884,0.000064,No
7964,maurice,74,10.79246708,65,6.645411014,6.644770822,4810,71.72037963,38,24,62,53,51,104,4,0.439229,0.454519,0.000032,No
425,wheat,117,10.33435824,81,6.42534913,6.424548825,9477,66.40185974,43,47,90,95,89,184,4,0.454886,0.46796,0.000022,No
5111,protocol,215,9.725894149,84,6.388981485,6.388151157,18060,62.13855765,39,47,86,127,144,271,4,0.46928,0.479123,0.000023,No
17452,archive,110,10.39605181,88,6.34246147,6.341591108,9680,65.93655805,37,39,76,54,78,132,4,0.459585,0.471523,0.000026,No
5283,priest,188,9.860090215,144,5.849984985,5.84855399,27072,57.6813797,34,60,94,172,160,332,4,0.466567,0.477297,0.000021,No
15288,chevrolet,56,11.07118049,23,7.684304068,7.684084048,1288,85.07431725,22,25,47,46,38,84,4,0.409585,0.427342,0.000042,No
3328,significant,178,9.914748627,169,5.689899569,5.68821819,30082,56.41392394,50,66,116,139,107,246,4,0.451679,0.46573,0.000017,No
9615,ion,87,10.63062406,51,6.887972651,6.887472536,4437,73.22344778,37,31,68,66,53,119,4,0.456994,0.46933,0.000029,No
783,vietnam,296,9.406172723,191,5.567524856,5.565623087,56536,52.36910044,57,74,131,276,254,530,4,0.461893,0.473997,0.000015,No
1691,throne,326,9.309634796,278,5.192177171,5.189403383,90628,48.33727325,33,76,109,317,281,598,4,0.462579,0.474551,0.000018,No
4292,rocket,122,10.29251113,73,6.529338843,6.528618598,8906,67.20329273,51,47,98,110,83,193,4,0.45106,0.464847,0.00002,No
16359,bomb,133,10.20618305,95,6.265921393,6.264980969,12635,63.9511407,37,52,89,120,106,226,4,0.458008,0.470509,0.000022,No
14702,condition,221,9.698369476,177,5.643648552,5.641887036,39117,54.73418885,54,49,103,183,190,373,4,0.469852,0.479602,0.000019,No
15636,caribbean,316,9.340789964,230,5.381718975,5.379426395,72680,50.26950659,39,83,122,307,253,560,4,0.45199,0.466279,0.000016,No
12890,emblem,53,11.12624026,34,7.29343776,7.293107712,1802,81.14854086,13,19,32,39,52,91,4,0.456888,0.469011,0.000061,No
3573,session,80,10.71450554,63,6.676663558,6.676043378,5040,71.5371487,30,31,61,58,64,122,4,0.465795,0.476184,0.000032,No
3972,sarah,113,10.36914436,77,6.475992862,6.475232589,8701,67.15050486,42,36,78,72,64,136,4,0.402471,0.42045,0.000025,No
15466,celtic,173,9.943240583,123,6.007613929,6.006393208,21279,59.73515062,53,55,108,150,125,275,4,0.451932,0.465697,0.000018,No
5561,poison,104,10.45214128,73,6.529338843,6.528618598,7592,68.24557204,40,41,81,89,87,176,4,0.449063,0.46311,0.000024,No
11059,groove,31,11.66254497,15,8.111748083,8.111608076,465,94.60362683,18,18,36,30,25,55,4,0.398639,0.416319,0.000054,No
14947,coconut,42,11.35886256,20,7.824066011,7.823875996,840,88.87249047,19,17,36,33,30,63,5,0.356962,0.368776,0.000054,No
14115,curry,32,11.63079627,21,7.775275846,7.77507583,672,90.43264935,18,16,34,27,23,50,4,0.426994,0.443557,0.000057,No
18352,abc,118,10.32584755,78,6.463089458,6.462319176,9204,66.73687646,39,49,88,108,90,198,4,0.459454,0.471588,0.000022,No
7682,miami,141,10.14777229,95,6.265921393,6.264980969,13395,63.58514346,42,42,84,127,102,229,4,0.46549,0.476137,0.000023,No
14517,conversion,81,10.70208302,49,6.927977986,6.92749788,3969,74.14379559,38,31,69,64,60,124,4,0.43016,0.446698,0.000028,No
6392,oxide,102,10.47155936,52,6.868554566,6.868044446,5304,71.92447688,28,36,64,89,72,161,4,0.428903,0.445707,0.00003,No
13754,dennis,76,10.76579884,62,6.692663899,6.692053725,4712,72.05187322,36,28,64,52,40,92,4,0.429505,0.446059,0.00003,No
10035,imperial,233,9.645493724,178,5.638014734,5.636243201,41474,54.38143573,48,72,120,209,188,397,5,0.396069,0.414476,0.000016,No
5571,poem,232,9.649794806,136,5.907143398,5.905792513,31552,57.00272168,38,63,101,207,187,394,4,0.470986,0.480687,0.000019,No
8758,leopard,39,11.43297053,21,7.775275846,7.77507583,819,88.89449963,17,16,33,30,24,54,4,0.438156,0.453444,0.000058,No
15879,buzz,30,11.6953348,22,7.728755831,7.728545813,660,90.390387,18,15,33,25,25,50,4,0.436808,0.45228,0.000058,No
6832,nose,143,10.13368755,104,6.175407385,6.174376875,14872,62.57964892,39,52,91,129,125,254,4,0.468983,0.479006,0.000021,No
12336,fan,139,10.16205824,119,6.040674791,6.039494118,16541,61.38568906,48,43,91,100,109,209,4,0.44921,0.463274,0.000021,No
1262,troy,95,10.54265529,61,6.70892442,6.708324252,5795,70.7298775,37,46,83,80,83,163,4,0.46403,0.475091,0.000023,No
1108,ukraine,193,9.833841988,129,5.95998588,5.958705086,24897,58.6095594,44,68,112,166,159,325,4,0.462326,0.474217,0.000017,No
17079,bach,137,10.17655125,74,6.515733191,6.515002939,10138,66.30769276,42,53,95,118,110,228,4,0.448756,0.463058,0.00002,No
12460,explanation,52,11.14528846,43,7.058598169,7.058178089,2236,78.6701127,26,17,43,40,50,90,4,0.457618,0.469551,0.000044,No
8883,laura,68,10.87702447,48,6.948597273,6.948127172,3264,75.58006259,33,28,61,48,39,87,5,0.399752,0.417499,0.000031,No
3681,seek,40,11.40765272,40,7.13091883,7.130528762,1600,81.34704561,12,23,35,33,36,69,4,0.443188,0.457876,0.000054,No
10975,gunpowder,59,11.01899473,43,7.058598169,7.058178089,2537,77.77865604,16,19,35,44,44,88,4,0.456183,0.468462,0.000054,No
218,woody,71,10.8338523,57,6.776747016,6.776186871,4047,73.41827625,41,29,70,60,48,108,4,0.429121,0.445707,0.000027,No
6864,nor,113,10.36914436,106,6.15635919,6.155308659,11978,63.83617717,64,54,118,69,80,149,4,0.449791,0.463997,0.000016,Yes
506,weak,171,9.954868621,140,5.878155862,5.876764922,23940,58.51626934,47,64,111,151,115,266,4,0.443975,0.459303,0.000017,No
1266,trough,47,11.24638458,25,7.600922459,7.600682435,1175,85.48289711,13,20,33,39,41,80,4,0.451312,0.464542,0.000057,No
2141,symphony,193,9.833841988,106,6.15635919,6.155308659,20458,60.5406635,63,36,99,169,176,345,4,0.461628,0.473034,0.000019,No
2015,tanzania,56,11.07118049,36,7.236279346,7.235929291,2016,80.11415469,18,29,47,47,48,95,4,0.44642,0.460706,0.00004,No
6356,paint,141,10.14777229,78,6.463089458,6.462319176,10998,65.58596009,48,46,94,113,108,221,4,0.466542,0.477011,0.00002,No
10778,hart,125,10.26821844,63,6.676663558,6.676043378,7875,68.55743986,51,43,94,101,102,203,4,0.442989,0.458063,0.00002,No
9246,kate,82,10.68981293,61,6.70892442,6.708324252,5002,71.71714701,46,26,72,71,49,120,4,0.394607,0.412104,0.000026,No
6573,ongoing,32,11.63079627,31,7.38581108,7.385511041,992,85.90286399,12,22,34,31,27,58,5,0.41157,0.429471,0.000055,No
9227,keep,584,8.726631195,511,4.583428694,4.578315747,298424,39.99789182,56,114,170,538,473,1011,4,0.467969,0.479405,0.000011,No
18182,address,167,9.978538365,98,6.234830806,6.233860354,16366,62.21449839,49,61,110,110,134,244,4,0.46964,0.479644,0.000017,No
2065,taken,824,8.382361647,747,4.203733099,4.196245284,615528,35.23721111,79,91,170,679,775,1454,4,0.472717,0.482517,0.000011,No
4338,rise,193,9.833841988,169,5.689899569,5.68821819,32617,55.95357329,54,35,89,159,182,341,4,0.453051,0.466251,0.000021,No
4721,raw,232,9.649794806,155,5.776373167,5.774832011,35960,55.74081579,58,75,133,178,163,341,4,0.451932,0.466096,0.000014,No
1245,truth,153,10.06609426,119,6.040674791,6.039494118,18207,60.80600182,37,56,93,135,137,272,4,0.468574,0.478762,0.00002,No
6202,particle,185,9.876176352,94,6.276503502,6.275573088,17390,61.98785546,50,43,93,149,115,264,4,0.466346,0.476823,0.00002,No
17505,approach,90,10.59672251,82,6.413079037,6.412268725,7380,67.95761897,35,27,62,59,84,143,4,0.464637,0.475222,0.00003,No
16224,brad,33,11.60002462,27,7.523961418,7.52370139,891,87.27813766,18,13,31,26,21,47,5,0.329773,0.334101,0.00006,No
2589,step,149,10.09258587,121,6.024007739,6.022807042,18029,60.79781539,62,54,116,137,126,263,4,0.470711,0.480325,0.000016,No
11776,freddy,26,11.83843564,13,8.254848927,8.254728922,338,97.72449773,18,17,35,18,20,38,4,0.388927,0.405832,0.000053,No
5600,plum,53,11.12624026,17,7.98658494,7.986424931,901,88.86066293,26,30,56,41,39,80,4,0.455609,0.46819,0.000033,No
15604,carr,28,11.76432767,21,7.775275846,7.77507583,588,91.47089276,14,19,33,25,22,47,4,0.430098,0.446397,0.000056,No
9318,juliet,53,11.12624026,34,7.29343776,7.293107712,1802,81.14854086,17,27,44,43,42,85,4,0.438675,0.454078,0.000042,No
9414,jimmy,139,10.16205824,102,6.194825471,6.193814981,14178,62.95217725,53,35,88,102,64,166,5,0.369628,0.384454,0.000021,No
3312,silk,116,10.34294199,64,6.660915201,6.660285015,7424,68.8934595,49,43,92,103,88,191,4,0.460563,0.472344,0.00002,No
4221,rotate,27,11.80069531,21,7.775275846,7.77507583,567,91.75366123,14,20,34,25,22,47,4,0.413699,0.431356,0.000054,No
1211,tundra,44,11.31234254,15,8.111748083,8.111608076,660,91.76287294,15,19,34,43,34,77,4,0.447602,0.461481,0.000054,No
12544,examination,37,11.48561426,31,7.38581108,7.385511041,1147,84.83057709,16,18,34,27,32,59,4,0.453862,0.466636,0.000054,No
7686,meyer,26,11.83843564,18,7.929426526,7.929256515,468,93.87200559,14,18,32,17,24,41,4,0.447376,0.461274,0.000057,No
11949,fog,35,11.54118412,21,7.775275846,7.77507583,735,89.7358901,16,16,32,30,26,56,4,0.443609,0.458087,0.000057,No
584,ward,85,10.65388092,57,6.776747016,6.776186871,4845,72.19865574,47,44,91,76,70,146,4,0.455259,0.468185,0.00002,No
7315,motto,58,11.03608917,53,6.849506371,6.848986246,3074,75.59176306,19,16,35,44,50,94,4,0.453827,0.466514,0.000052,No
4217,rotor,26,11.83843564,6,9.028038815,9.027988815,156,106.8778565,14,19,33,20,20,40,4,0.441424,0.456397,0.000055,No
4999,pupil,48,11.22533117,37,7.208880372,7.208520314,1776,80.92206951,15,18,33,39,42,81,4,0.44669,0.460702,0.000055,No
5707,pitch,117,10.33435824,72,6.543132165,6.542421927,8424,67.61907182,44,51,95,106,107,213,4,0.466162,0.476809,0.000019,No
5365,pradesh,119,10.31740868,84,6.388981485,6.388151157,9996,65.91773306,2,32,34,14,89,103,4,0.46521,0.475762,0.000053,No
4573,remainder,63,10.95339745,44,7.03560865,7.035178566,2772,77.06381786,13,21,34,59,59,118,4,0.429411,0.445928,0.000053,No
7217,musket,15,12.38848198,5,9.210360372,9.210320372,75,114.1023835,8,12,20,12,14,26,4,0.4205,0.437562,0.00009,No
1431,trans,36,11.51301324,23,7.684304068,7.684084048,828,88.46949447,20,20,40,24,25,49,4,0.415422,0.432915,0.000045,No
4013,sanchez,24,11.91847835,12,8.334891634,8.334781631,288,99.33922547,11,13,24,13,17,30,4,0.394467,0.411719,0.000075,No
17358,artificial,166,9.984544389,130,5.952263834,5.950973027,21580,59.43064246,54,46,100,139,75,214,4,0.428747,0.445707,0.000018,No
5302,presidential,164,9.99666575,134,5.921958484,5.920627626,21976,59.19983955,37,23,60,132,68,200,5,0.337087,0.34346,0.00003,No
17741,analogue,32,11.63079627,28,7.487593774,7.487323743,896,87.08667777,15,16,31,28,29,57,5,0.412229,0.42987,0.000058,No
13724,depot,27,11.80069531,26,7.561701746,7.56145172,702,89.23333834,16,15,31,20,22,42,4,0.437745,0.453064,0.000058,No
6272,parachute,29,11.72923635,10,8.517213191,8.517123189,290,99.90040654,16,15,31,20,18,38,4,0.419417,0.436886,0.000058,No
16958,barbara,79,10.72708432,63,6.676663558,6.676043378,4977,71.62113299,32,30,62,61,52,113,4,0.436582,0.452336,0.000029,No
11748,freshwater,69,10.86242567,60,6.725453722,6.72486356,4140,73.05474117,20,19,39,50,37,87,4,0.435511,0.4512,0.000046,No
13571,difficult,423,9.049159998,386,4.863960915,4.860103562,163278,44.01476054,57,81,138,387,380,767,4,0.465222,0.476687,0.000013,No
4273,roland,31,11.66254497,25,7.600922459,7.600682435,775,88.64610002,18,14,32,26,15,41,4,0.420281,0.437421,0.000056,No
3691,sedimentary,38,11.45894602,30,7.418600903,7.418310866,1140,85.00934727,22,6,28,36,24,60,4,0.428055,0.444332,0.000064,No
9209,kent,194,9.828674018,131,5.944600961,5.943300141,25414,58.42754501,34,71,105,159,168,327,4,0.463497,0.475161,0.000017,No
9214,kennedy,115,10.35160005,74,6.515733191,6.515002939,8510,67.44826402,38,43,81,103,82,185,4,0.442216,0.457401,0.000022,No
3461,sherman,28,11.76432767,19,7.875359305,7.875179292,532,92.64830736,16,17,33,21,20,41,5,0.410846,0.428414,0.000054,No
7446,monarch,191,9.844258749,139,5.885324351,5.883943426,26549,57.93665574,48,79,127,171,160,331,4,0.470537,0.480672,0.000014,No
16714,bend,69,10.86242567,57,6.776747016,6.776186871,3933,73.61191077,28,33,61,66,57,123,4,0.464954,0.475574,0.000029,No
4838,raccoon,30,11.6953348,15,8.111748083,8.111608076,450,94.86960961,15,14,29,23,24,47,4,0.395768,0.413465,0.000061,No
10061,immediate,34,11.57017165,31,7.38581108,7.385511041,1054,85.45510199,11,20,31,28,23,51,5,0.385925,0.402641,0.000057,No
13246,drill,29,11.72923635,12,8.334891634,8.334781631,348,97.76191391,13,18,31,23,24,47,4,0.437055,0.452604,0.000057,No
4261,romeo,50,11.18450917,26,7.561701746,7.56145172,1300,84.57392254,19,12,31,25,33,58,5,0.396741,0.414082,0.000057,No
12733,equal,385,9.143288843,292,5.143044482,5.140130298,112420,47.02434123,75,72,147,344,315,659,4,0.467895,0.478546,0.000012,No
13980,darling,28,11.76432767,18,7.929426526,7.929256515,504,93.28437187,15,17,32,26,22,48,4,0.438177,0.453491,0.000055,No
16566,binary,140,10.15488975,98,6.234830806,6.233860354,13720,63.31401947,51,37,88,119,81,200,4,0.451163,0.46473,0.00002,No
5187,prominent,105,10.44257183,105,6.165837934,6.164797414,11025,64.3872055,29,51,80,100,66,166,5,0.417268,0.435245,0.000022,No
2211,swan,65,10.92214491,43,7.058598169,7.058178089,2795,77.09503204,21,34,55,53,55,108,4,0.45623,0.468767,0.000032,No
15520,cattle,135,10.1912574,98,6.234830806,6.233860354,13230,63.54076558,53,50,103,95,101,196,4,0.460826,0.472706,0.000017,No
5096,provide,274,9.483404071,252,5.290369197,5.287856092,69048,50.17070878,35,90,125,237,209,446,4,0.464103,0.476015,0.000014,No
17440,argentine,63,10.95339745,57,6.776747016,6.776186871,3591,74.22840349,10,23,33,44,56,100,5,0.350602,0.360842,0.000053,No
10419,hole,193,9.833841988,122,6.015777239,6.014566531,23546,59.15820281,35,57,92,181,169,350,4,0.469442,0.479438,0.000019,No
8293,madison,126,10.26025027,73,6.529338843,6.528618598,9198,66.99265063,48,44,92,106,104,210,4,0.446005,0.460645,0.000019,No
13775,democracy,159,10.02762798,115,6.074866156,6.073725528,18285,60.91649781,52,57,109,140,136,276,4,0.468154,0.478466,0.000016,No
7861,medal,266,9.513035869,167,5.701804472,5.700143126,44422,54.24147046,43,44,87,238,239,477,4,0.459347,0.471419,0.00002,No
8704,liberty,111,10.38700198,60,6.725453722,6.72486356,6660,69.8573011,44,43,87,89,82,171,4,0.466935,0.477288,0.00002,No
4265,romania,546,8.792083375,440,4.733023557,4.728623981,240240,41.61313773,59,86,145,506,280,786,4,0.473196,0.482766,0.000012,No
13312,doug,34,11.57017165,28,7.487593774,7.487323743,952,86.63274523,17,14,31,22,14,36,4,0.391241,0.408273,0.000056,No
7490,modest,35,11.54118412,31,7.38581108,7.385511041,1085,85.24100552,14,18,32,28,25,53,4,0.430546,0.446782,0.000054,No
10455,historian,156,10.04667617,136,5.907143398,5.905792513,21216,59.34715681,48,60,108,130,123,253,4,0.465539,0.476546,0.000016,No
12675,escape,179,9.909146372,153,5.789360363,5.787839237,27387,57.36761923,49,59,108,151,155,306,4,0.467156,0.477757,0.000016,No
1114,u,131,10.19869238,87,6.319988614,6.319098235,11397,64.4556197,51,45,96,84,99,183,4,0.461053,0.472762,0.000018,No
12822,energetic,31,11.66254497,27,7.523961418,7.52370139,837,87.74853841,17,15,32,30,18,48,5,0.387348,0.404082,0.000054,No
7988,math,79,10.72708432,71,6.557118407,6.556418176,5609,70.33876208,26,40,66,65,61,126,4,0.460814,0.472499,0.000026,No
227,wooden,151,10.07925234,127,5.975611198,5.974350429,19177,60.22969315,52,55,107,131,83,214,4,0.436421,0.452669,0.000016,No
6963,nice,131,10.22133485,103,6.185069296,6.184048796,13493,63.21966437,36,59,95,97,88,185,4,0.463122,0.474631,0.000018,No
4176,rude,32,11.63079627,31,7.38581108,7.385511041,992,85.90286399,15,15,30,26,27,53,4,0.417062,0.434403,0.000057,No
12510,executive,261,9.53201177,186,5.59405161,5.592199934,48546,53.32256579,62,52,114,220,173,393,4,0.468055,0.478302,0.000015,No
3265,sing,215,9.725894149,169,5.689899569,5.68821819,36335,55.33936093,44,78,122,192,183,375,4,0.473095,0.482541,0.000014,No
9331,judy,36,11.51301324,23,7.684304068,7.684084048,828,88.46949447,14,17,31,28,31,59,4,0.442812,0.457434,0.000055,No
13700,describe,457,8.971848786,414,4.79393231,4.789793841,189198,43.01043578,31,100,131,437,387,824,4,0.46247,0.474912,0.000013,No
1445,trail,76,10.76579884,53,6.849506371,6.848986246,4028,73.74040772,28,35,63,60,65,125,4,0.4565,0.468992,0.000027,No
3587,serpent,43,11.33533206,27,7.523961418,7.52370139,1161,85.28660109,11,21,32,32,33,65,4,0.440264,0.455341,0.000053,No
86,yield,22,12.00548972,17,7.98658494,7.986424931,374,95.88286343,15,17,32,17,21,38,4,0.427323,0.444078,0.000053,No
10101,ieee,31,11.66254497,15,8.111748083,8.111608076,465,94.60362683,16,16,32,20,20,40,4,0.413583,0.431056,0.000053,No
12947,eleven,149,10.09258587,138,5.892544599,5.891173687,20562,59.47101237,54,52,106,121,78,199,4,0.460013,0.472091,0.000016,No
1595,tnt,38,11.45894602,11,8.421903011,8.421803008,418,96.50613197,18,14,32,26,23,49,4,0.429349,0.445609,0.000053,No
6957,nick,89,10.60789581,74,6.515733191,6.515002939,6586,69.1182188,42,35,77,64,49,113,4,0.439294,0.454768,0.000022,No
10255,hugo,115,10.35160005,81,6.42534913,6.424548825,9315,66.51264436,45,32,77,93,82,175,4,0.436475,0.452275,0.000022,No
9958,income,117,10.33435824,83,6.400957676,6.400137356,9711,66.14978972,47,47,94,101,103,204,4,0.458303,0.470668,0.000018,No
3531,shakespeare,163,10.00278198,118,6.04911366,6.047942998,19234,60.50796509,35,54,89,153,141,294,4,0.461185,0.473039,0.000019,No
8243,mail,134,10.19869238,83,6.400957676,6.400137356,11122,65.28139826,47,52,99,106,101,207,4,0.461412,0.473185,0.000017,No
4581,relief,62,10.96939779,46,6.991156888,6.990706795,2852,76.68878093,26,34,60,41,51,92,4,0.465417,0.475959,0.000028,No
18184,addition,302,9.38610516,285,5.167309104,5.16446512,86070,48.50090664,33,37,70,292,272,564,4,0.462965,0.474105,0.000024,No
3725,seasonal,39,11.43297053,38,7.182212124,7.181842063,1482,82.11401957,17,13,30,36,18,54,5,0.397301,0.414664,0.000056,No
902,vein,21,12.05200974,13,8.254848927,8.254728922,273,99.48751966,9,14,23,15,19,34,4,0.44045,0.455383,0.000073,No
2276,supply,188,9.860090215,142,5.863971227,5.86256026,26696,57.81928531,66,63,129,165,154,319,4,0.468068,0.478522,0.000013,No
16599,bicycle,82,10.68981293,67,6.615105665,6.61444546,5494,70.71424207,34,33,67,71,52,123,4,0.450602,0.464284,0.000025,No
14601,constantinople,153,10.06609426,118,6.04911366,6.047942998,18054,60.89094826,32,61,93,136,114,250,4,0.46582,0.476767,0.000018,No
17197,augustus,143,10.13368755,108,6.137667057,6.136596506,15444,62.19720022,45,48,93,131,102,233,4,0.455633,0.468546,0.000018,No
3732,sean,76,10.76579884,54,6.830814238,6.830284108,4104,73.53917198,32,22,54,46,46,92,4,0.4416,0.456514,0.000031,No
6496,organic,182,9.89252549,126,5.983516377,5.98226562,22932,59.19208828,64,29,93,146,74,220,4,0.433851,0.449932,0.000018,No
4749,raphael,25,11.87765635,17,7.98658494,7.986424931,425,94.86191135,15,16,31,22,17,39,4,0.431688,0.447871,0.000054,No
9176,khan,394,9.120181268,219,5.430726554,5.428544218,86286,49.52921059,44,95,139,91,248,339,4,0.473007,0.482794,0.000012,No
3602,serbia,175,9.931746203,110,6.119317918,6.118227346,19250,60.7755125,40,58,98,150,129,279,4,0.462965,0.474518,0.000017,No
14155,cuisine,53,11.12624026,40,7.13091883,7.130528762,2120,79.34031621,24,25,49,36,39,75,4,0.456312,0.468668,0.000034,No
12396,f,169,9.937476878,108,6.175407385,6.174376875,18252,61.3679681,61,58,119,149,145,294,4,0.461257,0.473142,0.000014,No
14932,coffee,182,9.89252549,96,6.255450093,6.25449966,17472,61.8821995,63,56,119,140,124,264,4,0.463751,0.475067,0.000014,No
15880,buy,286,9.440540367,233,5.368759831,5.366437182,66638,50.6839939,33,78,111,270,225,495,4,0.462639,0.474645,0.000015,No
13260,drawn,120,10.30904043,103,6.185069296,6.184048796,12360,63.76212946,38,45,83,93,112,205,4,0.463388,0.474584,0.00002,No
14277,credit,98,10.5115647,73,6.529338843,6.528618598,7154,68.63356769,44,28,72,83,79,162,4,0.44393,0.458678,0.000023,No
13527,diogenes,29,11.72923635,11,8.421903011,8.421803008,319,98.78249092,19,9,28,22,24,46,4,0.42494,0.441646,0.000059,No
3907,sc,23,11.96103796,17,7.98658494,7.986424931,391,95.52784565,12,13,25,15,13,28,5,0.360258,0.372692,0.000066,No
15184,chromium,21,12.05200974,8,8.740356743,8.740286741,168,105.3388646,12,13,25,16,19,35,4,0.428582,0.444928,0.000066,No
12124,finland,273,9.487060382,175,5.65501231,5.65327083,47775,53.64944325,58,92,150,226,231,457,4,0.472076,0.482071,0.000011,No
15050,clement,49,11.20471188,43,7.058598169,7.058178089,2107,79.08955875,12,18,30,47,44,91,4,0.423581,0.440473,0.000055,No
8565,liverpool,176,9.926048182,122,6.015777239,6.014566531,21472,59.71289473,44,66,110,159,152,311,4,0.463074,0.474748,0.000015,No
8647,limit,161,10.01512781,109,6.128450402,6.12736984,17549,61.37721407,47,50,97,132,150,282,4,0.465453,0.476269,0.000017,No
10085,illegal,207,9.763813384,165,5.71385281,5.712211497,34155,55.78899254,49,54,103,182,142,324,4,0.464054,0.475283,0.000016,No
5184,promise,85,10.65388092,64,6.660915201,6.660285015,5440,70.96459737,29,32,61,78,81,159,4,0.468389,0.478166,0.000027,No
3154,slim,48,11.22533117,21,7.775275846,7.77507583,1008,87.28004629,28,25,53,35,34,69,4,0.421609,0.438792,0.000031,No
12782,entrepreneur,32,11.63079627,29,7.452502454,7.452222421,928,86.67853778,13,18,31,23,27,50,5,0.419477,0.436743,0.000053,No
3692,sediment,23,11.96103796,20,7.824066011,7.823875996,460,93.58395057,13,18,31,21,20,41,4,0.424168,0.441069,0.000053,No
13568,diffusion,25,11.87765635,15,8.111748083,8.111608076,375,96.34855615,15,16,31,22,20,42,5,0.409481,0.427208,0.000053,No
4844,rabbi,36,11.51301324,19,7.875359305,7.875179292,684,90.66911594,16,15,31,23,23,46,4,0.402371,0.419943,0.000053,No
13949,dawson,27,11.80069531,20,7.824066011,7.823875996,540,92.32941909,18,13,31,23,24,47,5,0.354942,0.366241,0.000053,No
4412,rhode,85,10.65388092,56,6.794446593,6.793896453,4760,72.38722493,30,1,31,69,82,151,5,0.325958,0.329379,0.000053,No
5894,pet,108,10.41440095,69,6.58569178,6.585011562,7452,68.58603473,41,41,82,82,75,157,4,0.462699,0.474001,0.00002,No
325,willard,14,12.45747485,12,8.334891634,8.334781631,168,103.8317029,10,11,21,12,11,23,5,0.369997,0.38445,0.000078,No
8112,marcel,30,11.6953348,23,7.684304068,7.684084048,690,89.87050875,16,7,23,18,13,31,5,0.336767,0.342901,0.000071,No
5725,pioneer,79,10.72708432,55,6.812465099,6.811924964,4345,73.07788758,31,37,68,60,64,124,4,0.445636,0.460185,0.000024,No
8277,maggie,41,11.38296011,24,7.641744454,7.641514432,984,86.98567229,23,21,44,30,28,58,4,0.441402,0.456298,0.000037,No
1843,terry,69,10.86242567,59,6.74226084,6.741680684,4071,73.23730724,46,28,74,59,37,96,4,0.409453,0.427272,0.000022,No
8742,lester,24,11.91847835,22,7.728755831,7.728545813,528,92.11500902,12,17,29,17,21,38,4,0.427817,0.444313,0.000056,No
8088,marina,29,11.72923635,22,7.728755831,7.728545813,638,90.65240381,15,13,28,19,16,35,4,0.430286,0.446454,0.000058,No
7794,memphis,74,10.79246708,46,6.991156888,6.990706795,3404,75.45183059,34,24,58,67,57,124,4,0.454501,0.467199,0.000028,No
1299,trip,139,10.16205824,118,6.04911366,6.047942998,16402,61.47144534,44,46,90,121,117,238,4,0.467488,0.477752,0.000018,No
13578,dietrich,21,12.05200974,15,8.111748083,8.111608076,315,97.7628669,14,16,30,15,17,32,4,0.411971,0.429497,0.000054,No
10579,herman,38,11.45894602,30,7.418600903,7.418310866,1140,85.00934727,15,15,30,20,17,37,5,0.335735,0.341455,0.000054,No
11188,graduate,99,10.50141233,77,6.475992862,6.475232589,7623,68.00707128,34,26,60,82,72,154,4,0.420351,0.43767,0.000027,No
11552,garfield,48,11.22533117,24,7.641744454,7.641514432,1152,85.78111218,21,28,49,40,42,82,4,0.444854,0.459322,0.000033,No
11988,flour,105,10.44257183,60,6.725453722,6.72486356,6300,70.23103356,39,38,77,92,84,176,4,0.466383,0.476757,0.000021,No
9457,jefferson,188,9.860090215,118,6.04911366,6.047942998,22184,59.6448064,51,56,107,159,163,322,4,0.452301,0.466049,0.000015,No
4490,response,126,10.26025027,109,6.128450402,6.12736984,13734,62.87943489,32,32,64,108,113,221,4,0.465307,0.475837,0.000025,No
6908,nitrate,28,11.76432767,12,8.334891634,8.334781631,336,98.05439626,14,11,25,28,23,51,4,0.404434,0.421957,0.000064,No
13780,dementia,26,11.83843564,16,8.047209562,8.047059554,416,95.26637248,11,17,28,20,24,44,4,0.415607,0.433023,0.000057,No
17618,antennae,27,11.80069531,21,7.775275846,7.77507583,567,91.75366123,15,13,28,24,22,46,4,0.440898,0.455735,0.000057,No
1909,tell,476,8.931114323,406,4.813445125,4.809386982,193256,42.9894287,55,78,133,411,429,840,4,0.467735,0.478536,0.000012,No
9385,johnston,54,11.10754813,31,7.38581108,7.385511041,1674,82.03825205,31,24,55,43,48,91,4,0.447162,0.461218,0.000029,No
14990,clumsy,21,12.05200974,21,7.775275846,7.77507583,441,93.70770023,13,14,27,17,15,32,4,0.425092,0.441806,0.000059,No
3163,slender,30,11.6953348,29,7.452502454,7.452222421,870,87.15951127,13,17,30,29,21,50,5,0.390931,0.408002,0.000053,No
15590,cartilage,31,11.66254497,18,7.929426526,7.929256515,558,92.47729347,13,17,30,23,23,46,4,0.451277,0.464462,0.000053,No
12250,feldspar,12,12.61162553,7,8.873888135,8.873828135,84,111.9141541,8,7,15,12,11,23,4,0.417592,0.43467,0.000106,No
6098,pea,30,11.6953348,24,7.641744454,7.641514432,720,89.37275981,16,14,30,29,24,53,4,0.429401,0.445693,0.000053,No
7267,mulberry,24,11.91847835,12,8.334891634,8.334781631,288,99.33922547,17,13,30,21,15,36,4,0.39763,0.415024,0.000053,No
1169,tuskegee,25,11.87765635,7,8.873888135,8.873828135,175,105.4009938,17,13,30,23,22,45,4,0.419655,0.436722,0.000053,No
14615,consistent,33,11.60002462,33,7.323290723,7.322970678,1089,84.95035265,18,12,30,31,24,55,5,0.38914,0.405988,0.000053,No
2931,soup,82,10.68981293,47,6.969650683,6.969190586,3854,74.50426198,31,38,69,62,69,131,4,0.456101,0.468758,0.000023,No
10738,hawaii,235,9.636946663,169,5.689899569,5.68821819,39715,54.83325867,45,77,122,201,209,410,4,0.469926,0.48017,0.000013,No
15989,build,347,9.247207397,312,5.076795096,5.073680313,108264,46.94617717,53,69,122,321,297,618,4,0.468859,0.479231,0.000013,No
7683,mi,155,10.05310706,109,6.128450402,6.12736984,16895,61.60996801,26,46,72,34,124,158,4,0.457382,0.469927,0.000022,No
17199,augusta,86,10.64218488,42,7.082128666,7.08171859,3612,75.36932261,52,47,99,83,75,158,4,0.444642,0.459537,0.000016,No
5848,philadelphia,204,9.778412184,151,5.802518447,5.801017351,30804,56.73941708,46,47,93,172,134,306,4,0.443011,0.458167,0.000017,No
10697,hear,174,9.937476878,138,5.892544599,5.891173687,24012,58.55702571,36,69,105,157,158,315,4,0.458848,0.471499,0.000015,No
18011,airplane,157,10.04028637,115,6.074866156,6.073725528,18055,60.99339588,43,62,105,137,127,264,4,0.469442,0.479532,0.000015,No
5268,principal,160,10.02135836,143,5.856953654,5.855532673,22880,58.69463148,47,58,105,143,103,246,4,0.427117,0.44451,0.000015,No
5624,please,69,10.86242567,54,6.830814238,6.830284108,3726,74.19921194,35,28,63,56,64,120,4,0.431824,0.448106,0.000025,No
8830,leave,379,9.158995972,349,4.964726362,4.961240363,132271,45.47190875,43,114,157,329,354,683,4,0.468673,0.479935,0.00001,No
8215,malaysia,127,10.25234509,100,6.214628098,6.213637628,12700,63.71451187,37,50,87,103,102,205,4,0.462121,0.473706,0.000018,No
8762,leonard,55,11.08919899,49,6.927977986,6.92749788,2695,76.8257265,31,23,54,42,42,84,4,0.425408,0.442252,0.000029,No
8273,magician,32,11.63079627,24,7.641744454,7.641514432,768,88.87957293,13,16,29,25,23,48,4,0.411942,0.429483,0.000054,No
17229,attitude,36,11.51301324,31,7.38581108,7.385511041,1116,85.03294074,14,15,29,29,30,59,4,0.427725,0.444247,0.000054,No
2821,spin,110,10.39605181,69,6.58569178,6.585011562,7590,68.46519296,45,47,92,95,95,190,4,0.464868,0.475738,0.000017,No
9726,insurance,91,10.58567267,69,6.58569178,6.585011562,6279,69.71397749,36,32,68,75,59,134,4,0.43367,0.449829,0.000023,No
8859,lay,98,10.5115647,85,6.377147028,6.376306692,8330,67.03379357,37,31,68,71,59,130,4,0.451358,0.464791,0.000023,No
11446,geography,157,10.04028637,142,5.863971227,5.86256026,22294,58.87595039,43,54,97,93,128,221,4,0.461785,0.473513,0.000016,No
12048,flask,41,11.38296011,9,8.622573707,8.622493705,369,98.15041256,8,20,28,23,36,59,4,0.419655,0.436952,0.000055,No
1687,throw,111,10.38700198,84,6.388981485,6.388151157,9324,66.36236331,31,39,70,100,92,192,4,0.463146,0.474302,0.000022,No
6062,pedro,120,10.30904043,79,6.450350432,6.449570143,9480,66.49692342,43,27,70,93,58,151,4,0.424503,0.441515,0.000022,No
12844,empty,115,10.35160005,92,6.298009707,6.297099311,10580,65.19447759,36,45,81,102,95,197,4,0.414114,0.432102,0.000019,No
13044,edith,25,11.87765635,17,7.98658494,7.986424931,425,94.86191135,13,14,27,16,17,33,5,0.387898,0.404768,0.000057,No
8765,leo,136,10.18387729,101,6.204677767,6.203677287,13736,63.18767702,46,35,81,102,90,192,4,0.45924,0.471147,0.000019,No
18021,aires,61,10.98565831,42,7.082128666,7.08171859,2562,77.80184565,1,28,29,60,53,113,4,0.453526,0.466509,0.000053,No
3629,sensor,30,11.6953348,24,7.641744454,7.641514432,720,89.37275981,12,17,29,25,23,48,4,0.451564,0.464706,0.000053,No
14031,daisy,28,11.76432767,22,7.728755831,7.728545813,616,90.92361605,19,10,29,24,18,42,4,0.432592,0.448472,0.000053,No
17682,angular,54,11.10754813,26,7.561701746,7.56145172,1404,83.9919661,20,9,29,43,37,80,5,0.325015,0.32868,0.000053,No
9867,infectious,45,11.28986969,35,7.264450223,7.264110172,1575,82.01469637,23,6,29,40,6,46,5,0.345875,0.354732,0.000053,No
16544,birmingham,171,9.954868621,122,6.015777239,6.014566531,20862,59.88627207,38,58,96,154,150,304,4,0.449677,0.463932,0.000016,No
9713,intelligent,84,10.66571538,66,6.630143542,6.629493344,5544,70.71522394,33,28,61,71,56,127,4,0.450979,0.46442,0.000025,No
17784,ammonium,18,12.20616042,11,8.421903011,8.421803008,198,102.7990992,12,13,25,14,18,32,5,0.361219,0.374011,0.000061,No
155,wrong,224,9.684886125,199,5.526493459,5.524511536,44576,53.52345983,48,79,127,205,189,394,4,0.4651,0.476551,0.000012,No
14432,correct,205,9.768656009,183,5.604862527,5.603030887,37515,54.751974,35,82,117,175,161,336,4,0.466812,0.477898,0.000013,No
10105,idol,104,10.45214128,58,6.759355274,6.758785123,6032,70.64973627,24,52,76,45,81,126,4,0.458351,0.470804,0.00002,No
3723,seattle,147,10.10609959,104,6.175407385,6.174376875,15288,62.40928205,35,41,76,137,99,236,4,0.455457,0.468269,0.00002,No
6876,nomadic,44,11.31234254,32,7.354062381,7.35375234,1408,83.19167274,20,18,38,38,34,72,4,0.395319,0.412714,0.00004,No
12695,ernest,75,10.77904406,59,6.74226084,6.741680684,4425,72.67512669,44,32,76,61,61,122,4,0.438372,0.453942,0.00002,No
2904,spacecraft,125,10.26821844,78,6.463089458,6.462319176,9750,66.36441435,52,49,101,99,101,200,4,0.462808,0.474222,0.000015,No
8848,leaf,110,10.39605181,79,6.450350432,6.449570143,8690,67.05817729,36,53,89,93,81,174,4,0.464893,0.475898,0.000017,No
11098,greta,26,11.83843564,8,8.740356743,8.740286741,208,103.4721508,12,16,28,18,22,40,4,0.410941,0.428567,0.000054,No
7576,minimal,29,11.72923635,28,7.487593774,7.487323743,812,87.82375705,13,15,28,20,19,39,4,0.427117,0.443628,0.000054,No
5511,polymer,31,11.66254497,18,7.929426526,7.929256515,558,92.47729347,13,15,28,28,27,55,4,0.418853,0.436093,0.000054,No
8225,makeup,26,11.83843564,24,7.641744454,7.641514432,624,90.46629989,13,11,24,21,26,47,4,0.447241,0.461035,0.000063,No
14989,cluster,34,11.57017165,21,7.775275846,7.77507583,714,89.96127619,20,8,28,31,15,46,5,0.398004,0.415406,0.000054,No
3463,sheriff,22,12.00548972,20,7.824066011,7.823875996,440,93.93174409,13,13,26,20,21,41,5,0.412689,0.430142,0.000058,No
3406,shout,24,11.91847835,21,7.775275846,7.77507583,504,92.66945682,19,16,35,21,20,41,4,0.428013,0.44467,0.000043,No
1913,telescope,118,10.32584755,82,6.413079037,6.412268725,9676,66.22047648,28,47,75,100,97,197,4,0.468983,0.478898,0.00002,No
11470,genetic,161,10.01512781,116,6.066208093,6.065057454,18676,60.75384939,58,30,88,135,74,209,4,0.400465,0.418244,0.000017,No
12328,fantasy,284,9.447557939,194,5.551940125,5.550008299,55096,52.45227601,60,64,124,241,210,451,4,0.4386,0.454707,0.000012,No
10881,ham,100,10.49136199,53,6.849506371,6.848986246,5300,71.8606508,31,31,62,81,61,142,4,0.427498,0.444351,0.000024,No
13195,duff,37,11.48561426,17,7.98658494,7.986424931,629,91.73083391,9,19,28,9,29,38,4,0.408463,0.426107,0.000053,No
4174,rudolf,61,10.98565831,50,6.907775279,6.907285168,3050,75.88645892,31,22,53,50,44,94,5,0.396325,0.413971,0.000028,No
17698,angelica,41,11.38296011,7,8.873888135,8.873828135,287,101.0111147,16,10,26,27,21,48,5,0.354566,0.365805,0.000057,No
868,verb,133,10.20618305,91,6.308938778,6.30803839,12103,64.39018401,27,47,74,125,101,226,4,0.464649,0.475588,0.00002,No
8347,lynn,42,11.35886256,30,7.418600903,7.418310866,1260,84.26686803,16,21,37,26,24,50,4,0.43039,0.446712,0.00004,No
5623,pleasure,93,10.56393268,61,6.70892442,6.708324252,5673,70.87262596,37,37,74,79,80,159,4,0.465893,0.476368,0.00002,No
5120,protect,320,9.328211182,274,5.206670178,5.203936499,87680,48.56891897,26,61,87,299,287,586,4,0.446386,0.461265,0.000017,No
18355,abbey,221,9.698369476,156,5.769942277,5.768391106,34476,55.95903206,26,61,87,150,181,331,4,0.464382,0.475659,0.000017,No
11499,gazette,26,11.83843564,17,7.98658494,7.986424931,442,94.54867179,11,14,25,21,20,41,4,0.455399,0.467734,0.000059,No
9728,insulin,23,11.96103796,7,8.873888135,8.873828135,161,106.1409129,15,10,25,17,18,35,4,0.452416,0.46527,0.000059,No
9841,influential,127,10.25234509,122,6.015777239,6.014566531,15494,61.67582425,21,46,67,119,75,194,4,0.45075,0.464603,0.000022,No
11388,gil,11,12.6986369,11,8.421903011,8.421803008,121,106.9466884,5,6,11,5,7,12,5,0.319079,0.3226,0.000134,No
2630,statue,141,10.14777229,95,6.265921393,6.264980969,13395,63.58514346,32,35,67,137,128,265,4,0.465906,0.476344,0.000022,No
7631,milan,146,10.11292556,109,6.128450402,6.12736984,15914,61.97656269,38,54,92,129,120,249,4,0.457748,0.470354,0.000016,No
883,venice,157,10.04028637,121,6.024007739,6.022807042,18997,60.4827628,32,73,105,144,136,280,4,0.470038,0.480194,0.000014,No
3993,sang,178,9.914748627,148,5.82258601,5.821114958,26344,57.72947665,44,61,105,154,161,315,4,0.459252,0.471673,0.000014,No
15983,bulgaria,150,10.08589688,120,6.032306541,6.031115857,18000,60.84122175,50,55,105,128,107,235,4,0.447873,0.462382,0.000014,No
2494,strain,39,11.43297053,22,7.728755831,7.728545813,858,88.36263766,21,21,42,34,35,69,4,0.457748,0.469725,0.000035,No
17689,anglican,106,10.43309308,78,6.463089458,6.462319176,8268,67.43001392,27,22,49,100,91,191,4,0.396883,0.41439,0.00003,No
11848,fortress,103,10.46180319,75,6.502310171,6.501569912,7725,68.02588928,28,33,61,77,93,170,4,0.460993,0.472523,0.000024,No
10945,h,119,10.05310706,72,6.204677767,6.203677287,8568,62.37628987,38,43,81,96,94,190,4,0.466383,0.476846,0.000018,No
1879,tenor,59,11.01899473,36,7.236279346,7.235929291,2124,79.736524,28,26,54,54,51,105,4,0.447749,0.461725,0.000027,No
13691,desk,23,11.96103796,15,8.111748083,8.111608076,345,97.02492676,13,13,26,19,17,36,5,0.382829,0.399299,0.000056,No
81,yogi,28,11.76432767,14,8.180740955,8.180610949,392,96.24091715,11,17,28,17,24,41,4,0.406648,0.424239,0.000052,No
17161,automatic,72,10.81986606,58,6.759355274,6.758785123,4176,73.1353187,27,29,56,64,41,105,4,0.429952,0.446468,0.000026,No
5962,perhaps,208,9.758994098,198,5.531531254,5.52955935,41184,53.98218085,74,58,132,174,181,355,4,0.467994,0.478363,0.000011,No
10420,holden,46,11.26789078,14,8.180740955,8.180610949,644,92.17969558,32,26,58,36,32,68,4,0.430661,0.447031,0.000025,No
11920,footage,29,11.72923635,25,7.600922459,7.600682435,725,89.15301598,13,12,25,18,25,43,4,0.444453,0.458735,0.000058,No
5527,pollution,89,10.60789581,65,6.645411014,6.644770822,5785,70.49382764,34,35,69,79,74,153,4,0.456218,0.468781,0.000021,No
13053,edge,236,9.632700372,185,5.599442459,5.597600801,43660,53.93775146,55,56,111,184,213,397,4,0.460228,0.472349,0.000013,No
18198,acute,55,11.08919899,39,7.156236638,7.155856573,2145,79.35693211,23,25,48,40,43,83,5,0.396298,0.413866,0.00003,No
2259,surgeon,41,11.38296011,33,7.323290723,7.322970678,1353,83.36072618,20,20,40,38,32,70,4,0.441249,0.456176,0.000036,No
6340,palermo,25,11.87765635,24,7.641744454,7.641514432,600,90.76601456,15,12,27,21,20,41,4,0.434924,0.450543,0.000053,No
3596,sergeant,19,12.1520932,13,8.254848927,8.254728922,247,100.3136935,12,14,26,16,16,32,4,0.444976,0.459214,0.000055,No
732,viscosity,24,11.91847835,14,8.180740955,8.180610949,336,97.50198393,13,13,26,18,18,36,4,0.422201,0.439219,0.000055,No
13285,dr,69,10.86242567,54,6.830814238,6.830284108,3726,74.19921194,40,25,65,49,33,82,5,0.369874,0.384602,0.000022,No
8337,ma,59,11.01899473,43,7.058598169,7.058178089,2537,77.77865604,32,23,55,39,34,73,4,0.440286,0.455383,0.000026,Yes
8413,lucy,54,11.10754813,40,7.13091883,7.130528762,2160,79.20702412,29,22,51,36,30,66,4,0.434552,0.450416,0.000028,No
6694,occurred,129,10.23671977,122,6.015777239,6.014566531,15738,61.58182582,50,34,84,93,122,215,4,0.450853,0.46442,0.000017,No
13792,della,52,11.14528846,38,7.182212124,7.181842063,1976,80.0478259,16,5,21,20,5,25,5,0.32298,0.326661,0.000068,No
9780,input,149,10.09258587,75,6.502310171,6.501569912,11175,65.62512376,45,50,95,128,122,250,4,0.468451,0.478551,0.000015,No
16630,beta,95,10.54265529,57,6.776747016,6.776186871,5415,71.44490775,43,32,75,69,56,125,4,0.456723,0.46911,0.000019,No
681,voltage,132,10.21373025,67,6.615105665,6.61444546,8844,67.56490487,37,52,89,110,111,221,4,0.469628,0.479452,0.000016,No
3176,slavery,116,10.34294199,80,6.43777165,6.436981353,9280,66.58549869,40,39,79,87,100,187,4,0.469318,0.478996,0.000018,No
17851,already,374,9.17227638,357,4.942062502,4.938496222,133518,45.32996316,80,78,158,334,233,567,4,0.45873,0.471546,0.000009,No
17396,arnold,94,10.5532374,66,6.630143542,6.629493344,6204,69.96947876,43,36,79,77,62,139,4,0.452601,0.465899,0.000018,No
994,utah,127,10.25234509,79,6.450350432,6.449570143,10033,66.13121858,51,58,109,111,114,225,4,0.460359,0.472462,0.000013,No
8794,leigh,41,11.38296011,29,7.452502454,7.452222421,1189,84.83153816,16,31,47,23,34,57,4,0.4475,0.461603,0.00003,No
753,violet,68,10.87702447,46,6.991156888,6.990706795,3128,76.04298456,31,36,67,54,57,111,4,0.444709,0.459392,0.000021,No
17022,baldwin,77,10.75272676,60,6.725453722,6.72486356,4620,72.31696618,37,30,67,66,70,136,4,0.43795,0.453519,0.000021,No
15575,cash,78,10.73982335,61,6.70892442,6.708324252,4758,72.05266314,37,37,74,65,61,126,4,0.441853,0.457012,0.000019,No
9436,jerusalem,214,9.725894149,159,5.750894082,5.749312864,34026,55.9325871,37,80,117,189,166,355,4,0.468166,0.478907,0.000012,No
11932,follow,276,9.476131312,250,5.298337366,5.295844311,69000,50.20774062,52,65,117,232,243,475,4,0.455399,0.468739,0.000012,No
16261,boundary,146,10.11292556,115,6.074866156,6.073725528,16790,61.43466919,38,40,78,123,123,246,4,0.455914,0.468631,0.000018,No
11445,geology,98,10.5115647,80,6.43777165,6.436981353,7840,67.67105321,40,38,78,74,85,159,4,0.459942,0.471786,0.000018,No
14046,daddy,21,12.05200974,18,7.929426526,7.929256515,378,95.56552572,13,13,26,17,15,32,4,0.422834,0.439717,0.000054,No
7228,muscular,27,11.80069531,26,7.561701746,7.56145172,702,89.23333834,15,12,27,24,20,44,5,0.331807,0.337143,0.000052,No
17589,antoine,33,11.60002462,29,7.452502454,7.452222421,957,86.44921192,21,6,27,26,14,40,5,0.333127,0.338361,0.000052,No
5817,photo,82,10.68981293,74,6.515733191,6.515002939,6068,69.65196891,30,31,61,58,69,127,4,0.459561,0.471349,0.000023,No
4245,roosevelt,87,10.63062406,55,6.812465099,6.811924964,4785,72.42075538,27,43,70,80,71,151,4,0.451025,0.464739,0.00002,No
16186,brawl,32,11.63079627,21,7.775275846,7.77507583,672,90.43264935,7,18,25,29,26,55,4,0.412564,0.430098,0.000056,No
568,warrior,125,10.26821844,98,6.234830806,6.233860354,12250,64.02060465,47,53,100,96,101,197,4,0.461448,0.473222,0.000014,No
15134,circular,81,10.70208302,69,6.58569178,6.585011562,5589,70.48062019,33,40,73,67,59,126,4,0.426205,0.443351,0.000019,No
10649,helena,83,10.67769157,43,7.058598169,7.058178089,3569,75.36953416,36,37,73,72,62,134,4,0.462109,0.473438,0.000019,No
4319,rna,116,10.34294199,47,6.969650683,6.969190586,5452,72.08669267,33,44,77,91,82,173,4,0.467759,0.477921,0.000018,No
7783,meningitis,17,12.26331883,5,9.210360372,9.210320372,85,112.9495858,11,11,22,17,16,33,4,0.40472,0.42223,0.000063,No
10596,herbert,77,10.75272676,69,6.58569178,6.585011562,5313,70.8141442,38,28,66,58,54,112,5,0.414037,0.431733,0.000021,No
7581,minerva,20,12.1007999,13,8.254848927,8.254728922,260,99.8902751,13,13,26,17,15,32,4,0.434158,0.4499,0.000053,No
15823,calcite,25,11.87765635,21,7.775275846,7.77507583,525,92.35205455,16,10,26,22,20,42,4,0.423783,0.44051,0.000053,No
318,willow,20,12.1007999,18,7.929426526,7.929256515,360,95.95240375,11,14,25,17,16,33,4,0.417425,0.434652,0.000055,No
8923,lars,33,11.60002462,25,7.600922459,7.600682435,825,88.17088763,17,8,25,23,11,34,4,0.42965,0.445796,0.000055,No
12428,extinct,241,9.611735244,190,5.572774212,5.570882462,45790,53.5640303,49,65,114,196,184,380,4,0.466138,0.477072,0.000012,No
15979,bull,101,10.48141166,77,6.475992862,6.475232589,7777,67.8775471,33,43,76,85,58,143,4,0.462917,0.474203,0.000018,No
11980,flu,50,11.18450917,26,7.561701746,7.56145172,1300,84.57392254,16,24,40,46,37,83,4,0.439272,0.454552,0.000034,No
2639,statesman,128,10.24450191,111,6.110268083,6.109167499,14208,62.59665307,38,42,80,108,106,214,4,0.462013,0.473471,0.000017,No
1964,taxonomy,95,10.54265529,85,6.377147028,6.376306692,8075,67.23206282,38,30,68,53,81,134,4,0.446544,0.460828,0.00002,No
15501,cave,145,10.11979843,81,6.42534913,6.424548825,11745,65.02323806,43,54,97,117,107,224,4,0.465649,0.476499,0.000014,No
13581,diet,143,10.13368755,114,6.083599836,6.08246922,16302,61.6492999,44,53,97,113,125,238,4,0.470076,0.479837,0.000014,No
10397,holt,19,12.1520932,16,8.047209562,8.047059554,304,97.79044058,10,13,23,17,15,32,5,0.401806,0.419354,0.000059,No
18334,able,712,8.528454266,634,4.36774933,4.361399338,451408,37.2501504,47,12,59,683,709,1392,5,0.384904,0.401594,0.000023,No
5041,puerto,189,9.854785162,116,6.066208093,6.065057454,21924,59.78117751,49,10,59,156,133,289,5,0.371329,0.386102,0.000023,No
6296,panther,31,11.66254497,17,7.98658494,7.986424931,527,93.14390604,9,17,26,30,28,58,4,0.449882,0.463303,0.000052,No
3305,silt,21,12.00548972,11,8.421903011,8.421803008,231,101.1090701,13,13,26,16,17,33,4,0.406294,0.423831,0.000052,No
3574,sesame,39,11.43297053,31,7.38581108,7.385511041,1209,84.44176042,20,6,26,29,31,60,5,0.32786,0.331752,0.000052,No
2809,spiritual,157,10.04028637,127,5.975611198,5.974350429,19939,59.99684767,42,48,90,128,70,198,5,0.399644,0.417795,0.000015,No
14268,creole,24,11.91847835,19,7.875359305,7.875179292,456,93.86229935,11,14,25,23,18,41,4,0.44204,0.456749,0.000054,No
5081,psalm,17,12.26331883,6,9.028038815,9.027988815,102,110.7137184,12,13,25,14,17,31,4,0.435757,0.451303,0.000054,No
3881,scarlet,32,11.63079627,24,7.641744454,7.641514432,768,88.87957293,13,12,25,27,18,45,4,0.399689,0.417131,0.000054,No
18177,adenine,21,12.05200974,11,8.421903011,8.421803008,231,101.5008571,13,12,25,17,18,35,4,0.426491,0.443036,0.000054,No
18353,abbott,50,11.18450917,26,7.561701746,7.56145172,1300,84.57392254,27,23,50,45,39,84,4,0.442514,0.45727,0.000027,No
8345,lyon,59,11.01899473,43,7.058598169,7.058178089,2537,77.77865604,27,29,56,53,42,95,4,0.4452,0.459674,0.000024,No
5126,prostitute,23,11.96103796,17,7.98658494,7.986424931,391,95.52784565,8,16,24,23,19,42,4,0.414211,0.431675,0.000056,No
599,walsh,20,12.1007999,17,7.98658494,7.986424931,340,96.64406628,9,12,21,11,14,25,4,0.40899,0.426506,0.000064,No
18255,account,140,10.15488975,113,6.092410465,6.09128986,15820,61.86775662,42,42,84,108,121,229,4,0.466407,0.47686,0.000016,No
3889,scar,18,12.20616042,12,8.334891634,8.334781631,216,101.7370244,14,10,24,15,18,33,4,0.444642,0.458838,0.000056,No
2526,stomach,128,10.24450191,88,6.34246147,6.341591108,11264,64.97535866,28,46,74,117,95,212,4,0.454792,0.467856,0.000018,No
12815,engineer,139,10.16205824,113,6.092410465,6.09128986,15707,61.91143,47,64,111,101,119,220,4,0.455949,0.469128,0.000012,No
17259,athletic,161,10.01512781,107,6.14696945,6.145908909,17227,61.5626847,56,27,83,98,80,178,4,0.41516,0.432741,0.000016,No
728,visible,164,9.99666575,141,5.871038394,5.869637441,23124,58.69080843,49,53,102,133,139,272,4,0.452959,0.4665,0.000013,No
3454,shift,84,10.66571538,35,7.264450223,7.264110172,2940,77.48055846,40,38,78,83,74,157,4,0.460897,0.472527,0.000017,No
3318,silica,28,11.76432767,24,7.641744454,7.641514432,672,89.8999857,10,15,25,24,20,44,4,0.437378,0.45274,0.000053,No
14013,damon,24,11.91847835,16,8.047209562,8.047059554,384,95.91049292,10,15,25,12,19,31,4,0.429453,0.44574,0.000053,No
10367,honest,20,12.1007999,20,7.824066011,7.823875996,400,94.67745723,12,13,25,16,19,35,4,0.426164,0.442754,0.000053,No
6012,pensacola,23,11.96103796,15,8.111748083,8.111608076,345,97.02492676,13,12,25,20,20,40,4,0.435533,0.451083,0.000053,No
2829,spicy,18,12.20616042,14,8.180740955,8.180610949,252,99.85543644,15,10,25,15,11,26,4,0.423955,0.440647,0.000053,No
1303,trinity,92,10.5747436,67,6.615105665,6.61444546,6164,69.95304629,29,37,66,72,75,147,4,0.458268,0.470438,0.00002,No
7333,moss,71,10.8338523,39,7.156236638,7.155856573,2769,77.52961076,32,34,66,57,56,113,4,0.444988,0.459603,0.00002,No
11428,germanic,141,10.14777229,101,6.204677767,6.203677287,14241,62.9636571,41,25,66,131,64,195,4,0.412593,0.430281,0.00002,No
594,waltz,23,11.96103796,11,8.421903011,8.421803008,253,100.7347016,8,14,22,20,18,38,4,0.419289,0.436529,0.00006,No
8403,luke,117,10.33435824,67,6.615105665,6.61444546,7839,68.36287175,37,51,88,93,80,173,4,0.455715,0.468664,0.000015,No
2130,syndrome,71,10.8338523,48,6.948597273,6.948127172,3408,75.28007655,25,30,55,45,52,97,4,0.455961,0.468462,0.000024,No
2392,subsidiary,50,11.18450917,49,6.927977986,6.92749788,2450,77.48603333,11,13,24,37,44,81,4,0.438394,0.453599,0.000055,No
15039,cliff,47,11.24638458,39,7.156236638,7.155856573,1833,80.48178935,21,23,44,41,36,77,4,0.439099,0.454467,0.00003,No
14208,crown,200,9.798214811,154,5.782845682,5.781314541,30800,56.66156421,60,60,120,183,168,351,4,0.464479,0.475706,0.000011,No
281,wire,149,10.09258587,98,6.234830806,6.233860354,14602,62.9255653,40,54,94,111,128,239,4,0.464151,0.475349,0.000014,No
14285,cream,173,9.943240583,86,6.365450988,6.364600644,14878,63.29321059,44,57,101,137,123,260,4,0.469305,0.479302,0.000013,No
13773,democratic,363,9.202129343,276,5.199397418,5.196643685,100188,47.84552755,62,39,101,330,200,530,4,0.401289,0.4193,0.000013,No
16978,bangladesh,231,9.654114467,130,5.952263834,5.950973027,30030,57.46383639,58,73,131,212,173,385,4,0.459573,0.472142,0.00001,No
12391,fabric,93,10.56393268,70,6.571303042,6.570612818,6510,69.41880298,38,39,77,84,67,151,4,0.453468,0.466631,0.000017,No
12416,extreme,167,9.978538365,135,5.914523506,5.913182634,22545,59.01829971,62,57,119,146,99,245,4,0.430766,0.447759,0.000011,No
9383,join,304,9.379504476,282,5.177891213,5.175077314,85728,48.56605381,46,63,109,264,281,545,4,0.469454,0.479555,0.000012,No
12630,ethiopia,121,10.30074163,96,6.255450093,6.25449966,11616,64.4357752,27,60,87,107,93,200,4,0.46363,0.475062,0.000015,No
8709,liberal,208,9.758994098,146,5.836191663,5.834740639,30368,56.95535999,55,32,87,176,118,294,5,0.405357,0.423274,0.000015,No
2456,strike,108,10.41440095,73,6.529338843,6.528618598,7884,67.99915265,44,49,93,90,95,185,4,0.467895,0.478133,0.000014,No
15596,carry,328,9.303518569,284,5.170824046,5.167990091,93152,48.10685753,36,94,130,273,242,515,4,0.467821,0.478926,0.00001,No
16830,beam,93,10.56393268,38,7.182212124,7.181842063,3534,75.87240541,29,36,65,77,64,141,4,0.460551,0.472213,0.00002,No
7288,ms,21,12.05200974,27,7.98658494,7.986424931,567,96.25439949,13,12,25,16,12,28,4,0.372975,0.388246,0.000052,No
3659,sell,276,9.476131312,238,5.347527611,5.345154845,65688,50.67387383,33,85,118,252,214,466,4,0.472352,0.482137,0.000011,No
14167,cuba,247,9.587143841,139,5.885324351,5.883943426,34333,56.4234511,57,87,144,220,210,430,4,0.469727,0.480222,0.000009,No
15893,butler,53,11.12624026,39,7.156236638,7.155856573,2067,79.62200822,22,32,54,38,47,85,4,0.456148,0.468664,0.000024,No
14696,cone,67,10.89183956,38,7.182212124,7.181842063,2546,78.22750213,22,26,48,53,47,100,4,0.464929,0.475429,0.000027,No
11494,geese,21,12.05200974,15,8.111748083,8.111608076,315,97.7628669,12,12,24,13,20,33,4,0.421079,0.438041,0.000054,No
15297,cheryl,18,12.20616042,14,8.180740955,8.180610949,252,99.85543644,15,9,24,15,12,27,4,0.390424,0.407329,0.000054,No
12505,exercise,72,10.81986606,59,6.74226084,6.741680684,4248,72.95035922,34,34,68,53,59,112,4,0.44605,0.460462,0.000019,No
11803,frances,46,11.26789078,31,7.38581108,7.385511041,1426,83.22251257,23,20,43,35,29,64,5,0.387509,0.404373,0.00003,No
8364,luxembourg,169,9.966633462,117,6.057624349,6.056463699,19773,60.37412154,37,55,92,155,145,300,4,0.453549,0.467002,0.000014,No
16335,boogie,21,12.05200974,17,7.98658494,7.986424931,357,96.25439949,14,9,23,16,9,25,4,0.400854,0.41854,0.000056,No
1695,throat,92,10.5747436,65,6.645411014,6.644770822,5980,70.2735176,26,32,58,84,70,154,4,0.451186,0.464669,0.000022,No
11283,goal,282,9.454625106,229,5.386076281,5.383793723,64578,50.92333203,58,58,116,240,242,482,4,0.470499,0.480241,0.000011,No
17549,apollo,127,10.25234509,74,6.515733191,6.515002939,9398,66.80154519,40,58,98,103,101,204,4,0.447421,0.462058,0.000013,No
3647,seminary,36,11.51301324,30,7.418600903,7.418310866,1080,85.41045041,8,16,24,16,27,43,4,0.445356,0.459556,0.000053,No
8976,lamp,72,10.81986606,28,7.487593774,7.487323743,2016,81.01476173,19,34,53,61,63,124,4,0.45304,0.466208,0.000024,No
16564,bind,23,11.96103796,22,7.728755831,7.728545813,506,92.44394189,9,15,24,18,21,39,4,0.425235,0.441975,0.000053,No
17421,aristocracy,20,12.1007999,14,8.180740955,8.180610949,280,98.99350936,12,12,24,17,16,33,4,0.429962,0.446153,0.000053,No
13369,dominion,24,11.91847835,21,7.775275846,7.77507583,504,92.66945682,14,10,24,23,21,44,4,0.442922,0.457411,0.000053,No
17004,ballroom,25,11.87765635,21,7.775275846,7.77507583,525,92.35205455,11,12,23,15,21,36,4,0.429588,0.445825,0.000055,No
4164,rum,20,12.1007999,14,8.180740955,8.180610949,280,98.99350936,11,12,23,16,15,31,4,0.412747,0.430192,0.000055,No
16488,blanket,18,12.20616042,12,8.334891634,8.334781631,216,101.7370244,11,12,23,16,14,30,4,0.403524,0.421056,0.000055,No
17336,ashley,49,11.20471188,36,7.236279346,7.235929291,1764,81.08042515,27,28,55,35,34,69,4,0.402636,0.42046,0.000023,No
6754,ny,21,12.05200974,18,7.929426526,7.929256515,378,95.56552572,12,11,23,16,12,28,5,0.386926,0.403538,0.000055,No
17671,anita,19,12.1520932,14,8.180740955,8.180610949,266,99.41312651,12,11,23,14,12,26,4,0.393548,0.410728,0.000055,No
774,viii,259,9.539704116,204,5.50167829,5.499646268,52836,52.48438303,35,62,97,250,204,454,4,0.465979,0.476907,0.000013,No
7852,medici,77,10.75272676,57,6.776747016,6.776186871,4389,72.86850896,8,27,35,72,60,132,4,0.445468,0.459852,0.000036,No
11315,glory,76,10.76579884,62,6.692663899,6.692053725,4712,72.05187322,27,36,63,57,69,126,4,0.451944,0.465354,0.00002,No
9111,klein,42,11.35886256,23,7.684304068,7.684084048,966,87.28495377,24,21,45,38,29,67,4,0.442701,0.457401,0.000028,No
15294,chess,133,10.20618305,66,6.630143542,6.629493344,8778,67.66845863,48,42,90,106,81,187,4,0.459799,0.471753,0.000014,No
5443,porto,51,11.16470654,33,7.323290723,7.322970678,1683,81.76239186,24,18,42,35,29,64,4,0.4452,0.459462,0.00003,No
18244,ace,74,10.79246708,43,7.058598169,7.058178089,3182,76.17968839,36,27,63,54,55,109,4,0.457771,0.469884,0.00002,No
4300,robin,103,10.46180319,75,6.502310171,6.501569912,7725,68.02588928,40,30,70,69,66,135,4,0.456394,0.468833,0.000018,No
2307,sung,181,9.898035146,150,5.80916299,5.807671909,27150,57.49929945,36,38,74,152,163,315,4,0.452197,0.465598,0.000017,No
16753,bela,20,12.1007999,18,7.929426526,7.929256515,360,95.95240375,10,7,17,13,13,26,5,0.333346,0.33856,0.000074,No
3986,sanskrit,125,10.26821844,105,6.165837934,6.164797414,13125,63.31217077,23,43,66,100,92,192,4,0.45949,0.471509,0.000019,No
11107,greg,57,11.05348091,45,7.013135794,7.012695706,2565,77.51956262,28,22,50,39,35,74,5,0.350291,0.360594,0.000025,No
7244,munich,208,9.758994098,148,5.82258601,5.821114958,30784,56.82258251,36,60,96,164,183,347,4,0.461161,0.473156,0.000013,No
1735,thompson,73,10.80607274,52,6.868554566,6.868044446,3796,74.22210023,35,43,78,53,57,110,4,0.449256,0.463303,0.000016,No
15478,celebrity,80,10.71450554,62,6.692663899,6.692053725,4960,71.70858444,38,40,78,69,60,129,4,0.457878,0.470189,0.000016,No
9399,joel,51,11.16470654,36,7.236279346,7.235929291,1836,80.79093537,26,26,52,40,36,76,4,0.412028,0.42976,0.000024,No
14811,commonwealth,236,9.632700372,160,5.744624469,5.743033235,37760,55.33624626,35,54,89,228,161,389,4,0.461941,0.473659,0.000014,No
8820,leeds,114,10.36033373,53,6.849506371,6.848986246,6042,70.96317188,37,46,83,98,84,182,4,0.440712,0.45619,0.000015,No
11591,gallery,123,10.28434782,94,6.276503502,6.275573088,11562,64.54974512,24,45,69,85,103,188,4,0.469367,0.479165,0.000018,No
1559,tomb,94,10.5532374,67,6.615105665,6.61444546,6298,69.81078047,26,28,54,77,68,145,4,0.456782,0.469114,0.000023,No
16293,boron,17,12.26331883,6,9.028038815,9.027988815,102,110.7137184,14,9,23,17,16,33,4,0.390252,0.407334,0.000054,No
3177,slave,126,10.26025027,101,6.204677767,6.203677287,12726,63.66154674,34,39,73,107,91,198,4,0.455902,0.468607,0.000017,No
12140,finale,20,12.1007999,19,7.875359305,7.875179292,380,95.29814712,7,13,20,18,16,34,4,0.425632,0.442379,0.000062,No
11939,folk,247,9.587143841,175,5.65501231,5.65327083,43225,54.21541644,73,51,124,191,190,381,4,0.439784,0.455477,0.00001,No
6860,norfolk,130,10.22899773,86,6.365450988,6.364600644,11180,65.11218369,33,44,77,106,111,217,4,0.457005,0.46957,0.000016,No
12871,emil,22,12.00548972,22,7.728755831,7.728545813,484,92.78749871,15,7,22,17,11,28,5,0.326455,0.329996,0.000056,No
10,zoo,99,10.50141233,64,6.660915201,6.660285015,6336,69.949017,43,39,82,86,84,170,4,0.460598,0.472307,0.000015,No
10120,ida,30,11.6953348,15,8.111748083,8.111608076,450,94.86960961,17,18,35,20,24,44,4,0.449449,0.462983,0.000035,No
11964,flux,55,11.08919899,18,7.929426526,7.929256515,990,87.93098864,25,24,49,48,41,89,4,0.459359,0.471039,0.000025,No
15830,cake,95,10.54265529,43,7.058598169,7.058178089,4085,74.41636729,34,34,68,88,69,157,4,0.461149,0.472649,0.000018,No
16811,beaver,51,11.16470654,32,7.354062381,7.35375234,1632,82.1059484,27,24,51,44,42,86,4,0.438004,0.453449,0.000024,No
14024,dallas,127,10.25234509,86,6.365450988,6.364600644,10922,65.26080019,39,33,72,109,80,189,4,0.443897,0.45866,0.000017,No
5319,premier,317,9.337630403,193,5.557108095,5.555186288,61181,51.89022151,58,36,94,277,306,583,4,0.464893,0.475584,0.000013,No
11014,guiana,34,11.57017165,17,7.98658494,7.986424931,578,92.40615868,8,15,23,34,29,63,4,0.437551,0.45289,0.000053,No
14853,coma,21,12.05200974,16,8.047209562,8.047059554,336,96.98504802,8,15,23,19,18,37,4,0.454025,0.46665,0.000053,No
11223,gorge,26,11.83843564,23,7.684304068,7.684084048,598,90.97013915,10,13,23,17,21,38,4,0.447219,0.46104,0.000053,No
10213,hurst,20,12.1007999,11,8.421903011,8.421803008,220,101.9117632,10,13,23,17,17,34,4,0.407975,0.425483,0.000053,No
6206,partial,61,10.98565831,51,6.887972651,6.887472536,3111,75.66891402,29,24,53,56,40,96,4,0.435918,0.451655,0.000023,No
14426,corrosion,18,12.20616042,11,8.421903011,8.421803008,198,102.7990992,13,10,23,16,17,33,5,0.386294,0.402937,0.000053,No
13061,ecstasy,16,12.32394346,11,8.421903011,8.421803008,176,103.7910565,13,10,23,13,12,25,5,0.362754,0.375781,0.000053,No
6310,pandora,24,11.91847835,8,8.740356743,8.740286741,192,104.1717526,13,10,23,18,18,36,4,0.385029,0.401503,0.000053,No
12731,equatorial,32,11.63079627,27,7.523961418,7.52370139,864,87.50966243,14,9,23,29,29,58,5,0.329938,0.334476,0.000053,No
17303,assistant,133,10.20618305,114,6.083599836,6.08246922,15162,62.09033352,45,42,87,113,108,221,4,0.453932,0.467091,0.000014,No
5926,perry,80,10.71450554,48,6.948597273,6.948127172,3840,74.450784,37,39,76,54,61,115,4,0.460348,0.472128,0.000016,No
5487,pond,40,11.40765272,30,7.418600903,7.418310866,1200,84.62882279,19,19,38,33,33,66,5,0.417317,0.434776,0.000032,No
13714,derek,46,11.26789078,34,7.29343776,7.293107712,1564,82.18166009,25,13,38,30,25,55,5,0.386437,0.403059,0.000032,No
6899,nm,21,12.05200974,13,8.254848927,8.254728922,273,99.48751966,12,15,27,16,20,36,4,0.428623,0.445003,0.000045,No
9248,kashmir,360,9.210428146,197,5.536594555,5.534632671,70920,50.99440633,39,82,121,278,292,570,4,0.468401,0.47909,0.00001,No
16899,basalt,21,12.05200974,12,8.334891634,8.334781631,252,100.4521952,12,10,22,15,15,30,4,0.394362,0.411536,0.000055,No
3804,score,162,10.00893584,112,6.101299413,6.100188819,18144,61.06751438,53,57,110,129,137,266,4,0.463727,0.475077,0.000011,No
3232,sixth,234,9.641211062,220,5.426170738,5.42397838,51480,52.31485734,29,64,93,220,158,378,4,0.422412,0.44029,0.000013,No
15126,circus,41,11.38296011,35,7.264450223,7.264110172,1435,82.69094711,16,23,39,30,31,61,4,0.435063,0.450895,0.000031,No
16093,brittany,109,10.4051843,77,6.475992862,6.475232589,8393,67.38389923,22,45,67,98,87,185,4,0.454385,0.46749,0.000018,No
10417,holland,127,10.25234509,90,6.319988614,6.319098235,11430,64.79470424,33,53,86,107,102,209,4,0.460861,0.472757,0.000014,No
17919,alien,95,10.54265529,73,6.529338843,6.528618598,6935,68.83656867,38,48,86,78,69,147,4,0.456359,0.469152,0.000014,No
5751,pillow,15,12.38848198,13,8.254848927,8.254728922,195,102.2650471,7,13,20,15,15,30,4,0.418715,0.43598,0.00006,No
15136,circuit,161,10.01512781,100,6.214628098,6.213637628,16100,62.24029471,41,59,100,103,125,228,4,0.468698,0.478917,0.000012,No
6904,nitrogen,100,10.49136199,60,6.725453722,6.72486356,6000,70.55916955,44,36,80,87,81,168,4,0.443365,0.458237,0.000015,No
13692,desire,58,11.03608917,52,6.868554566,6.868044446,3016,75.80198063,30,20,50,51,54,105,4,0.455271,0.467748,0.000024,No
3101,smoke,90,10.59672251,60,6.725453722,6.72486356,5400,71.26776683,34,41,75,77,73,150,4,0.465857,0.47641,0.000016,No
18039,agricultural,113,10.36914436,99,6.224678434,6.223697973,11187,64.54458927,41,34,75,84,65,149,4,0.435127,0.451139,0.000016,No
549,watch,190,9.849508105,151,5.802518447,5.801017351,28690,57.15195248,47,62,109,172,150,322,4,0.462579,0.474278,0.000011,No
5074,psychiatrist,22,12.00548972,21,7.775275846,7.77507583,462,93.34599428,9,12,21,17,22,39,5,0.386093,0.402679,0.000057,No
3871,scenic,21,12.05200974,21,7.775275846,7.77507583,441,93.70770023,11,11,22,14,14,28,5,0.385858,0.402369,0.000054,No
2004,tara,19,12.1520932,13,8.254848927,8.254728922,247,100.3136935,11,11,22,12,15,27,4,0.39374,0.410925,0.000054,No
10527,hi,14,12.45747485,13,8.254848927,8.254728922,182,102.8345729,11,11,22,11,12,23,4,0.427921,0.444299,0.000054,No
1434,trance,25,11.87765635,15,8.111748083,8.111608076,375,96.34855615,12,10,22,18,16,34,4,0.401588,0.419305,0.000054,No
9886,inequality,17,12.26331883,10,8.517213191,8.517123189,170,104.4493009,13,9,22,15,15,30,4,0.440679,0.455467,0.000054,No
17747,anaerobic,26,11.83843564,11,8.421903011,8.421803008,286,99.70215676,17,5,22,22,18,40,5,0.398756,0.416542,0.000054,No
13614,diameter,264,9.520583074,226,5.399263285,5.397010795,59664,51.40413464,29,50,79,242,228,470,4,0.453711,0.467063,0.000015,No
10656,heinrich,112,10.37803331,99,6.224678434,6.223697973,11088,64.59992011,54,20,74,81,47,128,5,0.387678,0.404547,0.000016,No
9316,julius,160,10.02135836,126,5.983516377,5.98226562,20160,59.96296188,55,19,74,100,129,229,5,0.38931,0.406308,0.000016,No
15534,category,253,9.563142689,187,5.588689667,5.586827973,47311,53.44543673,60,58,118,208,226,434,4,0.457347,0.470119,0.00001,No
5380,poverty,76,10.76579884,62,6.692663899,6.692053725,4712,72.05187322,34,28,62,64,62,126,4,0.456265,0.468687,0.000019,No
8459,lot,1295,7.930266203,1136,3.784529685,3.773115012,1471120,30.01232786,16,82,98,1278,1249,2527,4,0.471499,0.481438,0.000012,No
11330,glenn,61,10.98565831,46,6.991156888,6.990706795,2806,76.80246078,27,20,47,40,40,80,5,0.388408,0.405341,0.000025,No
1624,timothy,44,11.31234254,40,7.13091883,7.130528762,1760,80.66739646,27,20,47,32,24,56,4,0.392574,0.409831,0.000025,No
12381,factor,110,10.39605181,82,6.413079037,6.412268725,9020,66.67070194,30,39,69,100,97,197,4,0.458303,0.470509,0.000017,No
11654,funny,85,10.65388092,72,6.543132165,6.542421927,6120,69.70975094,36,42,78,73,59,132,4,0.43974,0.455317,0.000015,No
5206,progress,73,10.80607274,60,6.725453722,6.72486356,4380,72.6757421,32,33,65,67,63,130,4,0.463315,0.474325,0.000018,No
17248,atomic,283,9.45108528,204,5.50167829,5.499646268,57732,51.9968307,51,27,78,208,132,340,4,0.389379,0.406503,0.000015,No
14362,couple,180,9.903575326,164,5.719931856,5.718300559,29520,56.647776,24,49,73,173,128,301,4,0.46282,0.474236,0.000016,No
9735,instructor,18,12.20616042,18,7.929426526,7.929256515,324,96.78785221,9,13,22,12,17,29,4,0.451473,0.464561,0.000053,No
5946,perkins,17,12.26331883,15,8.111748083,8.111608076,255,99.47695304,10,12,22,14,14,28,4,0.406211,0.423831,0.000053,No
13518,diploma,24,11.91847835,19,7.875359305,7.875179292,456,93.86229935,11,11,22,22,20,42,4,0.423884,0.440689,0.000053,No
14343,cove,19,12.1520932,15,8.111748083,8.111608076,285,98.57471871,11,11,22,15,16,31,4,0.435811,0.451313,0.000053,No
13625,diagonal,21,12.05200974,11,8.421903011,8.421803008,231,101.5008571,11,11,22,19,18,37,4,0.412057,0.429488,0.000053,No
17393,arose,21,12.05200974,21,7.775275846,7.77507583,441,93.70770023,12,10,22,12,21,33,5,0.399375,0.416781,0.000053,No
8059,marquette,19,12.1520932,11,8.421903011,8.421803008,209,102.3437503,13,9,22,18,14,32,4,0.418527,0.435576,0.000053,No
6166,patch,50,11.18450917,36,7.236279346,7.235929291,1800,80.93423271,33,20,53,49,40,89,4,0.448473,0.462227,0.000022,No
11841,fossil,213,9.735240012,154,5.782845682,5.781314541,32802,56.29739066,59,38,97,170,85,255,4,0.4497,0.463575,0.000012,No
10784,harris,84,10.66571538,60,6.725453722,6.72486356,5040,71.73177519,39,44,83,58,67,125,4,0.454734,0.467781,0.000014,No
17482,arabia,144,10.12671888,96,6.255450093,6.25449966,13824,63.34718454,20,69,89,136,122,258,4,0.465429,0.476612,0.000013,No
9320,julia,71,10.8338523,53,6.849506371,6.848986246,3763,74.20654035,39,29,68,50,42,92,4,0.43821,0.45373,0.000017,No
2833,spheroid,14,12.45747485,13,8.254848927,8.254728922,182,102.8345729,4,7,11,13,13,26,5,0.370252,0.384666,0.000105,No
4431,reynolds,15,12.38848198,14,8.180740955,8.180610949,210,101.3469619,9,12,21,13,14,27,4,0.416543,0.43376,0.000055,No
16675,berkeley,83,10.67769157,58,6.759355274,6.758785123,4814,72.17431082,25,39,64,72,65,137,4,0.447455,0.46172,0.000018,No
15026,clinton,161,10.01512781,68,6.600290579,6.599620368,10948,66.10275375,45,70,115,119,141,260,4,0.463691,0.475288,0.00001,No
1198,turbine,57,11.05348091,29,7.452502454,7.452222421,1653,82.37609361,16,30,46,50,41,91,4,0.44633,0.460622,0.000025,No
5176,pronounce,56,11.07118049,55,6.812465099,6.811924964,3080,75.42203067,18,23,41,24,46,70,4,0.44171,0.456627,0.000028,No
11706,frontier,54,11.10754813,42,7.082128666,7.08171859,2268,78.66508503,25,27,52,41,45,86,4,0.441512,0.456519,0.000022,No
15217,chop,19,12.1520932,11,8.421903011,8.421803008,209,102.3437503,9,13,22,12,17,29,5,0.373218,0.388337,0.000052,No
6038,penance,17,12.26331883,5,9.210360372,9.210320372,85,112.9495858,11,11,22,12,14,26,4,0.445714,0.459739,0.000052,No
16069,bronze,203,9.783326198,142,5.863971227,5.86256026,28826,57.36914333,50,38,88,179,172,351,4,0.461484,0.472969,0.000013,No
15999,buenos,61,10.98565831,42,7.082128666,7.08171859,2562,77.80184565,21,1,22,50,60,110,5,0.312029,0.31648,0.000052,No
9016,lack,138,10.16927849,132,5.936996362,5.935685529,18216,60.37496941,39,18,57,121,132,253,4,0.443144,0.457847,0.00002,No
9476,jar,59,11.01899473,22,7.728755831,7.728545813,1298,85.1631198,15,23,38,43,43,86,4,0.460873,0.472227,0.00003,No
12868,emily,62,10.96939779,46,6.991156888,6.990706795,2852,76.68878093,28,32,60,43,45,88,4,0.429494,0.446097,0.000019,No
15362,chard,14,12.45747485,7,8.873888135,8.873828135,98,110.5462382,11,9,20,14,11,25,4,0.41833,0.435515,0.000057,No
15869,byron,75,10.77904406,38,7.182212124,7.181842063,2850,77.41738097,30,37,67,58,54,112,4,0.452255,0.465617,0.000017,No
2256,surname,85,10.65388092,77,6.475992862,6.475232589,6545,68.9944568,31,36,67,75,64,139,4,0.465368,0.475959,0.000017,No
16788,beef,75,10.77904406,50,6.907775279,6.907285168,3750,74.45921411,32,35,67,58,62,120,4,0.451461,0.464922,0.000017,No
13251,drew,81,10.70208302,67,6.615105665,6.61444546,5427,70.79541003,37,34,71,68,63,131,4,0.442448,0.457491,0.000016,No
12550,ex,24,11.91847835,22,7.728755831,7.728545813,528,92.11500902,8,13,21,11,13,24,4,0.407881,0.425558,0.000054,No
13818,delaware,131,10.22133485,67,6.615105665,6.61444546,8777,67.6152101,36,45,81,113,104,217,4,0.451507,0.465143,0.000014,No
16005,buddhist,123,10.28434782,99,6.224678434,6.223697973,12177,64.0167581,38,43,81,108,73,181,4,0.397844,0.415789,0.000014,No
3057,snyder,18,12.20616042,11,8.421903011,8.421803008,198,102.7990992,10,11,21,15,14,29,4,0.402901,0.420418,0.000054,No
138,xenon,16,12.32394346,5,9.210360372,9.210320372,80,113.5079604,10,11,21,13,12,25,5,0.38249,0.398937,0.000054,No
14750,compression,69,10.86242567,31,7.38581108,7.385511041,2139,80.22782389,26,28,54,56,55,111,4,0.450133,0.46373,0.000021,No
10809,hardware,110,10.39605181,85,6.377147028,6.376306692,9350,66.29715091,42,39,81,74,71,145,4,0.463279,0.474386,0.000014,No
9737,institution,121,10.30074163,94,6.276503502,6.275573088,11374,64.65264092,34,29,63,80,97,177,4,0.456888,0.469199,0.000018,No
3698,sector,59,11.01899473,40,7.13091883,7.130528762,2360,78.57555703,30,24,54,52,46,98,4,0.443997,0.458566,0.000021,No
4439,revival,60,11.00218762,29,7.452502454,7.452222421,1740,81.9938302,32,22,54,51,44,95,4,0.444075,0.458678,0.000021,No
12104,firm,84,10.66571538,72,6.543132165,6.542421927,6048,69.78718536,32,43,75,69,64,133,4,0.455633,0.468476,0.000015,No
12028,flemish,134,10.19869238,110,6.119317918,6.118227346,14740,62.40904101,21,24,45,121,38,159,4,0.427467,0.44413,0.000025,No
1081,uniform,91,10.58567267,62,6.692663899,6.692053725,5642,70.84634933,35,40,75,82,63,145,4,0.452128,0.465584,0.000015,No
7868,meanwhile,35,11.54118412,33,7.323290723,7.322970678,1155,84.51944657,24,27,51,26,33,59,4,0.43402,0.450195,0.000022,No
4287,rocky,120,10.30904043,98,6.234830806,6.233860354,11760,64.27512288,38,28,66,102,56,158,4,0.397871,0.415554,0.000017,No
5758,pile,27,11.80069531,18,7.929426526,7.929256515,486,93.57274643,8,12,20,24,23,47,4,0.448847,0.462472,0.000056,No
14000,danger,120,10.30904043,117,6.057624349,6.056463699,14040,62.44829436,35,45,80,113,107,220,4,0.466542,0.477029,0.000014,No
17945,alexis,18,12.20616042,18,7.929426526,7.929256515,324,96.78785221,12,8,20,13,10,23,5,0.380784,0.396932,0.000056,No
10598,herb,45,11.28986969,39,7.156236638,7.155856573,1755,80.7929791,22,21,43,36,36,72,4,0.412574,0.430178,0.000026,No
12997,eighth,106,10.43309308,100,6.214628098,6.213637628,10600,64.83779343,16,46,62,100,77,177,4,0.424696,0.442064,0.000018,No
14842,comedian,181,9.898035146,161,5.738393919,5.73679267,29141,56.79882469,35,58,93,135,141,276,4,0.457642,0.470354,0.000012,No
1785,theorem,102,10.47155936,48,6.948597273,6.948127172,4896,72.76264884,26,36,62,88,89,177,4,0.46876,0.478532,0.000018,No
8264,magnetic,217,9.716634824,102,6.194825471,6.193814981,22134,60.1928569,56,37,93,181,160,341,4,0.420979,0.438431,0.000012,No
7525,mistletoe,17,12.26331883,6,9.028038815,9.027988815,102,110.7137184,10,11,21,16,12,28,4,0.442172,0.456777,0.000053,No
16410,boa,24,11.91847835,12,8.334891634,8.334781631,288,99.33922547,13,8,21,18,14,32,5,0.36334,0.376396,0.000053,No
2673,stand,264,9.520583074,212,5.46321201,5.461099823,55968,52.01296379,78,61,139,218,249,467,4,0.471424,0.480996,0.000008,No
4498,respect,119,10.31740868,111,6.110268083,6.109167499,13209,63.04213298,36,29,65,107,105,212,4,0.452947,0.466063,0.000017,No
8054,marry,119,10.31740868,98,6.234830806,6.233860354,11662,64.3272975,20,49,69,114,100,214,4,0.461233,0.472997,0.000016,No
14420,cortex,23,11.96103796,13,8.254848927,8.254728922,299,98.73656138,7,15,22,19,21,40,4,0.443975,0.458354,0.00005,No
3925,save,237,9.628472036,196,5.541683625,5.53973176,46452,53.35794582,37,73,110,213,210,423,4,0.460981,0.473269,0.00001,No
11510,gauss,19,12.1520932,13,8.254848927,8.254728922,247,100.3136935,7,13,20,18,15,33,4,0.432614,0.448533,0.000055,No
17891,alligator,25,11.87765635,10,8.517213191,8.517123189,250,101.1645314,9,11,20,17,13,30,4,0.393941,0.411108,0.000055,No
15856,cabinet,185,9.876176352,137,5.899817358,5.89845646,25345,58.26763668,48,52,100,168,118,286,4,0.455119,0.468246,0.000011,No
13900,decade,104,10.45214128,86,6.365450988,6.364600644,8944,66.53259303,23,38,61,101,84,185,4,0.461436,0.472959,0.000018,No
16865,baton,16,12.32394346,14,8.180740955,8.180610949,224,100.8189889,9,6,15,15,15,30,4,0.42198,0.4389,0.000073,No
17983,albany,101,10.48141166,39,7.156236638,7.155856573,3939,75.00746214,48,43,91,93,88,181,4,0.436325,0.452449,0.000012,No
5140,prose,41,11.38296011,34,7.29343776,7.293107712,1394,83.02091109,21,18,39,37,23,60,4,0.434828,0.450599,0.000028,No
15207,chose,144,10.12671888,140,5.878155862,5.876764922,20160,59.52643193,50,41,91,111,128,239,4,0.453178,0.466476,0.000012,No
17466,archaic,20,12.1007999,19,7.875359305,7.875179292,380,95.29814712,9,12,21,15,14,29,5,0.350942,0.361223,0.000052,No
9103,knew,172,9.949037701,163,5.726048083,5.724426802,28036,56.96866826,37,47,84,147,155,302,4,0.460216,0.472161,0.000013,No
7023,nerve,68,10.87702447,44,7.03560865,7.035178566,2992,76.52648747,27,15,42,53,23,76,4,0.442834,0.457416,0.000026,No
14870,colonel,67,10.89183956,59,6.74226084,6.741680684,3953,73.43562333,26,42,68,54,62,116,4,0.457547,0.469974,0.000016,No
6143,patricia,31,11.66254497,30,7.418600903,7.418310866,930,86.51976666,22,12,34,26,14,40,5,0.369174,0.383605,0.000032,No
8108,marco,58,11.03608917,42,7.082128666,7.08171859,2436,78.15900345,31,16,47,42,40,82,5,0.370075,0.384647,0.000023,No
14324,coyote,14,12.45747485,8,8.740356743,8.740286741,112,108.8827743,10,10,20,12,12,24,4,0.399366,0.416798,0.000054,No
1099,ultra,19,12.1520932,17,7.98658494,7.986424931,323,97.05372453,11,9,20,15,10,25,5,0.353979,0.365007,0.000054,No
17852,alpine,54,11.10754813,36,7.236279346,7.235929291,1944,80.37732112,20,16,36,44,31,75,4,0.401788,0.419685,0.00003,No
10838,hank,45,11.28986969,30,7.418600903,7.418310866,1350,83.75503745,27,18,45,33,27,60,4,0.413131,0.430783,0.000024,No
413,whereas,93,10.56393268,89,6.331161914,6.330281545,8277,66.88196828,56,34,90,56,74,130,4,0.439523,0.455031,0.000012,No
12951,elementary,130,10.22899773,84,6.388981485,6.388151157,10920,65.35287709,50,22,72,103,99,202,4,0.410808,0.428488,0.000015,No
12548,exact,151,10.07925234,137,5.899817358,5.89845646,20687,59.46574792,24,53,77,138,104,242,4,0.399087,0.41723,0.000014,No
4895,quebec,179,9.909146372,131,5.944600961,5.943300141,23449,58.90592104,41,57,98,142,149,291,4,0.459299,0.471659,0.000011,No
2410,stuttgart,70,10.84803694,53,6.849506371,6.848986246,3710,74.3036981,22,27,49,50,48,98,4,0.453862,0.466744,0.000022,No
1623,tin,74,10.79246708,52,6.868554566,6.868044446,3848,74.12864907,38,39,77,63,67,130,4,0.437659,0.453411,0.000014,No
2861,spectra,19,12.1520932,17,7.98658494,7.986424931,323,97.05372453,14,11,25,16,16,32,4,0.454559,0.467007,0.000043,No
3274,sin,83,10.67769157,54,6.830814238,6.830284108,4482,72.9373276,32,35,67,65,73,138,4,0.461965,0.473302,0.000016,No
4411,rhodes,76,10.76579884,42,7.082128666,7.08171859,3192,76.24477256,32,35,67,69,57,126,4,0.4429,0.457857,0.000016,No
11531,gasoline,71,10.8338523,41,7.106226218,7.105826145,2911,76.98780525,36,31,67,56,57,113,4,0.456512,0.468922,0.000016,No
6565,onto,244,9.599363952,217,5.439900931,5.437738638,52948,52.2195889,77,42,119,129,216,345,4,0.449438,0.46342,0.000009,No
12577,eve,118,10.32584755,67,6.615105665,6.61444546,7906,68.30657264,33,56,89,100,92,192,4,0.467722,0.478128,0.000012,No
17159,automobile,106,10.43309308,95,6.265921393,6.264980969,10070,65.37294114,39,43,82,90,64,154,4,0.459192,0.471293,0.000013,No
17571,anywhere,92,10.5747436,88,6.34246147,6.341591108,8096,67.06990384,49,33,82,71,88,159,4,0.444976,0.459561,0.000013,No
5775,pie,68,10.87702447,31,7.38581108,7.385511041,2108,80.33564786,28,31,59,54,50,104,4,0.455049,0.467748,0.000018,No
11754,frequent,54,11.10754813,53,6.849506371,6.848986246,2862,76.08122168,24,29,53,45,35,80,4,0.433904,0.449979,0.00002,No
7579,mini,18,12.20616042,16,8.047209562,8.047059554,288,98.22553084,8,12,20,10,12,22,4,0.414288,0.4316,0.000053,No
13856,deed,13,12.53158282,12,8.334891634,8.334781631,156,104.4493848,9,11,20,13,12,25,5,0.413333,0.430785,0.000053,No
14920,cohesion,17,12.26331883,7,8.873888135,8.873828135,119,108.8233195,9,11,20,12,13,25,4,0.432203,0.448139,0.000053,No
7766,mercedes,19,12.1520932,13,8.254848927,8.254728922,247,100.3136935,10,10,20,12,14,26,4,0.419239,0.436379,0.000053,No
9224,kelley,14,12.45747485,9,8.622573707,8.622493705,126,107.4154951,10,10,20,13,13,26,5,0.36952,0.383821,0.000053,No
438,weston,15,12.38848198,12,8.334891634,8.334781631,180,103.2566548,11,9,20,12,10,22,4,0.390381,0.407695,0.000053,No
7939,mayonnaise,7,13.15062203,6,9.028038815,9.027988815,42,118.7243261,6,4,10,6,4,10,5,0.355938,0.367846,0.000106,No
5909,persuasion,16,12.32394346,11,8.421903011,8.421803008,176,103.7910565,12,8,20,14,11,25,4,0.409141,0.4266,0.000053,No
15997,buffalo,176,9.926048182,91,6.308938778,6.30803839,16016,62.62283029,46,42,88,137,125,262,4,0.442801,0.457871,0.000012,No
1243,try,413,9.073084584,363,4.92539545,4.921768955,149919,44.68852953,63,33,96,348,403,751,4,0.457359,0.469654,0.000011,No
6604,olive,94,10.5532374,54,6.830814238,6.830284108,5076,72.08720425,40,26,66,70,70,140,4,0.44669,0.460833,0.000016,No
12621,etruscan,70,10.84803694,35,7.264450223,7.264110172,2450,78.80502433,33,29,62,56,50,106,5,0.391172,0.408462,0.000017,No
4887,question,190,9.849508105,139,5.885324351,5.883943426,26410,57.9675499,46,59,105,168,166,334,4,0.466996,0.47763,0.00001,No
13376,domestic,189,9.854785162,135,5.914523506,5.913182634,25515,58.28635849,57,48,105,153,99,252,4,0.442757,0.457984,0.00001,No
12234,fence,29,11.72923635,23,7.684304068,7.684084048,667,90.13101858,5,20,25,25,24,49,4,0.446735,0.460786,0.000042,No
6848,northeastern,157,10.04028637,145,5.843064542,5.841623533,22765,58.66604129,21,54,75,148,132,280,4,0.429266,0.446327,0.000014,No
8905,lateral,38,11.45894602,29,7.452502454,7.452222421,1102,85.39782332,18,7,25,30,15,45,4,0.412507,0.429797,0.000042,No
7734,mesopotamia,64,10.93764909,51,6.887972651,6.887472536,3264,75.33822783,24,31,55,57,53,110,4,0.447625,0.461706,0.000019,No
5649,platform,133,10.20618305,111,6.110268083,6.109167499,14763,62.36251453,42,45,87,104,106,210,4,0.464929,0.475785,0.000012,No
4731,ratio,120,10.30904043,83,6.400957676,6.400137356,9960,65.98773151,31,27,58,114,112,226,4,0.465088,0.47556,0.000018,No
7913,mcdonald,60,11.00218762,35,7.264450223,7.264110172,2100,79.92484427,32,26,58,52,41,93,4,0.405422,0.423145,0.000018,No
11078,grimm,23,11.96103796,12,8.334891634,8.334781631,276,99.69395524,5,15,20,7,16,23,4,0.428013,0.444468,0.000052,No
15154,cigarette,21,12.05200974,19,7.875359305,7.875179292,399,94.91390705,11,9,20,15,10,25,4,0.391138,0.408733,0.000052,No
17412,arlene,23,11.96103796,15,8.111748083,8.111608076,345,97.02492676,11,9,20,21,12,33,4,0.384904,0.401513,0.000052,No
12719,equivalent,135,10.1912574,124,5.999516719,5.998285986,16740,61.14261915,54,26,80,115,125,240,4,0.448144,0.462073,0.000013,No
13523,dioxide,182,9.89252549,110,6.119317918,6.118227346,20020,60.53550849,9,52,61,182,149,331,4,0.464613,0.475668,0.000017,No
1399,transmission,113,10.36914436,75,6.502310171,6.501569912,8475,67.42339282,41,38,79,97,82,179,4,0.462217,0.473546,0.000013,No
5401,pot,64,10.93764909,47,6.969650683,6.969190586,3008,76.23159347,22,35,57,51,50,101,4,0.464443,0.475227,0.000018,No
15149,cinderella,52,11.14528846,23,7.684304068,7.684084048,1196,85.64378545,24,30,54,38,42,80,4,0.451587,0.464946,0.000019,No
9153,kin,12,12.61162553,12,8.334891634,8.334781631,144,105.1165321,9,9,18,11,10,21,4,0.43087,0.447036,0.000057,No
1466,toyota,106,10.43309308,41,7.106226218,7.105826145,4346,74.1399196,27,37,64,90,68,158,4,0.452163,0.465556,0.000016,No
7600,milton,79,10.72708432,55,6.812465099,6.811924964,4345,73.07788758,31,33,64,64,66,130,4,0.460359,0.47203,0.000016,No
516,wavelength,81,10.70208302,47,6.969650683,6.969190586,3807,74.58978024,20,31,51,69,74,143,4,0.452543,0.465748,0.00002,No
16063,brooklyn,115,10.35160005,83,6.400957676,6.400137356,9545,66.2601538,30,38,68,100,99,199,4,0.454443,0.467401,0.000015,No
7396,montreal,252,9.56710309,148,5.82258601,5.821114958,37296,55.70528061,38,47,85,182,111,293,4,0.443033,0.458185,0.000012,No
13532,dinosaur,152,10.07265166,103,6.185069296,6.184048796,15656,62.30004849,31,37,68,78,115,193,4,0.457606,0.469931,0.000015,No
11092,grid,76,10.76579884,40,7.13091883,7.130528762,3040,76.77003765,28,32,60,59,50,109,4,0.457854,0.469997,0.000017,No
5458,pork,69,10.86242567,43,7.058598169,7.058178089,2967,76.67349796,29,31,60,52,58,110,4,0.440089,0.45542,0.000017,No
13454,distinct,133,10.20618305,125,5.991484547,5.990243802,16625,61.15018802,43,42,85,119,82,201,4,0.44462,0.459444,0.000012,No
16728,belly,57,11.05348091,45,7.013135794,7.012695706,2565,77.51956262,22,22,44,52,50,102,4,0.444999,0.459383,0.000023,No
4302,roberto,43,11.33533206,40,7.13091883,7.130528762,1720,80.83133284,15,3,18,24,3,27,5,0.336403,0.342087,0.000056,No
10351,hood,72,10.81986606,47,6.969650683,6.969190586,3384,75.41068686,16,37,53,61,60,121,4,0.464491,0.475297,0.000019,No
6271,parade,68,10.87702447,38,7.182212124,7.181842063,2584,78.12109704,21,32,53,59,60,119,4,0.461245,0.472682,0.000019,No
9996,inaccurate,12,12.61162553,12,8.334891634,8.334781631,144,105.1165321,8,11,19,9,12,21,4,0.413218,0.430633,0.000053,No
7040,nemesis,14,12.45747485,13,8.254848927,8.254728922,182,102.8345729,9,10,19,11,10,21,4,0.405876,0.423558,0.000053,No
6636,ogre,16,12.32394346,8,8.740356743,8.740286741,128,107.7156623,10,9,19,12,14,26,4,0.436647,0.452003,0.000053,No
10826,hanukkah,12,12.61162553,6,9.028038815,9.027988815,72,113.8582448,10,9,19,11,9,20,4,0.427828,0.444177,0.000053,No
3060,snowy,27,11.80069531,21,7.775275846,7.77507583,567,91.75366123,11,8,19,22,16,38,5,0.363884,0.377198,0.000053,No
13551,dill,14,12.45747485,7,8.873888135,8.873828135,98,110.5462382,8,9,17,8,11,19,4,0.431331,0.447336,0.000059,No
7174,mystery,77,10.75272676,69,6.58569178,6.585011562,5313,70.8141442,28,31,59,63,56,119,4,0.450316,0.463946,0.000017,No
18318,abraham,138,10.16927849,103,6.185069296,6.184048796,14214,62.89769216,47,30,77,101,107,208,4,0.435875,0.451721,0.000013,No
5812,phrase,185,9.876176352,142,5.863971227,5.86256026,26270,57.91361396,33,67,100,177,141,318,4,0.46855,0.478964,0.00001,No
17275,asylum,46,11.26789078,22,7.728755831,7.728545813,1012,87.08677657,26,24,50,36,37,73,4,0.454362,0.467091,0.00002,No
1337,trial,181,9.898035146,144,5.849984985,5.84855399,26064,57.90335698,51,60,111,159,159,318,4,0.469169,0.479288,0.000009,No
14219,crossover,27,11.80069531,20,7.824066011,7.823875996,540,92.32941909,12,15,27,19,15,34,4,0.442878,0.457467,0.000037,No
12209,fertile,72,10.81986606,65,6.645411014,6.644770822,4680,71.90245708,26,36,62,65,59,124,4,0.401497,0.419441,0.000016,No
14325,cox,45,11.28986969,32,7.354062381,7.35375234,1440,83.02640596,26,29,55,33,38,71,4,0.440865,0.456007,0.000018,No
5296,preston,63,10.95339745,38,7.182212124,7.181842063,2394,78.66962398,33,33,66,55,56,111,4,0.444854,0.459462,0.000015,No
11430,germ,22,12.00548972,13,8.254848927,8.254728922,286,99.10350396,10,9,19,19,18,37,5,0.386135,0.40266,0.000052,No
16578,bilingual,15,12.38848198,14,8.180740955,8.180610949,210,101.3469619,10,9,19,11,9,20,5,0.397746,0.415058,0.000052,No
15610,carp,21,12.05200974,5,9.210360372,9.210320372,105,111.0033529,11,8,19,15,9,24,4,0.410589,0.427995,0.000052,No
14998,clown,39,11.43297053,25,7.600922459,7.600682435,975,86.90112249,10,24,34,36,30,66,4,0.409236,0.426948,0.000029,No
12560,everywhere,72,10.81986606,72,6.543132165,6.542421927,5184,70.79581363,27,31,58,51,67,118,4,0.442724,0.457636,0.000017,No
11282,goat,67,10.89183956,39,7.156236638,7.155856573,2613,77.9445813,30,28,58,65,55,120,4,0.450819,0.464284,0.000017,No
8516,logan,26,11.83843564,24,7.641744454,7.641514432,624,90.46629989,20,14,34,23,19,42,4,0.410162,0.427797,0.000029,No
5205,progression,22,12.00548972,7,8.873888135,8.873828135,154,106.5353728,9,15,24,17,17,34,4,0.430473,0.446773,0.000041,No
7862,mechanism,61,10.98565831,57,6.776747016,6.776186871,3477,74.4470272,27,22,49,44,55,99,4,0.447297,0.46135,0.00002,No
6514,orbital,147,10.10609959,116,6.066208093,6.065057454,17052,61.30570313,33,16,49,119,49,168,4,0.426021,0.442783,0.00002,No
1779,therapy,33,11.60002462,23,7.684304068,7.684084048,759,89.13811635,14,21,35,20,25,45,4,0.441677,0.456561,0.000028,No
3407,shoulder,85,10.65388092,69,6.58569178,6.585011562,5865,70.163176,23,42,65,74,72,146,4,0.466898,0.477231,0.000015,No
8368,luther,131,10.22133485,90,6.319988614,6.319098235,11790,64.5987199,25,40,65,118,97,215,4,0.451725,0.465241,0.000015,No
8802,legislature,118,10.32584755,89,6.331161914,6.330281545,10502,65.37461276,26,39,65,105,99,204,4,0.466775,0.477081,0.000015,No
15976,bulletin,17,12.26331883,13,8.254848927,8.254728922,221,101.2318443,9,9,18,9,12,21,4,0.413141,0.430671,0.000054,No
2338,sulfate,13,12.53158282,13,8.254848927,8.254728922,169,103.446323,9,9,18,11,11,22,4,0.411293,0.428708,0.000054,No
690,volcano,224,9.684886125,126,5.983516377,5.98226562,28224,57.94967474,36,61,97,159,180,339,4,0.467858,0.478325,0.00001,No
4594,reign,274,9.483404071,234,5.364477169,5.362144497,64116,50.87350462,49,48,97,251,249,500,4,0.451404,0.465162,0.00001,No
9293,jury,69,10.86242567,39,7.156236638,7.155856573,2691,77.73408858,21,30,51,66,49,115,4,0.463739,0.474588,0.000019,No
9033,kyoto,95,10.54265529,50,6.907775279,6.907285168,4750,72.82629356,24,33,57,80,73,153,4,0.451323,0.464767,0.000017,No
12678,eruption,112,10.37803331,61,6.70892442,6.708324252,6832,69.62544108,26,31,57,96,90,186,4,0.457524,0.469748,0.000017,No
4007,sand,175,9.931746203,115,6.074866156,6.073725528,20125,60.33402888,57,64,121,149,123,272,4,0.459775,0.472128,0.000008,No
15105,claim,153,10.06609426,142,5.863971227,5.86256026,21726,59.02728708,47,41,88,120,147,267,4,0.453109,0.466392,0.000011,No
10731,hay,44,11.31234254,27,7.523961418,7.52370139,1188,85.11362885,26,20,46,34,33,67,4,0.435768,0.451444,0.000021,No
1183,turnip,7,13.15062203,2,10.1266511,10.1266411,14,133.1717611,6,3,9,6,3,9,5,0.359223,0.371626,0.000107,No
5330,prefecture,354,9.227235264,235,5.36021277,5.357870075,83190,49.4599443,28,46,74,136,284,420,4,0.465015,0.475865,0.000013,No
9311,junction,118,10.32584755,66,6.630143542,6.629493344,7788,68.46185147,33,41,74,89,103,192,4,0.45783,0.470175,0.000013,No
2709,stable,139,10.16205824,123,6.007613929,6.006393208,17097,61.04972265,37,59,96,116,104,220,4,0.466604,0.477316,0.00001,No
11240,goodbye,64,10.93764909,45,7.013135794,7.012695706,2880,76.70721837,25,39,64,37,48,85,4,0.453028,0.466284,0.000015,No
3852,schmidt,15,12.38848198,11,8.421903011,8.421803008,165,104.3345937,7,9,16,11,11,22,5,0.39829,0.415622,0.00006,No
3139,slope,45,11.28986969,34,7.29343776,7.293107712,1530,82.34196188,20,20,40,38,39,77,4,0.428137,0.444731,0.000024,No
14602,constantine,107,10.42370334,74,6.515733191,6.515002939,7918,67.91806984,45,35,80,87,89,176,4,0.449597,0.463406,0.000012,No
15905,businessman,105,10.44257183,100,6.214628098,6.213637628,10500,64.89670029,29,31,60,68,88,156,4,0.434105,0.450214,0.000016,No
17417,arithmetic,79,10.72708432,49,6.927977986,6.92749788,3871,74.31700406,29,31,60,67,60,127,4,0.452705,0.465866,0.000016,No
15389,chancellor,189,9.854785162,135,5.914523506,5.913182634,25515,58.28635849,43,44,87,157,172,329,4,0.466346,0.476828,0.000011,No
5423,possum,23,11.96103796,14,8.180740955,8.180610949,322,97.85015311,8,10,18,15,16,31,5,0.380947,0.397028,0.000053,No
12777,envelope,17,12.26331883,10,8.517213191,8.517123189,170,104.4493009,8,10,18,16,14,30,4,0.437562,0.452834,0.000053,No
14729,conception,20,12.1007999,17,7.98658494,7.986424931,340,96.64406628,9,9,18,13,19,32,4,0.419368,0.436417,0.000053,No
11189,gradual,15,12.38848198,15,8.111748083,8.111608076,225,100.4922449,9,9,18,14,11,25,4,0.390415,0.407324,0.000053,No
5929,perpetual,18,12.20616042,13,8.254848927,8.254728922,234,100.7600102,9,9,18,13,18,31,5,0.327739,0.331523,0.000053,No
11574,gamble,14,12.45747485,11,8.421903011,8.421803008,154,104.9156449,9,9,18,14,10,24,4,0.425428,0.441994,0.000053,No
11124,greedy,12,12.61162553,12,8.334891634,8.334781631,144,105.1165321,9,9,18,11,10,21,5,0.385992,0.402486,0.000053,No
17782,amnesia,20,12.1007999,7,8.873888135,8.873828135,140,107.3811447,9,9,18,15,19,34,4,0.411055,0.428581,0.000053,No
10277,howl,14,12.45747485,6,9.028038815,9.027988815,84,112.4665665,9,9,18,9,9,18,4,0.421439,0.438295,0.000053,No
8695,lice,12,12.61162553,4,9.433503923,9.433473923,48,118.9718189,9,9,18,9,10,19,4,0.42551,0.44206,0.000053,No
1985,tasty,19,12.1520932,17,7.98658494,7.986424931,323,97.05372453,10,8,18,14,9,23,4,0.432624,0.448444,0.000053,No
3497,shawnee,12,12.61162553,11,8.421903011,8.421803008,132,106.213887,10,8,18,10,9,19,5,0.349464,0.359234,0.000053,No
65,youngstown,15,12.38848198,5,9.210360372,9.210320372,75,114.1023835,10,8,18,13,15,28,5,0.360749,0.373187,0.000053,No
5858,phelps,15,12.38848198,5,9.210360372,9.210320372,75,114.1023835,11,7,18,12,14,26,4,0.391768,0.408728,0.000053,No
17912,alison,28,11.76432767,19,7.875359305,7.875179292,532,92.64830736,13,5,18,13,5,18,5,0.319694,0.323725,0.000053,No
16999,baltimore,101,10.48141166,65,6.645411014,6.644770822,6565,69.65328849,24,32,56,93,73,166,4,0.454292,0.46719,0.000017,No
16616,beverly,53,11.12624026,38,7.182212124,7.181842063,2014,79.91101772,25,9,34,41,10,51,5,0.373383,0.388501,0.000028,No
16244,bowl,218,9.712037115,123,6.007613929,6.006393208,26814,58.34616945,31,64,95,210,133,343,4,0.471925,0.481428,0.00001,No
2344,suicide,146,10.11292556,122,6.015777239,6.014566531,17812,60.83710738,41,54,95,113,109,222,4,0.468958,0.47902,0.00001,No
5376,powell,53,11.12624026,28,7.487593774,7.487323743,1484,83.30876733,28,22,50,36,36,72,4,0.424675,0.441604,0.000019,No
17369,artery,26,11.83843564,15,8.111748083,8.111608076,390,96.0304076,7,12,19,23,19,42,4,0.449768,0.463119,0.00005,No
1032,uranus,165,9.990586703,73,6.529338843,6.528618598,12045,65.23192583,31,48,79,125,119,244,4,0.457583,0.47011,0.000012,No
7355,morrison,50,11.18450917,30,7.418600903,7.418310866,1500,82.97340984,29,30,59,40,38,78,4,0.438838,0.454308,0.000016,No
10604,hepburn,27,11.80069531,21,7.775275846,7.77507583,567,91.75366123,8,15,23,24,23,47,4,0.434722,0.45043,0.000041,No
9812,inheritance,57,11.05348091,36,7.236279346,7.235929291,2052,79.9860756,20,21,41,49,47,96,4,0.456794,0.469035,0.000023,No
998,usual,143,10.13368755,141,5.871038394,5.869637441,20163,59.49526866,23,71,94,136,105,241,4,0.463025,0.474809,0.00001,No
4615,regime,62,10.96939779,47,6.969650683,6.969190586,2914,76.45287081,19,28,47,51,47,98,4,0.453086,0.466143,0.00002,No
7338,moses,80,10.71450554,43,7.058598169,7.058178089,3440,75.6293892,38,40,78,62,63,125,4,0.453398,0.466626,0.000012,No
4819,radioactive,130,10.22899773,98,6.234830806,6.233860354,12740,63.77607014,42,36,78,109,93,202,4,0.440417,0.455754,0.000012,No
8757,leopold,72,10.81986606,59,6.74226084,6.741680684,4248,72.95035922,29,23,52,53,62,115,4,0.41627,0.433755,0.000018,No
12187,fibrous,24,11.91847835,16,8.047209562,8.047059554,384,95.91049292,14,10,24,19,14,33,5,0.35581,0.367791,0.000039,No
2828,spider,71,10.8338523,36,7.236279346,7.235929291,2556,78.39678164,28,27,55,57,48,105,4,0.447478,0.461542,0.000017,No
1648,tie,59,11.01899473,46,6.991156888,6.990706795,2714,77.03552093,22,27,49,55,52,107,4,0.441831,0.456894,0.000019,No
1259,truck,85,10.65388092,56,6.794446593,6.793896453,4760,72.38722493,23,39,62,80,61,141,4,0.456371,0.468974,0.000015,No
14737,con,15,12.38848198,15,8.111748083,8.111608076,225,100.4922449,9,6,15,10,7,17,5,0.349925,0.359921,0.000062,No
11041,grown,345,9.25298776,294,5.136218517,5.133284275,101430,47.52536707,44,72,116,299,315,614,4,0.465234,0.476513,0.000008,No
13127,dylan,60,11.00218762,43,7.058598169,7.058178089,2580,77.66002135,24,34,58,56,43,99,4,0.444831,0.459425,0.000016,No
3447,shiny,48,11.22533117,42,7.082128666,7.08171859,2016,79.49923964,26,32,58,45,40,85,4,0.43768,0.453331,0.000016,No
17398,armstrong,72,10.81986606,45,7.013135794,7.012695706,3240,75.88118994,31,27,58,64,49,113,4,0.438903,0.454284,0.000016,No
16272,bottom,315,9.343959539,272,5.213996218,5.211282594,85680,48.71936969,31,72,103,307,287,594,4,0.469256,0.479583,0.000009,No
14825,commentary,45,11.28986969,37,7.208880372,7.208520314,1665,81.38731999,17,20,37,31,37,68,4,0.455376,0.467819,0.000025,No
142,wyoming,79,10.72708432,52,6.868554566,6.868044446,4108,73.67956402,30,36,66,72,69,141,4,0.455224,0.467992,0.000014,No
3559,severe,97,10.5218212,86,6.365450988,6.364600644,8342,66.97613715,37,40,77,81,66,147,4,0.449029,0.463058,0.000012,No
13699,description,115,10.35160005,107,6.14696945,6.145908909,12305,63.63096926,41,25,66,86,110,196,4,0.449017,0.462767,0.000014,No
3697,secular,38,11.45894602,34,7.29343776,7.293107712,1292,83.57510957,23,21,44,32,24,56,5,0.407975,0.425692,0.000021,No
287,winston,43,11.33533206,33,7.323290723,7.322970678,1419,83.01193213,28,18,46,41,36,77,4,0.418113,0.435379,0.00002,No
16657,bernstein,19,12.1520932,16,8.047209562,8.047059554,304,97.79044058,6,11,17,19,14,33,4,0.433713,0.449468,0.000054,No
8553,lo,18,12.20616042,16,8.047209562,8.047059554,288,98.22553084,7,10,17,9,11,20,4,0.39644,0.413723,0.000054,No
5798,pianist,159,10.02762798,126,5.983516377,5.98226562,20034,60.00047621,28,55,83,127,136,263,4,0.462796,0.474316,0.000011,No
8156,manhattan,117,10.33435824,90,6.319988614,6.319098235,10530,65.31302642,31,52,83,100,109,209,4,0.457925,0.470471,0.000011,No
16542,birthday,115,10.35160005,95,6.265921393,6.264980969,10925,64.86231219,34,49,83,107,96,203,4,0.468179,0.478339,0.000011,No
8811,leg,97,10.5218212,71,6.557118407,6.556418176,6887,68.99282746,37,39,76,84,78,162,4,0.462254,0.473602,0.000012,No
6003,pentecostal,17,12.26331883,13,8.254848927,8.254728922,221,101.2318443,9,7,16,16,9,25,5,0.38595,0.402402,0.000057,No
3482,sheet,94,10.5532374,71,6.557118407,6.556418176,6674,69.19882718,45,31,76,86,81,167,4,0.458896,0.470847,0.000012,No
16181,brazilian,479,8.92483158,436,4.742156041,4.737796639,208844,42.32294399,32,59,91,207,424,631,4,0.428427,0.445679,0.00001,No
18343,aberdeen,123,10.28434782,53,6.849506371,6.848986246,6519,70.44270592,39,52,91,109,111,220,4,0.444442,0.459453,0.00001,No
15103,claire,34,11.57017165,25,7.600922459,7.600682435,850,87.94397757,16,19,35,23,22,45,4,0.427519,0.444088,0.000026,No
13955,davies,26,11.83843564,21,7.775275846,7.77507583,546,92.04710269,16,19,35,21,23,44,4,0.439012,0.454233,0.000026,No
6352,pakistani,150,10.08589688,123,6.007613929,6.006393208,18450,60.5921746,37,45,82,136,113,249,5,0.402335,0.420471,0.000011,No
4526,representative,139,10.16205824,116,6.066208093,6.065057454,16124,61.64515996,50,32,82,122,121,243,4,0.459549,0.471382,0.000011,No
1844,terror,62,10.96939779,40,7.13091883,7.130528762,2480,78.22188527,17,36,53,55,51,106,4,0.450956,0.464589,0.000017,No
13705,descartes,23,11.96103796,18,7.929426526,7.929256515,414,94.84417169,6,11,17,9,17,26,4,0.430119,0.44628,0.000053,No
13534,dingo,14,12.45747485,6,9.028038815,9.027988815,84,112.4665665,7,10,17,13,11,24,4,0.391138,0.408085,0.000053,No
17923,alias,16,12.32394346,14,8.180740955,8.180610949,224,100.8189889,8,9,17,13,13,26,4,0.417101,0.434431,0.000053,No
11752,frescoes,14,12.45747485,13,8.254848927,8.254728922,182,102.8345729,8,9,17,9,13,22,5,0.396325,0.413683,0.000053,No
2208,swap,13,12.53158282,12,8.334891634,8.334781631,156,104.4493848,8,9,17,9,11,20,4,0.413429,0.430891,0.000053,No
15413,chair,70,10.84803694,57,6.776747016,6.776186871,3990,73.51440193,25,28,53,60,60,120,4,0.462001,0.473185,0.000017,No
13202,duct,19,12.1520932,10,8.517213191,8.517123189,190,103.5019685,10,7,17,16,19,35,5,0.384387,0.400914,0.000053,No
7708,meteor,21,12.05200974,13,8.254848927,8.254728922,273,99.48751966,11,6,17,18,10,28,5,0.349189,0.35889,0.000053,No
17252,atmosphere,186,9.870785504,134,5.921958484,5.920627626,24924,58.45438196,29,61,90,165,151,316,4,0.469902,0.479856,0.00001,No
13657,develop,193,9.833841988,184,5.604862527,5.603030887,35512,55.11733245,34,66,100,156,159,315,4,0.468636,0.479006,0.000009,No
11690,ft,202,9.78826448,159,5.899817358,5.89845646,32118,57.74897269,31,44,75,138,168,306,4,0.451427,0.465091,0.000012,No
14959,cocaine,59,11.01899473,40,7.13091883,7.130528762,2360,78.57555703,32,28,60,46,48,94,4,0.448609,0.462439,0.000015,No
13380,domain,126,10.26025027,89,6.331161914,6.330281545,11214,64.95930574,30,39,69,111,102,213,4,0.454071,0.467147,0.000013,No
3245,sirius,36,11.51301324,22,7.728755831,7.728545813,792,88.9812682,12,16,28,16,30,46,4,0.424706,0.441595,0.000032,No
5970,perez,12,12.61162553,11,8.421903011,8.421803008,132,106.213887,7,9,16,7,10,17,4,0.435479,0.450989,0.000056,No
5879,petroleum,84,10.66571538,65,6.645411014,6.644770822,5460,70.87806245,31,33,64,66,60,126,4,0.455703,0.468298,0.000014,No
10797,harmful,64,10.93764909,56,6.794446593,6.793896453,3584,74.31527263,31,16,47,55,42,97,4,0.416114,0.433501,0.000019,No
4757,rank,202,9.78826448,142,5.863971227,5.86256026,28684,57.39810127,46,53,99,154,179,333,4,0.468599,0.478724,0.000009,No
189,worship,150,10.08589688,114,6.083599836,6.08246922,17100,61.35856062,40,49,89,135,125,260,4,0.45809,0.470537,0.00001,No
3682,seeing,113,10.36914436,107,6.14696945,6.145908909,12091,63.73881359,45,44,89,84,93,177,4,0.459216,0.471288,0.00001,No
14188,crust,134,10.19869238,65,6.645411014,6.644770822,8710,67.77450266,22,52,74,126,116,242,4,0.462242,0.473818,0.000012,No
17377,arsenal,70,10.84803694,39,7.156236638,7.155856573,2730,77.63111937,36,38,74,56,58,114,4,0.461568,0.473044,0.000012,No
4828,radar,68,10.87702447,46,6.991156888,6.990706795,3128,76.04298456,30,29,59,51,45,96,4,0.457559,0.469711,0.000015,No
18129,advantage,96,10.53218399,88,6.34246147,6.341591108,8448,66.79997112,31,28,59,82,92,174,4,0.456946,0.469232,0.000015,No
14761,component,92,10.5747436,74,6.515733191,6.515002939,6808,68.90220786,34,25,59,75,75,150,4,0.455902,0.468396,0.000015,No
7020,nest,59,11.01899473,46,6.991156888,6.990706795,2714,77.03552093,23,29,52,53,51,104,4,0.459074,0.470936,0.000017,No
10466,hiram,14,12.45747485,9,8.622573707,8.622493705,126,107.4154951,7,10,17,8,13,21,4,0.424929,0.441548,0.000052,No
15978,bulldog,17,12.26331883,13,8.254848927,8.254728922,221,101.2318443,8,9,17,17,13,30,4,0.410542,0.427985,0.000052,No
3525,shallow,86,10.64218488,78,6.463089458,6.462319176,6708,68.78139291,33,35,68,80,60,140,4,0.429214,0.445923,0.000013,No
7724,metabolic,15,12.38848198,11,8.421903011,8.421803008,165,104.3345937,11,6,17,14,8,22,5,0.327286,0.331356,0.000052,No
3672,seismic,19,12.1520932,16,8.047209562,8.047059554,304,97.79044058,12,5,17,13,6,19,5,0.328424,0.332544,0.000052,No
14240,critic,63,10.95339745,58,6.759355274,6.758785123,3654,74.03790482,17,32,49,54,51,105,4,0.414269,0.432018,0.000018,No
7730,messenger,61,10.98565831,45,7.013135794,7.012695706,2745,77.04391354,18,24,42,45,49,94,4,0.430986,0.447364,0.000021,No
12117,firearm,16,12.32394346,10,8.517213191,8.517123189,160,104.9656538,7,9,16,16,15,31,4,0.437411,0.452763,0.000055,No
14567,context,153,10.06609426,118,6.04911366,6.047942998,18054,60.89094826,39,49,88,127,130,257,4,0.4685,0.478579,0.00001,No
3314,silicone,10,12.79394708,3,9.721185996,9.721165996,30,124.3723392,8,8,16,8,8,16,5,0.359412,0.371712,0.000055,No
12624,ethylene,13,12.53158282,4,9.433503923,9.433473923,52,118.2167357,13,9,22,13,13,26,5,0.380588,0.39658,0.00004,No
5968,perform,232,9.649794806,206,5.491922115,5.489870052,47792,52.9959215,37,73,110,200,182,382,4,0.465283,0.476583,0.000008,No
5708,pit,69,10.86242567,40,7.13091883,7.130528762,2760,77.45907577,25,30,55,52,56,108,4,0.443553,0.458308,0.000016,No
1478,toward,109,10.4051843,100,6.214628098,6.213637628,10900,64.66435069,43,37,80,46,97,143,4,0.444876,0.459561,0.000011,No
5652,plateau,136,10.18387729,84,6.388981485,6.388151157,11424,65.06460347,29,44,73,108,118,226,4,0.466297,0.476828,0.000012,No
6635,oh,36,11.51301324,29,7.452502454,7.452222421,1044,85.80075942,22,24,46,24,28,52,4,0.428602,0.445167,0.000019,No
9524,ivan,75,10.77904406,59,6.74226084,6.741680684,4425,72.67512669,34,12,46,55,34,89,4,0.426614,0.443135,0.000019,No
12795,enter,205,9.773522198,177,5.643648552,5.641887036,36285,55.1583244,39,58,97,169,187,356,4,0.460574,0.472645,0.000009,No
357,widespread,82,10.68981293,80,6.43777165,6.436981353,6560,68.81857462,30,37,67,74,68,142,4,0.440406,0.455777,0.000013,No
7401,montgomery,75,10.77904406,57,6.776747016,6.776186871,4275,73.0468547,33,34,67,67,65,132,4,0.444508,0.459167,0.000013,No
12901,ely,52,11.14528846,13,8.254848927,8.254728922,676,92.00267247,31,27,58,43,41,84,4,0.454956,0.467612,0.000015,No
11437,gerald,40,11.40765272,35,7.264450223,7.264110172,1400,82.87032537,17,13,30,31,33,64,4,0.423864,0.440628,0.000029,No
5250,pro,124,10.27625061,90,6.319988614,6.319098235,11160,64.94578686,40,22,62,94,56,150,4,0.431184,0.447435,0.000014,No
16122,brief,77,10.75272676,71,6.557118407,6.556418176,5467,70.50690254,19,35,54,67,60,127,5,0.401715,0.419636,0.000016,No
14068,cynthia,14,12.45747485,10,8.517213191,8.517123189,140,106.1029691,8,8,16,8,11,19,5,0.386353,0.402838,0.000054,No
9244,katherine,46,11.26789078,33,7.323290723,7.322970678,1518,82.51804002,28,26,54,39,36,75,5,0.421399,0.438672,0.000016,No
1151,twenty,150,10.08589688,141,5.871038394,5.869637441,21150,59.21468784,53,43,96,125,66,191,4,0.452785,0.46618,0.000009,No
8118,maple,115,10.35160005,65,6.645411014,6.644770822,7475,68.79063698,27,21,48,100,47,147,4,0.444164,0.45865,0.000018,No
17855,alphabetic,13,12.53158282,10,8.517213191,8.517123189,130,106.7341625,10,6,16,12,7,19,5,0.331794,0.336903,0.000054,No
8114,marc,36,11.51301324,31,7.38581108,7.385511041,1116,85.03294074,17,10,27,24,11,35,5,0.385414,0.401881,0.000032,No
2002,target,120,10.30904043,93,6.287198791,6.286278386,11160,64.81498656,34,52,86,106,96,202,4,0.452497,0.46611,0.00001,No
2675,stan,50,11.18450917,31,7.38581108,7.385511041,1550,82.60667176,28,15,43,34,34,68,4,0.426902,0.443454,0.00002,No
13292,downtown,76,10.76579884,68,6.600290579,6.599620368,5168,71.05740064,27,39,66,65,58,123,4,0.437583,0.453388,0.000013,No
6082,pearl,105,10.44257183,77,6.475992862,6.475232589,8085,67.62602062,32,29,61,91,66,157,4,0.440177,0.455425,0.000014,No
12434,extensive,84,10.66571538,77,6.475992862,6.475232589,6468,69.07109666,28,43,71,66,53,119,5,0.389541,0.407031,0.000012,No
14804,compact,97,10.5218212,79,6.450350432,6.449570143,7663,67.86943391,36,35,71,81,73,154,4,0.414879,0.432647,0.000012,No
10331,horn,126,10.26025027,80,6.43777165,6.436981353,10080,66.05314831,36,49,85,109,113,222,4,0.453711,0.467035,0.00001,No
485,weed,29,11.72923635,20,7.824066011,7.823875996,580,91.77031944,15,19,34,22,22,44,4,0.444664,0.45903,0.000025,No
6888,nocturnal,52,11.14528846,42,7.082128666,7.08171859,2184,78.93236688,18,16,34,44,32,76,4,0.402426,0.419972,0.000025,No
5985,percent,154,10.05957957,116,6.066208093,6.065057454,17864,61.02350303,52,33,85,135,144,279,4,0.452485,0.465758,0.00001,No
15595,carson,51,11.16470654,31,7.38581108,7.385511041,1581,82.4604133,25,25,50,40,41,81,4,0.427426,0.444097,0.000017,No
17631,answer,155,10.05310706,113,6.092410465,6.09128986,17515,61.24765467,44,62,106,141,130,271,4,0.468241,0.478626,0.000008,No
8288,madrigal,14,12.45747485,8,8.740356743,8.740286741,112,108.8827743,7,9,16,14,11,25,4,0.428654,0.445059,0.000053,No
2184,swept,16,12.32394346,16,8.047209562,8.047059554,256,99.17335561,9,7,16,14,14,28,5,0.406508,0.424147,0.000053,No
7480,moe,16,12.32394346,8,8.740356743,8.740286741,128,107.7156623,9,7,16,12,10,22,4,0.41915,0.436281,0.000053,No
2581,stereo,14,12.45747485,9,8.622573707,8.622493705,126,107.4154951,10,6,16,12,9,21,5,0.367113,0.381128,0.000053,No
13047,edinburgh,172,9.949037701,121,6.024007739,6.022807042,20812,59.9330801,38,56,94,163,143,306,4,0.452439,0.466119,0.000009,No
13727,deposit,48,11.22533117,24,7.641744454,7.641514432,1152,85.78111218,20,27,47,38,39,77,4,0.447174,0.461303,0.000018,No
4256,rondo,15,12.38848198,5,9.210360372,9.210320372,75,114.1023835,6,7,13,13,14,27,5,0.356245,0.367897,0.000065,No
7440,monday,127,10.25234509,109,6.128450402,6.12736984,13843,62.83098839,31,34,65,114,110,224,4,0.462422,0.473649,0.000013,No
8837,learn,377,9.16428699,302,5.109371267,5.106356788,113854,46.82374463,39,81,120,344,342,686,4,0.473398,0.482846,0.000007,No
8192,malta,77,10.75272676,42,7.082128666,7.08171859,3234,76.15219439,29,41,70,74,65,139,4,0.459169,0.471185,0.000012,No
1525,topic,75,10.77904406,61,6.70892442,6.708324252,4575,72.31579194,30,40,70,70,67,137,4,0.46707,0.477325,0.000012,No
16499,blade,104,10.45214128,65,6.645411014,6.644770822,6760,69.45877477,34,36,70,79,88,167,4,0.454746,0.467636,0.000012,No
6945,nigeria,83,10.67769157,50,6.907775279,6.907285168,4150,73.75909386,35,35,70,75,58,133,4,0.45385,0.466866,0.000012,No
13234,drop,107,10.42370334,89,6.331161914,6.330281545,9523,65.99415361,42,42,84,96,91,187,4,0.466996,0.477302,0.00001,No
15934,burke,58,11.03608917,35,7.264450223,7.264110172,2030,80.17112041,31,29,60,50,54,104,4,0.409528,0.427333,0.000014,No
4534,repertoire,11,12.6986369,10,8.517213191,8.517123189,110,108.1569978,10,5,15,11,9,20,4,0.422522,0.439431,0.000056,No
483,week,313,9.350328987,220,5.426170738,5.42397838,68860,50.73648154,33,72,105,298,278,576,4,0.471499,0.481259,0.000008,No
2059,talent,141,10.14777229,107,6.14696945,6.145908909,15087,62.37804623,49,44,93,116,116,232,4,0.458469,0.470734,0.000009,No
1514,torn,35,11.54118412,34,7.29343776,7.293107712,1190,84.17490802,15,16,31,30,33,63,4,0.427683,0.444177,0.000027,No
1933,teenage,73,10.80607274,64,6.660915201,6.660285015,4672,71.97833415,24,20,44,70,48,118,5,0.364909,0.378549,0.000019,No
13381,dolphin,72,10.81986606,30,7.418600903,7.418310866,2160,80.26826811,16,22,38,57,48,105,4,0.441809,0.456669,0.000022,No
9267,kane,39,11.43297053,25,7.600922459,7.600682435,975,86.90112249,18,20,38,30,31,61,4,0.455224,0.467687,0.000022,No
9056,kremlin,16,12.32394346,11,8.421903011,8.421803008,176,103.7910565,4,12,16,16,14,30,4,0.43195,0.447937,0.000052,No
6996,nevada,167,9.978538365,93,6.287198791,6.286278386,15531,62.73705434,38,66,104,129,136,265,4,0.458611,0.47125,0.000008,No
5720,pipeline,19,12.1520932,11,8.421903011,8.421803008,209,102.3437503,7,9,16,14,13,27,4,0.402864,0.420324,0.000052,No
14116,curriculum,11,12.6986369,11,8.421903011,8.421803008,121,106.9466884,7,9,16,10,11,21,4,0.4279,0.444402,0.000052,No
7092,nbc,96,10.53218399,75,6.502310171,6.501569912,7200,68.48352705,28,36,64,80,77,157,4,0.438242,0.453876,0.000013,No
5829,phonetic,27,11.80069531,15,8.111748083,8.111608076,405,95.72426757,9,7,16,19,20,39,5,0.327195,0.331269,0.000052,No
5917,persistent,12,12.61162553,12,8.334891634,8.334781631,144,105.1165321,9,7,16,10,8,18,5,0.32803,0.33217,0.000052,No
8524,locust,11,12.6986369,9,8.622573707,8.622493705,99,109.4949327,9,7,16,11,7,18,5,0.354008,0.36504,0.000052,No
12576,evelyn,17,12.26331883,13,8.254848927,8.254728922,221,101.2318443,11,5,16,14,5,19,5,0.346165,0.354967,0.000052,No
5237,processor,127,10.25234509,82,6.413079037,6.412268725,10414,65.74909938,35,48,83,106,92,198,4,0.459442,0.471584,0.00001,No
1547,tongue,104,10.45214128,80,6.43777165,6.436981353,8320,67.2884988,23,46,69,90,86,176,4,0.458339,0.470678,0.000012,No
16859,battery,104,10.45214128,65,6.645411014,6.644770822,6760,69.45877477,26,43,69,80,87,167,4,0.463751,0.474814,0.000012,No
16175,break,307,9.36968443,275,5.203027187,5.200283481,84425,48.75072282,65,73,138,273,282,555,4,0.472767,0.482222,0.000006,No
15368,chapman,30,11.6953348,23,7.684304068,7.684084048,690,89.87050875,16,20,36,23,22,45,4,0.429349,0.445768,0.000023,No
16073,bronchitis,11,12.6986369,4,9.433503923,9.433473923,44,119.7926411,5,10,15,10,10,20,4,0.434988,0.450557,0.000055,No
10994,gulf,303,9.382799372,211,5.467940151,5.465837985,63933,51.30458541,34,41,75,242,283,525,4,0.464795,0.475593,0.000011,No
7585,mine,81,10.70208302,70,6.571303042,6.570612818,5670,70.32663072,38,37,75,72,63,135,4,0.460336,0.472072,0.000011,No
2120,synthesis,47,11.24638458,35,7.264450223,7.264110172,1645,81.69880094,18,23,41,36,38,74,4,0.434946,0.450876,0.00002,No
369,whom,199,9.803227353,191,5.567524856,5.565623087,38009,54.57971196,36,46,82,171,174,345,4,0.459204,0.47133,0.00001,Yes
14298,crash,140,10.15488975,105,6.165837934,6.164797414,14700,62.61340447,40,51,91,122,105,227,4,0.467501,0.477856,0.000009,No
13973,darwin,118,10.32584755,65,6.645411014,6.644770822,7670,68.61950106,41,50,91,111,86,197,4,0.448303,0.462617,0.000009,No
17863,alongside,89,10.60789581,88,6.34246147,6.341591108,7832,67.28017043,51,40,91,57,74,131,4,0.434818,0.451059,0.000009,No
133,xi,77,10.75272676,67,6.615105665,6.61444546,5159,71.13042367,31,32,63,64,48,112,4,0.460897,0.472424,0.000013,No
8133,mansion,48,11.22533117,33,7.323290723,7.322970678,1584,82.20636359,16,27,43,38,41,79,4,0.459014,0.470847,0.000019,No
12568,evergreen,73,10.80607274,68,6.600290579,6.599620368,4964,71.32322008,25,23,48,68,42,110,4,0.432434,0.448571,0.000017,No
11058,gross,39,11.43297053,36,7.236279346,7.235929291,1404,82.73216852,18,16,34,26,29,55,4,0.434095,0.449895,0.000024,No
16802,bed,95,10.54265529,65,6.645411014,6.644770822,6175,70.06027756,32,42,74,87,82,169,4,0.468142,0.478189,0.000011,No
6097,peabody,12,12.61162553,10,8.517213191,8.517123189,120,107.4159033,7,7,14,12,10,22,5,0.410266,0.42794,0.000058,No
13087,eaten,269,9.501820798,206,5.491922115,5.489870052,55414,52.18325978,33,57,90,234,246,480,4,0.464966,0.47602,0.000009,No
14531,controversial,107,10.42370334,102,6.194825471,6.193814981,10914,64.57302297,32,49,81,91,84,175,4,0.424746,0.442158,0.00001,No
9382,joint,131,10.22133485,105,6.165837934,6.164797414,13755,63.02309418,40,50,90,118,88,206,4,0.450762,0.464678,0.000009,No
9126,kiss,119,10.31740868,80,6.43777165,6.436981353,9520,66.42112112,42,48,90,107,103,210,4,0.466211,0.476804,0.000009,No
2961,sony,114,10.36033373,85,6.377147028,6.376306692,9690,66.06937145,27,27,54,89,55,144,4,0.44362,0.458317,0.000015,No
14975,coastal,158,10.03393714,140,5.878155862,5.876764922,22120,58.98104644,48,42,90,142,93,235,5,0.40791,0.425992,0.000009,No
11249,golf,82,10.68981293,58,6.759355274,6.758785123,4756,72.2562434,29,25,54,52,68,120,4,0.453468,0.466392,0.000015,No
8384,lunch,26,11.83843564,18,7.929426526,7.929256515,468,93.87200559,13,17,30,21,24,45,4,0.451346,0.464518,0.000027,No
12942,elijah,14,12.45747485,12,8.334891634,8.334781631,168,103.8317029,8,7,15,9,12,21,5,0.32806,0.33207,0.000054,No
15190,christy,11,12.6986369,10,8.517213191,8.517123189,110,108.1569978,7,6,13,8,7,15,5,0.36545,0.379106,0.000062,No
10823,happen,399,9.10506763,347,4.967595804,4.96411984,138453,45.23029576,41,74,115,325,356,681,4,0.468475,0.479011,0.000007,No
15639,cargo,106,10.43309308,65,6.645411014,6.644770822,6890,69.33219169,40,49,89,89,80,169,4,0.464127,0.475246,0.000009,No
6837,norton,42,11.35886256,19,7.875359305,7.875179292,798,89.45512395,19,21,40,32,22,54,4,0.438415,0.453754,0.00002,No
5589,pluto,90,10.59672251,39,7.156236638,7.155856573,3510,75.83265385,41,39,80,81,75,156,4,0.444286,0.459063,0.00001,No
1923,telegraph,61,10.98565831,37,7.208880372,7.208520314,2257,79.19429658,13,29,42,38,46,84,4,0.44423,0.458871,0.000019,No
10652,heisenberg,15,12.38848198,10,8.517213191,8.517123189,150,105.5153421,5,10,15,12,11,23,5,0.339433,0.346412,0.000053,No
1675,thunderstorm,20,12.1007999,16,8.047209562,8.047059554,320,97.37767269,6,9,15,16,10,26,4,0.419239,0.436374,0.000053,No
15597,carrot,9,12.8993076,9,8.622573707,8.622493705,81,111.2252305,6,9,15,7,9,16,5,0.368515,0.382774,0.000053,No
5994,peppermint,9,12.8993076,6,9.028038815,9.027988815,54,116.4554497,7,8,15,7,9,16,5,0.385799,0.402233,0.000053,No
9048,kruger,9,12.8993076,2,10.1266511,10.1266411,18,130.6267875,8,7,15,9,7,16,4,0.39131,0.408799,0.000053,No
18098,aesthetic,14,12.45747485,13,8.254848927,8.254728922,182,102.8345729,9,6,15,11,7,18,4,0.389439,0.406184,0.000053,No
15227,choice,161,10.01512781,139,5.885324351,5.883943426,22379,58.94227559,42,46,88,132,132,264,4,0.467476,0.477757,0.000009,No
17105,axis,138,10.16927849,94,6.276503502,6.275573088,12972,63.82751207,42,46,88,117,99,216,4,0.469305,0.479123,0.000009,No
8214,malcolm,82,10.68981293,59,6.74226084,6.741680684,4838,72.07350711,41,25,66,64,69,133,4,0.400709,0.418422,0.000012,No
15708,canton,1267,7.952124997,1062,3.851889082,3.84122261,1345554,30.63070346,35,64,99,1221,1216,2437,4,0.468698,0.478996,0.000008,No
11246,gone,184,9.88159642,166,5.707810496,5.706159166,30544,56.40227976,45,67,112,171,170,341,4,0.462796,0.474527,0.000007,No
16318,boot,65,10.92214491,35,7.264450223,7.264110172,2275,79.34337801,25,31,56,57,49,106,4,0.464722,0.475363,0.000014,No
5658,plasma,81,10.70208302,33,7.323290723,7.322970678,2673,78.37446531,26,30,56,71,62,133,4,0.453734,0.466692,0.000014,No
12859,emma,64,10.93764909,43,7.058598169,7.058178089,2752,77.20446986,30,26,56,41,44,85,5,0.397782,0.415471,0.000014,No
6321,pan,125,10.26821844,79,6.450350432,6.449570143,9875,66.23360725,41,46,87,93,86,179,4,0.463945,0.47502,0.000009,No
5897,pest,44,11.31234254,29,7.452502454,7.452222421,1276,84.30526057,19,27,46,38,38,76,4,0.447975,0.461927,0.000017,No
13570,difficulty,63,10.95339745,52,6.868554566,6.868044446,3276,75.23400807,26,20,46,55,46,101,4,0.451255,0.464518,0.000017,No
12142,fin,61,10.98565831,35,7.264450223,7.264110172,2135,79.80476798,19,20,39,51,48,99,4,0.440876,0.455848,0.00002,No
17102,axon,21,12.05200974,6,9.028038815,9.027988815,126,108.8060117,5,10,15,20,17,37,4,0.423824,0.440637,0.000052,No
5976,percussion,97,10.5218212,73,6.529338843,6.528618598,7081,68.70053585,31,34,65,56,53,109,4,0.441008,0.456228,0.000012,No
9693,interior,96,10.53218399,85,6.377147028,6.376306692,8160,67.1652858,32,33,65,91,72,163,4,0.448836,0.462777,0.000012,No
15326,check,86,10.64218488,65,6.645411014,6.644770822,5590,70.72169263,32,33,65,76,82,158,4,0.445423,0.459932,0.000012,No
15083,clarke,52,11.14528846,33,7.323290723,7.322970678,1716,81.62018757,26,26,52,44,39,83,4,0.447095,0.46119,0.000015,No
7243,municipal,122,10.29251113,98,6.234830806,6.233860354,11956,64.17206548,38,22,60,95,70,165,4,0.394423,0.412057,0.000013,No
10112,ideology,53,11.12624026,36,7.236279346,7.235929291,1908,80.51258262,18,23,41,33,46,79,4,0.45363,0.46649,0.000019,No
16723,belt,218,9.712037115,157,5.763552479,5.761991292,34226,55.97583559,40,57,97,175,180,355,4,0.468302,0.478583,0.000008,No
5265,print,134,10.19869238,99,6.224678434,6.223697973,13266,63.4835805,45,52,97,115,100,215,4,0.467291,0.47772,0.000008,No
18285,academic,128,10.24450191,113,6.092410465,6.09128986,14464,62.41371067,49,48,97,106,75,181,5,0.409888,0.428058,0.000008,No
10515,hidden,116,10.34294199,101,6.204677767,6.203677287,11716,64.17462219,49,48,97,98,90,188,4,0.448802,0.463002,0.000008,No
14564,continental,258,9.543572592,208,5.482260205,5.480188101,53664,52.32034823,40,46,86,237,213,450,5,0.373132,0.388799,0.000009,No
14029,dakota,135,10.1912574,77,6.475992862,6.475232589,10395,65.99851017,12,65,77,128,121,249,4,0.462832,0.474546,0.00001,No
2915,southwestern,715,8.524249635,707,4.258767618,4.251682721,505505,36.30279831,20,57,77,709,677,1386,5,0.392149,0.410059,0.00001,No
3738,seal,94,10.5532374,50,6.907775279,6.907285168,4700,72.89939239,39,38,77,82,73,155,4,0.466358,0.476748,0.00001,No
12221,fern,11,12.6986369,10,8.517213191,8.517123189,110,108.1569978,8,6,14,10,7,17,4,0.431059,0.447031,0.000055,No
13582,diesel,234,9.641211062,187,5.588689667,5.586827973,43758,53.88173664,51,26,77,191,164,355,4,0.438545,0.453974,0.00001,No
4063,sale,125,10.26821844,90,6.319988614,6.319098235,11250,64.89502363,27,43,70,109,97,206,4,0.468847,0.47872,0.000011,No
10227,hungarian,169,9.966633462,122,6.015777239,6.014566531,20618,59.95704674,36,60,96,106,93,199,4,0.455096,0.468354,0.000008,No
18130,advance,144,10.12671888,95,6.265921393,6.264980969,13680,63.45322445,43,53,96,118,105,223,4,0.456406,0.469283,0.000008,No
15376,chaos,61,10.98565831,40,7.13091883,7.130528762,2440,78.33783773,31,33,64,51,57,108,4,0.455539,0.468185,0.000012,No
13950,dawn,83,10.67769157,63,6.676663558,6.676043378,5229,71.29135418,32,32,64,73,65,138,4,0.452959,0.466119,0.000012,No
2842,spend,115,10.35160005,113,6.092410465,6.09128986,12995,63.06619647,28,31,59,96,111,207,4,0.442735,0.457636,0.000013,No
11306,glucose,65,10.92214491,33,7.323290723,7.322970678,2145,79.98604247,31,28,59,53,52,105,4,0.418251,0.435745,0.000013,No
15440,ceremony,144,10.12671888,115,6.074866156,6.073725528,16560,61.51846178,34,51,85,99,126,225,4,0.46755,0.477893,0.000009,No
8115,marble,70,10.84803694,47,6.969650683,6.969190586,3290,75.60702803,36,33,69,59,57,116,4,0.437713,0.453364,0.000011,No
14873,colombia,129,10.23671977,91,6.308938778,6.30803839,11739,64.58283833,35,49,84,108,102,210,4,0.459763,0.471842,0.000009,No
9123,kitchen,58,11.03608917,45,7.013135794,7.012695706,2610,77.39759197,22,32,54,51,46,97,4,0.442161,0.457167,0.000014,No
16572,billion,252,9.56710309,187,5.588689667,5.586827973,47124,53.46757018,51,57,108,215,133,348,4,0.458872,0.471283,0.000007,No
7720,metallic,57,11.05348091,42,7.082128666,7.08171859,2394,78.28217401,27,27,54,46,36,82,5,0.398031,0.415734,0.000014,No
11560,gap,86,10.64218488,53,6.849506371,6.848986246,4558,72.89371314,27,31,58,64,71,135,4,0.453804,0.466762,0.000013,No
15285,chew,26,11.83843564,22,7.728755831,7.728545813,572,91.49637848,15,14,29,24,22,46,4,0.430682,0.446834,0.000026,No
2571,steven,91,10.58567267,81,6.42534913,6.424548825,7371,68.01664268,35,23,58,71,33,104,4,0.385414,0.402541,0.000013,No
6375,package,110,10.39605181,76,6.489064944,6.488314678,8360,67.46065537,38,37,75,80,68,148,4,0.465112,0.475781,0.00001,No
1511,toronto,260,9.535850546,168,5.695834305,5.694162942,43680,54.31462467,49,58,107,214,223,437,4,0.445434,0.460397,0.000007,No
14184,cruz,64,10.93764909,43,7.058598169,7.058178089,2752,77.20446986,9,25,34,49,52,101,4,0.433851,0.449862,0.000022,No
6248,parasite,28,11.76432767,22,7.728755831,7.728545813,616,90.92361605,11,13,24,25,20,45,4,0.436743,0.452261,0.000031,No
2459,strict,70,10.84803694,63,6.676663558,6.676043378,4410,72.42869288,26,36,62,63,46,109,4,0.421369,0.438745,0.000012,No
4710,reach,299,9.396088604,278,5.192177171,5.189403383,83122,48.78615674,33,73,106,264,232,496,4,0.469504,0.47978,0.000007,No
17076,bacillus,14,12.45747485,5,9.210360372,9.210320372,70,114.7378327,6,8,14,7,9,16,4,0.396591,0.413817,0.000053,No
17427,ariadne,12,12.61162553,7,8.873888135,8.873828135,84,111.9141541,7,7,14,8,10,18,4,0.372897,0.387819,0.000053,No
16163,breath,48,11.22533117,44,7.03560865,7.035178566,2112,78.97703706,27,26,53,43,38,81,4,0.450876,0.464307,0.000014,No
17896,allergic,21,12.05200974,15,8.111748083,8.111608076,315,97.7628669,10,4,14,21,13,34,5,0.364056,0.377389,0.000053,No
1110,ugly,65,10.92214491,45,7.013135794,7.012695706,2925,76.5984854,27,30,57,57,56,113,4,0.438188,0.453697,0.000013,No
16497,blair,59,11.01899473,39,7.156236638,7.155856573,2301,78.85453383,27,30,57,53,43,96,4,0.430965,0.447336,0.000013,No
8589,listen,115,10.35160005,98,6.234830806,6.233860354,11270,64.54047487,36,21,57,91,110,201,4,0.442393,0.457162,0.000013,No
17729,anatomy,89,10.60789581,66,6.630143542,6.629493344,5874,70.33187189,36,38,74,67,83,150,4,0.464856,0.475588,0.00001,No
11045,grove,82,10.68981293,53,6.849506371,6.848986246,4346,73.21994177,32,35,67,65,76,141,4,0.443199,0.458096,0.000011,No
6771,numerous,150,10.08589688,142,5.863971227,5.86256026,21300,59.14340912,38,54,92,114,69,183,4,0.422794,0.440445,0.000008,No
7142,napkin,4,13.71023782,4,9.433503923,9.433473923,16,129.3355822,3,4,7,4,4,8,5,0.367249,0.381311,0.000105,No
15062,clean,146,10.11292556,116,6.066208093,6.065057454,16936,61.34711085,58,47,105,127,118,245,4,0.453005,0.46642,0.000007,No
9603,iraq,215,9.725894149,161,5.738393919,5.73679267,34615,55.81101184,49,73,122,198,168,366,4,0.461664,0.473781,0.000006,No
10684,heath,64,10.93764909,48,6.948597273,6.948127172,3072,76.00131867,29,32,61,40,42,82,4,0.460336,0.471983,0.000012,No
16871,bath,70,10.84803694,43,7.058598169,7.058178089,3010,76.57193364,34,27,61,62,59,121,4,0.443254,0.458016,0.000012,No
12016,flint,43,11.33533206,34,7.29343776,7.293107712,1462,82.67353888,25,18,43,33,32,65,4,0.413295,0.430821,0.000017,No
7443,monastery,142,10.14070512,89,6.331161914,6.330281545,12638,64.20244604,24,49,73,107,121,228,4,0.467796,0.478053,0.00001,No
13252,dress,97,10.5218212,61,6.70892442,6.708324252,5917,70.59010318,45,36,81,81,75,156,4,0.466126,0.476522,0.000009,No
15072,claus,23,11.96103796,19,7.875359305,7.875179292,437,94.19747161,12,15,27,22,17,39,4,0.434127,0.449904,0.000027,No
5107,protozoa,21,12.05200974,18,7.929426526,7.929256515,378,95.56552572,13,14,27,16,19,35,4,0.436443,0.451928,0.000027,No
17385,arrest,69,10.86242567,55,6.812465099,6.811924964,3795,73.99989579,20,32,52,62,58,120,4,0.457878,0.470025,0.000014,No
13624,diagram,69,10.86242567,55,6.812465099,6.811924964,3795,73.99989579,23,29,52,59,52,111,4,0.457229,0.469509,0.000014,No
5740,ping,12,12.61162553,10,8.517213191,8.517123189,120,107.4159033,5,9,14,6,10,16,4,0.421889,0.438783,0.000052,No
10300,houdini,11,12.6986369,3,9.721185996,9.721165996,33,123.4458112,6,8,14,10,9,19,5,0.353563,0.364342,0.000052,No
12855,emotion,50,11.18450917,41,7.106226218,7.105826145,2050,79.47965231,25,31,56,44,45,89,4,0.458398,0.470438,0.000013,No
10654,heir,98,10.5115647,89,6.331161914,6.330281545,8722,66.55041808,33,23,56,96,84,180,4,0.447997,0.461889,0.000013,No
9970,inch,97,10.5218212,67,6.615105665,6.61444546,6499,69.60295902,30,36,66,87,56,143,4,0.451484,0.464978,0.000011,No
8236,mainland,174,9.937476878,150,5.80916299,5.807671909,26100,57.7284229,40,63,103,155,162,317,4,0.467082,0.477762,0.000007,No
10856,handle,121,10.30074163,93,6.287198791,6.286278386,11253,64.76281033,32,48,80,114,103,217,4,0.466297,0.476879,0.000009,No
6850,northampton,33,11.60002462,25,7.600922459,7.600682435,825,88.17088763,16,20,36,30,31,61,4,0.378769,0.394785,0.00002,No
11621,gaelic,147,10.10609959,99,6.224678434,6.223697973,14553,62.90722017,30,30,60,116,91,207,4,0.459823,0.471537,0.000012,No
14973,coat,198,9.808265147,131,5.944600961,5.943300141,25938,58.30622242,49,31,80,176,183,359,4,0.461472,0.472851,0.000009,No
10175,hydroxide,58,11.03608917,27,7.523961418,7.52370139,1566,83.0351091,19,26,45,55,45,100,4,0.453572,0.466471,0.000016,No
12051,flash,149,10.09258587,88,6.34246147,6.341591108,13112,64.01183702,50,40,90,92,96,188,4,0.454397,0.467429,0.000008,No
3107,smile,52,11.14528846,34,7.29343776,7.293107712,1768,81.28746769,27,28,55,40,46,86,4,0.447873,0.461871,0.000013,No
16372,bold,112,10.37803331,91,6.308938778,6.30803839,10192,65.47437676,15,36,51,107,82,189,4,0.456183,0.468767,0.000014,No
11744,freud,46,11.26789078,19,7.875359305,7.875179292,874,88.73868851,23,28,51,40,34,74,4,0.449597,0.463298,0.000014,No
1561,tomato,49,11.20471188,29,7.452502454,7.452222421,1421,83.50314278,26,25,51,41,39,80,4,0.447805,0.461753,0.000014,No
7705,meter,101,10.48141166,79,6.450350432,6.449570143,7979,67.60877823,37,42,79,93,85,178,4,0.451151,0.464828,0.000009,No
14808,commune,6342,6.341582722,6088,2.105723385,2.042923317,38610096,13.35361903,27,44,71,6267,6288,12555,4,0.454257,0.467387,0.00001,No
16085,broadway,99,10.50141233,81,6.42534913,6.424548825,8019,67.47524056,28,43,71,86,70,156,4,0.423834,0.441233,0.00001,No
13407,documentary,95,10.54265529,79,6.450350432,6.449570143,7505,68.00382107,38,33,71,80,68,148,4,0.447805,0.461932,0.00001,No
9351,joy,65,10.92214491,41,7.106226218,7.105826145,2665,77.61523249,30,34,64,49,53,102,4,0.465954,0.476368,0.000011,No
18106,aerial,42,11.35886256,38,7.182212124,7.181842063,1596,81.58176039,22,22,44,31,24,55,5,0.375127,0.390766,0.000016,No
11386,gilbert,104,10.45214128,69,6.58569178,6.585011562,7176,68.8345809,46,42,88,82,73,155,4,0.434498,0.450749,0.000008,No
6671,odd,115,10.35160005,88,6.34246147,6.341591108,10120,65.65462446,35,29,64,106,47,153,4,0.438892,0.454312,0.000011,No
9034,kyle,42,11.35886256,28,7.487593774,7.487323743,1176,85.05054858,27,17,44,33,25,58,4,0.43712,0.452571,0.000016,No
16857,battlefield,44,11.31234254,36,7.236279346,7.235929291,1584,81.8592707,13,26,39,38,33,71,4,0.429422,0.446041,0.000018,No
1739,thirty,142,10.14070512,133,5.929449156,5.92812831,18886,60.12879541,52,26,78,124,35,159,4,0.453063,0.466086,0.000009,No
2832,sphinx,20,12.1007999,8,8.740356743,8.740286741,160,105.765308,6,7,13,15,12,27,4,0.415685,0.432966,0.000054,No
9637,inversion,21,12.05200974,8,8.740356743,8.740286741,168,105.3388646,12,14,26,16,17,33,4,0.406928,0.424633,0.000027,No
2736,spy,61,10.98565831,51,6.887972651,6.887472536,3111,75.66891402,26,28,54,54,40,94,4,0.419348,0.436778,0.000013,No
1534,tooth,53,11.12624026,32,7.354062381,7.35375234,1696,81.82306497,27,27,54,48,43,91,4,0.442293,0.45719,0.000013,No
12693,ernie,11,12.6986369,10,8.517213191,8.517123189,110,108.1569978,7,6,13,8,7,15,4,0.402681,0.420235,0.000054,No
2800,splash,21,12.05200974,16,8.047209562,8.047059554,336,96.98504802,14,12,26,19,16,35,4,0.442139,0.456758,0.000027,No
16112,brighton,95,10.54265529,42,7.082128666,7.08171859,3990,74.66444121,43,57,100,84,88,172,4,0.416397,0.434558,0.000007,No
756,viola,95,10.54265529,50,6.907775279,6.907285168,4750,72.82629356,26,32,58,74,67,141,4,0.456277,0.468772,0.000012,No
689,volcanoes,109,10.4051843,57,6.776747016,6.776186871,6213,70.51330163,44,43,87,93,95,188,4,0.467082,0.477391,0.000008,No
9409,jo,33,11.60002462,30,7.418600903,7.418310866,990,86.05595308,15,14,29,24,15,39,4,0.447602,0.461387,0.000024,No
4519,republican,176,9.926048182,119,6.040674791,6.039494118,20944,59.96002903,35,42,77,160,129,289,4,0.446095,0.460674,0.000009,No
14108,curtis,59,11.01899473,38,7.182212124,7.181842063,2242,79.14075757,30,33,63,49,46,95,4,0.450716,0.464288,0.000011,No
1849,terrible,47,11.24638458,42,7.082128666,7.08171859,1974,79.64834259,22,24,46,44,26,70,4,0.432192,0.44836,0.000015,No
9303,juniper,12,12.61162553,7,8.873888135,8.873828135,84,111.9141541,6,7,13,6,9,15,5,0.368607,0.382872,0.000053,No
4886,quetzal,12,12.61162553,2,10.1266511,10.1266411,24,127.7135316,6,7,13,8,8,16,4,0.425622,0.442271,0.000053,No
16084,broccoli,10,12.79394708,8,8.740356743,8.740286741,80,111.8236617,7,6,13,9,10,19,4,0.399509,0.416873,0.000053,No
12840,enamel,8,13.01709064,7,8.873888135,8.873828135,56,115.5122061,7,6,13,8,6,14,4,0.410011,0.427398,0.000053,No
7059,nee,13,12.53158282,13,8.254848927,8.254728922,169,103.446323,9,4,13,9,4,13,5,0.320838,0.324465,0.000053,No
12609,eukaryotic,18,12.20616042,14,8.180740955,8.180610949,252,99.85543644,10,3,13,14,4,18,5,0.322423,0.325742,0.000053,No
15513,caught,136,10.18387729,121,6.024007739,6.022807042,16456,61.34775561,47,39,86,119,118,237,4,0.455949,0.468636,0.000008,No
10627,helsinki,71,10.8338523,39,7.156236638,7.155856573,2769,77.52961076,27,30,57,63,60,123,4,0.455177,0.467847,0.000012,No
3347,siege,214,9.730556162,179,5.632412478,5.630630928,38306,54.80650595,50,26,76,193,199,392,4,0.451232,0.464598,0.000009,No
5360,prairie,71,10.8338523,42,7.082128666,7.08171859,2982,76.72673594,30,38,68,58,58,116,4,0.441468,0.456697,0.00001,No
10798,harm,90,10.59672251,75,6.502310171,6.501569912,6750,68.90317653,33,35,68,79,81,160,4,0.461713,0.473109,0.00001,No
16089,broad,112,10.37803331,102,6.194825471,6.193814981,11424,64.29010506,32,53,85,93,83,176,4,0.430233,0.447177,0.000008,No
8862,lawyer,182,9.89252549,153,5.789360363,5.787839237,27846,57.27139496,39,46,85,161,157,318,4,0.455645,0.468556,0.000008,No
9405,joaquin,13,12.53158282,7,8.873888135,8.873828135,91,111.2038641,4,9,13,10,12,22,5,0.38632,0.402843,0.000052,No
12309,farthest,85,10.65388092,73,6.529338843,6.528618598,6205,69.56279853,16,36,52,80,81,161,5,0.410732,0.428796,0.000013,No
9045,ku,15,12.38848198,10,8.517213191,8.517123189,150,105.5153421,6,7,13,11,12,23,5,0.348619,0.358167,0.000052,No
240,wombat,12,12.61162553,6,9.028038815,9.027988815,72,113.8582448,6,7,13,10,8,18,4,0.390475,0.407339,0.000052,No
14877,colloquial,10,12.79394708,7,8.873888135,8.873828135,70,113.5320552,7,6,13,10,8,18,5,0.333778,0.339203,0.000052,No
13247,driftwood,10,12.79394708,5,9.210360372,9.210320372,50,117.8368632,7,6,13,8,8,16,5,0.359959,0.372558,0.000052,No
13797,delirium,10,12.79394708,5,9.210360372,9.210320372,50,117.8368632,7,6,13,8,7,15,5,0.365172,0.378595,0.000052,No
18231,acidic,46,11.26789078,38,7.182212124,7.181842063,1748,80.92838178,29,23,52,39,37,76,4,0.420979,0.438163,0.000013,No
17879,alluvial,9,12.8993076,9,8.622573707,8.622493705,81,111.2252305,8,5,13,9,6,15,5,0.325784,0.329393,0.000052,No
1925,tel,29,11.72923635,16,8.047209562,8.047059554,464,94.38762289,9,4,13,23,26,49,4,0.389892,0.406658,0.000052,No
9554,islam,335,9.282401646,228,5.390452655,5.38818012,76380,50.0363466,49,86,135,261,259,520,4,0.467353,0.478391,0.000005,No
2976,somewhat,88,10.61919536,86,6.365450988,6.364600644,7568,67.59596761,39,36,75,69,61,130,5,0.406006,0.423973,0.000009,No
3943,saturday,158,10.03393714,134,5.921958484,5.920627626,21172,59.4205592,43,32,75,145,123,268,4,0.459121,0.471034,0.000009,No
9368,josef,57,11.05348091,49,6.927977986,6.92749788,2793,76.57827241,26,19,45,42,25,67,5,0.390467,0.407666,0.000015,No
3040,sociology,62,10.96939779,45,7.013135794,7.012695706,2790,76.9298763,22,34,56,55,55,110,4,0.449939,0.463702,0.000012,No
1033,uranium,79,10.72708432,39,7.156236638,7.155856573,3081,76.76555387,27,29,56,62,57,119,4,0.449825,0.463486,0.000012,No
11970,fluorine,21,12.05200974,13,8.254848927,8.254728922,273,99.48751966,14,14,28,19,19,38,4,0.412612,0.430098,0.000024,No
15614,caroline,59,11.01899473,49,6.927977986,6.92749788,2891,76.33935294,28,33,61,41,42,83,4,0.45122,0.46473,0.000011,No
4706,ready,111,10.38700198,107,6.14696945,6.145908909,11877,63.84858382,37,24,61,87,110,197,4,0.446926,0.460998,0.000011,No
2441,struck,83,10.67769157,71,6.557118407,6.556418176,5893,70.01488794,31,36,67,78,72,150,4,0.452843,0.466096,0.00001,No
5790,pick,94,10.5532374,78,6.463089458,6.462319176,7332,68.20651735,32,35,67,82,87,169,4,0.460718,0.472326,0.00001,No
912,vector,110,10.39605181,49,6.927977986,6.92749788,5390,72.02361809,33,41,74,90,78,168,4,0.457571,0.469955,0.000009,No
5664,plankton,32,11.63079627,28,7.487593774,7.487323743,896,87.08667777,19,16,35,29,27,56,4,0.433776,0.449623,0.000019,No
11846,fortune,92,10.5747436,62,6.692663899,6.692053725,5704,70.77320474,28,55,83,82,70,152,4,0.449472,0.463697,0.000008,No
17456,architect,133,10.20618305,124,5.999516719,5.998285986,16492,61.23216584,31,52,83,110,101,211,4,0.462917,0.474358,0.000008,No
16037,brussels,56,11.07118049,45,7.013135794,7.012695706,2520,77.64369216,20,31,51,53,46,99,4,0.450247,0.463899,0.000013,No
17828,alvin,46,11.26789078,18,7.929426526,7.929256515,828,89.34791205,20,13,33,35,22,57,4,0.427982,0.44436,0.00002,No
4831,rack,7,13.15062203,6,9.028038815,9.027988815,42,118.7243261,5,7,12,7,7,14,4,0.408764,0.426206,0.000055,No
5049,publication,94,10.5532374,82,6.413079037,6.412268725,7708,67.67874551,31,29,60,69,80,149,4,0.446252,0.460617,0.000011,No
1586,todd,60,11.00218762,42,7.082128666,7.08171859,2520,77.9189083,37,23,60,50,37,87,4,0.429827,0.446219,0.000011,No
5204,progressive,86,10.64218488,59,6.74226084,6.741680684,5074,71.75238638,40,20,60,75,77,152,5,0.38772,0.404585,0.000011,No
13101,earthquake,257,9.547456092,175,5.65501231,5.65327083,44975,53.99098173,44,50,94,212,165,377,4,0.468946,0.478935,0.000007,No
4263,romantic,187,9.86542356,154,5.782845682,5.781314541,28798,57.05022204,45,49,94,156,130,286,5,0.406564,0.424804,0.000007,No
16106,bring,213,9.735240012,192,5.562302912,5.560391124,40896,54.15035387,43,66,109,196,186,382,4,0.446802,0.461767,0.000006,No
5831,phone,157,10.04028637,104,6.175407385,6.174376875,16328,62.00285861,44,49,93,140,96,236,4,0.459573,0.471701,0.000007,No
15840,cafe,30,11.6953348,22,7.728755831,7.728545813,660,90.390387,15,16,31,24,24,48,4,0.438037,0.453369,0.000021,No
13487,discussion,77,10.75272676,72,6.543132165,6.542421927,5544,70.3565123,33,32,65,60,67,127,4,0.44714,0.461387,0.00001,No
428,whatever,79,10.72708432,78,6.463089458,6.462319176,6162,69.33010561,39,26,65,62,64,126,4,0.439937,0.455162,0.00001,No
14474,coral,117,10.33435824,66,6.630143542,6.629493344,7722,68.51827856,40,25,65,93,59,152,4,0.424564,0.441557,0.00001,No
11844,forum,71,10.8338523,51,6.887972651,6.887472536,3621,74.62327835,23,36,59,53,55,108,4,0.461197,0.472696,0.000011,No
15093,clara,66,10.90687744,37,7.208880372,7.208520314,2442,78.62637466,25,29,54,58,54,112,4,0.44362,0.458345,0.000012,No
3054,soap,113,10.36914436,73,6.529338843,6.528618598,8249,67.70365703,42,30,72,87,90,177,4,0.422613,0.439863,0.000009,No
12797,enrico,15,12.38848198,15,8.111748083,8.111608076,225,100.4922449,8,4,12,10,11,21,5,0.310897,0.31566,0.000054,No
12099,fischer,44,11.31234254,25,7.600922459,7.600682435,1100,85.98423851,19,24,43,29,35,64,4,0.446622,0.460744,0.000015,No
2244,survive,142,10.14070512,132,5.936996362,5.935685529,18744,60.2053294,32,60,92,123,123,246,4,0.468463,0.478762,0.000007,No
16361,bolton,31,11.66254497,25,7.600922459,7.600682435,775,88.64610002,17,15,32,25,17,42,5,0.395284,0.412702,0.00002,No
1012,uruguay,79,10.72708432,51,6.887972651,6.887472536,4029,73.88786346,37,27,64,74,54,128,4,0.4416,0.456603,0.00001,No
1250,trunk,78,10.73982335,46,6.991156888,6.990706795,3588,75.08378999,23,35,58,67,70,137,4,0.461173,0.472673,0.000011,No
15292,chester,56,11.07118049,39,7.156236638,7.155856573,2184,79.22798743,28,30,58,45,51,96,4,0.443509,0.458279,0.000011,No
4376,ride,122,10.29251113,99,6.224678434,6.223697973,12078,64.06757208,51,40,91,110,95,205,4,0.465857,0.476414,0.000007,No
2975,somewhere,97,10.5218212,91,6.308938778,6.30803839,8827,66.38152577,60,31,91,73,94,167,4,0.44393,0.458702,0.000007,No
13910,debt,57,11.05348091,33,7.323290723,7.322970678,1881,80.9478542,24,29,53,49,45,94,4,0.462458,0.47357,0.000012,No
109,ye,10,12.79394708,8,8.740356743,8.740286741,80,111.8236617,6,6,12,7,7,14,5,0.367432,0.381367,0.000053,No
18125,adventurous,7,13.15062203,7,8.873888135,8.873828135,49,116.6971488,6,6,12,6,7,13,5,0.384937,0.401266,0.000053,No
14239,critique,12,12.61162553,12,8.334891634,8.334781631,144,105.1165321,7,5,12,11,12,23,4,0.423672,0.440421,0.000053,No
15442,cerebral,16,12.32394346,14,8.180740955,8.180610949,224,100.8189889,8,4,12,14,10,24,5,0.327141,0.331048,0.000053,No
8677,lifetime,114,10.36033373,110,6.119317918,6.118227346,12540,63.39817583,23,40,63,97,78,175,4,0.4567,0.469265,0.00001,No
12681,error,84,10.66571538,57,6.776747016,6.776186871,4788,72.27885487,23,40,63,74,66,140,4,0.453364,0.466584,0.00001,No
5855,phenomena,42,11.35886256,38,7.182212124,7.181842063,1596,81.58176039,22,23,45,29,38,67,4,0.448326,0.462176,0.000014,No
492,weber,41,11.38296011,23,7.684304068,7.684084048,943,87.47012669,21,21,42,36,31,67,4,0.444698,0.459092,0.000015,No
16883,basketball,260,9.535850546,167,5.701804472,5.700143126,43420,54.37155529,53,52,105,134,131,265,4,0.460073,0.472147,0.000006,No
7108,nausea,21,12.05200974,14,8.180740955,8.180610949,294,98.59436966,11,10,21,14,17,31,4,0.396617,0.413902,0.00003,No
9745,instant,75,10.77904406,51,6.887972651,6.887472536,3825,74.24576072,27,18,45,48,32,80,5,0.369435,0.38409,0.000014,No
4257,ronald,100,10.49136199,91,6.308938778,6.30803839,9100,66.1893605,40,23,63,78,79,157,5,0.361572,0.374629,0.00001,No
12424,extract,19,12.1520932,17,7.98658494,7.986424931,323,97.05372453,8,10,18,13,15,28,5,0.427405,0.444122,0.000035,No
12280,fbi,47,11.24638458,38,7.182212124,7.181842063,1786,80.77391966,10,23,33,35,35,70,4,0.435095,0.450895,0.000019,No
12537,excellent,94,10.5532374,93,6.287198791,6.286278386,8742,66.35030139,23,55,78,81,68,149,4,0.43435,0.450848,0.000008,No
11364,girth,11,12.6986369,7,8.873888135,8.873828135,77,112.6862834,5,7,12,8,11,19,4,0.432361,0.448191,0.000052,No
4881,quick,82,10.68981293,77,6.475992862,6.475232589,6314,69.22715224,33,45,78,77,57,134,4,0.454059,0.467251,0.000008,No
7408,montana,79,10.72708432,59,6.74226084,6.741680684,4661,72.32480057,35,43,78,71,69,140,4,0.456653,0.469274,0.000008,No
1786,theology,118,10.32584755,86,6.365450988,6.364600644,10148,65.72867651,30,39,69,95,89,184,4,0.462458,0.473762,0.000009,No
5560,poisonous,88,10.61919536,76,6.489064944,6.488314678,6688,68.90864836,25,37,62,80,70,150,4,0.447896,0.462063,0.00001,No
2341,suite,111,10.38700198,73,6.529338843,6.528618598,8103,67.82025547,27,35,62,88,88,176,4,0.46235,0.473593,0.00001,No
12692,ernst,84,10.66571538,62,6.692663899,6.692053725,5208,71.38204827,37,25,62,65,36,101,4,0.435896,0.45166,0.00001,No
16088,broadcast,156,10.04667617,133,5.929449156,5.92812831,20748,59.57125554,53,50,103,135,138,273,4,0.467316,0.477701,0.000006,No
13139,duty,82,10.68981293,58,6.759355274,6.758785123,4756,72.2562434,29,27,56,74,71,145,4,0.461556,0.472837,0.000011,No
9507,jacksonville,66,10.90687744,24,7.641744454,7.641514432,1584,83.34757015,29,27,56,58,54,112,4,0.425816,0.442886,0.000011,No
13038,edmonton,75,10.77904406,36,7.236279346,7.235929291,2700,78.00017393,23,21,44,52,38,90,4,0.434073,0.449956,0.000014,No
9363,joshua,37,11.48561426,30,7.418600903,7.418310866,1110,85.20718835,23,21,44,29,28,57,5,0.37343,0.388726,0.000014,No
6843,northrop,8,13.01709064,5,9.210360372,9.210320372,40,119.8920957,6,5,11,7,6,13,5,0.355311,0.367101,0.000056,No
5420,postal,104,10.45214128,59,6.74226084,6.741680684,6136,70.47106284,30,14,44,82,69,151,5,0.334306,0.339985,0.000014,No
10089,il,46,11.26789078,35,7.264450223,7.264110172,1610,81.85503169,22,6,28,29,6,35,5,0.337973,0.344769,0.000022,No
2648,starr,46,11.26789078,32,7.354062381,7.35375234,1472,82.86477171,15,26,41,19,32,51,4,0.444965,0.459406,0.000015,No
15086,clarinet,65,10.92214491,33,7.323290723,7.322970678,2145,79.98604247,20,21,41,60,43,103,4,0.453746,0.466518,0.000015,No
16749,belgian,660,8.604292342,651,4.341288642,4.334767556,429660,37.35371662,23,45,68,643,635,1278,5,0.400113,0.418133,0.000009,No
3909,saxophone,39,11.43297053,33,7.323290723,7.322970678,1287,83.72696702,16,20,36,31,29,60,4,0.443708,0.458261,0.000017,No
8595,lisa,57,11.05348091,43,7.058598169,7.058178089,2451,78.0220801,26,25,51,44,41,85,4,0.438762,0.454134,0.000012,No
8552,load,92,10.5747436,70,6.571303042,6.570612818,6440,69.48984479,37,31,68,80,68,148,4,0.46471,0.475354,0.000009,No
11432,gerhard,23,11.96103796,21,7.775275846,7.77507583,483,93.00036956,14,4,18,17,4,21,5,0.325271,0.329585,0.000034,No
10167,hymn,61,10.98565831,44,7.03560865,7.035178566,2684,77.29079266,23,24,47,52,50,102,4,0.427107,0.443862,0.000013,No
5805,physician,81,10.70208302,78,6.463089458,6.462319176,6318,69.16851996,32,29,61,62,64,126,4,0.453248,0.466307,0.00001,No
1385,transportation,128,10.24450191,114,6.083599836,6.08246922,14592,62.32345016,41,46,87,102,89,191,4,0.458848,0.471086,0.000007,No
15726,cannabis,26,11.83843564,11,8.421903011,8.421803008,286,99.70215676,16,13,29,23,17,40,4,0.427436,0.443989,0.000021,No
16770,begin,214,9.730556162,198,5.531531254,5.52955935,42372,53.82487553,52,35,87,155,169,324,4,0.465466,0.476011,0.000007,No
7432,monitor,67,10.89183956,44,7.03560865,7.035178566,2948,76.63072061,26,29,55,44,52,96,4,0.459954,0.471612,0.000011,No
17256,atlanta,134,10.19869238,93,6.287198791,6.286278386,12462,64.12120639,33,34,67,120,91,211,4,0.4408,0.456035,0.000009,No
16831,beak,48,11.22533117,39,7.156236638,7.155856573,1872,80.33112617,21,22,43,39,44,83,4,0.456641,0.468875,0.000014,No
14223,crosby,43,11.33533206,21,7.775275846,7.77507583,903,88.13533359,22,21,43,39,26,65,4,0.421369,0.438478,0.000014,No
2987,somebody,111,10.38700198,94,6.276503502,6.275573088,10434,65.19405428,49,37,86,100,84,184,4,0.445356,0.459965,0.000007,No
15195,christina,51,11.16470654,44,7.03560865,7.035178566,2244,78.55050594,32,11,43,44,15,59,5,0.399986,0.41753,0.000014,No
16672,berkshire,65,10.92214491,43,7.058598169,7.058178089,2795,77.09503204,16,24,40,43,50,93,4,0.44811,0.461993,0.000015,No
10700,healthy,127,10.25234509,101,6.204677767,6.203677287,12827,63.61249765,46,54,100,109,92,201,4,0.458457,0.470922,0.000006,No
3619,seoul,58,11.03608917,35,7.264450223,7.264110172,2030,80.17112041,19,21,40,50,47,97,4,0.44069,0.455683,0.000015,No
5216,profit,53,11.12624026,41,7.106226218,7.105826145,2173,79.06558026,24,26,50,49,47,96,4,0.467304,0.477236,0.000012,No
2113,syrup,67,10.89183956,35,7.264450223,7.264110172,2345,79.1232263,24,26,50,64,60,124,4,0.456664,0.468964,0.000012,No
5661,plantation,48,11.22533117,40,7.13091883,7.130528762,1920,80.04692539,30,20,50,43,37,80,4,0.455002,0.467532,0.000012,No
5369,practical,95,10.54265529,84,6.388981485,6.388151157,7980,67.35682943,35,40,75,89,48,137,4,0.406016,0.424042,0.000008,No
10557,herself,103,10.46180319,100,6.214628098,6.213637628,10300,65.01621606,36,39,75,61,89,150,4,0.45943,0.471391,0.000008,Yes
12429,external,98,10.5115647,87,6.353890166,6.353029813,8526,66.78932756,39,36,75,89,48,137,5,0.39131,0.408984,0.000008,No
1801,theft,58,11.03608917,38,7.182212124,7.181842063,2204,79.26353342,23,23,46,54,50,104,4,0.446937,0.460993,0.000013,No
12616,euclid,45,11.28986969,25,7.600922459,7.600682435,1125,85.81342407,25,21,46,37,30,67,4,0.44279,0.45758,0.000013,No
7121,natalie,23,11.96103796,18,7.929426526,7.929256515,414,94.84417169,14,9,23,17,11,28,4,0.390098,0.406977,0.000026,No
6875,nomenclature,40,11.40765272,17,7.98658494,7.986424931,680,91.10818744,15,20,35,25,30,55,4,0.445815,0.460045,0.000017,No
16156,breed,141,10.14777229,94,6.276503502,6.275573088,13254,63.6925283,40,45,85,131,127,258,4,0.470263,0.479827,0.000007,No
3642,senate,207,9.763813384,150,5.80916299,5.807671909,31050,56.71958335,21,78,99,168,158,326,4,0.472453,0.482076,0.000006,No
7973,matrix,89,10.60789581,45,7.013135794,7.012695706,4005,74.39461379,26,40,66,81,61,142,4,0.461701,0.473194,0.000009,No
8258,magnitude,126,10.26025027,76,6.489064944,6.488314678,9576,66.57943035,30,36,66,119,107,226,4,0.460551,0.472222,0.000009,No
6669,ode,15,12.38848198,11,8.421903011,8.421803008,165,104.3345937,10,8,18,11,15,26,4,0.407002,0.424554,0.000033,No
1412,transform,43,11.33533206,31,7.38581108,7.385511041,1333,83.72062113,19,14,33,42,34,76,4,0.441842,0.456571,0.000018,No
1613,tip,119,10.31740868,96,6.255450093,6.25449966,11424,64.54003511,32,22,54,109,112,221,4,0.459859,0.471405,0.000011,No
2604,steep,39,11.43297053,36,7.236279346,7.235929291,1404,82.73216852,15,22,37,37,26,63,4,0.419874,0.437102,0.000016,No
4329,rival,97,10.5218212,95,6.265921393,6.264980969,9215,65.92890454,34,40,74,81,71,152,4,0.45011,0.46396,0.000008,No
2913,sovereign,108,10.41440095,89,6.331161914,6.330281545,9612,65.93525866,36,38,74,103,87,190,4,0.459847,0.471687,0.000008,No
7379,moral,109,10.4051843,94,6.276503502,6.275573088,10246,65.30817567,40,34,74,96,56,152,4,0.446499,0.460861,0.000008,No
117,yard,60,11.00218762,42,7.082128666,7.08171859,2520,77.9189083,24,35,59,47,48,95,4,0.459859,0.471645,0.00001,No
2183,swift,29,11.72923635,22,7.728755831,7.728545813,638,90.65240381,14,17,31,24,20,44,4,0.447252,0.461152,0.000019,No
7627,mile,148,10.0993199,104,6.175407385,6.174376875,15392,62.36741472,32,52,84,133,128,261,4,0.463981,0.475189,0.000007,No
9819,ingredient,36,11.51301324,32,7.354062381,7.35375234,1152,84.66741756,12,16,28,33,31,64,4,0.453526,0.466265,0.000021,No
12786,entity,54,11.10754813,45,7.013135794,7.012695706,2430,77.89874338,18,24,42,43,46,89,4,0.449631,0.463242,0.000014,No
15206,chosen,298,9.399438691,267,5.232549626,5.229886135,79566,49.1830294,46,52,98,271,279,550,4,0.463448,0.474762,0.000006,No
4985,puritan,11,12.6986369,10,8.517213191,8.517123189,110,108.1569978,7,7,14,10,7,17,5,0.387407,0.403974,0.000042,No
5171,propaganda,42,11.35886256,33,7.323290723,7.322970678,1386,83.1842528,21,21,42,30,34,64,4,0.451151,0.464429,0.000014,No
5221,profession,52,11.14528846,45,7.013135794,7.012695706,2340,78.16342143,14,31,45,38,49,87,4,0.453955,0.46688,0.000013,No
11808,framework,53,11.12624026,46,6.991156888,6.990706795,2438,77.78529125,17,22,39,38,46,84,4,0.444375,0.458904,0.000015,No
14338,coverage,50,11.18450917,45,7.013135794,7.012695706,2250,78.43848162,25,20,45,39,45,84,4,0.448995,0.462655,0.000013,No
16297,boris,51,11.16470654,42,7.082128666,7.08171859,2142,79.06988827,35,10,45,45,17,62,4,0.426707,0.443186,0.000013,No
4486,restaurant,116,10.34294199,91,6.308938778,6.30803839,10556,65.25298777,39,34,73,101,85,186,4,0.45145,0.464946,0.000008,No
177,wow,12,12.61162553,10,8.517213191,8.517123189,120,107.4159033,4,7,11,11,8,19,4,0.400763,0.418136,0.000053,No
17756,amtrak,8,13.01709064,7,8.873888135,8.873828135,56,115.5122061,6,5,11,6,5,11,5,0.390329,0.407157,0.000053,No
18148,adolescent,8,13.01709064,8,8.740356743,8.740286741,64,113.7740159,7,4,11,8,4,12,5,0.326569,0.330623,0.000053,No
10009,improper,10,12.79394708,8,8.740356743,8.740286741,80,111.8236617,8,3,11,10,3,13,5,0.384337,0.400547,0.000053,No
16312,bop,11,12.6986369,4,9.433503923,9.433473923,44,119.7926411,8,3,11,8,11,19,5,0.349677,0.35953,0.000053,No
16026,bubonic,29,11.72923635,17,7.98658494,7.986424931,493,93.67654237,10,1,11,26,29,55,5,0.317379,0.32102,0.000053,No
11342,glasgow,168,9.972568198,124,5.999516719,5.998285986,20832,59.83058963,41,56,97,150,141,291,4,0.461472,0.473325,0.000006,No
5361,prague,123,10.28434782,76,6.489064944,6.488314678,9348,66.73580092,33,50,83,114,105,219,4,0.458398,0.470804,0.000007,No
8667,lightning,113,10.36914436,72,6.543132165,6.542421927,8136,67.84668198,36,47,83,98,92,190,4,0.449996,0.463983,0.000007,No
14174,cryptography,108,10.41440095,83,6.400957676,6.400137356,8964,66.66213971,19,39,58,90,93,183,4,0.462651,0.473912,0.00001,No
15703,cap,56,11.07118049,43,7.058598169,7.058178089,2408,78.14701431,30,28,58,47,43,90,4,0.456394,0.468781,0.00001,No
5383,pound,83,10.67769157,46,6.991156888,6.990706795,3818,74.64941696,27,37,64,68,67,135,4,0.443598,0.458477,0.000009,No
14620,conservative,190,9.849508105,135,5.914523506,5.913182634,25650,58.25514721,45,51,96,174,142,316,4,0.42068,0.438421,0.000006,No
7874,meal,78,10.73982335,61,6.70892442,6.708324252,4758,72.05266314,33,31,64,71,65,136,4,0.465869,0.47625,0.000009,No
6713,obsidian,29,11.72923635,8,8.740356743,8.740286741,232,102.51771,17,15,32,20,20,40,4,0.445591,0.459711,0.000018,No
15477,celery,12,12.61162553,9,8.622573707,8.622493705,108,108.7446707,7,7,14,7,12,19,4,0.399339,0.416714,0.000041,No
11944,foley,10,12.79394708,6,9.028038815,9.027988815,60,115.5042509,4,7,11,4,9,13,5,0.354857,0.366002,0.000052,No
11167,grandpa,8,13.01709064,6,9.028038815,9.027988815,48,117.5187995,5,6,11,5,6,11,5,0.384754,0.401068,0.000052,No
18287,acacia,10,12.79394708,8,8.740356743,8.740286741,80,111.8236617,8,3,11,8,3,11,5,0.325599,0.329006,0.000052,No
15667,carbonaceous,9,12.8993076,8,8.740356743,8.740286741,72,112.7445502,8,3,11,9,4,13,5,0.384337,0.400547,0.000052,No
12640,eternal,55,11.08919899,47,6.969650683,6.969190586,2585,77.28784332,25,32,57,51,46,97,4,0.415432,0.433093,0.00001,No
5853,phenomenon,72,10.81986606,67,6.615105665,6.61444546,4824,71.57455726,27,30,57,60,66,126,4,0.452959,0.466082,0.00001,No
7670,mickey,87,10.63062406,61,6.70892442,6.708324252,5307,71.32005335,37,20,57,56,66,122,4,0.42645,0.443121,0.00001,No
1130,typeface,8,13.01709064,7,8.873888135,8.873828135,56,115.5122061,5,5,10,7,6,13,4,0.438058,0.453153,0.000057,No
10754,hatred,27,11.80069531,23,7.684304068,7.684084048,621,90.68013099,18,12,30,22,26,48,4,0.450556,0.463777,0.000019,No
16738,belle,45,11.26789078,25,7.561701746,7.56145172,1125,85.20442939,24,14,38,37,33,70,4,0.426645,0.443205,0.000015,No
13220,drunk,63,10.95339745,47,6.969650683,6.969190586,2961,76.34135402,32,31,63,46,46,92,4,0.448054,0.462091,0.000009,No
8554,lloyd,79,10.72708432,50,6.907775279,6.907285168,3950,74.10028791,35,28,63,66,53,119,4,0.441765,0.456777,0.000009,No
11626,gabriel,111,10.38700198,85,6.377147028,6.376306692,9435,66.23943878,45,36,81,90,58,148,4,0.437034,0.452848,0.000007,No
826,vessel,68,10.87702447,48,6.948597273,6.948127172,3264,75.58006259,18,29,47,61,54,115,4,0.459062,0.470917,0.000012,No
9489,jamaica,121,10.30074163,90,6.319988614,6.319098235,10890,65.10056983,39,55,94,107,100,207,4,0.455096,0.468251,0.000006,No
3219,ski,62,10.96939779,49,6.927977986,6.92749788,3038,75.99574643,30,17,47,41,23,64,5,0.400068,0.417612,0.000012,No
5021,pump,61,10.98565831,41,7.106226218,7.105826145,2501,78.06657312,25,26,51,53,48,101,4,0.446813,0.460951,0.000011,No
5631,playoff,43,11.33533206,29,7.452502454,7.452222421,1247,84.47659001,18,15,33,34,28,62,4,0.420043,0.43713,0.000017,No
15760,camouflage,51,11.16470654,29,7.452502454,7.452222421,1479,83.20500292,29,22,51,40,38,78,4,0.456958,0.469128,0.000011,No
15936,burgundy,98,10.5115647,77,6.475992862,6.475232589,7546,68.07281796,19,51,70,83,79,162,4,0.466444,0.477048,0.000008,No
10766,hastings,41,11.38296011,32,7.354062381,7.35375234,1312,83.71099874,17,23,40,36,31,67,4,0.435843,0.451561,0.000014,No
14237,croatia,114,10.36033373,84,6.388981485,6.388151157,9576,66.19198038,34,46,80,98,85,183,4,0.449074,0.463218,0.000007,No
12765,epic,113,10.36914436,86,6.365450988,6.364600644,9718,66.0042802,32,38,70,87,84,171,4,0.448643,0.462702,0.000008,No
16197,brandy,32,11.63079627,16,8.047209562,8.047059554,512,93.59545499,18,17,35,19,21,40,4,0.441468,0.456298,0.000016,No
12920,ellis,25,11.87765635,20,7.824066011,7.823875996,500,92.93156735,19,16,35,19,21,40,4,0.419289,0.436417,0.000016,No
14262,crest,49,11.20471188,32,7.354062381,7.35375234,1568,82.40015013,20,23,43,40,42,82,4,0.449154,0.462838,0.000013,No
4769,ranch,35,11.54118412,25,7.600922459,7.600682435,875,87.72364555,14,17,31,27,31,58,4,0.451748,0.464856,0.000018,No
1727,thorn,50,11.18450917,16,8.047209562,8.047059554,800,90.00408915,31,31,62,35,33,68,4,0.40596,0.42399,0.000009,No
523,watson,45,11.28986969,33,7.323290723,7.322970678,1485,82.67899794,33,29,62,40,37,77,4,0.434967,0.450932,0.000009,No
10324,horror,130,10.22899773,85,6.377147028,6.376306692,11050,65.23182245,44,35,79,108,81,189,4,0.413343,0.431192,0.000007,No
10879,hamburg,110,10.39605181,82,6.413079037,6.412268725,9020,66.67070194,29,40,69,100,84,184,4,0.450613,0.464368,0.000008,No
1560,tomatoes,53,11.12624026,38,7.182212124,7.181842063,2014,79.91101772,24,22,46,41,37,78,4,0.443564,0.458167,0.000012,No
6041,pen,84,10.66571538,57,6.776747016,6.776186871,4788,72.27885487,25,30,55,67,70,137,4,0.460598,0.472152,0.00001,No
5912,perspective,61,10.98565831,45,7.013135794,7.012695706,2745,77.04391354,27,28,55,47,48,95,4,0.448847,0.462688,0.00001,No
14292,crawford,50,11.18450917,31,7.38581108,7.385511041,1550,82.60667176,31,24,55,47,43,90,4,0.443753,0.458383,0.00001,No
10989,gully,7,13.15062203,6,9.028038815,9.027988815,42,118.7243261,6,4,10,6,5,11,5,0.38712,0.403641,0.000055,No
5274,primitive,67,10.89183956,60,6.725453722,6.72486356,4020,73.25256289,24,37,61,60,40,100,4,0.437228,0.453036,0.000009,No
13749,dense,78,10.73982335,71,6.557118407,6.556418176,5538,70.42229338,27,34,61,72,53,125,4,0.434679,0.450759,0.000009,No
17418,aristotle,68,10.87702447,50,6.907775279,6.907285168,3400,75.13604076,31,30,61,48,50,98,4,0.453155,0.466241,0.000009,No
14078,cyclone,223,9.689360406,118,6.04911366,6.047942998,26314,58.61204239,19,59,78,59,153,212,4,0.466322,0.477105,0.000007,No
17048,bag,52,11.14528846,37,7.208880372,7.208520314,1924,80.34505121,17,25,42,46,47,93,4,0.449711,0.46334,0.000013,No
15838,cage,39,11.43297053,28,7.487593774,7.487323743,1092,85.60543897,17,25,42,37,29,66,4,0.452024,0.465218,0.000013,No
8873,lavender,40,11.40765272,14,8.180740955,8.180610949,560,93.32305183,19,23,42,35,29,64,4,0.445133,0.459467,0.000013,No
4357,rigid,39,11.43297053,30,7.418600903,7.418310866,1170,84.8166455,23,19,42,30,25,55,4,0.432867,0.448853,0.000013,No
7833,meiji,57,11.05348091,25,7.600922459,7.600682435,1425,84.0166513,15,17,32,44,49,93,4,0.419556,0.43691,0.000017,No
5329,prefer,54,11.10754813,53,6.849506371,6.848986246,2862,76.08122168,16,18,34,36,47,83,4,0.429089,0.44566,0.000016,No
18190,adaptation,56,11.07118049,51,6.887972651,6.887472536,2856,76.25798841,20,14,34,51,51,102,4,0.446285,0.460312,0.000016,No
17977,alberto,49,11.20471188,33,7.323290723,7.322970678,1617,82.05536256,24,8,32,35,9,44,4,0.405821,0.423375,0.000017,No
11287,gnu,73,10.80607274,43,7.058598169,7.058178089,3139,76.27572522,14,22,36,61,59,120,4,0.448201,0.462026,0.000015,No
17610,anthropology,39,11.43297053,26,7.561701746,7.56145172,1014,86.45271323,13,17,30,21,28,49,4,0.442867,0.4575,0.000018,No
7465,molecular,83,10.67769157,68,6.600290579,6.599620368,5644,70.47586707,32,28,60,64,63,127,5,0.385757,0.40258,0.000009,No
18364,aaron,80,10.71450554,54,6.830814238,6.830284108,4320,73.18879701,32,28,60,55,42,97,4,0.437616,0.453195,0.000009,No
17890,allison,56,11.07118049,22,7.728755831,7.728545813,1232,85.56645074,36,24,60,51,35,86,4,0.448382,0.462213,0.000009,No
7634,miguel,59,11.01899473,51,6.887972651,6.887472536,3009,75.89853437,19,11,30,39,36,75,4,0.409575,0.427267,0.000018,No
2243,survivor,77,10.75272676,44,7.03560865,7.035178566,3388,75.65197738,43,34,77,68,70,138,4,0.450053,0.463767,0.000007,No
1242,tsar,122,10.29251113,85,6.377147028,6.376306692,10370,65.63685678,45,32,77,99,107,206,4,0.45237,0.465622,0.000007,No
7060,ned,62,10.96939779,40,7.13091883,7.130528762,2480,78.22188527,31,18,49,42,48,90,4,0.389012,0.406315,0.000011,No
6269,paradise,85,10.65388092,67,6.615105665,6.61444546,5695,70.47654803,31,36,67,68,74,142,4,0.455212,0.467997,0.000008,No
9486,jan,121,10.30074163,101,6.214628098,6.213637628,12221,64.01527838,52,15,67,65,26,91,4,0.382622,0.399006,0.000008,No
7336,mosque,205,9.773522198,93,6.287198791,6.286278386,19065,61.44807695,34,42,76,155,172,327,4,0.46642,0.476856,0.000007,No
1816,thai,93,10.56393268,56,6.794446593,6.793896453,5208,71.77607644,34,42,76,70,67,137,4,0.409387,0.42745,0.000007,No
9530,item,120,10.30904043,87,6.353890166,6.353029813,10440,65.50251063,39,37,76,109,108,217,4,0.467464,0.47756,0.000007,No
10339,horace,29,11.72923635,18,7.929426526,7.929256515,522,93.00611783,23,15,38,25,20,45,4,0.433406,0.449266,0.000014,No
2493,strait,139,10.16205824,99,6.224678434,6.223697973,13761,63.2555448,18,41,59,78,116,194,4,0.456841,0.469405,0.000009,No
9621,involve,78,10.73982335,71,6.557118407,6.556418176,5538,70.42229338,20,33,53,48,56,104,4,0.434828,0.450993,0.00001,No
10212,hurt,215,9.725894149,178,5.638014734,5.636243201,38270,54.83473451,48,58,106,184,183,367,4,0.464966,0.476053,0.000005,No
1105,ulcer,10,12.79394708,6,9.028038815,9.027988815,60,115.5042509,2,8,10,7,9,16,4,0.435138,0.450665,0.000053,No
4997,puppeteer,10,12.79394708,7,8.873888135,8.873828135,70,113.5320552,4,6,10,6,7,13,4,0.422814,0.439539,0.000053,No
6054,peggy,7,13.15062203,6,9.028038815,9.027988815,42,118.7243261,4,6,10,4,6,10,5,0.384495,0.400777,0.000053,No
3341,sienna,10,12.79394708,7,8.873888135,8.873828135,70,113.5320552,5,5,10,7,7,14,4,0.391465,0.408343,0.000053,No
14317,cradle,16,12.32394346,13,8.254848927,8.254728922,208,101.7322914,6,4,10,13,16,29,4,0.418241,0.435417,0.000053,No
2947,sore,9,12.8993076,7,8.873888135,8.873828135,63,114.4670127,6,4,10,7,8,15,5,0.367973,0.382156,0.000053,No
12087,fit,167,9.978538365,150,5.80916299,5.807671909,25050,57.96695577,39,49,88,137,150,287,4,0.469169,0.479081,0.000006,No
4116,sa,36,11.51301324,28,7.487593774,7.487323743,1008,86.20476625,13,20,33,26,27,53,4,0.45267,0.465655,0.000016,No
15037,clifton,30,11.6953348,19,7.875359305,7.875179292,570,92.10496371,14,19,33,23,27,50,4,0.439762,0.454857,0.000016,No
2118,syphilis,25,11.87765635,11,8.421903011,8.421803008,275,100.0324698,15,18,33,20,23,43,4,0.441468,0.456326,0.000016,No
4496,respiration,49,11.20471188,25,7.600922459,7.600682435,1225,85.16614617,11,20,31,44,36,80,4,0.44022,0.455294,0.000017,No
11981,floyd,86,10.64218488,47,6.969650683,6.969190586,4042,74.17231112,28,47,75,78,74,152,4,0.428313,0.445426,0.000007,No
11422,gerry,34,11.57017165,22,7.728755831,7.728545813,748,89.42303163,20,15,35,22,24,46,4,0.431331,0.447421,0.000015,No
9469,jaw,93,10.56393268,62,6.692663899,6.692053725,5766,70.70085091,20,38,58,55,76,131,4,0.465551,0.476119,0.000009,No
72,yorkshire,228,9.667186548,128,5.96776802,5.966497239,29184,57.69152673,30,57,87,208,204,412,4,0.466395,0.477133,0.000006,No
15363,charcoal,25,11.87765635,17,7.98658494,7.986424931,425,94.86191135,13,16,29,16,21,37,4,0.446982,0.460922,0.000018,No
10411,holly,63,10.95339745,38,7.182212124,7.181842063,2394,78.66962398,26,32,58,47,46,93,4,0.437023,0.452768,0.000009,No
8143,manitoba,102,10.47155936,53,6.849506371,6.848986246,5406,71.72501257,23,29,52,80,81,161,4,0.456031,0.468523,0.00001,No
15155,cigar,11,12.6986369,10,8.517213191,8.517123189,110,108.1569978,3,7,10,9,7,16,5,0.347534,0.356943,0.000052,No
13309,doughnut,11,12.6986369,6,9.028038815,9.027988815,66,114.6437869,3,7,10,8,8,16,5,0.336333,0.342555,0.000052,No
6113,pavilion,7,13.15062203,6,9.028038815,9.027988815,42,118.7243261,4,6,10,4,7,11,4,0.428044,0.444322,0.000052,No
18216,acronym,80,10.71450554,70,6.571303042,6.570612818,5600,70.40826287,18,22,40,71,58,129,4,0.46067,0.472058,0.000013,No
12570,eventual,14,12.45747485,13,8.254848927,8.254728922,182,102.8345729,5,5,10,13,5,18,5,0.3247,0.328053,0.000052,No
5886,petit,12,12.61162553,11,8.421903011,8.421803008,132,106.213887,5,5,10,5,6,11,5,0.32731,0.330962,0.000052,No
8531,lockheed,12,12.61162553,10,8.517213191,8.517123189,120,107.4159033,5,5,10,11,10,21,5,0.334281,0.339621,0.000052,No
16230,brace,5,13.48709426,4,9.433503923,9.433473923,20,127.2305567,5,5,10,5,5,10,5,0.347031,0.35638,0.000052,No
1994,tartar,6,13.30477271,3,9.721185996,9.721165996,18,129.3381701,5,5,10,5,6,11,5,0.329332,0.333748,0.000052,No
12520,exclusive,69,10.86242567,64,6.660915201,6.660285015,4416,72.35369628,37,28,65,58,46,104,4,0.436948,0.452613,0.000008,No
12361,fairy,102,10.47155936,59,6.74226084,6.741680684,6018,70.60198464,40,25,65,87,61,148,5,0.384504,0.401376,0.000008,No
4241,rope,107,10.42370334,72,6.543132165,6.542421927,7704,68.20366862,29,45,74,95,86,181,4,0.465185,0.475968,0.000007,No
11751,fresh,159,10.02762798,132,5.936996362,5.935685529,20988,59.5339908,43,31,74,128,134,262,4,0.434828,0.450801,0.000007,No
3387,shrine,68,10.87702447,48,6.948597273,6.948127172,3264,75.58006259,21,26,47,58,56,114,4,0.464528,0.475119,0.000011,No
3001,solomon,63,10.95339745,47,6.969650683,6.969190586,2961,76.34135402,17,26,43,52,37,89,4,0.449006,0.462781,0.000012,No
11481,gender,100,10.49136199,65,6.645411014,6.644770822,6500,69.71941253,45,41,86,89,79,168,4,0.462699,0.473959,0.000006,No
15212,chord,73,10.80607274,29,7.452502454,7.452222421,2117,80.53228359,26,31,57,57,59,116,4,0.461568,0.472922,0.000009,No
13352,doom,54,11.10754813,26,7.561701746,7.56145172,1404,83.9919661,28,29,57,46,51,97,4,0.44258,0.457448,0.000009,No
17057,bacon,66,10.90687744,37,7.208880372,7.208520314,2442,78.62637466,29,28,57,56,42,98,4,0.440133,0.455355,0.000009,No
4336,risk,111,10.38700198,95,6.265921393,6.264980969,10545,65.08413789,30,27,57,94,98,192,4,0.459478,0.471222,0.000009,No
15832,cairo,87,10.63062406,68,6.600290579,6.599620368,5916,70.16520782,25,39,64,80,73,153,4,0.466628,0.476968,0.000008,No
6521,oral,96,10.53218399,58,6.759355274,6.758785123,5568,71.19077337,40,24,64,71,79,150,5,0.396316,0.41388,0.000008,No
11368,giovanni,102,10.47155936,85,6.377147028,6.376306692,8670,66.77867367,41,23,64,72,42,114,4,0.403781,0.42154,0.000008,No
6023,penis,127,10.25234509,57,6.776747016,6.776186871,7239,69.47754901,23,50,73,116,111,227,4,0.462398,0.473917,0.000007,No
8355,lying,74,10.79246708,71,6.557118407,6.556418176,5254,70.76748458,37,36,73,55,61,116,4,0.420999,0.438473,0.000007,No
3757,sculptor,66,10.90687744,59,6.74226084,6.741680684,3894,73.53701262,22,29,51,51,48,99,4,0.436679,0.452411,0.00001,No
10892,halloween,28,11.76432767,17,7.98658494,7.986424931,476,93.95680218,16,18,34,21,23,44,4,0.447557,0.46142,0.000015,No
14966,cobb,29,11.72923635,16,8.047209562,8.047059554,464,94.38762289,16,18,34,22,25,47,4,0.446128,0.460228,0.000015,No
11113,greenland,112,10.37803331,69,6.58569178,6.585011562,7728,68.34652863,40,45,85,100,93,193,4,0.461017,0.472725,0.000006,No
3498,shaw,48,11.22533117,31,7.38581108,7.385511041,1488,82.9081753,25,26,51,41,35,76,4,0.409207,0.42699,0.00001,No
9496,jade,26,11.83843564,16,8.047209562,8.047059554,416,95.26637248,17,13,30,17,18,35,4,0.368952,0.383218,0.000017,No
15367,chapter,101,10.48141166,79,6.450350432,6.449570143,7979,67.60877823,51,34,85,83,85,168,4,0.458504,0.470579,0.000006,No
722,vista,65,10.92214491,45,7.013135794,7.012695706,2925,76.5984854,10,29,39,32,49,81,4,0.455645,0.468208,0.000013,No
9334,judith,31,11.66254497,24,7.641744454,7.641514432,744,89.12218836,20,19,39,22,23,45,4,0.430317,0.446599,0.000013,No
8947,lanka,86,10.64218488,68,6.600290579,6.599620368,5848,70.24151261,3,43,46,86,74,160,4,0.458896,0.471049,0.000011,No
5447,portia,30,11.6953348,15,8.111748083,8.111608076,450,94.86960961,11,12,23,21,24,45,4,0.432466,0.448388,0.000022,No
3956,saskatchewan,44,11.31234254,23,7.684304068,7.684084048,1012,86.92747983,22,24,46,40,40,80,4,0.447489,0.461476,0.000011,No
8971,lancaster,72,10.81986606,44,7.03560865,7.035178566,3168,76.12434324,21,35,56,57,55,112,4,0.459454,0.471354,0.000009,No
15404,challenge,75,10.77904406,60,6.725453722,6.72486356,4500,72.49396202,25,31,56,59,64,123,4,0.463775,0.474649,0.000009,No
17840,alto,73,10.80607274,46,6.991156888,6.990706795,3358,75.54694984,20,22,42,57,48,105,4,0.429817,0.44621,0.000012,No
8387,lunar,61,10.98565831,45,7.013135794,7.012695706,2745,77.04391354,20,22,42,53,44,97,4,0.390372,0.407442,0.000012,No
4917,quantity,97,10.5218212,76,6.489064944,6.488314678,7372,68.27678109,30,33,63,68,79,147,4,0.465991,0.476372,0.000008,No
5284,pride,74,10.79246708,53,6.849506371,6.848986246,3922,73.92307205,27,29,56,55,61,116,4,0.448269,0.462199,0.000009,No
6015,penny,76,10.76579884,34,7.29343776,7.293107712,2584,78.51968375,29,27,56,62,63,125,4,0.414056,0.431741,0.000009,No
10634,hello,69,10.86242567,39,7.156236638,7.155856573,2691,77.73408858,34,29,63,49,66,115,4,0.419041,0.436487,0.000008,No
6697,occupation,120,10.30904043,99,6.224678434,6.223697973,11880,64.17046167,42,30,72,104,95,199,4,0.463364,0.474283,0.000007,No
13951,davy,24,11.91847835,19,7.875359305,7.875179292,456,93.86229935,14,7,21,14,20,34,5,0.413112,0.43071,0.000024,No
5715,pirate,47,11.24638458,35,7.264450223,7.264110172,1645,81.69880094,21,29,50,43,38,81,4,0.443708,0.45842,0.00001,No
11396,gibson,48,11.22533117,35,7.264450223,7.264110172,1680,81.54585949,22,28,50,40,37,77,4,0.432856,0.449017,0.00001,No
11191,grade,91,10.58567267,68,6.600290579,6.599620368,6188,69.8685156,38,45,83,69,74,143,4,0.464722,0.475621,0.000006,No
10764,hat,107,10.42370334,73,6.529338843,6.528618598,7811,68.05989113,24,47,71,94,78,172,4,0.463098,0.474405,0.000007,No
567,warsaw,110,10.39605181,64,6.660915201,6.660285015,7040,69.24721954,29,42,71,99,98,197,4,0.464868,0.475696,0.000007,No
4098,sad,85,10.65388092,73,6.529338843,6.528618598,6205,69.56279853,31,40,71,72,68,140,4,0.439175,0.454763,0.000007,No
10806,hardy,74,10.79246708,36,7.236279346,7.235929291,2664,78.09730665,34,37,71,58,52,110,4,0.452243,0.465612,0.000007,No
10340,hopkins,50,11.18450917,39,7.156236638,7.155856573,1950,80.03899432,11,20,31,21,23,44,4,0.444364,0.458791,0.000016,No
7877,meadow,26,11.83843564,19,7.875359305,7.875179292,494,93.23193427,13,18,31,21,23,44,4,0.439555,0.454669,0.000016,No
3473,shellfish,28,11.76432767,18,7.929426526,7.929256515,504,93.28437187,14,17,31,18,23,41,4,0.403175,0.420798,0.000016,No
12927,elliot,24,11.91847835,21,7.775275846,7.77507583,504,92.66945682,18,13,31,22,15,37,5,0.395407,0.412711,0.000016,No
9497,jacques,117,10.33435824,106,6.15635919,6.155308659,12402,63.62202134,46,16,62,84,52,136,4,0.43293,0.448867,0.000008,No
8417,luck,66,10.90687744,57,6.776747016,6.776186871,3762,73.91314912,17,38,55,65,63,128,4,0.46437,0.475227,0.000009,No
14129,cure,78,10.73982335,64,6.660915201,6.660285015,4992,71.53705261,22,33,55,75,63,138,4,0.461532,0.472936,0.000009,No
15782,calvin,70,10.84803694,41,7.106226218,7.105826145,2870,77.08860448,29,26,55,58,56,114,4,0.436271,0.451998,0.000009,No
5029,pulmonary,26,11.83843564,15,8.111748083,8.111608076,390,96.0304076,5,4,9,19,9,28,5,0.313605,0.317883,0.000055,No
10459,hiss,5,13.48709426,4,9.433503923,9.433473923,20,127.2305567,5,4,9,5,5,10,5,0.396369,0.413523,0.000055,No
2530,stoke,52,11.14528846,17,7.98658494,7.986424931,884,89.01279296,31,24,55,43,34,77,5,0.383242,0.399892,0.000009,No
2967,sonic,61,10.98565831,32,7.354062381,7.35375234,1952,80.78921654,26,19,45,44,51,95,4,0.429598,0.445956,0.000011,No
8297,madeleine,26,11.83843564,14,8.180740955,8.180610949,364,96.84717527,12,14,26,19,20,39,4,0.411598,0.429098,0.000019,No
4060,salesman,39,11.43297053,27,7.523961418,7.52370139,1053,86.02122917,10,19,29,30,32,62,4,0.451105,0.464354,0.000017,No
2362,sue,23,11.96103796,16,8.047209562,8.047059554,368,96.25297905,14,15,29,18,18,36,4,0.43655,0.452017,0.000017,No
2922,southeastern,180,9.903575326,172,5.672303807,5.670592378,30960,56.17608803,25,57,82,171,148,319,4,0.436443,0.45273,0.000006,No
10907,haiti,150,10.08589688,93,6.287198791,6.286278386,13950,63.41203869,31,51,82,131,119,250,4,0.459597,0.471743,0.000006,No
12728,equilibrium,44,11.31234254,25,7.600922459,7.600682435,1100,85.98423851,18,23,41,33,39,72,4,0.451438,0.464692,0.000012,No
11766,freeman,41,11.38296011,25,7.600922459,7.600682435,1025,86.52099716,21,20,41,30,30,60,4,0.443033,0.457678,0.000012,No
7572,ministry,209,9.754197925,92,6.298009707,6.297099311,19228,61.43203322,47,35,82,182,190,372,4,0.46521,0.475799,0.000006,No
1338,triad,8,13.01709064,8,8.740356743,8.740286741,64,113.7740159,7,5,12,8,6,14,5,0.393078,0.410291,0.000041,No
10151,hypothesis,85,10.65388092,38,7.182212124,7.181842063,3230,76.51843272,17,32,49,61,68,129,4,0.454536,0.467377,0.00001,No
8289,madrid,193,9.833841988,132,5.936996362,5.935685529,25476,58.38348411,34,64,98,161,165,326,4,0.468055,0.478536,0.000005,No
2834,sphere,83,10.67769157,57,6.776747016,6.776186871,4731,72.36001449,18,31,49,77,77,154,4,0.460802,0.472321,0.00001,No
2303,sunlight,91,10.58567267,76,6.489064944,6.488314678,6916,68.69111744,32,38,70,80,69,149,4,0.462941,0.474109,0.000007,No
7071,necessary,143,10.13368755,136,5.907143398,5.905792513,19448,59.8611455,34,36,70,125,128,253,4,0.447873,0.462021,0.000007,No
1732,thor,59,11.01899473,26,7.561701746,7.56145172,1534,83.32235172,26,35,61,44,53,97,4,0.447433,0.461636,0.000008,No
7967,mature,65,10.92214491,63,6.676663558,6.676043378,4095,72.92348688,25,29,54,54,39,93,4,0.452335,0.465518,0.000009,No
10905,hal,33,11.60002462,28,7.487593774,7.487323743,924,86.85627209,14,13,27,23,26,49,5,0.363088,0.376393,0.000018,No
13199,dudley,26,11.83843564,20,7.824066011,7.823875996,520,92.62470191,15,12,27,19,18,37,4,0.436389,0.451843,0.000018,No
11378,gilmore,17,12.26331883,11,8.421903011,8.421803008,187,103.2804818,11,7,18,13,9,22,4,0.41552,0.432839,0.000027,No
6134,patron,91,10.58567267,80,6.43777165,6.436981353,7280,68.14814341,28,16,44,84,86,170,4,0.43768,0.453036,0.000011,No
12451,explosion,85,10.65388092,57,6.776747016,6.776186871,4845,72.19865574,27,42,69,78,65,143,4,0.461185,0.472818,0.000007,No
1934,teen,88,10.61919536,72,6.543132165,6.542421927,6336,69.48279875,33,36,69,72,69,141,4,0.411236,0.429182,0.000007,No
2013,tap,37,11.48561426,26,7.561701746,7.56145172,962,86.85078944,16,21,37,27,31,58,4,0.441666,0.456538,0.000013,No
5102,proud,47,11.24638458,41,7.106226218,7.105826145,1927,79.91935292,21,16,37,44,45,89,4,0.447286,0.461162,0.000013,No
9071,kong,216,9.72125377,124,5.999516719,5.998285986,26784,58.32282452,10,86,96,211,168,379,4,0.453549,0.467603,0.000005,No
13408,document,177,9.920382445,146,5.836191663,5.834740639,25842,57.89725331,46,50,96,151,142,293,4,0.471374,0.480743,0.000005,No
13612,diana,65,10.92214491,37,7.208880372,7.208520314,2405,78.73643604,28,20,48,53,51,104,5,0.414056,0.43155,0.00001,No
15537,catch,166,9.984544389,134,5.921958484,5.920627626,22244,59.12805736,36,44,80,150,132,282,4,0.455574,0.468424,0.000006,No
14871,colon,49,11.20471188,20,7.824066011,7.823875996,980,87.66640537,19,21,40,36,38,74,4,0.453202,0.466077,0.000012,No
15865,byzantine,239,9.620068625,198,5.531531254,5.52955935,47322,53.21371026,40,40,80,195,218,413,4,0.427405,0.444393,0.000006,No
6431,ottoman,314,9.347139191,243,5.326736841,5.324313956,76302,49.78975069,43,37,80,292,278,570,5,0.397782,0.415608,0.000006,No
2330,sultan,181,9.898035146,133,5.929449156,5.92812831,24073,58.68989614,43,37,80,130,113,243,4,0.455026,0.46788,0.000006,No
5974,percy,34,11.57017165,29,7.452502454,7.452222421,986,86.22673264,19,13,32,26,18,44,4,0.403725,0.421493,0.000015,No
16646,beryl,17,12.26331883,9,8.622573707,8.622493705,153,105.7413705,6,9,15,12,11,23,4,0.41003,0.427535,0.000032,No
12466,expert,78,10.73982335,65,6.645411014,6.644770822,5070,71.37054039,30,30,60,60,61,121,4,0.458765,0.470711,0.000008,No
8280,magdalene,8,13.01709064,8,8.740356743,8.740286741,64,113.7740159,3,6,9,8,7,15,5,0.385631,0.402239,0.000053,No
9115,klan,11,12.6986369,4,9.433503923,9.433473923,44,119.7926411,3,6,9,11,7,18,5,0.351895,0.362287,0.000053,No
14003,dandy,7,13.15062203,5,9.210360372,9.210320372,35,121.121968,3,6,9,7,6,13,5,0.366355,0.379938,0.000053,No
10533,hexagon,8,13.01709064,4,9.433503923,9.433473923,32,122.7967756,3,6,9,7,7,14,4,0.39779,0.415225,0.000053,No
14986,clyde,55,11.08919899,41,7.106226218,7.105826145,2255,78.80235661,21,32,53,52,43,95,4,0.443287,0.458087,0.000009,No
9937,indecent,7,13.15062203,7,8.873888135,8.873828135,49,116.6971488,4,5,9,4,6,10,5,0.327721,0.331668,0.000053,No
8458,lotion,7,13.15062203,3,9.721185996,9.721165996,21,127.8396427,4,5,9,6,5,11,5,0.356704,0.368771,0.000053,No
8414,lucretia,5,13.48709426,2,10.1266511,10.1266411,10,136.579098,4,5,9,4,5,9,5,0.395759,0.412908,0.000053,No
5605,plow,9,12.8993076,6,9.028038815,9.027988815,54,116.4554497,5,4,9,9,6,15,4,0.427477,0.4439,0.000053,No
11321,globular,7,13.15062203,7,8.873888135,8.873828135,49,116.6971488,5,4,9,7,4,11,5,0.323198,0.326493,0.000053,No
2771,sportswear,10,12.79394708,5,9.210360372,9.210320372,50,117.8368632,5,4,9,6,8,14,4,0.390115,0.406883,0.000053,No
17943,alfonso,78,10.73982335,70,6.571303042,6.570612818,5460,70.57463386,35,18,53,65,56,121,4,0.401216,0.41907,0.000009,No
13143,dutchess,42,11.35886256,38,7.182212124,7.181842063,1596,81.58176039,6,3,9,40,42,82,5,0.361432,0.374243,0.000053,No
12375,fade,8,13.01709064,7,8.873888135,8.873828135,56,115.5122061,6,3,9,8,6,14,5,0.361373,0.374186,0.000053,No
18294,abuse,83,10.67769157,50,6.907775279,6.907285168,4150,73.75909386,21,47,68,73,71,144,4,0.452266,0.465838,0.000007,No
3776,screenplay,59,11.01899473,42,7.082128666,7.08171859,2478,78.03793847,13,21,34,47,51,98,4,0.458765,0.470532,0.000014,No
8684,lieutenant,113,10.36914436,82,6.413079037,6.412268725,9266,66.49814232,31,37,68,104,100,204,4,0.460407,0.472133,0.000007,No
2250,surrey,92,10.5747436,64,6.660915201,6.660285015,5888,70.43747039,31,37,68,70,81,151,4,0.445401,0.460012,0.000007,No
14622,conservation,114,10.36033373,81,6.42534913,6.424548825,9234,66.56876131,34,34,68,101,95,196,4,0.462784,0.473926,0.000007,No
3455,shield,98,10.5115647,64,6.660915201,6.660285015,6272,70.01664109,34,34,68,78,84,162,4,0.4656,0.476072,0.000007,No
3877,scary,29,11.72923635,26,7.561701746,7.56145172,754,88.69298697,20,14,34,24,20,44,4,0.438415,0.453627,0.000014,No
11464,genius,40,11.40765272,28,7.487593774,7.487323743,1120,85.41586951,16,27,43,37,35,72,4,0.456958,0.469218,0.000011,No
16914,barrier,64,10.93764909,47,6.969650683,6.969190586,3008,76.23159347,21,22,43,57,53,110,4,0.442437,0.457237,0.000011,No
4067,salad,60,11.00218762,24,7.641744454,7.641514432,1440,84.07590619,26,33,59,53,50,103,4,0.458647,0.470664,0.000008,No
14550,contract,196,9.818417518,152,5.795917763,5.794406652,29792,56.9067405,46,48,94,159,170,329,4,0.46876,0.478757,0.000005,No
2230,sussex,124,10.27625061,82,6.413079037,6.412268725,10168,65.90240738,27,40,67,115,105,220,4,0.457347,0.469772,0.000007,No
11168,grandmother,73,10.80607274,61,6.70892442,6.708324252,4453,72.49712526,16,36,52,72,62,134,4,0.444486,0.459204,0.000009,No
10232,hun,16,12.32394346,15,8.111748083,8.111608076,240,99.9687247,3,6,9,13,12,25,5,0.361682,0.374609,0.000052,No
6792,nrc,7,13.15062203,4,9.433503923,9.433473923,28,124.0564445,3,6,9,6,6,12,5,0.352202,0.362714,0.000052,No
15024,clip,42,11.35886256,29,7.452502454,7.452222421,1218,84.6519511,13,26,39,42,38,80,4,0.454303,0.467091,0.000012,No
9305,jungle,69,10.86242567,49,6.927977986,6.92749788,3381,75.25464594,19,33,52,62,59,121,4,0.451312,0.464809,0.000009,No
11924,fool,44,11.31234254,34,7.29343776,7.293107712,1496,82.50586626,20,32,52,41,40,81,4,0.448212,0.462232,0.000009,No
7950,maximum,143,10.13368755,123,6.007613929,6.006393208,17589,60.87928246,31,47,78,125,99,224,4,0.425643,0.442947,0.000006,No
12453,exploration,90,10.59672251,78,6.463089458,6.462319176,7020,68.48756552,22,30,52,79,70,149,4,0.463122,0.474114,0.000009,No
7293,mozart,121,10.30074163,79,6.450350432,6.449570143,9559,66.44339323,34,44,78,104,102,206,4,0.446746,0.461265,0.000006,No
16626,bethesda,6,13.30477271,6,9.028038815,9.027988815,36,120.1160044,4,5,9,5,6,11,5,0.361712,0.374618,0.000052,No
7127,nashville,65,10.92214491,38,7.182212124,7.181842063,2470,78.44516158,27,25,52,56,51,107,4,0.442205,0.457073,0.000009,No
13872,decline,51,11.16470654,49,6.927977986,6.92749788,2499,77.34884116,21,18,39,44,49,93,4,0.446106,0.460214,0.000012,No
14042,daffodil,6,13.30477271,2,10.1266511,10.1266411,12,134.7327912,5,4,9,5,4,9,5,0.346158,0.355192,0.000052,No
17500,approximate,77,10.75272676,61,6.70892442,6.708324252,4697,72.13923111,35,17,52,55,65,120,4,0.415821,0.433586,0.000009,No
10230,hundred,320,9.328211182,284,5.170824046,5.167990091,90880,48.23453868,38,55,93,314,127,441,4,0.437864,0.453951,0.000005,No
6767,nurse,35,11.54118412,30,7.418600903,7.418310866,1050,85.6194389,13,18,31,29,25,54,4,0.455738,0.468082,0.000015,No
14263,crescent,89,10.60789581,48,6.948597273,6.948127172,4272,73.70999588,26,40,66,66,73,139,4,0.459573,0.471537,0.000007,No
2477,straw,50,11.18450917,32,7.354062381,7.35375234,1600,82.25157816,18,24,42,37,44,81,4,0.457842,0.469866,0.000011,No
14840,comet,101,10.48141166,39,7.156236638,7.155856573,3939,75.00746214,29,37,66,87,75,162,4,0.452785,0.466058,0.000007,No
2363,sudden,37,11.48561426,35,7.264450223,7.264110172,1295,83.4366731,20,22,42,35,25,60,5,0.389225,0.406289,0.000011,No
15120,citizen,131,10.22133485,109,6.128450402,6.12736984,14279,62.6409437,37,40,77,93,116,209,4,0.461833,0.473288,0.000006,No
6545,opium,34,11.57017165,22,7.728755831,7.728545813,748,89.42303163,16,17,33,28,26,54,4,0.427447,0.443998,0.000014,No
16781,beethoven,86,10.64218488,65,6.645411014,6.644770822,5590,70.72169263,33,33,66,76,67,143,4,0.43848,0.454026,0.000007,No
11448,geoffrey,50,11.18450917,46,6.991156888,6.990706795,2300,78.19265833,24,18,42,39,43,82,5,0.381291,0.397716,0.000011,No
6028,penguin,65,10.92214491,34,7.29343776,7.293107712,2210,79.65998408,20,26,46,43,37,80,4,0.45677,0.469063,0.00001,No
11469,geneva,162,10.00893584,83,6.400957676,6.400137356,13446,64.06677471,44,48,92,140,117,257,4,0.462193,0.47372,0.000005,No
8404,luis,94,10.5532374,60,6.725453722,6.72486356,5640,70.97530972,32,19,51,68,34,102,5,0.39266,0.409904,0.000009,No
15142,cipher,134,10.19869238,54,6.830814238,6.830284108,7236,69.6653731,29,47,76,122,102,224,4,0.462868,0.474217,0.000006,No
13648,devon,92,10.5747436,61,6.70892442,6.708324252,5612,70.94515558,32,44,76,79,78,157,4,0.456817,0.469401,0.000006,No
1268,trouble,131,10.22133485,121,6.024007739,6.022807042,15851,61.57340026,35,41,76,114,89,203,4,0.461173,0.472809,0.000006,No
13644,devotion,25,11.87765635,17,7.98658494,7.986424931,425,94.86191135,13,11,24,23,24,47,4,0.442757,0.457293,0.000019,No
2116,syria,182,9.89252549,138,5.892544599,5.891173687,25116,58.29214765,45,69,114,163,156,319,4,0.467501,0.478212,0.000004,No
6434,ottawa,103,10.46180319,58,6.759355274,6.758785123,5974,70.71504456,27,30,57,84,67,151,4,0.4355,0.451378,0.000008,No
15412,chairman,150,10.08589688,121,6.024007739,6.022807042,18150,60.75752088,34,23,57,123,133,256,4,0.453816,0.46664,0.000008,No
11614,gain,150,10.08589688,135,5.914523506,5.913182634,20250,59.65327419,37,54,91,131,127,258,4,0.458315,0.470809,0.000005,No
8828,lebanon,134,10.19869238,81,6.42534913,6.424548825,10854,65.53015919,41,50,91,115,106,221,4,0.455084,0.468133,0.000005,No
11737,friday,154,10.05957957,130,5.952263834,5.950973027,20020,59.87727169,45,46,91,143,138,281,4,0.46386,0.474973,0.000005,No
1406,transit,94,10.5532374,48,6.948597273,6.948127172,4512,73.33019659,31,34,65,86,73,159,4,0.458339,0.470443,0.000007,No
9130,kirk,46,11.26789078,37,7.208880372,7.208520314,1702,81.22887668,20,15,35,31,28,59,4,0.41835,0.435558,0.000013,No
7141,naples,123,10.28434782,93,6.287198791,6.286278386,11439,64.65973919,31,59,90,113,106,219,4,0.464346,0.475602,0.000005,No
9253,karen,39,11.43297053,27,7.523961418,7.52370139,1053,86.02122917,23,22,45,32,25,57,4,0.43366,0.449618,0.00001,No
2980,somerset,117,10.33435824,76,6.489064944,6.488314678,8892,67.06032179,28,47,75,99,98,197,4,0.456136,0.468945,0.000006,No
5119,protector,53,11.12624026,40,7.13091883,7.130528762,2120,79.34031621,12,18,30,49,48,97,4,0.444064,0.458523,0.000015,No
11762,freeway,22,12.00548972,16,8.047209562,8.047059554,352,96.6106917,12,16,28,15,21,36,4,0.440046,0.455073,0.000016,No
15591,carthage,73,10.80607274,41,7.106226218,7.105826145,2993,76.79039739,26,30,56,55,58,113,4,0.452001,0.465312,0.000008,No
2430,stuck,62,10.96939779,59,6.74226084,6.741680684,3658,73.95854118,27,29,56,48,61,109,4,0.45854,0.470504,0.000008,No
12643,eta,33,11.60002462,11,8.421903011,8.421803008,363,97.69428224,16,16,32,20,20,40,4,0.452393,0.465359,0.000014,No
11231,goose,35,11.54118412,22,7.728755831,7.728545813,770,89.19899403,18,14,32,32,25,57,4,0.441842,0.456547,0.000014,No
12915,elmer,8,13.01709064,7,8.873888135,8.873828135,56,115.5122061,5,3,8,5,5,10,5,0.317203,0.321044,0.000056,No
6985,newfoundland,108,10.41440095,68,6.600290579,6.599620368,7344,68.73807248,32,42,74,94,100,194,4,0.456359,0.469016,0.000006,No
18126,adventure,94,10.5532374,80,6.43777165,6.436981353,7520,67.93933251,33,41,74,74,81,155,4,0.465942,0.47648,0.000006,No
13585,diego,172,9.949037701,115,6.074866156,6.073725528,19780,60.43907241,36,38,74,153,110,263,4,0.441227,0.4565,0.000006,No
6221,parody,40,11.40765272,26,7.561701746,7.56145172,1040,86.26126752,16,18,34,35,33,68,4,0.442051,0.456815,0.000013,No
15629,carlisle,33,11.60002462,19,7.875359305,7.875179292,627,91.3543618,16,18,34,19,27,46,4,0.405682,0.423338,0.000013,No
2754,springfield,79,10.72708432,43,7.058598169,7.058178089,3397,75.71817777,31,32,63,71,71,142,4,0.440548,0.455782,0.000007,No
8246,maiden,59,11.01899473,41,7.106226218,7.105826145,2419,78.30346927,15,29,44,50,56,106,4,0.445535,0.459946,0.00001,No
16366,bologna,57,11.05348091,39,7.156236638,7.155856573,2223,79.10132506,15,25,40,48,49,97,4,0.443953,0.458542,0.000011,No
15157,cicero,38,11.45894602,22,7.728755831,7.728545813,836,88.56339585,17,23,40,27,30,57,4,0.454443,0.467147,0.000011,No
513,wax,53,11.12624026,31,7.38581108,7.385511041,1643,82.17630862,29,26,55,46,46,92,4,0.446409,0.460627,0.000008,No
11490,gel,19,12.1520932,7,8.873888135,8.873828135,133,107.8363156,11,9,20,18,14,32,4,0.42051,0.437553,0.000022,No
15502,cavalry,53,11.12624026,33,7.323290723,7.322970678,1749,81.4806921,32,23,55,45,33,78,4,0.447016,0.461049,0.000008,No
14321,cpu,97,10.5218212,52,6.868554566,6.868044446,5044,72.26970303,21,52,73,84,75,159,4,0.464224,0.475372,0.000006,No
1677,thunder,83,10.67769157,65,6.645411014,6.644770822,5395,70.95764916,36,37,73,72,68,140,4,0.44352,0.45842,0.000006,No
3234,sixteen,105,10.44257183,96,6.255450093,6.25449966,10080,65.3229869,38,35,73,94,56,150,4,0.450293,0.464007,0.000006,No
7946,maya,116,10.34294199,64,6.660915201,6.660285015,7424,68.8934595,38,35,73,98,62,160,4,0.442459,0.457505,0.000006,No
3562,seventh,196,9.818417518,166,5.707810496,5.706159166,32536,56.04166656,32,55,87,185,151,336,4,0.449358,0.463612,0.000005,No
15557,castor,13,12.53158282,9,8.622573707,8.622493705,117,108.0544965,7,7,14,10,12,22,5,0.386328,0.40281,0.000031,No
9559,isabella,86,10.64218488,64,6.660915201,6.660285015,5504,70.88669104,30,32,62,75,74,149,4,0.456923,0.469279,0.000007,No
16841,bayreuth,56,11.07118049,32,7.354062381,7.35375234,1792,81.41815193,14,22,36,42,41,83,4,0.414482,0.432037,0.000012,No
83,yoga,53,11.12624026,34,7.29343776,7.293107712,1802,81.14854086,19,29,48,29,43,72,4,0.428261,0.444994,0.000009,No
16278,botany,66,10.90687744,60,6.725453722,6.72486356,3960,73.35369944,24,30,54,65,61,126,4,0.461029,0.472466,0.000008,No
13131,dye,40,11.40765272,24,7.641744454,7.641514432,960,87.17436693,17,19,36,32,31,63,4,0.441249,0.456148,0.000012,No
2365,sudan,84,10.66571538,50,6.907775279,6.907285168,4200,73.67636502,34,38,72,80,58,138,4,0.454385,0.467363,0.000006,No
9579,irregular,38,11.45894602,33,7.323290723,7.322970678,1254,83.91719306,18,18,36,32,20,52,4,0.40118,0.418751,0.000012,No
10138,ibn,133,10.20618305,86,6.365450988,6.364600644,11438,64.96695797,16,11,27,35,18,53,5,0.349065,0.359061,0.000016,No
2005,tar,37,11.48561426,21,7.775275846,7.77507583,777,89.30381917,22,14,36,30,26,56,4,0.437066,0.452496,0.000012,No
17733,anastasia,39,11.43297053,19,7.875359305,7.875179292,741,90.03875086,22,21,43,31,27,58,4,0.44696,0.460993,0.00001,No
16119,brigade,34,11.57017165,22,7.728755831,7.728545813,748,89.42303163,13,20,33,26,28,54,4,0.458138,0.470025,0.000013,No
14180,cryptanalysis,36,11.51301324,21,7.775275846,7.77507583,756,89.51685376,16,17,33,34,28,62,4,0.444041,0.45858,0.000013,No
2117,syracuse,44,11.31234254,24,7.641744454,7.641514432,1056,86.44603089,22,17,39,37,34,71,4,0.411331,0.42891,0.000011,No
1421,transcription,41,11.38296011,19,7.875359305,7.875179292,779,89.64490083,22,17,39,25,29,54,4,0.454921,0.467382,0.000011,No
1570,toledo,74,10.79246708,45,7.013135794,7.012695706,3330,75.68903722,25,36,61,66,65,131,4,0.4401,0.455519,0.000007,No
12057,flanders,225,9.680431775,187,5.588689667,5.586827973,42075,54.10092904,23,48,71,211,209,420,4,0.461005,0.472776,0.000006,No
1895,temporary,100,10.49136199,86,6.365450988,6.364600644,8600,66.78225055,36,49,85,86,64,150,4,0.427015,0.444205,0.000005,No
16850,bavaria,306,9.372947075,238,5.347527611,5.345154845,72828,50.12209328,34,72,106,221,269,490,4,0.465453,0.476663,0.000004,No
6362,pagoda,7,13.15062203,7,8.873888135,8.873828135,49,116.6971488,3,5,8,3,6,9,5,0.361638,0.37452,0.000053,No
16557,biopsy,9,12.8993076,3,9.721185996,9.721165996,27,125.3965684,3,5,8,4,8,12,4,0.390303,0.407592,0.000053,No
11203,gourmet,6,13.30477271,5,9.210360372,9.210320372,30,122.5417513,4,4,8,4,4,8,5,0.398603,0.416368,0.000053,No
8933,larch,15,12.38848198,1,10.81979828,10.81979828,15,134.040876,4,4,8,6,4,10,4,0.428034,0.444275,0.000053,No
1953,teapot,6,13.30477271,2,10.1266511,10.1266411,12,134.7327912,4,4,8,6,5,11,5,0.348955,0.358666,0.000053,No
7741,merritt,7,13.15062203,4,9.433503923,9.433473923,28,124.0564445,5,3,8,5,3,8,5,0.332827,0.337664,0.000053,No
771,vile,5,13.48709426,5,9.210360372,9.210320372,25,124.2209985,5,3,8,5,3,8,5,0.326599,0.330021,0.000053,No
11820,foxtrot,6,13.30477271,2,10.1266511,10.1266411,12,134.7327912,5,3,8,5,5,10,5,0.34731,0.356685,0.000053,No
7026,neptunium,5,13.48709426,2,10.1266511,10.1266411,10,136.579098,5,3,8,5,5,10,5,0.351561,0.361922,0.000053,No
8020,mask,58,11.03608917,41,7.106226218,7.105826145,2378,78.42494618,17,30,47,44,48,92,4,0.45717,0.469443,0.000009,No
5804,physiology,98,10.5115647,85,6.377147028,6.376306692,8330,67.03379357,21,26,47,91,93,184,4,0.457205,0.469396,0.000009,No
1482,tough,54,11.10754813,51,6.887972651,6.887472536,2754,76.50848775,21,26,47,46,33,79,4,0.389148,0.406254,0.000009,No
5269,princeton,77,10.75272676,49,6.927977986,6.92749788,3773,74.49465425,23,24,47,59,38,97,4,0.413902,0.431534,0.000009,No
1990,tasmania,92,10.5747436,62,6.692663899,6.692053725,5704,70.77320474,22,38,60,79,84,163,4,0.449643,0.463518,0.000007,No
7000,neutral,85,10.65388092,74,6.515733191,6.515002939,6290,69.41784553,34,50,84,70,63,133,4,0.455996,0.46887,0.000005,No
17472,arc,111,10.38700198,81,6.42534913,6.424548825,8991,66.74011411,29,41,70,103,79,182,4,0.465967,0.476522,0.000006,No
757,vinyl,49,11.20471188,34,7.29343776,7.293107712,1666,81.72086871,21,21,42,39,25,64,5,0.415938,0.4334,0.00001,No
13132,dyadic,14,12.45747485,1,10.81979828,10.81979828,14,134.787365,11,10,21,12,10,22,5,0.350125,0.360253,0.00002,No
6373,packet,30,11.6953348,23,7.684304068,7.684084048,690,89.87050875,16,14,30,25,21,46,4,0.438123,0.453383,0.000014,No
17830,alveolar,4,13.71023782,4,9.433503923,9.433473923,16,129.3355822,1,3,4,1,3,4,5,0.292371,0.298572,0.000104,No
7450,momentum,59,11.01899473,35,7.264450223,7.264110172,2065,80.04693875,19,33,52,51,50,101,4,0.461845,0.473152,0.000008,No
14271,creep,5,13.48709426,5,9.210360372,9.210320372,25,124.2209985,3,5,8,3,5,8,5,0.396928,0.414119,0.000052,No
8074,markham,5,13.48709426,4,9.433503923,9.433473923,20,127.2305567,3,5,8,3,5,8,5,0.347922,0.357326,0.000052,No
2214,swamp,50,11.18450917,40,7.13091883,7.130528762,2000,79.75582706,22,30,52,35,36,71,4,0.441315,0.456505,0.000008,No
13911,debris,43,11.33533206,37,7.208880372,7.208520314,1591,81.7150528,25,27,52,38,33,71,4,0.436819,0.452491,0.000008,No
17411,arlington,50,11.18450917,32,7.354062381,7.35375234,1600,82.25157816,25,27,52,41,46,87,4,0.416612,0.434243,0.000008,No
18221,acquisition,10,12.79394708,10,8.517213191,8.517123189,100,108.9687749,4,4,8,7,9,16,4,0.420003,0.437022,0.000052,No
14466,coriander,5,13.48709426,4,9.433503923,9.433473923,20,127.2305567,4,4,8,4,4,8,5,0.349429,0.35938,0.000052,No
14506,conway,17,12.26331883,14,8.180740955,8.180610949,238,100.3230346,15,11,26,15,14,29,4,0.426471,0.442989,0.000016,No
8432,loyal,71,10.8338523,58,6.759355274,6.758785123,4118,73.22985668,31,21,52,54,59,113,4,0.430912,0.447219,0.000008,No
15632,carla,6,13.30477271,6,9.028038815,9.027988815,36,120.1160044,5,3,8,5,3,8,5,0.341905,0.349867,0.000052,No
6078,pebble,5,13.48709426,4,9.433503923,9.433473923,20,127.2305567,5,3,8,5,4,9,5,0.329118,0.333644,0.000052,No
4832,racial,50,11.18450917,43,7.058598169,7.058178089,2150,78.94695596,22,10,32,41,20,61,5,0.385556,0.402031,0.000013,No
7279,muddy,36,11.51301324,30,7.418600903,7.418310866,1080,85.41045041,22,10,32,33,14,47,4,0.397221,0.414554,0.000013,No
4893,queensland,126,10.26025027,84,6.388981485,6.388151157,10584,65.55254901,34,49,83,104,104,208,4,0.458706,0.47102,0.000005,No
8584,literary,111,10.38700198,99,6.224678434,6.223697973,10989,64.65574719,42,41,83,95,76,171,5,0.388612,0.405923,0.000005,No
560,wash,55,11.08919899,30,7.600922459,7.600682435,1650,84.28814168,19,27,46,42,43,85,4,0.453932,0.466786,0.000009,No
5397,potato,69,10.86242567,40,7.13091883,7.130528762,2760,77.45907577,21,25,46,55,41,96,4,0.441897,0.456824,0.000009,No
1175,turtle,54,11.10754813,28,7.487593774,7.487323743,1512,83.16880823,21,25,46,44,38,82,4,0.416504,0.434032,0.000009,No
1983,tate,17,12.26331883,15,8.111748083,8.111608076,255,99.47695304,11,12,23,13,15,28,5,0.387958,0.404693,0.000018,No
18298,abstract,92,10.5747436,66,6.630143542,6.629493344,6072,70.11206799,33,36,69,79,63,142,4,0.458516,0.470617,0.000006,No
278,wise,60,11.00218762,50,6.907775279,6.907285168,3000,76.00063962,29,30,59,54,53,107,4,0.443808,0.458533,0.000007,No
13882,decimal,61,10.98565831,33,7.323290723,7.322970678,2013,80.45116961,18,23,41,53,42,95,4,0.441721,0.456632,0.00001,No
3414,shorthand,38,11.45894602,24,7.641744454,7.641514432,912,87.56633718,17,17,34,28,30,58,4,0.424219,0.441093,0.000012,No
8628,linear,83,10.67769157,52,6.868554566,6.868044446,4316,73.34030718,36,32,68,63,59,122,4,0.425011,0.442036,0.000006,No
4447,revenge,72,10.81986606,61,6.70892442,6.708324252,4392,72.58966362,37,31,68,62,66,128,4,0.462422,0.473574,0.000006,No
8042,martha,56,11.07118049,35,7.264450223,7.264110172,1960,80.42603955,29,22,51,35,38,73,5,0.400266,0.417917,0.000008,No
13056,eddy,14,12.45747485,11,8.421903011,8.421803008,154,104.9156449,11,6,17,11,7,18,5,0.366219,0.37991,0.000024,No
11322,globe,173,9.943240583,150,5.80916299,5.807671909,25950,57.7619052,18,40,58,168,121,289,4,0.466224,0.476673,0.000007,No
9206,kenya,62,10.96939779,47,6.969650683,6.969190586,2914,76.45287081,18,27,45,50,48,98,4,0.444275,0.458871,0.000009,No
3020,sol,28,11.76432767,17,7.98658494,7.986424931,476,93.95680218,13,14,27,22,18,40,4,0.427261,0.443754,0.000015,No
17904,allan,57,11.05348091,41,7.106226218,7.105826145,2337,78.54853583,23,22,45,45,37,82,5,0.345431,0.354162,0.000009,No
15858,cabbage,41,11.38296011,23,7.684304068,7.684084048,943,87.47012669,23,22,45,36,32,68,4,0.428282,0.444825,0.000009,No
9257,kappa,42,11.35886256,20,7.824066011,7.823875996,840,88.87249047,23,22,45,33,35,68,4,0.450419,0.463828,0.000009,No
7403,monteverdi,13,12.53158282,9,8.622573707,8.622493705,117,108.0544965,6,7,13,13,10,23,4,0.424371,0.440985,0.000031,No
16484,blast,44,11.31234254,27,7.523961418,7.52370139,1188,85.11362885,21,10,31,38,28,66,4,0.445144,0.45935,0.000013,No
3996,sandy,90,10.59672251,71,6.557118407,6.556418176,6390,69.48396421,35,32,67,76,54,130,5,0.408341,0.426208,0.000006,No
5890,petersburg,129,10.23671977,92,6.298009707,6.297099311,11868,64.4709605,28,52,80,115,114,229,4,0.45207,0.465767,0.000005,No
4179,ruby,39,11.43297053,23,7.684304068,7.684084048,897,87.85442197,21,19,40,32,31,63,4,0.453943,0.466645,0.00001,No
15181,chronic,47,11.24638458,31,7.38581108,7.385511041,1457,83.06367181,27,13,40,40,22,62,5,0.331144,0.33627,0.00001,No
15395,champagne,63,10.95339745,30,7.418600903,7.418310866,1890,81.25888422,18,32,50,51,46,97,4,0.447941,0.461974,0.000008,No
4097,saddle,22,12.00548972,9,8.622573707,8.622493705,198,103.51822,10,15,25,20,19,39,4,0.452462,0.465401,0.000016,No
10601,hera,47,11.24638458,30,7.418600903,7.418310866,1410,83.43243876,22,28,50,38,41,79,4,0.44092,0.456026,0.000008,No
5578,pocket,62,10.96939779,37,7.208880372,7.208520314,2294,79.07707643,26,24,50,47,40,87,4,0.393968,0.41155,0.000008,No
5259,prism,19,12.1520932,14,8.180740955,8.180610949,266,99.41312651,7,12,19,18,15,33,4,0.444053,0.458397,0.000021,No
17263,athena,50,11.18450917,26,7.561701746,7.56145172,1300,84.57392254,27,30,57,41,40,81,4,0.454769,0.467518,0.000007,No
7886,mcmahon,80,10.71450554,35,7.264450223,7.264110172,2800,77.83499218,28,38,66,43,60,103,4,0.448201,0.462326,0.000006,No
5115,protest,67,10.89183956,59,6.74226084,6.741680684,3953,73.43562333,19,25,44,62,55,117,4,0.449586,0.463237,0.000009,No
9164,kidney,38,11.45894602,30,7.418600903,7.418310866,1140,85.00934727,19,14,33,34,23,57,4,0.435875,0.451425,0.000012,No
1636,till,84,10.66571538,76,6.489064944,6.488314678,6384,69.21051976,44,35,79,59,71,130,4,0.442922,0.457988,0.000005,No
10737,hawaiian,103,10.46180319,67,6.615105665,6.61444546,6901,69.20593354,26,30,56,92,60,152,4,0.415714,0.433351,0.000007,No
14948,cocoa,63,10.95339745,27,7.523961418,7.52370139,1701,82.41293982,29,27,56,54,40,94,4,0.443298,0.458035,0.000007,No
465,welfare,44,11.31234254,34,7.29343776,7.293107712,1496,82.50586626,20,19,39,39,33,72,4,0.444208,0.45866,0.00001,No
17054,bacterium,47,11.24638458,36,7.236279346,7.235929291,1692,81.38198042,11,19,30,44,31,75,4,0.439599,0.454726,0.000013,No
17626,antarctic,83,10.67769157,54,6.830814238,6.830284108,4482,72.9373276,14,29,43,76,72,148,4,0.432645,0.448857,0.000009,No
3542,shade,55,11.08919899,37,7.208880372,7.208520314,2035,79.94070895,21,22,43,43,53,96,4,0.460574,0.471959,0.000009,No
10381,homo,122,10.29251113,41,7.106226218,7.105826145,5002,73.14091245,27,16,43,83,51,134,4,0.413285,0.430797,0.000009,No
4612,reginald,26,11.83843564,23,7.684304068,7.684084048,598,90.97013915,17,18,35,21,21,42,5,0.38734,0.404172,0.000011,No
17687,angola,59,11.01899473,32,7.354062381,7.35375234,1888,81.03437465,28,27,55,46,42,88,4,0.438307,0.453744,0.000007,No
3974,sara,29,11.72923635,23,7.684304068,7.684084048,667,90.13101858,18,17,35,19,21,40,5,0.354793,0.36616,0.000011,No
14818,committed,109,10.4051843,99,6.224678434,6.223697973,10791,64.76892628,32,23,55,89,101,190,4,0.450487,0.463979,0.000007,No
9802,initial,72,10.81986606,64,6.660915201,6.660285015,4608,72.0702103,23,41,64,59,46,105,5,0.355674,0.367606,0.000006,No
4253,roof,102,10.47155936,81,6.42534913,6.424548825,8262,67.28342484,26,38,64,88,86,174,4,0.465539,0.476128,0.000006,No
1092,un,88,10.61919536,66,6.630143542,6.629493344,5808,70.40678956,27,37,64,66,49,115,4,0.439599,0.455073,0.000006,No
15417,chad,90,10.59672251,64,6.660915201,6.660285015,5760,70.58387003,31,33,64,71,68,139,4,0.442911,0.457829,0.000006,No
16461,blizzard,31,11.66254497,20,7.824066011,7.823875996,620,91.24852172,12,12,24,24,17,41,4,0.439926,0.454979,0.000016,No
12553,evolutionary,88,10.61919536,60,6.725453722,6.72486356,5280,71.41890698,37,27,64,70,58,128,5,0.335646,0.341926,0.000006,No
4945,python,65,10.92214491,32,7.354062381,7.35375234,2080,80.32213499,10,28,38,55,54,109,4,0.448892,0.46273,0.00001,No
17934,algeria,86,10.64218488,66,6.630143542,6.629493344,5676,70.55921336,32,44,76,80,70,150,4,0.46386,0.474912,0.000005,No
4764,randolph,33,11.60002462,23,7.684304068,7.684084048,759,89.13811635,17,21,38,25,29,54,5,0.377866,0.3939,0.00001,No
2840,sperm,100,10.49136199,54,6.830814238,6.830284108,5400,71.66454486,41,35,76,87,76,163,4,0.447636,0.461819,0.000005,No
589,wang,45,11.28986969,33,7.323290723,7.322970678,1485,82.67899794,26,12,38,34,13,47,4,0.395662,0.412944,0.00001,No
16262,bound,82,10.68981293,77,6.475992862,6.475232589,6314,69.22715224,37,26,63,54,73,127,4,0.419091,0.436473,0.000006,No
487,wednesday,106,10.43309308,91,6.308938778,6.30803839,9646,65.82174552,20,34,54,102,90,192,4,0.467009,0.47717,0.000007,No
17138,avery,30,11.6953348,21,7.775275846,7.77507583,630,90.93445415,15,12,27,20,21,41,4,0.374802,0.390063,0.000014,No
15091,claremont,11,12.6986369,8,8.740356743,8.740286741,88,110.9906167,7,6,13,7,9,16,4,0.390595,0.407456,0.000029,No
3727,seaside,44,11.31234254,44,7.03560865,7.035178566,1936,79.58921505,18,11,29,41,23,64,4,0.40852,0.426178,0.000013,No
3583,serve,198,9.808265147,182,5.615791597,5.613979993,36036,55.08117299,32,62,94,171,180,351,4,0.456653,0.469673,0.000004,No
2657,starch,52,11.14528846,33,7.323290723,7.322970678,1716,81.62018757,23,24,47,45,46,91,4,0.437184,0.452773,0.000008,No
16991,ban,49,11.20471188,40,7.13091883,7.130528762,1960,79.89989093,24,23,47,43,38,81,4,0.457677,0.469692,0.000008,No
10373,homosexual,49,11.20471188,27,7.523961418,7.52370139,1323,84.30381988,24,23,47,37,37,74,4,0.419002,0.43629,0.000008,No
1991,task,103,10.46180319,76,6.489064944,6.488314678,7828,67.88732032,49,45,94,90,84,174,4,0.464771,0.475649,0.000004,No
17234,attention,156,10.04667617,150,5.80916299,5.807671909,23400,58.36277938,50,44,94,125,140,265,4,0.458185,0.470532,0.000004,No
16100,bristol,101,10.48141166,76,6.489064944,6.488314678,7676,68.01456097,30,45,75,87,78,165,4,0.445915,0.46058,0.000005,No
9794,inland,87,10.63062406,76,6.489064944,6.488314678,6612,68.98280991,37,38,75,58,75,133,4,0.448065,0.462237,0.000005,No
11718,fritz,44,11.31234254,38,7.182212124,7.181842063,1672,81.24764377,25,9,34,35,18,53,4,0.403781,0.421389,0.000011,No
15948,bureau,188,9.860090215,161,5.738393919,5.73679267,30268,56.58108173,16,46,62,157,130,287,4,0.44491,0.459753,0.000006,No
14233,crocodile,36,11.51301324,20,7.824066011,7.823875996,720,90.07857556,14,17,31,30,24,54,4,0.449154,0.462772,0.000012,No
6456,osborne,24,11.91847835,18,7.929426526,7.929256515,432,94.50669836,14,17,31,17,22,39,4,0.431908,0.447961,0.000012,No
9030,lab,25,11.87765635,20,7.824066011,7.823875996,500,92.93156735,17,14,31,18,19,37,4,0.45385,0.466476,0.000012,No
10642,helium,52,11.14528846,37,7.208880372,7.208520314,1924,80.34505121,22,31,53,46,45,91,4,0.444119,0.45881,0.000007,No
9690,intermittent,7,13.15062203,6,9.028038815,9.027988815,42,118.7243261,3,4,7,5,5,10,5,0.32932,0.333314,0.000053,No
11393,gift,75,10.77904406,57,6.776747016,6.776186871,4275,73.0468547,25,28,53,65,67,132,4,0.466065,0.476325,0.000007,No
18328,abode,9,12.8993076,9,8.622573707,8.622493705,81,111.2252305,4,3,7,4,9,13,5,0.382928,0.399233,0.000053,No
6110,paw,6,13.30477271,6,9.028038815,9.027988815,36,120.1160044,4,3,7,6,4,10,5,0.372834,0.387773,0.000053,No
371,wholesome,5,13.48709426,5,9.210360372,9.210320372,25,124.2209985,4,3,7,4,3,7,5,0.362361,0.375388,0.000053,No
14169,ct,7,13.15062203,9,8.873888135,8.873828135,63,116.6971488,5,2,7,5,2,7,5,0.398129,0.415894,0.000053,No
12653,ester,7,13.15062203,6,9.028038815,9.027988815,42,118.7243261,5,2,7,7,4,11,5,0.390879,0.407922,0.000053,No
17260,athlete,91,10.58567267,71,6.557118407,6.556418176,6461,69.41150912,33,41,74,56,81,137,4,0.452197,0.465683,0.000005,No
12877,emerson,33,11.60002462,17,7.98658494,7.986424931,561,92.6445819,18,19,37,25,26,51,4,0.398872,0.416549,0.00001,No
11016,guest,112,10.37803331,88,6.34246147,6.341591108,9856,65.82227638,42,32,74,88,54,142,4,0.433152,0.449449,0.000005,No
11266,goethe,41,11.38296011,27,7.523961418,7.52370139,1107,85.6449527,17,24,41,35,36,71,4,0.43565,0.451416,0.000009,No
11627,gabon,32,11.63079627,17,7.98658494,7.986424931,544,92.89034237,19,22,41,26,28,54,4,0.440931,0.455918,0.000009,No
27,zeus,192,9.839036805,113,6.092410465,6.09128986,21696,59.9434508,38,54,92,163,158,321,4,0.455469,0.468556,0.000004,No
14191,crusade,137,10.17655125,107,6.14696945,6.145908909,14659,62.55494965,24,49,73,118,103,221,4,0.465832,0.476541,0.000005,No
7662,mid,90,10.59672251,85,6.377147028,6.376306692,7650,67.57685744,14,38,52,87,70,157,4,0.452855,0.466147,0.000007,No
5506,polyphemus,6,13.30477271,5,9.210360372,9.210320372,30,122.5417513,3,4,7,4,5,9,5,0.349436,0.359539,0.000052,No
14215,crotch,4,13.71023782,3,9.721185996,9.721165996,12,133.2797719,3,4,7,4,4,8,5,0.38637,0.40282,0.000052,No
6247,parasitic,28,11.76432767,21,7.775275846,7.77507583,588,91.47089276,12,16,28,25,17,42,4,0.415636,0.433037,0.000013,No
16538,biscuit,26,11.83843564,17,7.98658494,7.986424931,442,94.54867179,12,16,28,20,19,39,4,0.445121,0.459354,0.000013,No
10063,immature,6,13.30477271,6,9.028038815,9.027988815,36,120.1160044,4,3,7,4,3,7,5,0.38442,0.400641,0.000052,No
1761,thesis,34,11.57017165,29,7.452502454,7.452222421,986,86.22673264,12,21,33,30,31,61,4,0.445367,0.459683,0.000011,No
259,witness,32,11.63079627,26,7.561701746,7.56145172,832,87.9486125,13,20,33,29,24,53,4,0.448484,0.462242,0.000011,No
8654,lima,42,11.35886256,29,7.452502454,7.452222421,1218,84.6519511,15,18,33,28,34,62,4,0.446319,0.460378,0.000011,No
15985,bulb,44,11.31234254,28,7.487593774,7.487323743,1232,84.7022256,10,20,30,41,35,76,4,0.422905,0.439989,0.000012,No
12801,enormous,36,11.51301324,36,7.236279346,7.235929291,1296,83.31137991,13,23,36,33,29,62,5,0.387052,0.403923,0.00001,No
14716,conclusion,43,11.33533206,29,7.452502454,7.452222421,1247,84.47659001,12,18,30,40,37,77,4,0.450442,0.4638,0.000012,No
7172,myth,90,10.59672251,72,6.543132165,6.542421927,6480,69.33575588,25,35,60,81,75,156,4,0.451381,0.464871,0.000006,No
840,verse,83,10.67769157,57,6.776747016,6.776186871,4731,72.36001449,31,41,72,79,68,147,4,0.467414,0.477583,0.000005,No
8132,manslaughter,14,12.45747485,10,8.517213191,8.517123189,140,106.1029691,8,10,18,13,12,25,4,0.43565,0.451153,0.00002,No
8877,laurie,19,12.1520932,15,8.111748083,8.111608076,285,98.57471871,12,12,24,14,15,29,5,0.365405,0.379018,0.000015,No
7810,melody,76,10.76579884,58,6.759355274,6.758785123,4408,72.76985914,36,36,72,68,63,131,4,0.457783,0.470058,0.000005,No
10869,han,165,9.990586703,100,6.214628098,6.213637628,16500,62.08778084,38,34,72,144,132,276,4,0.440526,0.455833,0.000005,No
16338,bony,37,11.48561426,33,7.323290723,7.322970678,1221,84.11249239,17,13,30,31,22,53,5,0.367318,0.38155,0.000012,No
1326,tributary,171,9.954868621,121,6.024007739,6.022807042,20691,59.96820561,23,17,40,152,157,309,4,0.437486,0.45297,0.000009,No
9114,klaus,37,11.48561426,29,7.452502454,7.452222421,1073,85.5965685,23,13,36,27,21,48,4,0.426471,0.443031,0.00001,No
563,warwick,44,11.31234254,31,7.38581108,7.385511041,1364,83.55082489,18,27,45,40,34,74,4,0.455201,0.467819,0.000008,No
10876,hamlet,73,10.80607274,49,6.927977986,6.92749788,3577,74.86423403,19,26,45,59,65,124,4,0.461929,0.4731,0.000008,No
4811,radius,78,10.73982335,59,6.74226084,6.741680684,4602,72.41069041,21,24,45,68,68,136,4,0.454106,0.466889,0.000008,No
16992,bamboo,47,11.24638458,33,7.323290723,7.322970678,1551,82.36054383,21,24,45,35,30,65,4,0.441435,0.456402,0.000008,No
15042,clever,40,11.40765272,35,7.264450223,7.264110172,1400,82.87032537,21,24,45,38,35,73,4,0.437088,0.452665,0.000008,No
17386,array,58,11.03608917,29,7.452502454,7.452222421,1682,82.2464816,22,23,45,53,52,105,4,0.462073,0.473142,0.000008,No
12035,fled,51,11.16470654,50,6.907775279,6.907285168,2550,77.12328386,24,21,45,33,49,82,4,0.424685,0.441665,0.000008,No
6705,obvious,58,11.03608917,54,6.830814238,6.830284108,3132,75.38547501,18,33,51,55,39,94,4,0.445915,0.460345,0.000007,No
11461,genre,177,9.920382445,137,5.899817358,5.89845646,24249,58.52844455,44,45,89,162,151,313,4,0.46346,0.474673,0.000004,No
12255,feed,160,10.02135836,136,5.907143398,5.905792513,21760,59.19760089,36,35,71,129,134,263,4,0.464893,0.475579,0.000005,No
9538,istanbul,104,10.45214128,75,6.502310171,6.501569912,7800,67.96306454,24,35,59,78,82,160,4,0.440166,0.455519,0.000006,No
11111,greenwich,83,10.67769157,52,6.868554566,6.868044446,4316,73.34030718,27,32,59,72,80,152,4,0.450224,0.463861,0.000006,No
6223,parliamentary,86,10.64218488,71,6.557118407,6.556418176,6106,69.78206638,30,29,59,78,57,135,5,0.407077,0.42495,0.000006,No
14225,crop,70,10.84803694,56,6.794446593,6.793896453,3920,73.7064076,39,20,59,60,39,99,4,0.430046,0.446435,0.000006,No
17772,amongst,94,10.5532374,91,6.308938778,6.30803839,8554,66.57972863,40,19,59,61,63,124,4,0.420949,0.438342,0.000006,No
7175,mysterious,52,11.14528846,49,6.927977986,6.92749788,2548,77.21431309,16,28,44,50,32,82,5,0.399078,0.416809,0.000008,No
1646,tiffany,17,12.26331883,11,8.421903011,8.421803008,187,103.2804818,6,10,16,11,11,22,4,0.391578,0.408573,0.000022,No
10313,horton,22,12.00548972,14,8.180740955,8.180610949,308,98.21380147,14,18,32,19,19,38,5,0.372404,0.387398,0.000011,No
3862,scheme,64,10.93764909,52,6.868554566,6.868044446,3328,75.12583962,22,22,44,37,52,89,4,0.450293,0.463763,0.000008,No
10235,humphrey,34,11.57017165,24,7.641744454,7.641514432,816,88.41629506,23,21,44,27,25,52,4,0.423874,0.440886,0.000008,No
3848,schneider,22,12.00548972,10,8.517213191,8.517123189,220,102.2533154,17,15,32,18,18,36,4,0.42601,0.442632,0.000011,No
4763,random,117,10.33435824,84,6.388981485,6.388151157,9828,66.02602347,49,39,88,102,74,176,4,0.447805,0.462012,0.000004,No
1069,unity,54,11.10754813,53,6.849506371,6.848986246,2862,76.08122168,25,19,44,36,45,81,4,0.442018,0.456801,0.000008,No
9550,isle,146,10.11292556,108,6.137667057,6.136596506,15768,62.06977003,23,16,39,130,141,271,4,0.444675,0.458988,0.000009,No
9433,jessica,50,11.18450917,43,7.058598169,7.058178089,2150,78.94695596,23,16,39,29,42,71,5,0.398478,0.415964,0.000009,No
17947,alexandria,108,10.41440095,77,6.475992862,6.475232589,8316,67.44358622,24,46,70,98,92,190,4,0.455434,0.468373,0.000005,No
7363,morocco,86,10.64218488,65,6.645411014,6.644770822,5590,70.72169263,31,39,70,75,69,144,4,0.448495,0.462594,0.000005,No
9174,khmer,33,11.60002462,18,7.929426526,7.929256515,594,91.9815429,10,15,25,31,30,61,5,0.358324,0.370396,0.000014,No
16801,bedford,51,11.16470654,37,7.208880372,7.208520314,1887,80.48503386,20,30,50,38,38,76,4,0.452624,0.465805,0.000007,No
13379,dome,78,10.73982335,49,6.927977986,6.92749788,3822,74.40525975,25,25,50,65,74,139,4,0.45207,0.465251,0.000007,No
13113,ear,85,10.65388092,54,6.830814238,6.830284108,4590,72.77468148,22,36,58,65,62,127,4,0.455914,0.468575,0.000006,No
16189,brave,69,10.86242567,47,6.969650683,6.969190586,3243,75.7073125,27,31,58,62,60,122,4,0.396795,0.414474,0.000006,No
18308,absolute,86,10.64218488,58,6.759355274,6.758785123,4988,71.9343085,30,28,58,69,70,139,4,0.441842,0.45681,0.000006,No
16695,benny,25,11.87765635,14,8.180740955,8.180610949,350,97.16802977,16,13,29,18,20,38,4,0.427282,0.443759,0.000012,No
9720,integer,92,10.5747436,49,6.927977986,6.92749788,4508,73.26159087,25,44,69,86,76,162,4,0.452508,0.466016,0.000005,No
7981,matilda,81,10.70208302,40,7.13091883,7.130528762,3240,76.31568535,35,34,69,63,71,134,4,0.459847,0.471607,0.000005,No
18043,agree,202,9.78826448,181,5.621301253,5.619499667,36562,55.02278339,40,29,69,165,199,364,4,0.459086,0.470941,0.000005,No
4690,receive,145,10.11979843,134,5.921958484,5.920627626,19430,59.9290262,32,54,86,128,120,248,4,0.447264,0.461974,0.000004,No
17195,aunt,54,11.10754813,39,7.156236638,7.155856573,2106,79.48824289,19,24,43,48,40,88,4,0.446858,0.46096,0.000008,No
2790,spoke,128,10.24450191,113,6.092410465,6.09128986,14464,62.41371067,39,47,86,103,115,218,4,0.461701,0.473368,0.000004,No
4650,reduce,111,10.38700198,98,6.234830806,6.233860354,10878,64.7611999,15,34,49,99,98,197,4,0.430505,0.447097,0.000007,No
7029,nephew,74,10.79246708,70,6.571303042,6.570612818,5180,70.92057178,16,33,49,69,62,131,4,0.446712,0.461035,0.000007,No
11692,fry,38,11.45894602,25,7.600922459,7.600682435,950,87.09856015,26,23,49,33,31,64,4,0.448167,0.462021,0.000007,No
13282,draft,102,10.47155936,61,6.70892442,6.708324252,6222,70.25290033,18,39,57,59,79,138,4,0.466689,0.47702,0.000006,No
16603,bibliography,51,11.16470654,48,6.948597273,6.948127172,2448,77.57904945,22,35,57,24,38,62,4,0.455726,0.468387,0.000006,No
15766,cameron,84,10.66571538,61,6.70892442,6.708324252,5124,71.55547836,24,33,57,55,67,122,4,0.45011,0.463819,0.000006,No
9212,kenneth,63,10.95339745,46,6.991156888,6.990706795,2898,76.57692003,30,27,57,42,33,75,5,0.348702,0.358621,0.000006,No
14476,copyright,75,10.77904406,38,7.182212124,7.181842063,2850,77.41738097,33,24,57,66,39,105,4,0.455656,0.468143,0.000006,No
15762,camille,32,11.63079627,23,7.684304068,7.684084048,736,89.37457513,16,15,31,24,19,43,4,0.422935,0.439933,0.000011,No
15608,carpenter,36,11.51301324,27,7.523961418,7.52370139,972,86.62346742,13,21,34,29,30,59,4,0.448031,0.461875,0.00001,No
12497,exhibition,98,10.5115647,65,6.645411014,6.644770822,6370,69.85366783,32,36,68,86,77,163,4,0.451921,0.465345,0.000005,No
9195,kerry,32,11.63079627,21,7.775275846,7.77507583,672,90.43264935,19,15,34,28,22,50,4,0.433215,0.449106,0.00001,No
10872,hampshire,138,10.16927849,102,6.194825471,6.193814981,14076,62.99690542,24,61,85,128,119,247,4,0.466113,0.476992,0.000004,No
13726,deposition,24,11.91847835,14,8.180740955,8.180610949,336,97.50198393,12,16,28,14,23,37,4,0.429942,0.446271,0.000012,No
16644,beside,35,11.54118412,32,7.354062381,7.35375234,1120,84.87458794,13,15,28,18,32,50,4,0.442448,0.457073,0.000012,No
1437,tram,74,10.79246708,46,6.991156888,6.990706795,3404,75.45183059,28,28,56,59,47,106,4,0.449267,0.463002,0.000006,No
5177,pronoun,29,11.72923635,16,8.047209562,8.047059554,464,94.38762289,15,13,28,24,21,45,4,0.443442,0.457998,0.000012,No
15302,cherokee,72,10.81986606,45,7.013135794,7.012695706,3240,75.88118994,32,24,56,67,59,126,4,0.435533,0.451322,0.000006,No
6217,parrot,20,12.1007999,14,8.180740955,8.180610949,280,98.99350936,10,14,24,14,18,32,4,0.418064,0.435323,0.000014,No
8526,locomotive,182,9.89252549,116,6.066208093,6.065057454,21112,60.01011819,36,48,84,157,135,292,4,0.451633,0.465345,0.000004,No
22,zinc,41,11.38296011,26,7.561701746,7.56145172,1066,86.07454935,19,23,42,38,31,69,4,0.436475,0.452139,0.000008,No
8271,magma,56,11.07118049,24,7.641744454,7.641514432,1344,84.60313208,22,26,48,49,35,84,4,0.457088,0.469307,0.000007,No
8454,lotus,62,10.96939779,25,7.600922459,7.600682435,1550,83.37754205,23,25,48,48,35,83,4,0.444865,0.459298,0.000007,No
14438,corporate,49,11.20471188,40,7.13091883,7.130528762,1960,79.89989093,21,21,42,32,24,56,5,0.39699,0.414509,0.000008,No
5939,permission,73,10.80607274,68,6.600290579,6.599620368,4964,71.32322008,26,22,48,61,68,129,4,0.456043,0.468438,0.000007,No
10090,ike,22,12.00548972,13,8.254848927,8.254728922,286,99.10350396,14,10,24,17,12,29,4,0.433702,0.44943,0.000014,No
12371,fahrenheit,79,10.72708432,37,7.208880372,7.208520314,2923,77.33026763,29,38,67,53,64,117,4,0.46223,0.473541,0.000005,No
1710,thread,86,10.64218488,48,6.948597273,6.948127172,4128,73.94825685,32,35,67,67,69,136,4,0.463207,0.474278,0.000005,No
16385,boeing,107,10.42370334,41,7.106226218,7.105826145,4387,74.07319398,33,34,67,89,80,169,4,0.450934,0.464471,0.000005,No
9521,ivory,34,11.57017165,23,7.684304068,7.684084048,782,88.9087171,16,21,37,28,33,61,4,0.449267,0.462861,0.000009,No
4429,rhea,86,10.64218488,23,7.684304068,7.684084048,1978,81.77778458,41,42,83,66,64,130,4,0.446881,0.461289,0.000004,No
12302,fatal,37,11.48561426,36,7.236279346,7.235929291,1332,83.11311328,15,18,33,30,24,54,4,0.420301,0.437558,0.00001,No
10792,harmony,66,10.90687744,51,6.887972651,6.887472536,3366,75.12627349,31,35,66,60,57,117,4,0.467009,0.477166,0.000005,No
6703,occasion,29,11.72923635,28,7.487593774,7.487323743,812,87.82375705,16,17,33,29,24,53,4,0.437723,0.453195,0.00001,No
11827,fourteen,99,10.50141233,98,6.234830806,6.233860354,9702,65.47452908,35,31,66,89,45,134,4,0.418222,0.435741,0.000005,No
14560,continue,190,9.849508105,184,5.604862527,5.603030887,34960,55.20513888,36,30,66,162,157,319,4,0.457029,0.46933,0.000005,No
7261,multi,4,13.71023782,4,9.433503923,9.433473923,16,129.3355822,2,4,6,4,4,8,5,0.324308,0.327672,0.000055,No
7526,mist,28,11.76432767,15,8.111748083,8.111608076,420,95.4292624,11,19,30,28,26,54,4,0.41911,0.436384,0.000011,No
4736,rat,73,10.80607274,40,7.13091883,7.130528762,2920,77.05722755,27,28,55,59,51,110,4,0.458422,0.470401,0.000006,No
7044,nell,4,13.71023782,3,9.721185996,9.721165996,12,133.2797719,3,3,6,3,3,6,5,0.405784,0.423372,0.000055,No
15809,calgary,96,10.53218399,49,6.927977986,6.92749788,4704,72.9667388,29,26,55,76,55,131,4,0.43625,0.45205,0.000006,No
12662,essay,68,10.87702447,55,6.812465099,6.811924964,3740,74.0993496,21,26,47,60,61,121,4,0.453619,0.466518,0.000007,No
10444,ho,49,11.20471188,40,7.13091883,7.130528762,1960,79.89989093,31,16,47,43,38,81,4,0.45252,0.46541,0.000007,No
14609,consort,74,10.79246708,59,6.74226084,6.741680684,4366,72.76562819,16,25,41,68,62,130,4,0.449928,0.463514,0.000008,No
3133,slovakia,121,10.30074163,86,6.365450988,6.364600644,10406,65.568866,34,48,82,102,99,201,4,0.461448,0.473142,0.000004,No
4669,recovery,36,11.51301324,29,7.452502454,7.452222421,1044,85.80075942,20,21,41,27,30,57,4,0.45905,0.470781,0.000008,No
14055,czech,283,9.45108528,197,5.536594555,5.534632671,55751,52.3268273,47,35,82,239,66,305,4,0.435426,0.451435,0.000004,No
4688,reception,16,12.32394346,15,8.111748083,8.111608076,240,99.9687247,11,14,25,12,15,27,4,0.448156,0.461852,0.000013,No
17457,archipelago,105,10.44257183,80,6.43777165,6.436981353,8400,67.22689286,17,37,54,79,91,170,4,0.46642,0.476771,0.000006,No
15778,cambodia,57,11.05348091,41,7.106226218,7.105826145,2337,78.54853583,17,37,54,47,51,98,4,0.447737,0.461922,0.000006,No
796,victim,80,10.71450554,58,6.759355274,6.758785123,4640,72.42314954,18,36,54,79,66,145,4,0.45435,0.467316,0.000006,No
5320,prelude,27,11.80069531,20,7.824066011,7.823875996,540,92.32941909,11,16,27,23,25,48,4,0.459763,0.471213,0.000012,No
903,veil,19,12.1520932,14,8.180740955,8.180610949,266,99.41312651,12,15,27,19,16,35,4,0.436668,0.452176,0.000012,No
5045,pudding,27,11.80069531,12,8.334891634,8.334781631,324,98.35751663,18,18,36,23,25,48,4,0.451771,0.46488,0.000009,No
9301,juno,51,11.16470654,26,7.561701746,7.56145172,1326,84.42418097,32,22,54,43,34,77,4,0.452855,0.465805,0.000006,No
4835,raceway,5,13.48709426,4,9.433503923,9.433473923,20,127.2305567,2,4,6,2,4,6,5,0.425133,0.441972,0.000054,No
7017,net,107,10.42370334,83,6.400957676,6.400137356,8881,66.72168393,34,47,81,97,94,191,4,0.466101,0.47672,0.000004,No
2260,surge,27,11.80069531,21,7.775275846,7.77507583,567,91.75366123,7,12,19,26,19,45,4,0.445759,0.459824,0.000017,No
17211,audition,25,11.87765635,21,7.775275846,7.77507583,525,92.35205455,7,16,23,21,22,43,4,0.446487,0.460514,0.000014,No
7558,mint,43,11.33533206,31,7.38581108,7.385511041,1333,83.72062113,19,27,46,31,40,71,4,0.44678,0.460936,0.000007,No
8940,laos,44,11.31234254,33,7.323290723,7.322970678,1452,82.8435732,22,24,46,39,39,78,4,0.431814,0.448022,0.000007,No
1815,thailand,197,9.813328449,131,5.944600961,5.943300141,25807,58.33632173,40,67,107,177,148,325,4,0.455376,0.468711,0.000003,No
14569,contest,141,10.14777229,109,6.128450402,6.12736984,15369,62.19011915,26,38,64,120,120,240,4,0.462736,0.473969,0.000005,No
16067,brook,20,12.1007999,11,8.421903011,8.421803008,220,101.9117632,7,13,20,18,18,36,4,0.409575,0.427159,0.000016,No
2888,sparrow,16,12.32394346,11,8.421903011,8.421803008,176,103.7910565,8,12,20,14,13,27,4,0.375238,0.390584,0.000016,No
1411,transformation,35,11.54118412,32,7.354062381,7.35375234,1120,84.87458794,16,24,40,30,31,61,4,0.453479,0.466439,0.000008,No
2855,spectroscopy,20,12.1007999,12,8.334891634,8.334781631,240,100.8588559,9,11,20,11,15,26,4,0.413506,0.430896,0.000016,No
14501,cookery,12,12.61162553,11,8.421903011,8.421803008,132,106.213887,9,11,20,11,11,22,4,0.428582,0.444937,0.000016,No
1154,twelfth,53,11.12624026,53,6.849506371,6.848986246,2809,76.20925357,18,22,40,49,40,89,5,0.421349,0.438522,0.000008,No
11625,gabrielle,27,11.80069531,16,8.047209562,8.047059554,432,94.96266815,17,12,29,22,14,36,4,0.422442,0.439318,0.000011,No
3092,smythe,24,11.91847835,18,7.929426526,7.929256515,432,94.50669836,3,3,6,24,24,48,5,0.331987,0.336666,0.000053,No
12516,excretion,5,13.48709426,5,9.210360372,9.210320372,25,124.2209985,3,3,6,4,3,7,4,0.415753,0.433037,0.000053,No
6266,paragon,5,13.48709426,4,9.433503923,9.433473923,20,127.2305567,3,3,6,4,4,8,5,0.387644,0.404413,0.000053,No
9017,lachesis,5,13.48709426,3,9.721185996,9.721165996,15,131.1105519,3,3,6,4,4,8,4,0.392279,0.409193,0.000053,No
13729,deportation,4,13.71023782,3,9.721185996,9.721165996,12,133.2797719,3,3,6,3,3,6,5,0.405997,0.423372,0.000053,No
2844,spellbound,3,13.99791989,3,9.721185996,9.721165996,9,136.0763828,3,3,6,3,3,6,4,0.422452,0.439144,0.000053,No
4208,roundup,3,13.99791989,3,9.721185996,9.721165996,9,136.0763828,3,3,6,3,3,6,5,0.353535,0.363896,0.000053,No
16834,beadle,4,13.71023782,2,10.1266511,10.1266411,8,138.8387949,3,3,6,4,3,7,5,0.351895,0.362422,0.000053,No
16981,bane,3,13.99791989,2,10.1266511,10.1266411,6,141.7520509,3,3,6,3,3,6,5,0.379084,0.394932,0.000053,No
5121,protease,4,13.71023782,1,10.81979828,10.81979828,4,148.3420076,3,3,6,4,4,8,5,0.356138,0.367819,0.000053,No
16889,basil,54,11.10754813,30,7.418600903,7.418310866,1620,82.40246659,32,21,53,42,37,79,4,0.441183,0.45612,0.000006,No
7136,narcotic,6,13.30477271,6,9.028038815,9.027988815,36,120.1160044,4,2,6,6,2,8,5,0.328607,0.332443,0.000053,No
5297,presto,4,13.71023782,2,10.1266511,10.1266411,8,138.8387949,4,2,6,4,2,6,5,0.320207,0.323546,0.000053,No
9242,kathy,6,13.30477271,6,9.028038815,9.027988815,36,120.1160044,5,1,6,5,1,6,5,0.319056,0.322952,0.000053,No
3960,sari,5,13.48709426,4,9.433503923,9.433473923,20,127.2305567,5,1,6,5,3,8,5,0.345599,0.354479,0.000053,No
14565,continent,165,9.990586703,134,5.921958484,5.920627626,22110,59.16383969,24,55,79,127,149,276,4,0.458102,0.470664,0.000004,No
13940,dc,140,10.15488975,116,6.066208093,6.065057454,16240,61.60167441,32,47,79,119,83,202,4,0.46521,0.476015,0.000004,No
6901,nixon,57,11.05348091,40,7.13091883,7.130528762,2280,78.82147516,17,28,45,54,39,93,4,0.432772,0.448975,0.000007,No
11416,gesture,16,12.32394346,13,8.254848927,8.254728922,208,101.7322914,8,13,21,15,15,30,4,0.426768,0.443304,0.000015,No
4562,remote,83,10.67769157,71,6.557118407,6.556418176,5893,70.01488794,27,36,63,69,50,119,4,0.450899,0.464528,0.000005,No
15578,cascade,54,11.10754813,28,7.487593774,7.487323743,1512,83.16880823,20,25,45,49,49,98,4,0.444308,0.458861,0.000007,No
15922,burnt,65,10.92214491,61,6.70892442,6.708324252,3965,73.27584469,29,34,63,59,60,119,4,0.445647,0.460129,0.000005,No
16172,breakfast,76,10.76579884,49,6.927977986,6.92749788,3724,74.58521735,30,33,63,55,66,121,4,0.452624,0.465866,0.000005,No
3320,silent,79,10.72708432,70,6.571303042,6.570612818,5530,70.49092186,31,32,63,64,64,128,4,0.436539,0.452331,0.000005,No
9439,jerome,30,11.6953348,25,7.600922459,7.600682435,750,88.89533292,18,17,35,24,19,43,4,0.399932,0.417577,0.000009,No
6855,normandy,124,10.27625061,79,6.450350432,6.449570143,9796,66.28541757,12,40,52,95,105,200,4,0.451829,0.465354,0.000006,No
13848,defend,94,10.5532374,90,6.319988614,6.319098235,8460,66.69634018,15,37,52,90,92,182,4,0.448054,0.462176,0.000006,No
6838,northwestern,135,10.1912574,125,5.991484547,5.990243802,16875,61.06076122,24,54,78,126,112,238,5,0.348969,0.359319,0.000004,No
10048,immunology,5,13.48709426,3,9.721185996,9.721165996,15,131.1105519,2,4,6,3,4,7,5,0.346266,0.355295,0.000052,No
4705,reagan,77,10.75272676,51,6.887972651,6.887472536,3927,74.06448782,18,34,52,71,62,133,4,0.440635,0.455885,0.000006,No
13428,divorce,71,10.8338523,60,6.725453722,6.72486356,4260,72.86257228,20,32,52,66,64,130,4,0.447613,0.461749,0.000006,No
881,venom,43,11.33533206,28,7.487593774,7.487323743,1204,84.87436177,22,30,52,34,36,70,4,0.447106,0.461284,0.000006,No
8234,mainstream,84,10.66571538,64,6.660915201,6.660285015,5376,71.04342569,33,45,78,73,66,139,4,0.420969,0.438562,0.000004,No
4062,salem,75,10.77904406,46,6.991156888,6.990706795,3450,75.35798815,24,28,52,60,66,126,4,0.440078,0.455312,0.000006,No
9651,intuitive,3,13.99791989,3,9.721185996,9.721165996,9,136.0763828,3,3,6,3,3,6,5,0.385038,0.401327,0.000052,No
12064,flake,3,13.99791989,2,10.1266511,10.1266411,6,141.7520509,3,3,6,3,3,6,5,0.38442,0.400637,0.000052,No
7394,monument,105,10.44257183,74,6.515733191,6.515002939,7770,68.04101185,29,23,52,87,76,163,4,0.461053,0.472377,0.000006,No
3718,sebaceous,11,12.6986369,4,9.433503923,9.433473923,44,119.7926411,4,2,6,7,3,10,5,0.311159,0.315743,0.000052,No
1804,thea,5,13.48709426,5,9.210360372,9.210320372,25,124.2209985,4,2,6,4,2,6,5,0.303498,0.309144,0.000052,No
3987,sans,5,13.48709426,5,9.210360372,9.210320372,25,124.2209985,4,2,6,4,3,7,5,0.271692,0.277347,0.000052,No
10536,hex,5,13.48709426,4,9.433503923,9.433473923,20,127.2305567,4,2,6,5,4,9,5,0.345619,0.354521,0.000052,No
54,yugoslavia,88,10.61919536,58,6.759355274,6.758785123,5104,71.77891418,22,40,62,66,63,129,4,0.453491,0.466706,0.000005,No
16694,benson,30,11.6953348,18,7.929426526,7.929256515,540,92.73729796,13,18,31,19,22,41,4,0.437077,0.452538,0.00001,No
11648,furniture,77,10.75272676,62,6.692663899,6.692053725,4774,71.96438617,30,32,62,60,56,116,4,0.457689,0.469894,0.000005,No
5721,pipe,80,10.71450554,48,6.948597273,6.948127172,3840,74.450784,33,29,62,66,57,123,4,0.450373,0.463936,0.000005,No
3984,santiago,122,10.29251113,78,6.463089458,6.462319176,9516,66.52142019,37,25,62,99,78,177,4,0.458481,0.470373,0.000005,No
5904,peruvian,27,11.80069531,22,7.728755831,7.728545813,594,91.2046927,7,21,28,20,21,41,5,0.387585,0.404458,0.000011,No
3361,sicily,145,10.11979843,119,6.040674791,6.039494118,17255,61.1304113,22,55,77,131,122,253,4,0.460718,0.472687,0.000004,No
8005,massive,102,10.47155936,94,6.276503502,6.275573088,9588,65.72477902,27,50,77,86,64,150,4,0.425102,0.442585,0.000004,No
9604,iranian,128,10.24450191,94,6.276503502,6.275573088,12032,64.29965214,33,44,77,114,86,200,5,0.392279,0.409974,0.000004,No
11783,fraud,44,11.31234254,26,7.561701746,7.56145172,1144,85.54056036,19,25,44,37,41,78,4,0.460383,0.471851,0.000007,No
2546,stinky,18,12.20616042,6,9.028038815,9.027988815,108,110.19769,10,12,22,11,14,25,5,0.378947,0.395815,0.000014,No
9754,insomnia,15,12.38848198,8,8.740356743,8.740286741,120,108.279752,11,11,22,13,13,26,4,0.428065,0.444421,0.000014,No
6264,paraguay,50,11.18450917,38,7.182212124,7.181842063,1900,80.32951738,23,21,44,40,43,83,4,0.436411,0.452017,0.000007,No
14380,countdown,27,11.80069531,23,7.684304068,7.684084048,621,90.68013099,15,13,28,20,24,44,4,0.428292,0.444778,0.000011,No
17078,bachelor,101,10.48141166,80,6.43777165,6.436981353,8080,67.47693484,24,20,44,86,87,173,4,0.457194,0.469265,0.000007,No
256,witty,13,12.53158282,10,8.517213191,8.517123189,130,106.7341625,10,4,14,11,4,15,5,0.384462,0.400707,0.000022,No
1457,trademark,40,11.40765272,34,7.29343776,7.293107712,1360,83.20100512,13,21,34,35,28,63,4,0.451255,0.46457,0.000009,No
7771,menzies,14,12.45747485,10,8.517213191,8.517123189,140,106.1029691,7,11,18,13,11,24,4,0.421139,0.438191,0.000017,No
13718,deputy,84,10.66571538,69,6.58569178,6.585011562,5796,70.24111409,20,31,51,76,64,140,4,0.451576,0.464983,0.000006,No
15090,clarence,49,11.20471188,40,7.13091883,7.130528762,1960,79.89989093,22,29,51,39,40,79,4,0.437875,0.45343,0.000006,No
194,worm,80,10.71450554,36,7.236279346,7.235929291,2880,77.53315516,25,36,61,58,60,118,4,0.456476,0.469016,0.000005,No
6538,opposition,122,10.29251113,90,6.319988614,6.319098235,10980,65.04855317,37,39,76,106,104,210,4,0.454699,0.467664,0.000004,No
886,venezuela,113,10.36914436,86,6.365450988,6.364600644,9718,66.0042802,37,39,76,95,83,178,4,0.45319,0.466424,0.000004,No
9487,jamestown,71,10.8338523,33,7.323290723,7.322970678,2343,79.33945004,43,33,76,59,65,124,4,0.442205,0.457247,0.000004,No
4394,rica,97,10.5218212,56,6.794446593,6.793896453,5432,71.4899522,3,40,43,97,72,169,4,0.458587,0.470767,0.000007,No
15628,carlo,65,10.92214491,46,6.991156888,6.990706795,2990,76.3584286,21,22,43,52,30,82,4,0.424158,0.441144,0.000007,No
13319,dot,45,11.28986969,30,7.418600903,7.418310866,1350,83.75503745,22,21,43,38,31,69,4,0.439055,0.454322,0.000007,No
6184,passion,70,10.84803694,43,7.058598169,7.058178089,3010,76.57193364,23,20,43,62,60,122,4,0.45841,0.470232,0.000007,No
16949,barcelona,100,10.49136199,63,6.676663558,6.676043378,6300,70.04729428,22,38,60,85,76,161,4,0.452382,0.46572,0.000005,No
8629,lineage,36,11.51301324,24,7.641744454,7.641514432,864,87.97950507,13,17,30,21,28,49,4,0.444175,0.458617,0.00001,No
6742,oasis,22,12.00548972,17,7.98658494,7.986424931,374,95.88286343,13,17,30,20,20,40,4,0.417474,0.434783,0.00001,No
9902,indoor,56,11.07118049,47,6.969650683,6.969190586,2632,77.16226063,24,26,50,43,36,79,5,0.39667,0.414279,0.000006,No
6572,onion,25,11.87765635,20,7.824066011,7.823875996,500,92.93156735,15,15,30,22,19,41,4,0.43174,0.447796,0.00001,No
15406,chalk,68,10.87702447,31,7.38581108,7.385511041,2108,80.33564786,31,29,60,59,55,114,4,0.458872,0.470758,0.000005,No
6481,orlando,80,10.71450554,46,6.991156888,6.990706795,3680,74.90678922,33,27,60,62,62,124,4,0.440723,0.455838,0.000005,No
583,warden,9,12.8993076,9,8.622573707,8.622493705,81,111.2252305,7,6,13,9,8,17,5,0.392348,0.409462,0.000023,No
2681,stamford,35,11.54118412,24,7.641744454,7.641514432,840,88.19477971,16,7,23,29,25,54,5,0.34731,0.356591,0.000013,No
9134,kipling,27,11.80069531,16,8.047209562,8.047059554,432,94.96266815,9,18,27,25,20,45,4,0.404332,0.421953,0.000011,No
8953,lange,26,11.83843564,14,8.180740955,8.180610949,364,96.84717527,10,17,27,17,23,40,4,0.44342,0.457941,0.000011,No
5052,pub,32,11.63079627,25,7.600922459,7.600682435,800,88.40478062,16,17,33,26,24,50,4,0.425286,0.442191,0.000009,No
14937,coefficient,41,11.38296011,16,8.047209562,8.047059554,656,91.60106545,16,17,33,29,36,65,4,0.453422,0.46619,0.000009,No
15293,chest,90,10.59672251,75,6.502310171,6.501569912,6750,68.90317653,31,43,74,79,79,158,4,0.457689,0.470114,0.000004,No
448,wesley,45,11.28986969,29,7.452502454,7.452222421,1305,84.13778155,19,18,37,43,30,73,4,0.441315,0.456171,0.000008,No
7290,mr,38,11.45894602,31,7.38581108,7.385511041,1178,84.63361046,24,13,37,30,16,46,5,0.33564,0.341381,0.000008,No
6889,nobody,102,10.47155936,92,6.298009707,6.297099311,9384,65.94998252,49,25,74,81,56,137,4,0.406192,0.423953,0.000004,No
12461,explain,134,10.19869238,119,6.040674791,6.039494118,15946,61.60698395,18,41,59,124,117,241,4,0.451679,0.465237,0.000005,No
14449,cornwall,87,10.63062406,54,6.830814238,6.830284108,4698,72.61581818,18,41,59,77,74,151,4,0.450419,0.46419,0.000005,No
2677,stamp,88,10.61919536,50,6.907775279,6.907285168,4400,73.35501521,27,32,59,73,60,133,4,0.441359,0.456514,0.000005,No
9182,keynes,57,11.03608917,20,7.824066011,7.823875996,1140,86.34709014,14,28,42,42,41,83,4,0.451886,0.465162,0.000007,No
4911,quarry,19,12.1520932,15,8.111748083,8.111608076,285,98.57471871,10,11,21,17,18,35,4,0.434286,0.449965,0.000014,No
8560,livingston,32,11.63079627,22,7.728755831,7.728545813,704,89.89158452,22,20,42,27,26,53,4,0.454956,0.467476,0.000007,No
16221,bradley,35,11.54118412,30,7.418600903,7.418310866,1050,85.6194389,26,23,49,30,27,57,4,0.394318,0.411761,0.000006,No
17821,amateur,109,10.4051843,84,6.388981485,6.388151157,9156,66.47852981,42,31,73,86,68,154,4,0.404397,0.422281,0.000004,No
6092,peach,85,10.65388092,39,7.156236638,7.155856573,3315,76.24169298,19,39,58,65,62,127,4,0.446465,0.460922,0.000005,No
7712,metaphor,33,11.60002462,28,7.487593774,7.487323743,924,86.85627209,10,19,29,30,28,58,4,0.45643,0.468636,0.00001,No
14492,coordinate,49,11.20471188,29,7.452502454,7.452222421,1421,83.50314278,16,13,29,46,42,88,4,0.43292,0.448815,0.00001,No
13681,destiny,110,10.38700198,72,6.529338843,6.528618598,7920,67.82025547,35,23,58,95,96,191,4,0.463303,0.474114,0.000005,No
16725,belong,213,9.735240012,204,5.50167829,5.499646268,43452,53.56015862,45,13,58,153,213,366,4,0.438903,0.45404,0.000005,No
15555,castro,43,11.33533206,26,7.561701746,7.56145172,1118,85.71440024,11,21,32,17,26,43,4,0.440964,0.455951,0.000009,No
16701,bengal,131,10.22133485,76,6.489064944,6.488314678,9956,66.32690568,25,47,72,124,109,233,4,0.463715,0.474889,0.000004,No
13275,drain,36,11.51301324,27,7.523961418,7.52370139,972,86.62346742,13,23,36,31,34,65,4,0.452936,0.465931,0.000008,No
16002,budget,64,10.93764909,54,6.830814238,6.830284108,3456,74.71304916,20,28,48,54,56,110,4,0.450099,0.463706,0.000006,No
12649,estonia,95,10.54265529,72,6.543132165,6.542421927,6840,68.98198691,34,38,72,72,77,149,4,0.445602,0.460185,0.000004,No
1085,unesco,150,10.08589688,132,5.936996362,5.935685529,19800,59.8799331,23,25,48,134,133,267,4,0.438589,0.454054,0.000006,No
7644,midway,36,11.51301324,24,7.641744454,7.641514432,864,87.97950507,16,16,32,30,32,62,4,0.428499,0.444909,0.000009,No
3216,skill,88,10.61919536,82,6.413079037,6.412268725,7216,68.10173917,37,35,72,74,80,154,4,0.466689,0.476945,0.000004,No
16222,bradford,49,11.20471188,34,7.29343776,7.293107712,1666,81.72086871,25,23,48,39,39,78,4,0.418567,0.436013,0.000006,No
14732,concentrate,21,12.05200974,21,7.775275846,7.77507583,441,93.70770023,10,6,16,21,16,37,4,0.393688,0.411235,0.000018,No
8736,lettuce,39,11.43297053,18,7.929426526,7.929256515,702,90.6568998,21,20,41,27,30,57,4,0.434733,0.450524,0.000007,No
5483,pontiac,48,11.22533117,15,8.111748083,8.111608076,720,91.05705857,22,19,41,34,32,66,4,0.399833,0.417437,0.000007,No
8032,marvel,97,10.5218212,62,6.692663899,6.692053725,6014,70.41901289,27,14,41,91,26,117,4,0.419824,0.437173,0.000007,No
15028,clinic,22,12.00548972,13,8.254848927,8.254728922,286,99.10350396,12,14,26,18,16,34,4,0.429338,0.445646,0.000011,No
8653,limb,17,12.26331883,14,8.180740955,8.180610949,238,100.3230346,9,13,22,12,14,26,4,0.431457,0.447637,0.000013,No
13862,decree,25,11.87765635,24,7.641744454,7.641514432,600,90.76601456,10,12,22,24,16,40,4,0.439077,0.454223,0.000013,No
1255,truly,57,11.05348091,44,7.03560865,7.035178566,2508,77.7679659,21,36,57,37,43,80,4,0.411636,0.4296,0.000005,No
12659,essential,76,10.76579884,70,6.571303042,6.570612818,5320,70.74532665,25,32,57,68,59,127,4,0.439001,0.454472,0.000005,No
6665,odysseus,54,11.10754813,22,7.728755831,7.728545813,1188,85.84752738,29,28,57,46,44,90,4,0.450682,0.464195,0.000005,No
7154,naked,89,10.60789581,76,6.489064944,6.488314678,6764,68.83532481,33,38,71,72,78,150,4,0.446476,0.460918,0.000004,No
17819,amazon,101,10.48141166,70,6.571303042,6.570612818,7070,68.87653233,21,26,47,94,66,160,4,0.452774,0.465838,0.000006,No
10669,hedgehog,41,11.38296011,23,7.684304068,7.684084048,943,87.47012669,8,20,28,39,29,68,4,0.448144,0.461927,0.00001,No
14659,congo,105,10.44257183,56,6.794446593,6.793896453,5880,70.95149658,17,39,56,97,83,180,4,0.445568,0.460134,0.000005,No
2583,steppe,26,11.83843564,15,8.111748083,8.111608076,390,96.0304076,11,17,28,21,23,44,4,0.447715,0.461547,0.00001,No
310,winchester,61,10.98565831,40,7.13091883,7.130528762,2440,78.33783773,25,31,56,49,57,106,4,0.443453,0.458242,0.000005,No
12258,fedora,33,11.60002462,11,8.421903011,8.421803008,363,97.69428224,14,14,28,19,24,43,4,0.391293,0.408348,0.00001,No
14295,crater,78,10.73982335,50,6.907775279,6.907285168,3900,74.18828624,29,27,56,56,66,122,4,0.456453,0.468814,0.000005,No
8853,lazy,18,12.20616042,18,7.929426526,7.929256515,324,96.78785221,16,12,28,17,15,32,5,0.386698,0.40328,0.00001,No
2352,suffrage,20,12.1007999,10,8.517213191,8.517123189,200,103.0650926,8,12,20,19,16,35,5,0.399545,0.417086,0.000014,No
17329,ask,140,10.15488975,125,5.991484547,5.990243802,17500,60.84286504,28,42,70,124,124,248,4,0.461785,0.473297,0.000004,No
3290,simmons,44,11.31234254,31,7.38581108,7.385511041,1364,83.55082489,17,23,40,44,38,82,4,0.443975,0.458514,0.000007,No
3388,shrimp,48,11.22533117,26,7.561701746,7.56145172,1248,84.88260628,17,23,40,35,41,76,4,0.434042,0.449984,0.000007,No
10939,habit,32,11.63079627,24,7.641744454,7.641514432,768,88.87957293,15,20,35,24,29,53,4,0.446892,0.460918,0.000008,No
15063,clayton,24,11.91847835,20,7.824066011,7.823875996,480,93.25096133,17,18,35,20,19,39,4,0.404001,0.421671,0.000008,No
3570,seth,38,11.45894602,30,7.418600903,7.418310866,1140,85.00934727,13,18,31,27,27,54,4,0.425826,0.442515,0.000009,No
7843,medusa,29,11.72923635,14,8.180740955,8.180610949,406,95.95384415,16,15,31,21,25,46,4,0.433851,0.449651,0.000009,No
2146,symbolic,31,11.66254497,29,7.452502454,7.452222421,899,86.91514503,18,13,31,25,20,45,4,0.433882,0.449674,0.000009,No
13068,ecliptic,89,10.60789581,83,6.400957676,6.400137356,7387,67.9006921,8,15,23,82,77,159,4,0.42053,0.437642,0.000012,No
15666,carbonate,69,10.86242567,47,6.969650683,6.969190586,3243,75.7073125,16,30,46,64,45,109,4,0.451346,0.464786,0.000006,No
14874,cologne,119,10.31740868,69,6.58569178,6.585011562,8211,67.94727356,24,45,69,103,98,201,4,0.461089,0.472795,0.000004,No
4795,rainbow,101,10.48141166,62,6.692663899,6.692053725,6262,70.14856543,24,45,69,93,89,182,4,0.446207,0.460805,0.000004,No
975,vacuum,111,10.38700198,57,6.776747016,6.776186871,6327,70.39008465,26,43,69,101,82,183,4,0.462917,0.474185,0.000004,No
1876,tension,55,11.08919899,41,7.106226218,7.105826145,2255,78.80235661,20,26,46,45,45,90,4,0.463909,0.474649,0.000006,No
4008,sanctuary,42,11.35886256,31,7.38581108,7.385511041,1302,83.89441294,23,23,46,35,37,72,4,0.457984,0.469955,0.000006,No
13546,dimension,47,11.24638458,39,7.156236638,7.155856573,1833,80.48178935,24,22,46,41,39,80,4,0.432308,0.448501,0.000006,No
16647,berwick,23,12.00548972,17,8.047209562,8.047059554,391,96.6106917,13,10,23,18,15,33,4,0.439294,0.454308,0.000012,No
16804,becky,4,13.71023782,4,9.433503923,9.433473923,16,129.3355822,4,2,6,4,3,7,5,0.321396,0.325005,0.000046,No
3827,schumacher,32,11.63079627,25,7.600922459,7.600682435,800,88.40478062,11,14,25,29,26,55,4,0.447252,0.461124,0.000011,No
15038,clifford,18,12.20616042,15,8.111748083,8.111608076,270,99.01329838,11,14,25,13,16,29,5,0.401461,0.418988,0.000011,No
8476,loose,51,11.16470654,49,6.927977986,6.92749788,2499,77.34884116,25,30,55,42,38,80,4,0.447275,0.461406,0.000005,No
8594,lisbon,67,10.89183956,54,6.830814238,6.830284108,3618,74.40013273,26,29,55,55,52,107,4,0.458647,0.470598,0.000005,No
8116,marathon,49,11.20471188,26,7.561701746,7.56145172,1274,84.72668938,27,28,55,44,39,83,4,0.448314,0.462251,0.000005,No
14402,costa,142,10.14070512,77,6.475992862,6.475232589,10934,65.67113397,41,14,55,112,115,227,5,0.336729,0.342662,0.000005,No
11667,fund,65,10.92214491,45,7.013135794,7.012695706,2925,76.5984854,16,23,39,58,47,105,4,0.457689,0.469706,0.000007,No
3033,soda,36,11.51301324,21,7.775275846,7.77507583,756,89.51685376,16,23,39,24,27,51,4,0.429515,0.445951,0.000007,No
1435,tramway,52,11.14528846,29,7.452502454,7.452222421,1508,83.06028959,20,19,39,35,42,77,4,0.439414,0.45458,0.000007,No
2416,stupid,28,11.76432767,24,7.641744454,7.641514432,672,89.8999857,22,17,39,26,23,49,4,0.443542,0.458063,0.000007,No
965,valentine,38,11.45894602,23,7.684304068,7.684084048,874,88.0540255,23,16,39,31,31,62,4,0.442481,0.457153,0.000007,No
11208,gottfried,42,11.35886256,41,7.106226218,7.105826145,1722,80.71864692,28,11,39,38,28,66,4,0.427817,0.444205,0.000007,No
17541,apostolic,38,11.45894602,30,7.418600903,7.418310866,1140,85.00934727,10,11,21,20,29,49,5,0.380148,0.396279,0.000013,No
16007,buddha,94,10.5532374,51,6.887972651,6.887472536,4794,72.69041056,27,41,68,71,68,139,4,0.457064,0.469574,0.000004,No
9541,israeli,98,10.5115647,69,6.58569178,6.585011562,6762,69.22592523,28,40,68,89,59,148,5,0.38834,0.405618,0.000004,No
17382,arrive,53,11.12624026,52,6.868554566,6.868044446,2756,76.42118836,18,16,34,37,50,87,4,0.440209,0.455214,0.000008,No
495,weave,10,12.79394708,7,8.873888135,8.873828135,70,113.5320552,9,7,16,9,8,17,4,0.442856,0.457289,0.000017,No
15994,bug,38,11.45894602,22,7.728755831,7.728545813,836,88.56339585,20,14,34,32,34,66,4,0.440155,0.45512,0.000008,No
11005,guillotine,28,11.76432767,18,7.929426526,7.929256515,504,93.28437187,7,20,27,26,26,52,4,0.430546,0.446933,0.00001,No
15366,char,6,13.15062203,6,8.873888135,8.873828135,36,116.6971488,2,3,5,2,3,5,5,0.384337,0.400543,0.000054,No
9424,jewelry,64,10.93764909,45,7.013135794,7.012695706,2880,76.70721837,23,31,54,49,50,99,4,0.445434,0.459899,0.000005,No
75,yonkers,7,13.15062203,3,9.721185996,9.721165996,21,127.8396427,4,5,9,4,6,10,4,0.393583,0.410615,0.00003,No
5699,pittsburgh,130,10.22899773,88,6.34246147,6.341591108,11440,64.87702396,25,29,54,108,67,175,4,0.441457,0.456477,0.000005,No
398,whiplash,11,12.6986369,4,9.433503923,9.433473923,44,119.7926411,7,8,15,8,9,17,4,0.42937,0.445595,0.000018,No
666,vortex,36,11.51301324,11,8.421903011,8.421803008,396,96.96148087,14,16,30,30,19,49,4,0.455855,0.468129,0.000009,No
3437,shirt,58,11.03608917,41,7.106226218,7.105826145,2378,78.42494618,21,24,45,46,48,94,4,0.459086,0.470856,0.000006,No
8136,manor,58,11.03608917,40,7.13091883,7.130528762,2320,78.69745605,21,24,45,44,47,91,4,0.452151,0.465321,0.000006,No
13932,deaf,72,10.81986606,32,7.354062381,7.35375234,2304,79.56996995,21,24,45,58,60,118,4,0.444041,0.458617,0.000006,No
6819,notice,43,11.33533206,42,7.082128666,7.08171859,1806,80.27828013,21,24,45,36,41,77,4,0.451725,0.464974,0.000006,No
9983,inca,80,10.71450554,39,7.156236638,7.155856573,3120,76.67553712,22,23,45,65,57,122,4,0.437486,0.453003,0.000006,No
316,wilmington,56,11.07118049,21,7.775275846,7.77507583,1176,86.08148223,28,26,54,51,41,92,4,0.418695,0.436215,0.000005,No
6121,pauline,29,11.72923635,20,7.824066011,7.823875996,580,91.77031944,16,11,27,21,12,33,5,0.352573,0.363231,0.00001,No
7555,minus,32,11.63079627,24,7.641744454,7.641514432,768,88.87957293,18,12,30,28,25,53,4,0.42214,0.439285,0.000009,No
1769,thermal,87,10.63062406,51,6.887972651,6.887472536,4437,73.22344778,37,17,54,74,46,120,5,0.385824,0.402453,0.000005,No
7291,mph,127,10.25234509,94,6.276503502,6.275573088,11938,64.34887987,26,41,67,122,97,219,4,0.456347,0.469016,0.000004,No
2668,stanford,81,10.70208302,48,6.948597273,6.948127172,3888,74.36446491,35,32,67,57,41,98,4,0.439871,0.455214,0.000004,No
650,w,120,10.28434782,109,6.165837934,6.164797414,13080,63.41162193,38,29,67,80,53,133,4,0.44802,0.462021,0.000004,No
10196,hyde,75,10.77904406,32,7.354062381,7.35375234,2400,79.26976246,47,20,67,66,67,133,4,0.438329,0.453646,0.000004,No
8517,log,36,11.51301324,30,7.418600903,7.418310866,1080,85.41045041,18,20,38,33,29,62,4,0.422401,0.439567,0.000007,No
17284,astrology,33,11.60002462,25,7.600922459,7.600682435,825,88.17088763,18,20,38,31,29,60,4,0.440734,0.455725,0.000007,No
13895,decay,72,10.81986606,45,7.013135794,7.012695706,3240,75.88118994,23,30,53,68,56,124,4,0.463957,0.474753,0.000005,No
6083,pearce,4,13.71023782,4,9.433503923,9.433473923,16,129.3355822,2,3,5,2,3,5,4,0.395389,0.412484,0.000053,No
17900,allegro,6,13.30477271,3,9.721185996,9.721165996,18,129.3381701,2,3,5,2,4,6,5,0.398246,0.416016,0.000053,No
15528,catheter,4,13.71023782,3,9.721185996,9.721165996,12,133.2797719,2,3,5,4,3,7,5,0.398335,0.416082,0.000053,No
10740,havoc,3,13.99791989,2,10.1266511,10.1266411,6,141.7520509,2,3,5,2,3,5,4,0.396892,0.414432,0.000053,No
8935,lapse,5,13.48709426,5,9.210360372,9.210320372,25,124.2209985,3,2,5,5,5,10,5,0.378623,0.394434,0.000053,No
2692,stairway,6,13.30477271,4,9.433503923,9.433473923,24,125.5106255,3,2,5,3,5,8,5,0.359194,0.371565,0.000053,No
720,vita,4,13.71023782,4,9.433503923,9.433473923,16,129.3355822,3,2,5,3,2,5,5,0.380661,0.396683,0.000053,No
15970,bulrush,6,13.30477271,2,10.1266511,10.1266411,12,134.7327912,3,2,5,3,3,6,5,0.355212,0.366928,0.000053,No
9857,infestation,3,13.99791989,3,9.721185996,9.721165996,9,136.0763828,3,2,5,3,2,5,5,0.378947,0.394753,0.000053,No
11847,fortunate,3,13.99791989,3,9.721185996,9.721165996,9,136.0763828,3,2,5,3,2,5,5,0.363713,0.377023,0.000053,No
17324,aspen,3,13.99791989,3,9.721185996,9.721165996,9,136.0763828,3,2,5,3,2,5,5,0.321524,0.324904,0.000053,No
13765,demonstrable,3,13.99791989,2,10.1266511,10.1266411,6,141.7520509,3,2,5,3,2,5,5,0.326852,0.330166,0.000053,No
3911,saxon,52,11.14528846,42,7.082128666,7.08171859,2184,78.93236688,17,27,44,43,39,82,5,0.401734,0.419504,0.000006,No
355,widow,54,11.10754813,50,6.907775279,6.907285168,2700,76.72844639,18,26,44,49,47,96,4,0.420122,0.437464,0.000006,No
2451,stripe,46,11.26789078,33,7.323290723,7.322970678,1518,82.51804002,21,23,44,46,40,86,4,0.456782,0.468997,0.000006,No
4102,sacrifice,53,11.12624026,37,7.208880372,7.208520314,1961,80.20773505,22,22,44,47,46,93,4,0.463062,0.473922,0.000006,No
15584,cartridge,51,11.16470654,26,7.561701746,7.56145172,1326,84.42418097,22,22,44,47,41,88,4,0.45854,0.470373,0.000006,No
2182,swim,86,10.64218488,70,6.571303042,6.570612818,6020,69.93302188,23,43,66,83,80,163,4,0.451645,0.465255,0.000004,No
7448,monaco,71,10.8338523,41,7.106226218,7.105826145,2911,76.98780525,24,42,66,65,61,126,4,0.454048,0.467147,0.000004,No
4888,quest,43,11.33533206,37,7.208880372,7.208520314,1591,81.7150528,14,19,33,33,40,73,4,0.452624,0.465655,0.000008,No
8146,manila,53,11.12624026,36,7.236279346,7.235929291,1908,80.51258262,17,16,33,48,30,78,4,0.444375,0.458739,0.000008,No
17745,anaheim,51,11.16470654,35,7.264450223,7.264110172,1785,81.10545494,13,16,29,46,35,81,4,0.442315,0.457002,0.000009,No
12597,eureka,28,11.76432767,21,7.775275846,7.77507583,588,91.47089276,15,14,29,24,26,50,4,0.391751,0.40886,0.000009,No
12024,flew,104,10.45214128,96,6.255450093,6.25449966,9984,65.38284813,22,30,52,96,101,197,4,0.45962,0.471391,0.000005,No
15153,cilia,25,11.87765635,10,8.517213191,8.517123189,250,101.1645314,12,14,26,17,22,39,4,0.399833,0.417305,0.00001,No
5871,ph,67,10.89183956,30,7.418600903,7.418310866,2010,80.80221078,24,28,52,57,56,113,4,0.428158,0.444872,0.000005,No
2222,suzuki,59,11.01899473,28,7.487593774,7.487323743,1652,82.50575636,24,28,52,42,43,85,4,0.434754,0.450707,0.000005,No
5625,pleasant,49,11.20471188,36,7.236279346,7.235929291,1764,81.08042515,26,26,52,45,43,88,4,0.436765,0.452411,0.000005,No
2760,spray,21,12.05200974,18,7.929426526,7.929256515,378,95.56552572,15,11,26,18,17,35,4,0.432645,0.448674,0.00001,No
14027,dale,48,11.22533117,30,7.418600903,7.418310866,1440,83.27625192,30,22,52,40,30,70,4,0.436561,0.452158,0.000005,No
18050,agnes,50,11.18450917,27,7.523961418,7.52370139,1350,84.15181549,30,22,52,38,29,67,4,0.41587,0.433342,0.000005,No
16377,bohemia,111,10.38700198,92,6.298009707,6.297099311,10212,65.41743927,17,48,65,101,88,189,4,0.459264,0.471424,0.000004,No
7014,nettle,3,13.99791989,3,9.721185996,9.721165996,9,136.0763828,2,3,5,2,3,5,5,0.314366,0.318708,0.000052,No
12835,encryption,102,10.47155936,56,6.794446593,6.793896453,5712,71.14845085,29,36,65,73,86,159,4,0.450979,0.464603,0.000004,No
4109,sac,12,12.61162553,11,8.421903011,8.421803008,132,106.213887,9,11,20,10,12,22,4,0.421189,0.438196,0.000013,No
13884,decide,208,9.758994098,182,5.615791597,5.613979993,37856,54.80447705,31,34,65,181,200,381,4,0.451473,0.464941,0.000004,No
11960,flynn,22,12.00548972,14,8.180740955,8.180610949,308,98.21380147,10,10,20,14,16,30,5,0.402745,0.420213,0.000013,No
4695,rebel,70,10.84803694,63,6.676663558,6.676043378,4410,72.42869288,37,28,65,60,41,101,5,0.408369,0.426227,0.000004,No
10510,hieroglyphic,5,13.48709426,5,9.210360372,9.210320372,25,124.2209985,3,2,5,3,2,5,5,0.323622,0.326879,0.000052,No
2092,tabula,3,13.99791989,3,9.721185996,9.721165996,9,136.0763828,3,2,5,3,2,5,5,0.375325,0.391883,0.000052,No
14072,cygnus,3,13.99791989,3,9.721185996,9.721165996,9,136.0763828,3,2,5,3,2,5,5,0.384262,0.400444,0.000052,No
16031,bryn,6,13.30477271,6,9.028038815,9.027988815,36,120.1160044,4,1,5,6,4,10,6,0.285079,0.291507,0.000052,No
14630,conscientious,6,13.30477271,4,9.433503923,9.433473923,24,125.5106255,4,1,5,5,4,9,6,0.260473,0.264357,0.000052,No
1498,tortoise,34,11.57017165,12,8.334891634,8.334781631,408,96.43612692,17,20,37,31,29,60,4,0.431982,0.448097,0.000007,No
16827,beard,36,11.51301324,28,7.487593774,7.487323743,1008,86.20476625,19,18,37,33,28,61,4,0.447376,0.461289,0.000007,No
14228,cromwell,61,10.98565831,35,7.264450223,7.264110172,2135,79.80476798,16,27,43,31,43,74,4,0.4355,0.451331,0.000006,No
17171,auto,55,11.08919899,40,7.13091883,7.130528762,2200,79.0761779,18,25,43,45,36,81,4,0.429411,0.445914,0.000006,No
16097,britannica,51,11.16470654,35,7.264450223,7.264110172,1785,81.10545494,7,25,32,10,35,45,4,0.435993,0.45174,0.000008,No
4513,rescue,79,10.72708432,62,6.692663899,6.692053725,4898,71.79277,25,39,64,72,64,136,4,0.456829,0.469326,0.000004,No
5033,pull,78,10.73982335,69,6.58569178,6.585011562,5382,70.72916635,27,37,64,63,68,131,4,0.459525,0.471438,0.000004,No
10021,impossible,113,10.36914436,98,6.234830806,6.233860354,11074,64.64986067,32,32,64,100,99,199,4,0.460383,0.471997,0.000004,No
17701,angela,38,11.45894602,29,7.452502454,7.452222421,1102,85.39782332,20,12,32,28,13,41,5,0.393078,0.410204,0.000008,No
12492,exit,47,11.24638458,25,7.600922459,7.600682435,1175,85.48289711,24,27,51,36,37,73,4,0.44929,0.463091,0.000005,No
15853,cacao,36,11.51301324,19,7.875359305,7.875179292,684,90.66911594,9,14,23,27,28,55,4,0.439436,0.454496,0.000011,No
4419,rhine,160,10.02135836,107,6.14696945,6.145908909,17120,61.6009837,17,46,63,145,125,270,4,0.449108,0.463246,0.000004,No
12496,exile,108,10.41440095,83,6.400957676,6.400137356,8964,66.66213971,19,44,63,96,91,187,4,0.467132,0.477424,0.000004,No
1753,thief,24,11.91847835,23,7.684304068,7.684084048,552,91.58521165,7,14,21,21,21,42,4,0.450065,0.463434,0.000012,No
8999,lagoon,46,11.26789078,30,7.418600903,7.418310866,1380,83.59198472,14,28,42,28,42,70,4,0.460359,0.471908,0.000006,No
1141,twist,42,11.35886256,32,7.354062381,7.35375234,1344,83.53378384,16,26,42,37,41,78,4,0.458469,0.470382,0.000006,No
9087,knowles,115,10.35160005,50,6.907775279,6.907285168,5750,71.50652691,24,39,63,47,84,131,4,0.452474,0.465856,0.000004,No
15444,cereal,50,11.18450917,32,7.354062381,7.35375234,1600,82.25157816,15,21,36,43,29,72,4,0.427951,0.444491,0.000007,No
13682,dessert,45,11.28986969,35,7.264450223,7.264110172,1575,82.01469637,16,20,36,42,34,76,4,0.410751,0.428408,0.000007,No
1513,tornado,44,11.31234254,27,7.523961418,7.52370139,1188,85.11362885,16,20,36,32,26,58,4,0.438177,0.453533,0.000007,No
3429,shoe,36,11.51301324,25,7.600922459,7.600682435,900,87.5095209,16,20,36,31,29,60,4,0.448269,0.462049,0.000007,No
13046,edison,34,11.57017165,20,7.824066011,7.823875996,680,90.52578677,16,20,36,32,26,58,4,0.439109,0.454355,0.000007,No
1605,titan,97,10.5218212,56,6.794446593,6.793896453,5432,71.4899522,28,35,63,87,84,171,4,0.445882,0.460345,0.000004,No
16567,bin,56,11.07118049,42,7.082128666,7.08171859,2352,78.40752469,10,11,21,16,23,39,4,0.42853,0.444853,0.000012,No
13849,defect,18,12.20616042,15,8.111748083,8.111608076,270,99.01329838,10,11,21,18,16,34,4,0.446881,0.460744,0.000012,No
657,vs,24,11.91847835,18,7.929426526,7.929256515,432,94.50669836,14,14,28,15,16,31,4,0.399788,0.417596,0.000009,No
7473,moisture,47,11.24638458,41,7.106226218,7.105826145,1927,79.91935292,21,21,42,32,40,72,4,0.44092,0.455899,0.000006,No
605,wallis,20,12.1007999,15,8.111748083,8.111608076,300,98.15864042,11,10,21,16,17,33,4,0.426041,0.442576,0.000012,No
2438,struggle,69,10.86242567,61,6.70892442,6.708324252,4209,72.87519286,22,20,42,58,64,122,4,0.443697,0.458261,0.000006,No
15616,carol,44,11.31234254,38,7.182212124,7.181842063,1672,81.24764377,22,20,42,35,30,65,4,0.418735,0.436036,0.000006,No
63,yourself,34,11.57017165,33,7.323290723,7.322970678,1122,84.73173073,22,20,42,28,29,57,4,0.458362,0.470194,0.000006,Yes
3952,satan,46,11.26789078,23,7.684304068,7.684084048,1058,86.58589897,22,20,42,36,36,72,4,0.42207,0.439116,0.000006,No
3680,seem,128,10.24450191,124,5.999516719,5.998285986,15872,61.4620605,33,30,63,86,119,205,4,0.431237,0.447632,0.000004,No
1496,torture,48,11.22533117,32,7.354062381,7.35375234,1536,82.55178565,25,17,42,42,37,79,4,0.461161,0.472344,0.000006,No
1938,teddy,38,11.45894602,23,7.684304068,7.684084048,874,88.0540255,18,10,28,26,20,46,5,0.353676,0.364655,0.000009,No
10835,hannah,32,11.63079627,21,7.775275846,7.77507583,672,90.43264935,19,9,28,23,24,47,4,0.422854,0.439614,0.000009,No
658,voyage,75,10.77904406,66,6.630143542,6.629493344,4950,71.46660939,20,30,50,69,63,132,4,0.453479,0.466509,0.000005,No
3492,shear,80,10.71450554,40,7.13091883,7.130528762,3200,76.40426933,21,29,50,75,63,138,4,0.453584,0.466523,0.000005,No
17227,attorney,79,10.72708432,55,6.812465099,6.811924964,4345,73.07788758,23,27,50,60,69,129,4,0.442613,0.457462,0.000005,No
7391,moody,22,12.00548972,13,8.254848927,8.254728922,286,99.10350396,12,13,25,17,17,34,4,0.426707,0.443322,0.00001,No
3144,sloan,16,12.32394346,9,8.622573707,8.622493705,144,106.2641108,12,13,25,13,15,28,4,0.405886,0.423483,0.00001,No
1633,timber,48,11.22533117,42,7.082128666,7.08171859,2016,79.49923964,24,26,50,37,36,73,4,0.458433,0.470368,0.000005,No
17619,antenna,43,11.33533206,26,7.561701746,7.56145172,1118,85.71440024,24,26,50,41,36,77,4,0.459847,0.471513,0.000005,No
13958,davenport,23,11.96103796,16,8.047209562,8.047059554,368,96.25297905,14,11,25,17,16,33,4,0.423177,0.439961,0.00001,No
15935,burial,54,11.10754813,52,6.868554566,6.868044446,2808,76.29280043,29,21,50,51,39,90,4,0.44352,0.458124,0.000005,No
10898,halifax,49,11.20471188,26,7.561701746,7.56145172,1274,84.72668938,29,21,50,38,42,80,4,0.423915,0.440834,0.000005,No
1850,terrestrial,66,10.90687744,54,6.830814238,6.830284108,3564,74.50285367,32,18,50,55,26,81,4,0.402818,0.420441,0.000005,No
1597,titus,53,11.12624026,36,7.236279346,7.235929291,1908,80.51258262,32,18,50,45,24,69,4,0.428065,0.444581,0.000005,No
4424,rhetoric,28,11.76432767,22,7.728755831,7.728545813,616,90.92361605,11,20,31,23,25,48,4,0.448722,0.462401,0.000008,No
18248,accurate,88,10.61919536,81,6.42534913,6.424548825,7128,68.23203768,25,37,62,75,61,136,4,0.456418,0.468983,0.000004,No
11639,fusion,107,10.42370334,54,6.830814238,6.830284108,5778,71.2023812,27,35,62,97,76,173,4,0.463122,0.474185,0.000004,No
6673,octopus,30,11.6953348,20,7.824066011,7.823875996,600,91.50507146,14,17,31,25,25,50,4,0.444999,0.459284,0.000008,No
12170,fife,42,11.35886256,33,7.323290723,7.322970678,1386,83.1842528,15,16,31,34,37,71,4,0.45237,0.46534,0.000008,No
655,vulcan,56,11.07118049,24,7.641744454,7.641514432,1344,84.60313208,31,31,62,43,50,93,4,0.448054,0.462068,0.000004,No
11406,ghost,85,10.65388092,61,6.70892442,6.708324252,5185,71.47608188,32,30,62,63,53,116,4,0.453317,0.466373,0.000004,No
8107,marcus,93,10.56393268,74,6.515733191,6.515002939,6882,68.83176682,43,19,62,65,30,95,4,0.391181,0.40847,0.000004,No
9586,irony,17,12.26331883,7,8.873888135,8.873828135,119,108.8233195,9,10,19,14,16,30,4,0.439806,0.454721,0.000013,No
4239,rosa,48,11.22533117,36,7.236279346,7.235929291,1728,81.22963207,16,25,41,34,33,67,4,0.431866,0.448177,0.000006,No
950,vampire,93,10.56393268,67,6.615105665,6.61444546,6231,69.88153094,18,23,41,86,30,116,4,0.435864,0.451599,0.000006,No
11568,gandhi,60,11.00218762,29,7.452502454,7.452222421,1740,81.9938302,18,23,41,31,40,71,4,0.432203,0.44836,0.000006,No
10343,hop,106,10.43309308,71,6.557118407,6.556418176,7526,68.4110267,10,39,49,99,80,179,4,0.423702,0.441036,0.000005,No
13021,efficient,58,11.03608917,51,6.887972651,6.887472536,2958,76.01628036,19,30,49,54,45,99,4,0.444709,0.459265,0.000005,No
7418,monroe,73,10.80607274,48,6.948597273,6.948127172,3504,75.08704755,21,28,49,65,64,129,4,0.434296,0.450299,0.000005,No
1584,toe,38,11.45894602,27,7.523961418,7.52370139,1026,86.21666773,21,28,49,35,32,67,4,0.45697,0.469246,0.000005,No
209,wore,84,10.66571538,76,6.489064944,6.488314678,6384,69.21051976,22,27,49,55,65,120,4,0.425367,0.442482,0.000005,No
10355,honorary,75,10.77904406,67,6.615105665,6.61444546,5025,71.30451545,23,26,49,63,48,111,5,0.38761,0.404608,0.000005,No
14700,conduct,72,10.81986606,65,6.645411014,6.644770822,4680,71.90245708,23,26,49,68,46,114,4,0.4573,0.469476,0.000005,No
14336,cow,63,10.95339745,50,6.907775279,6.907285168,3150,75.66360813,24,25,49,52,53,105,4,0.44785,0.461786,0.000005,No
8063,maroon,67,10.89183956,34,7.29343776,7.293107712,2278,79.4389539,24,25,49,59,44,103,4,0.436389,0.45205,0.000005,No
17372,artemis,52,11.14528846,21,7.775275846,7.77507583,1092,86.65769216,26,23,49,42,47,89,4,0.413295,0.430938,0.000005,No
5434,poseidon,34,11.57017165,25,7.600922459,7.600682435,850,87.94397757,16,19,35,31,29,60,4,0.437777,0.453167,0.000007,No
9714,intellectual,36,11.51301324,34,7.29343776,7.293107712,1224,83.96944548,19,16,35,30,25,55,4,0.427395,0.443923,0.000007,No
455,wendy,28,11.76432767,17,7.98658494,7.986424931,476,93.95680218,19,16,35,23,16,39,4,0.391664,0.408761,0.000007,No
187,worst,115,10.35160005,102,6.194825471,6.193814981,11730,64.12635565,17,44,61,104,65,169,4,0.431866,0.44851,0.000004,No
18275,accept,109,10.4051843,97,6.245087306,6.244126864,10573,64.98128436,25,36,61,97,94,191,4,0.445792,0.460279,0.000004,No
12794,enterprise,66,10.90687744,41,7.106226218,7.105826145,2706,77.50673838,28,33,61,48,49,97,4,0.45051,0.464143,0.000004,No
14613,console,221,9.698369476,162,5.732201949,5.730590684,35802,55.59301241,27,54,81,187,183,370,4,0.467414,0.477846,0.000003,No
16500,bladder,33,11.60002462,21,7.775275846,7.77507583,693,90.19339121,10,17,27,31,24,55,4,0.443498,0.458016,0.000009,No
503,wealth,97,10.5218212,80,6.43777165,6.436981353,7760,67.73708222,40,41,81,84,81,165,4,0.458493,0.47072,0.000003,No
14519,conversation,41,11.38296011,36,7.236279346,7.235929291,1476,82.37027914,20,28,48,38,36,74,4,0.459097,0.470931,0.000005,No
1254,truman,48,11.22533117,26,7.561701746,7.56145172,1248,84.88260628,23,25,48,46,35,81,4,0.40098,0.418737,0.000005,No
7829,mel,30,11.6953348,25,7.600922459,7.600682435,750,88.89533292,15,9,24,21,20,41,5,0.384645,0.401007,0.00001,No
12246,felix,58,11.03608917,51,6.887972651,6.887472536,2958,76.01628036,32,16,48,49,30,79,4,0.43534,0.451003,0.000005,No
5710,pistol,34,11.57017165,22,7.728755831,7.728545813,748,89.42303163,14,26,40,24,28,52,4,0.448201,0.462134,0.000006,No
186,worth,130,10.22899773,109,6.128450402,6.12736984,14170,62.68790523,36,44,80,116,111,227,4,0.463388,0.474555,0.000003,No
5359,praise,41,11.38296011,37,7.208880372,7.208520314,1517,82.05839771,19,21,40,31,40,71,4,0.45993,0.471471,0.000006,No
1643,tight,44,11.31234254,38,7.182212124,7.181842063,1672,81.24764377,22,18,40,37,25,62,4,0.4076,0.425234,0.000006,No
13563,digestion,44,11.31234254,32,7.354062381,7.35375234,1408,83.19167274,22,18,40,37,32,69,4,0.448122,0.461889,0.000006,No
5442,portrait,64,10.93764909,41,7.106226218,7.105826145,2624,77.72540875,23,17,40,49,49,98,4,0.44696,0.460918,0.000006,No
14665,confusion,74,10.79246708,61,6.70892442,6.708324252,4514,72.40584597,29,31,60,65,62,127,4,0.452335,0.465579,0.000004,No
9616,iodine,29,11.72923635,12,8.334891634,8.334781631,348,97.76191391,15,15,30,22,21,43,4,0.410665,0.428234,0.000008,No
16192,brass,90,10.59672251,48,6.948597273,6.948127172,4320,73.63235712,30,30,60,69,58,127,4,0.43847,0.453974,0.000004,No
4765,randall,24,11.91847835,22,7.728755831,7.728545813,528,92.11500902,16,14,30,19,16,35,4,0.428272,0.444679,0.000008,No
6774,numeral,63,10.95339745,40,7.13091883,7.130528762,2520,78.10778814,17,13,30,58,55,113,4,0.429629,0.445867,0.000008,No
15692,capitol,85,10.65388092,50,6.907775279,6.907285168,4250,73.59461525,38,22,60,74,43,117,4,0.444508,0.458955,0.000004,No
7411,mont,39,11.43297053,27,7.523961418,7.52370139,1053,86.02122917,24,6,30,32,23,55,4,0.388833,0.405911,0.000008,No
7342,morton,33,11.60002462,28,7.487593774,7.487323743,924,86.85627209,12,22,34,19,26,45,4,0.44331,0.457951,0.000007,No
14798,compare,45,11.28986969,40,7.13091883,7.130528762,1800,80.50714434,16,18,34,41,35,76,4,0.425704,0.442473,0.000007,No
7524,mistress,40,11.40765272,31,7.38581108,7.385511041,1240,84.25476788,18,16,34,35,31,66,4,0.453213,0.466016,0.000007,No
14062,cyrus,41,11.38296011,29,7.452502454,7.452222421,1189,84.83153816,18,16,34,27,31,58,4,0.429224,0.445562,0.000007,No
11802,franchise,113,10.36914436,90,6.319988614,6.319098235,10170,65.53287428,35,44,79,75,79,154,4,0.466052,0.476626,0.000003,No
1685,thrown,123,10.28434782,106,6.15635919,6.155308659,13038,63.31413923,25,34,59,113,118,231,4,0.461821,0.473171,0.000004,No
16885,basis,161,10.01512781,146,5.836191663,5.834740639,23506,58.45020544,29,30,59,138,155,293,4,0.45717,0.469438,0.000004,No
2485,strategy,78,10.73982335,61,6.70892442,6.708324252,4758,72.05266314,31,28,59,67,61,128,4,0.460718,0.472208,0.000004,No
10404,holocaust,61,10.98565831,41,7.106226218,7.105826145,2501,78.06657312,13,34,47,56,50,106,4,0.461484,0.472894,0.000005,No
700,vocabulary,52,11.14528846,44,7.03560865,7.035178566,2288,78.41388789,19,28,47,43,44,87,4,0.463897,0.474677,0.000005,No
2897,span,52,11.14528846,41,7.106226218,7.105826145,2132,79.20094105,26,21,47,47,47,94,4,0.453317,0.46619,0.000005,No
17757,amsterdam,114,10.36033373,84,6.388981485,6.388151157,9576,66.19198038,26,52,78,100,95,195,4,0.466101,0.476823,0.000003,No
13679,destroy,146,10.11292556,131,5.944600961,5.943300141,19126,60.11730698,28,50,78,133,122,255,4,0.452013,0.465683,0.000003,No
7554,minute,104,10.45214128,82,6.413079037,6.412268725,8528,67.03040812,29,49,78,97,76,173,4,0.460527,0.472433,0.000003,No
4264,romano,19,12.1520932,14,8.180740955,8.180610949,266,99.41312651,7,11,18,11,14,25,4,0.43596,0.451439,0.000013,No
178,woven,38,11.45894602,30,7.418600903,7.418310866,1140,85.00934727,19,20,39,31,34,65,4,0.439577,0.454791,0.000006,No
946,vancouver,130,10.22899773,87,6.353890166,6.353029813,11310,64.99392806,38,40,78,117,93,210,4,0.461149,0.472743,0.000003,No
13435,divide,98,10.5115647,82,6.413079037,6.412268725,8036,67.41149521,38,40,78,83,84,167,4,0.464808,0.475584,0.000003,No
4723,raven,37,11.48561426,19,7.875359305,7.875179292,703,90.45333917,20,19,39,35,34,69,4,0.45385,0.46657,0.000006,No
7826,melanie,19,12.1520932,11,8.421903011,8.421803008,209,102.3437503,14,12,26,16,13,29,5,0.356625,0.368347,0.000009,No
17712,andrea,54,11.10754813,36,7.236279346,7.235929291,1944,80.37732112,28,11,39,35,28,63,5,0.398908,0.416321,0.000006,No
9944,incorrect,30,11.6953348,28,7.487593774,7.487323743,840,87.569916,9,20,29,21,25,46,4,0.43986,0.454993,0.000008,No
11003,guilty,136,10.18387729,110,6.119317918,6.118227346,14960,62.31838279,23,35,58,126,129,255,4,0.466077,0.47648,0.000004,No
8477,loop,67,10.89183956,44,7.03560865,7.035178566,2948,76.63072061,24,34,58,58,53,111,4,0.459811,0.471603,0.000004,No
17400,armour,53,11.12624026,34,7.29343776,7.293107712,1802,81.14854086,26,32,58,44,44,88,4,0.46471,0.475377,0.000004,No
16807,beck,25,11.87765635,19,7.875359305,7.875179292,475,93.54081148,14,15,29,22,19,41,4,0.431163,0.447261,0.000008,No
13627,diagnosis,28,11.76432767,21,7.775275846,7.77507583,588,91.47089276,8,13,21,19,24,43,4,0.443564,0.458012,0.000011,No
6655,offer,114,10.36033373,104,6.175407385,6.174376875,11856,63.97928142,31,46,77,90,86,176,4,0.463545,0.474734,0.000003,No
212,worcestershire,42,11.35886256,31,7.38581108,7.385511041,1302,83.89441294,14,19,33,25,34,59,4,0.450453,0.463795,0.000007,No
12085,fitzgerald,29,11.72923635,17,7.98658494,7.986424931,493,93.67654237,15,18,33,27,24,51,4,0.445401,0.459631,0.000007,No
17038,bailey,29,11.72923635,21,7.775275846,7.77507583,609,91.19804807,16,17,33,24,23,47,4,0.432382,0.448393,0.000007,No
11500,gazelle,25,11.87765635,7,8.873888135,8.873828135,175,105.4009938,12,9,21,15,10,25,5,0.390441,0.407528,0.000011,No
623,wake,121,10.30074163,71,6.557118407,6.556418176,8591,67.54318256,56,21,77,95,110,205,4,0.43502,0.450834,0.000003,No
11512,gauntlet,10,12.79394708,4,9.433503923,9.433473923,40,120.69175,4,7,11,10,8,18,4,0.411245,0.428614,0.000021,No
1375,trash,47,11.24638458,26,7.561701746,7.56145172,1222,85.04180588,18,28,46,28,33,61,4,0.424462,0.441557,0.000005,No
12027,flesh,61,10.98565831,48,6.948597273,6.948127172,2928,76.3349154,23,23,46,54,55,109,4,0.44828,0.462124,0.000005,No
2929,sour,38,11.45894602,31,7.38581108,7.385511041,1178,84.63361046,23,23,46,28,33,61,4,0.440603,0.455679,0.000005,No
3476,shelf,45,11.28986969,22,7.728755831,7.728545813,990,87.25664618,23,23,46,39,42,81,4,0.46067,0.472086,0.000005,No
8556,lizzie,20,12.1007999,6,9.028038815,9.027988815,120,109.2464912,14,9,23,18,17,35,4,0.401634,0.419089,0.00001,No
15114,citrus,60,11.00218762,41,7.106226218,7.105826145,2460,78.18403408,29,17,46,60,38,98,5,0.353331,0.364204,0.000005,No
3910,saxony,249,9.579079281,183,5.610312131,5.60849051,45567,53.7416247,22,54,76,179,215,394,4,0.463787,0.475053,0.000003,No
7847,mediterranean,306,9.372947075,229,5.386076281,5.383793723,70074,50.48340792,23,53,76,297,278,575,4,0.454571,0.4678,0.000003,No
15218,choose,208,9.758994098,182,5.615791597,5.613979993,37856,54.80447705,27,49,76,185,195,380,4,0.458445,0.470786,0.000003,No
1107,ukrainian,105,10.44257183,68,6.600290579,6.599620368,7140,68.92400845,32,44,76,86,63,149,4,0.399482,0.417512,0.000003,No
2540,stitch,44,11.31234254,13,8.254848927,8.254728922,572,93.3816787,17,21,38,23,31,54,4,0.447241,0.461209,0.000006,No
2636,static,53,11.12624026,25,7.600922459,7.600682435,1325,84.56968951,18,20,38,40,27,67,4,0.436754,0.452303,0.000006,No
4510,reservoir,61,10.98565831,44,7.03560865,7.035178566,2684,77.29079266,20,18,38,44,43,87,4,0.457854,0.469753,0.000006,No
17786,ammonia,32,11.63079627,22,7.728755831,7.728545813,704,89.89158452,20,18,38,28,25,53,4,0.436464,0.452007,0.000006,No
595,walton,34,11.57017165,17,7.98658494,7.986424931,578,92.40615868,21,17,38,32,26,58,4,0.433469,0.449364,0.000006,No
4803,rage,38,11.45894602,29,7.452502454,7.452222421,1102,85.39782332,22,16,38,32,36,68,4,0.426881,0.443482,0.000006,No
10832,hanover,75,10.77904406,49,6.927977986,6.92749788,3675,74.67697999,14,43,57,69,73,142,4,0.453514,0.466753,0.000004,No
5182,promotion,73,10.80607274,59,6.74226084,6.741680684,4307,72.85736105,25,32,57,50,59,109,4,0.453572,0.466617,0.000004,No
5913,personnel,71,10.8338523,64,6.660915201,6.660285015,4544,72.16337147,33,24,57,48,45,93,4,0.41586,0.433426,0.000004,No
14905,cole,73,10.80607274,41,7.106226218,7.105826145,2993,76.79039739,35,22,57,57,42,99,4,0.434148,0.450059,0.000004,No
9553,islamabad,55,11.08919899,36,7.236279346,7.235929291,1980,80.24454163,22,23,45,47,44,91,4,0.43924,0.454491,0.000005,No
9037,kuwait,43,11.33533206,34,7.29343776,7.293107712,1462,82.67353888,22,23,45,34,35,69,4,0.454501,0.467161,0.000005,No
13067,ecology,51,11.16470654,41,7.106226218,7.105826145,2091,79.33893036,25,20,45,44,39,83,4,0.456043,0.468359,0.000005,No
16494,blanc,39,11.43297053,28,7.487593774,7.487323743,1092,85.60543897,9,19,28,29,32,61,4,0.419844,0.437036,0.000008,No
14890,collect,84,10.66571538,74,6.515733191,6.515002939,6216,69.4949557,20,36,56,71,62,133,4,0.445211,0.459814,0.000004,No
7308,mountainous,82,10.68981293,77,6.475992862,6.475232589,6314,69.22715224,23,33,56,75,63,138,4,0.426963,0.443844,0.000004,No
12145,filter,63,10.95339745,43,7.058598169,7.058178089,2709,77.31563119,24,32,56,52,45,97,4,0.462736,0.473851,0.000004,No
8605,lip,42,11.35886256,35,7.264450223,7.264110172,1470,82.51589165,13,15,28,16,34,50,4,0.414772,0.432173,0.000008,No
15283,cheyenne,20,12.1007999,10,8.517213191,8.517123189,200,103.0650926,13,15,28,17,20,37,5,0.358845,0.371061,0.000008,No
3703,secretion,11,12.6986369,10,8.517213191,8.517123189,110,108.1569978,8,8,16,8,10,18,4,0.430714,0.446792,0.000014,No
14792,compatible,27,11.80069531,24,7.641744454,7.641514432,648,90.17789795,15,13,28,21,25,46,4,0.433692,0.449491,0.000008,No
4613,regina,26,11.83843564,13,8.254848927,8.254728922,338,97.72449773,15,13,28,20,18,38,4,0.389883,0.407001,0.000008,No
14978,coalition,92,10.5747436,68,6.600290579,6.599620368,6256,69.79638056,30,26,56,88,57,145,4,0.457547,0.469673,0.000004,No
8730,levi,30,11.6953348,21,7.775275846,7.77507583,630,90.93445415,20,12,32,21,21,42,4,0.425123,0.441773,0.000007,No
17506,apprentice,53,11.12624026,46,6.991156888,6.990706795,2438,77.78529125,14,23,37,47,44,91,4,0.429204,0.445717,0.000006,No
9345,jr,35,11.33533206,31,7.156236638,7.155856573,1085,81.1183186,15,22,37,25,26,51,4,0.433607,0.449594,0.000006,No
11458,gentle,36,11.51301324,36,7.236279346,7.235929291,1296,83.31137991,15,22,37,33,28,61,4,0.440504,0.455566,0.000006,No
768,villain,57,11.05348091,52,6.868554566,6.868044446,2964,75.92143677,18,19,37,55,43,98,4,0.422895,0.439928,0.000006,No
11558,garage,40,11.40765272,30,7.418600903,7.418310866,1200,84.62882279,18,19,37,26,32,58,4,0.410855,0.428455,0.000006,No
5818,phosphorus,41,11.38296011,20,7.824066011,7.823875996,820,89.0610313,18,19,37,35,32,67,4,0.440177,0.455228,0.000006,No
16317,booth,32,11.63079627,18,7.929426526,7.929256515,576,92.2255445,18,19,37,25,24,49,4,0.456031,0.468335,0.000006,No
8542,lobe,12,12.61162553,8,8.740356743,8.740286741,96,110.2301062,4,7,11,6,10,16,4,0.426358,0.442942,0.00002,No
9106,knee,48,11.22533117,34,7.29343776,7.293107712,1632,81.87125419,18,26,44,43,41,84,4,0.440712,0.455819,0.000005,No
4404,rhyme,41,11.38296011,30,7.418600903,7.418310866,1230,84.44563815,19,25,44,34,38,72,4,0.457783,0.469851,0.000005,No
13846,defensive,62,10.96939779,54,6.830814238,6.830284108,3348,74.92991862,26,18,44,52,32,84,5,0.385841,0.4025,0.000005,No
1172,tuscany,112,10.37803331,91,6.308938778,6.30803839,10192,65.47437676,18,37,55,101,96,197,4,0.452728,0.466025,0.000004,No
6542,opponent,70,10.84803694,59,6.74226084,6.741680684,4130,73.14029462,21,34,55,64,55,119,4,0.4563,0.468837,0.000004,No
9790,inn,67,10.89183956,43,7.058598169,7.058178089,2881,76.88111876,23,32,55,48,54,102,4,0.456406,0.468861,0.000004,No
8324,macedonia,79,10.72708432,44,7.03560865,7.035178566,3476,75.47156727,24,31,55,68,59,127,4,0.457724,0.469894,0.000004,No
14139,cuneiform,20,12.1007999,12,8.334891634,8.334781631,240,100.8588559,11,9,20,13,10,23,4,0.413506,0.430948,0.000011,No
13496,discipline,51,11.16470654,41,7.106226218,7.105826145,2091,79.33893036,32,23,55,45,40,85,4,0.44482,0.459242,0.000004,No
13129,dying,81,10.70208302,75,6.502310171,6.501569912,6075,69.58826329,38,35,73,70,71,141,4,0.455411,0.468143,0.000003,No
11156,grape,34,11.57017165,24,7.641744454,7.641514432,816,88.41629506,16,15,31,26,22,48,4,0.425316,0.442008,0.000007,No
15712,canterbury,126,10.26025027,87,6.353890166,6.353029813,10962,65.19250329,19,53,72,120,81,201,4,0.448722,0.46303,0.000003,No
13441,dive,37,11.48561426,29,7.452502454,7.452222421,1073,85.5965685,9,18,27,26,25,51,4,0.442492,0.457186,0.000008,No
17990,alarm,64,10.93764909,37,7.208880372,7.208520314,2368,78.84820386,14,22,36,59,42,101,4,0.435159,0.451045,0.000006,No
9519,ix,108,10.41440095,97,6.245087306,6.244126864,10476,65.03884317,23,31,54,98,83,181,4,0.446061,0.460425,0.000004,No
7706,meteorology,38,11.45894602,31,7.38581108,7.385511041,1178,84.63361046,17,19,36,32,33,65,4,0.443442,0.457998,0.000006,No
8675,lift,83,10.67769157,45,7.013135794,7.012695706,3735,74.88410095,34,38,72,75,68,143,4,0.453503,0.466617,0.000003,No
1787,theologian,78,10.73982335,69,6.58569178,6.585011562,5382,70.72916635,26,28,54,61,59,120,4,0.426399,0.443308,0.000004,No
14183,cry,49,11.20471188,39,7.156236638,7.155856573,1911,80.18356967,26,28,54,45,44,89,4,0.448326,0.462256,0.000004,No
2078,taft,22,12.00548972,8,8.740356743,8.740286741,176,104.9322631,12,12,24,21,16,37,5,0.391586,0.408622,0.000009,No
7282,mucus,40,11.40765272,23,7.684304068,7.684084048,920,87.65987223,18,18,36,28,28,56,4,0.449928,0.463382,0.000006,No
5762,pigment,42,11.35886256,27,7.523961418,7.52370139,1134,85.46364365,19,17,36,37,25,62,4,0.419963,0.437121,0.000006,No
3505,sharon,37,11.48561426,21,7.775275846,7.77507583,777,89.30381917,20,16,36,24,24,48,4,0.407713,0.425347,0.000006,No
6870,none,121,10.30074163,119,6.040674791,6.039494118,14399,62.2234303,44,28,72,89,118,207,4,0.443354,0.45819,0.000003,No
2257,surgical,21,12.05200974,19,7.875359305,7.875179292,399,94.91390705,12,6,18,20,9,29,5,0.361167,0.373994,0.000012,No
16660,bernie,26,11.83843564,21,7.775275846,7.77507583,546,92.04710269,13,5,18,16,12,28,5,0.384804,0.401111,0.000012,No
14543,contrast,103,10.46180319,101,6.204677767,6.203677287,10403,64.91211765,19,24,43,96,92,188,4,0.464139,0.474781,0.000005,No
5799,pi,46,11.26789078,21,7.775275846,7.77507583,966,87.61095903,21,22,43,25,32,57,4,0.448552,0.462284,0.000005,No
16041,brush,43,11.33533206,34,7.29343776,7.293107712,1462,82.67353888,23,20,43,40,28,68,4,0.442073,0.456857,0.000005,No
10871,hampton,40,11.40765272,26,7.561701746,7.56145172,1040,86.26126752,25,18,43,35,31,66,4,0.409368,0.427103,0.000005,No
4596,reich,87,10.63062406,58,6.759355274,6.758785123,5046,71.85616479,20,51,71,74,76,150,4,0.44962,0.463725,0.000003,No
7956,mawr,5,13.48709426,5,9.210360372,9.210320372,25,124.2209985,1,3,4,4,5,9,5,0.398729,0.416514,0.000053,No
6731,objector,4,13.71023782,3,9.721185996,9.721165996,12,133.2797719,1,3,4,4,3,7,5,0.352195,0.362445,0.000053,No
4960,pyle,3,13.99791989,2,10.1266511,10.1266411,6,141.7520509,1,3,4,1,3,4,5,0.39846,0.416199,0.000053,No
16534,bismarck,64,10.93764909,25,7.600922459,7.600682435,1600,83.13622265,23,30,53,55,60,115,4,0.452428,0.465631,0.000004,No
9297,jurassic,125,10.26821844,75,6.502310171,6.501569912,9375,66.7671412,24,29,53,78,113,191,4,0.449643,0.463359,0.000004,No
18180,adelaide,60,11.00218762,41,7.106226218,7.105826145,2460,78.18403408,24,29,53,50,53,103,4,0.455317,0.467997,0.000004,No
7234,murphy,45,11.28986969,37,7.208880372,7.208520314,1665,81.38731999,24,29,53,39,36,75,4,0.446476,0.460744,0.000004,No
4958,pyramid,68,10.87702447,37,7.208880372,7.208520314,2516,78.41116822,25,28,53,60,58,118,4,0.450019,0.463706,0.000004,No
6667,odin,52,11.14528846,29,7.452502454,7.452222421,1508,83.06028959,25,28,53,44,43,87,4,0.435511,0.451369,0.000004,No
9907,indivisible,3,13.99791989,3,9.721185996,9.721165996,9,136.0763828,2,2,4,2,2,4,5,0.320942,0.324946,0.000053,No
2055,talkie,2,14.403385,2,10.1266511,10.1266411,4,145.8580546,2,2,4,2,2,4,5,0.325074,0.328359,0.000053,No
2351,suffragette,2,14.403385,2,10.1266511,10.1266411,4,145.8580546,2,2,4,2,2,4,5,0.322634,0.326091,0.000053,No
4318,roach,2,14.403385,2,10.1266511,10.1266411,4,145.8580546,2,2,4,2,2,4,5,0.326251,0.330494,0.000053,No
5129,prostaglandin,2,14.403385,2,10.1266511,10.1266411,4,145.8580546,2,2,4,2,2,4,4,0.422432,0.439107,0.000053,No
11077,grin,2,14.403385,2,10.1266511,10.1266411,4,145.8580546,2,2,4,2,2,4,5,0.385615,0.401932,0.000053,No
12953,elegy,2,14.403385,2,10.1266511,10.1266411,4,145.8580546,2,2,4,2,2,4,5,0.3447,0.353282,0.000053,No
14485,copious,2,14.403385,2,10.1266511,10.1266411,4,145.8580546,2,2,4,2,2,4,5,0.322031,0.325386,0.000053,No
15787,calorimeter,2,14.403385,2,10.1266511,10.1266411,4,145.8580546,2,2,4,2,2,4,5,0.354191,0.365413,0.000053,No
17564,apatite,2,14.403385,2,10.1266511,10.1266411,4,145.8580546,2,2,4,2,2,4,5,0.398147,0.415917,0.000053,No
4822,radical,50,11.18450917,41,7.106226218,7.105826145,2050,79.47965231,27,26,53,44,30,74,4,0.412632,0.430337,0.000004,No
1846,territorial,63,10.95339745,58,6.759355274,6.758785123,3654,74.03790482,28,25,53,51,32,83,5,0.387314,0.404223,0.000004,No
8764,leon,64,10.93764909,50,6.907775279,6.907285168,3200,75.55482202,29,24,53,54,31,85,4,0.443022,0.457754,0.000004,No
15401,chamberlain,45,11.28986969,25,7.600922459,7.600682435,1125,85.81342407,17,25,42,29,37,66,4,0.448563,0.462401,0.000005,No
15598,carroll,33,11.60002462,29,7.452502454,7.452222421,957,86.44921192,17,25,42,29,29,58,4,0.43835,0.453754,0.000005,No
14213,crow,32,11.63079627,24,7.641744454,7.641514432,768,88.87957293,13,17,30,25,29,54,4,0.434243,0.450069,0.000007,No
257,wittgenstein,31,11.66254497,13,8.254848927,8.254728922,403,96.27254685,13,17,30,25,24,49,4,0.445994,0.460115,0.000007,No
18160,adler,28,11.76432767,22,7.728755831,7.728545813,616,90.92361605,17,18,35,22,21,43,4,0.452601,0.465556,0.000006,No
11938,folklore,55,11.08919899,45,7.013135794,7.012695706,2475,77.77005838,21,21,42,43,45,88,4,0.461448,0.472626,0.000005,No
13280,drag,37,11.48561426,23,7.684304068,7.684084048,851,88.25895242,21,21,42,27,26,53,4,0.44452,0.458951,0.000005,No
13747,dental,34,11.57017165,23,7.684304068,7.684084048,782,88.9087171,18,17,35,28,23,51,5,0.3988,0.416819,0.000006,No
1657,ticket,84,10.66571538,44,7.03560865,7.035178566,3696,75.03979938,37,33,70,70,61,131,4,0.453584,0.46664,0.000003,No
15836,caiman,14,12.45747485,3,9.721185996,9.721165996,42,121.10143,8,7,15,10,8,18,4,0.415899,0.43321,0.000014,No
9443,jeremy,48,11.22533117,43,7.058598169,7.058178089,2064,79.23510201,24,18,42,32,27,59,4,0.393235,0.410817,0.000005,No
12796,ensemble,23,11.96103796,21,7.775275846,7.77507583,483,93.00036956,10,9,19,20,15,35,4,0.45051,0.463692,0.000011,No
4747,rapt,3,13.99791989,2,10.1266511,10.1266411,6,141.7520509,1,3,4,3,3,6,5,0.362554,0.375485,0.000052,No
11023,guardian,79,10.72708432,64,6.660915201,6.660285015,5056,71.45219904,17,35,52,76,68,144,4,0.444219,0.45896,0.000004,No
1101,ultimate,72,10.81986606,57,6.776747016,6.776186871,4104,73.32349503,23,29,52,65,35,100,5,0.366931,0.381225,0.000004,No
9836,informal,62,10.96939779,50,6.907775279,6.907285168,3100,75.77413489,25,27,52,55,38,93,4,0.427745,0.444444,0.000004,No
7507,moan,2,14.403385,2,10.1266511,10.1266411,4,145.8580546,2,2,4,2,2,4,5,0.299762,0.305637,0.000052,No
10840,hangout,2,14.403385,2,10.1266511,10.1266411,4,145.8580546,2,2,4,2,2,4,5,0.319838,0.323323,0.000052,No
12174,fiend,2,14.403385,2,10.1266511,10.1266411,4,145.8580546,2,2,4,2,2,4,5,0.322769,0.326141,0.000052,No
2813,spiny,35,11.54118412,19,7.875359305,7.875179292,665,90.89097172,13,13,26,19,25,44,5,0.395125,0.412429,0.000008,No
2429,stud,25,11.87765635,8,8.740356743,8.740286741,200,103.8149538,13,13,26,17,16,33,4,0.402499,0.420216,0.000008,No
10730,hayden,23,11.96103796,16,8.047209562,8.047059554,368,96.25297905,14,12,26,17,18,35,4,0.394554,0.411817,0.000008,No
15353,charleston,49,11.20471188,25,7.600922459,7.600682435,1225,85.16614617,28,24,52,44,47,91,4,0.408802,0.426511,0.000004,No
2198,sweat,60,11.00218762,32,7.354062381,7.35375234,1920,80.91077405,29,23,52,50,40,90,4,0.426655,0.443435,0.000004,No
10474,hip,120,10.30904043,82,6.413079037,6.412268725,9840,66.1126911,36,16,52,85,108,193,4,0.437077,0.45251,0.000004,No
7748,merle,4,13.71023782,4,9.433503923,9.433473923,16,129.3355822,3,1,4,3,1,4,6,0.28475,0.29117,0.000052,No
6150,patient,112,10.37803331,76,6.489064944,6.488314678,8512,67.34373211,15,54,69,106,88,194,4,0.452739,0.466331,0.000003,No
13416,dock,20,12.1007999,15,8.111748083,8.111608076,300,98.15864042,8,15,23,17,17,34,4,0.440373,0.455326,0.000009,No
13781,demand,100,10.49136199,61,6.70892442,6.708324252,6100,70.38575466,30,39,69,87,88,175,4,0.466224,0.476659,0.000003,No
15929,burma,83,10.67769157,61,6.70892442,6.708324252,5063,71.63582572,31,38,69,67,70,137,4,0.444753,0.459472,0.000003,No
4435,revolutionary,226,9.675997178,192,5.562302912,5.560391124,43392,53.82082728,32,37,69,80,188,268,5,0.416241,0.433996,0.000003,No
15719,canon,92,10.5747436,52,6.868554566,6.868044446,4784,72.63320344,32,37,69,68,84,152,4,0.459133,0.47111,0.000003,No
8265,magnet,47,11.24638458,28,7.487593774,7.487323743,1316,84.20835913,16,25,41,46,42,88,4,0.44887,0.462645,0.000005,No
237,wonder,50,11.18450917,40,7.13091883,7.130528762,2000,79.75582706,17,24,41,33,43,76,4,0.442216,0.457068,0.000005,No
14320,crab,54,11.10754813,29,7.452502454,7.452222421,1566,82.77902971,17,24,41,48,39,87,4,0.43726,0.452824,0.000005,No
11901,forbes,46,11.26789078,32,7.354062381,7.35375234,1472,82.86477171,19,22,41,42,40,82,4,0.447534,0.461495,0.000005,No
773,viking,51,11.16470654,43,7.058598169,7.058178089,2193,78.80717717,21,20,41,45,31,76,5,0.408492,0.426147,0.000005,No
762,vinegar,38,11.45894602,25,7.600922459,7.600682435,950,87.09856015,21,20,41,31,32,63,4,0.417033,0.434445,0.000005,No
10371,honda,45,11.28986969,18,7.929426526,7.929256515,810,89.52219218,21,20,41,29,28,57,4,0.424178,0.441276,0.000005,No
14532,controlling,37,11.48561426,35,7.264450223,7.264110172,1295,83.4366731,22,19,41,30,29,59,4,0.420401,0.437834,0.000005,No
15576,casey,35,11.54118412,24,7.641744454,7.641514432,840,88.19477971,22,19,41,27,24,51,4,0.422844,0.439858,0.000005,No
10915,hail,36,11.51301324,24,7.641744454,7.641514432,864,87.97950507,23,18,41,33,32,65,4,0.449506,0.463035,0.000005,No
14423,corruption,40,11.40765272,34,7.29343776,7.293107712,1360,83.20100512,24,17,41,36,36,72,4,0.443321,0.457852,0.000005,No
10605,hepatitis,53,11.12624026,19,7.875359305,7.875179292,1007,87.62313979,25,16,41,44,47,91,4,0.445714,0.459838,0.000005,No
15800,caliphate,61,10.98565831,45,7.013135794,7.012695706,2745,77.04391354,13,21,34,33,53,86,4,0.453688,0.466504,0.000006,No
6357,painful,27,11.80069531,26,7.561701746,7.56145172,702,89.23333834,14,20,34,25,22,47,4,0.456841,0.468997,0.000006,No
12139,finance,103,10.46180319,78,6.463089458,6.462319176,8034,67.6155699,29,39,68,86,72,158,4,0.462519,0.473809,0.000003,No
7281,mud,73,10.80607274,43,7.058598169,7.058178089,3139,76.27572522,31,37,68,65,61,126,4,0.452209,0.465598,0.000003,No
6304,panic,66,10.90687744,39,7.156236638,7.155856573,2574,78.05219591,30,21,51,56,53,109,4,0.445066,0.459397,0.000004,No
10069,imaginary,70,10.84803694,49,6.927977986,6.92749788,3430,75.15496108,31,20,51,64,35,99,4,0.424462,0.441318,0.000004,No
4944,q,53,11.12624026,35,7.264450223,7.264110172,1855,80.82601856,31,20,51,38,43,81,4,0.437163,0.452669,0.000004,No
6783,nucleus,146,10.11292556,81,6.42534913,6.424548825,11826,64.97907742,24,43,67,138,122,260,4,0.466273,0.476776,0.000003,No
4018,samurai,78,10.73982335,38,7.182212124,7.181842063,2964,77.13568948,30,37,67,69,53,122,4,0.453734,0.466847,0.000003,No
15295,cheshire,50,11.18450917,44,7.03560865,7.035178566,2200,78.68982948,13,27,40,32,42,74,4,0.448495,0.462354,0.000005,No
17753,amy,41,11.38296011,31,7.38581108,7.385511041,1271,84.07239291,17,23,40,22,28,50,4,0.428685,0.445393,0.000005,No
1219,tulip,20,12.1007999,13,8.254848927,8.254728922,260,99.8902751,9,11,20,13,13,26,4,0.393548,0.410681,0.00001,No
3279,sims,63,10.95339745,15,8.111748083,8.111608076,945,88.85120078,19,21,40,60,46,106,4,0.4386,0.453918,0.000005,No
7474,moist,45,11.28986969,38,7.182212124,7.181842063,1710,81.08623895,20,20,40,33,30,63,4,0.438026,0.453392,0.000005,No
13062,ecosystem,48,11.22533117,27,7.523961418,7.52370139,1296,84.4589586,20,20,40,38,28,66,4,0.448756,0.462453,0.000005,No
14838,comfort,35,11.54118412,28,7.487593774,7.487323743,980,86.41569833,20,20,40,33,31,64,4,0.449916,0.46342,0.000005,No
17250,atoll,39,11.43297053,21,7.775275846,7.77507583,819,88.89449963,9,16,25,30,31,61,4,0.462314,0.473217,0.000008,No
5100,prove,92,10.5747436,81,6.42534913,6.424548825,7452,67.94641959,18,32,50,85,85,170,4,0.438383,0.454035,0.000004,No
8029,marx,68,10.87702447,43,7.058598169,7.058178089,2924,76.77654502,19,31,50,49,43,92,4,0.438166,0.453768,0.000004,No
8563,livestock,49,11.20471188,40,7.13091883,7.130528762,1960,79.89989093,20,30,50,42,40,82,4,0.454909,0.46764,0.000004,No
15765,cameroon,57,11.05348091,38,7.182212124,7.181842063,2166,79.38844461,22,28,50,47,42,89,4,0.455773,0.468298,0.000004,No
1864,terminal,58,11.03608917,49,6.927977986,6.92749788,2842,76.4577828,25,25,50,45,38,83,4,0.460264,0.47179,0.000004,No
8972,lancashire,71,10.8338523,60,6.725453722,6.72486356,4260,72.86257228,26,24,50,56,68,124,4,0.453202,0.466171,0.000004,No
8886,launch,69,10.86242567,53,6.849506371,6.848986246,3657,74.40225385,29,21,50,52,53,105,4,0.455189,0.467687,0.000004,No
8121,mao,51,11.16470654,22,7.728755831,7.728545813,1122,86.28929081,31,19,50,39,27,66,4,0.428696,0.44512,0.000004,No
15263,chili,71,10.8338523,48,6.948597273,6.948127172,3408,75.28007655,18,7,25,67,11,78,4,0.423369,0.440041,0.000008,No
3669,seizure,19,12.1520932,12,8.334891634,8.334781631,228,101.2863799,7,15,22,19,16,35,4,0.442878,0.457462,0.000009,No
4137,russ,9,12.8993076,6,9.028038815,9.027988815,54,116.4554497,4,7,11,6,8,14,5,0.399159,0.416988,0.000018,No
3696,secure,86,10.64218488,72,6.543132165,6.542421927,6192,69.6332222,26,40,66,69,68,137,4,0.432993,0.44936,0.000003,No
8303,madagascar,71,10.8338523,48,6.948597273,6.948127172,3408,75.28007655,27,39,66,68,61,129,4,0.460766,0.472443,0.000003,No
1407,transistor,28,11.76432767,19,7.875359305,7.875179292,532,92.64830736,14,19,33,28,21,49,4,0.448915,0.462608,0.000006,No
17585,antony,53,11.12624026,33,7.323290723,7.322970678,1749,81.4806921,15,18,33,41,36,77,4,0.407479,0.42515,0.000006,No
782,vietnamese,83,10.67769157,52,6.868554566,6.868044446,4316,73.34030718,31,35,66,69,48,117,4,0.440428,0.455758,0.000003,No
10538,hewitt,17,12.26331883,6,9.028038815,9.027988815,102,110.7137184,11,11,22,11,15,26,4,0.402252,0.419718,0.000009,No
5771,pier,34,11.57017165,24,7.641744454,7.641514432,816,88.41629506,17,16,33,27,22,49,4,0.454094,0.46672,0.000006,No
16573,billie,46,11.26789078,35,7.264450223,7.264110172,1610,81.85503169,20,13,33,31,33,64,4,0.409169,0.426859,0.000006,No
6386,ozone,31,11.66254497,10,8.517213191,8.517123189,310,99.33238189,10,8,18,26,14,40,5,0.378874,0.394674,0.000011,No
6076,peck,24,11.91847835,16,8.047209562,8.047059554,384,95.91049292,11,17,28,19,20,39,4,0.431677,0.447782,0.000007,No
11548,garlic,26,11.83843564,22,7.728755831,7.728545813,572,91.49637848,12,16,28,22,21,43,4,0.402462,0.420056,0.000007,No
16975,banjo,34,11.57017165,18,7.929426526,7.929256515,612,91.74482602,14,14,28,23,20,43,4,0.401697,0.419244,0.000007,No
749,virgil,18,12.20616042,15,8.111748083,8.111608076,270,99.01329838,14,14,28,16,15,31,4,0.439403,0.454491,0.000007,No
1251,trumpet,71,10.8338523,42,7.082128666,7.08171859,2982,76.72673594,26,23,49,59,50,109,4,0.42211,0.439248,0.000004,No
763,vine,24,11.91847835,19,7.875359305,7.875179292,456,93.86229935,15,13,28,20,17,37,4,0.444264,0.458674,0.000007,No
9659,introduction,113,10.36914436,107,6.14696945,6.145908909,12091,63.73881359,30,19,49,94,109,203,4,0.427611,0.444214,0.000004,No
17503,approval,54,11.10754813,42,7.082128666,7.08171859,2268,78.66508503,31,18,49,44,41,85,4,0.453653,0.466406,0.000004,No
3948,satire,37,11.48561426,28,7.487593774,7.487323743,1036,85.99961386,12,27,39,24,34,58,4,0.465197,0.475654,0.000005,No
16762,behave,54,11.10754813,52,6.868554566,6.868044446,2808,76.29280043,15,24,39,39,45,84,4,0.444687,0.459129,0.000005,No
7575,minimum,63,10.95339745,46,6.991156888,6.990706795,2898,76.57692003,15,24,39,54,50,104,4,0.42939,0.44597,0.000005,No
7327,moth,55,11.08919899,31,7.38581108,7.385511041,1705,81.90272878,15,24,39,37,40,77,4,0.441732,0.456777,0.000005,No
16279,botanist,42,11.35886256,39,7.156236638,7.155856573,1638,81.28670841,19,20,39,32,30,62,4,0.434265,0.45013,0.000005,No
10776,hartley,49,11.20471188,8,8.740356743,8.740286741,392,97.93317902,30,35,65,38,39,77,5,0.383499,0.400299,0.000003,No
1117,tyrant,14,12.45747485,10,8.517213191,8.517123189,140,106.1029691,7,8,15,14,11,25,4,0.410808,0.428267,0.000013,No
4780,ram,93,10.56393268,64,6.660915201,6.660285015,5952,70.3654598,38,27,65,70,59,129,4,0.46454,0.475156,0.000003,No
11616,gail,13,12.53158282,12,8.334891634,8.334781631,156,104.4493848,9,6,15,9,8,17,5,0.40108,0.418955,0.000013,No
10512,hierarchy,39,11.43297053,35,7.264450223,7.264110172,1365,83.05424532,13,19,32,34,34,68,4,0.453155,0.466016,0.000006,No
7599,milwaukee,49,11.20471188,29,7.452502454,7.452222421,1421,83.50314278,14,18,32,43,36,79,4,0.429245,0.445637,0.000006,No
16214,brahms,35,11.54118412,32,7.354062381,7.35375234,1120,84.87458794,14,18,32,31,32,63,4,0.433141,0.449111,0.000006,No
7723,metabolism,43,11.33533206,35,7.264450223,7.264110172,1505,82.34495552,21,27,48,37,37,74,4,0.455691,0.468222,0.000004,No
5978,perch,20,12.1007999,15,8.111748083,8.111608076,300,98.15864042,15,17,32,18,19,37,5,0.386783,0.403751,0.000006,No
7129,nash,69,10.86242567,32,7.354062381,7.35375234,2208,79.88295601,30,34,64,53,61,114,5,0.40704,0.424973,0.000003,No
14643,connect,143,10.13368755,126,5.983516377,5.98226562,18018,60.6350854,31,33,64,116,120,236,4,0.453978,0.466936,0.000003,No
3667,select,57,11.05348091,51,6.887972651,6.887472536,2907,76.13607421,24,24,48,51,40,91,4,0.44352,0.458171,0.000004,No
1591,tobacco,80,10.71450554,43,7.058598169,7.058178089,3440,75.6293892,33,31,64,65,55,120,4,0.441359,0.456467,0.000003,No
16941,barium,26,11.83843564,5,9.210360372,9.210320372,130,109.0362585,17,15,32,19,21,40,4,0.393452,0.410667,0.000006,No
3630,sensitive,61,10.98565831,52,6.868554566,6.868044446,3172,75.45559356,28,20,48,54,50,104,4,0.448529,0.46227,0.000004,No
16653,bert,19,12.1520932,13,8.254848927,8.254728922,247,100.3136935,10,6,16,14,10,24,5,0.339726,0.346736,0.000012,No
3014,sole,54,11.10754813,52,6.868554566,6.868044446,2808,76.29280043,11,27,38,43,38,81,4,0.439817,0.455204,0.000005,No
11817,fraction,50,11.18450917,33,7.323290723,7.322970678,1650,81.90741226,18,20,38,47,40,87,4,0.438827,0.454162,0.000005,No
9560,isabel,33,11.60002462,24,7.641744454,7.641514432,792,88.64442377,18,20,38,24,24,48,5,0.408473,0.426241,0.000005,No
6781,nude,40,11.40765272,20,7.824066011,7.823875996,800,89.25422793,19,19,38,30,32,62,4,0.410096,0.427685,0.000005,No
2806,spit,29,11.72923635,22,7.728755831,7.728545813,638,90.65240381,20,18,38,23,26,49,4,0.44785,0.461688,0.000005,No
4502,resistant,54,11.10754813,45,7.013135794,7.012695706,2430,77.89874338,23,15,38,50,47,97,4,0.434733,0.450435,0.000005,No
17207,audrey,14,12.45747485,12,8.334891634,8.334781631,168,103.8317029,7,3,10,9,10,19,5,0.304555,0.309962,0.000019,No
3468,shepherd,69,10.86242567,46,6.991156888,6.990706795,3174,75.94092206,24,39,63,62,51,113,4,0.428344,0.445252,0.000003,No
7436,mongolia,98,10.5115647,65,6.645411014,6.644770822,6370,69.85366783,25,38,63,68,75,143,4,0.449654,0.463514,0.000003,No
14065,cyprus,77,10.75272676,55,6.812465099,6.811924964,4235,73.25257574,25,38,63,66,62,128,4,0.436496,0.452397,0.000003,No
11666,fundamental,99,10.50141233,85,6.377147028,6.376306692,8415,66.96905041,33,30,63,94,40,134,4,0.406937,0.424962,0.000003,No
11740,fricative,2,14.403385,2,10.1266511,10.1266411,4,145.8580546,2,1,3,2,1,3,5,0.384237,0.400402,0.000063,No
10660,heidelberg,52,11.14528846,39,7.156236638,7.155856573,2028,79.75832161,19,28,47,44,41,85,4,0.442657,0.457533,0.000004,No
16917,barrel,60,11.00218762,36,7.236279346,7.235929291,2160,79.614903,21,26,47,53,46,99,4,0.463013,0.473955,0.000004,No
6593,omega,44,11.31234254,16,8.047209562,8.047059554,704,91.03279108,24,23,47,34,30,64,4,0.43781,0.453378,0.000004,No
8944,lantern,15,12.38848198,10,8.517213191,8.517123189,150,105.5153421,9,8,17,15,10,25,4,0.417327,0.434483,0.000011,No
11085,griffin,25,11.87765635,17,7.98658494,7.986424931,425,94.86191135,13,18,31,19,21,40,4,0.441787,0.456571,0.000006,No
9558,isaiah,30,11.6953348,16,8.047209562,8.047059554,480,94.11481,14,17,31,21,20,41,4,0.427004,0.443679,0.000006,No
15092,clare,59,11.01899473,28,7.487593774,7.487323743,1652,82.50575636,30,32,62,55,52,107,4,0.454711,0.467518,0.000003,No
16923,baroque,127,10.25234509,87,6.353890166,6.353029813,11049,65.14227465,31,31,62,116,97,213,4,0.405746,0.423652,0.000003,No
8247,maid,32,11.63079627,28,7.487593774,7.487323743,896,87.08667777,16,15,31,30,26,56,4,0.445803,0.459927,0.000006,No
5555,polar,100,10.49136199,62,6.692663899,6.692053725,6200,70.21515965,36,26,62,85,53,138,4,0.413757,0.431464,0.000003,No
6894,nobel,333,9.288389687,229,5.386076281,5.383793723,76257,50.02797538,37,25,62,307,305,612,4,0.417641,0.435173,0.000003,No
5247,probe,57,11.05348091,41,7.106226218,7.105826145,2337,78.54853583,11,26,37,40,40,80,4,0.443786,0.45842,0.000005,No
7643,midwest,38,11.45894602,25,7.600922459,7.600682435,950,87.09856015,13,24,37,32,35,67,4,0.427117,0.443867,0.000005,No
11522,gather,45,11.28986969,44,7.03560865,7.035178566,1980,79.43110483,15,22,37,36,39,75,4,0.438838,0.454158,0.000005,No
1279,trojan,104,10.45214128,61,6.70892442,6.708324252,6344,70.12262586,17,20,37,98,88,186,4,0.409916,0.427567,0.000005,No
16755,beirut,44,11.31234254,25,7.600922459,7.600682435,1100,85.98423851,17,20,37,39,36,75,4,0.447061,0.461026,0.000005,No
8522,lodge,34,11.57017165,26,7.561701746,7.56145172,884,87.49018719,17,20,37,26,31,57,4,0.453236,0.466105,0.000005,No
9838,info,53,11.12624026,46,6.991156888,6.990706795,2438,77.78529125,22,15,37,34,43,77,4,0.443221,0.457843,0.000005,No
12444,exposure,38,11.45894602,31,7.38581108,7.385511041,1178,84.63361046,22,15,37,25,33,58,4,0.431059,0.4472,0.000005,No
16376,bohr,21,12.05200974,11,8.421903011,8.421803008,231,101.5008571,8,15,23,9,18,27,5,0.389712,0.406641,0.000008,No
1709,threat,89,10.60789581,76,6.489064944,6.488314678,6764,68.83532481,20,26,46,84,80,164,4,0.436153,0.451928,0.000004,No
8880,lauren,19,12.1520932,15,8.111748083,8.111608076,285,98.57471871,15,8,23,17,9,26,5,0.377015,0.393564,0.000008,No
1357,treasure,80,10.71450554,48,6.948597273,6.948127172,3840,74.450784,32,29,61,55,72,127,4,0.462049,0.473269,0.000003,No
9760,insignia,27,11.80069531,11,8.421903011,8.421803008,297,99.38431138,12,14,26,23,22,45,4,0.435351,0.450965,0.000007,No
13560,digit,29,11.72923635,21,7.775275846,7.77507583,609,91.19804807,13,13,26,28,21,49,4,0.449848,0.463227,0.000007,No
12111,fireplace,11,12.6986369,8,8.740356743,8.740286741,88,110.9906167,6,8,14,10,10,20,4,0.433131,0.448918,0.000013,No
17814,ambiguity,10,12.79394708,7,8.873888135,8.873828135,70,113.5320552,7,7,14,8,9,17,4,0.43015,0.44635,0.000013,No
241,womb,35,11.54118412,26,7.561701746,7.56145172,910,87.27099208,8,22,30,32,34,66,4,0.459537,0.471175,0.000006,No
10632,helmet,40,11.40765272,34,7.29343776,7.293107712,1360,83.20100512,12,24,36,28,34,62,4,0.440406,0.455524,0.000005,No
6339,palestine,75,10.77904406,57,6.776747016,6.776186871,4275,73.0468547,23,37,60,72,60,132,4,0.443553,0.458439,0.000003,No
10583,heresy,33,11.60002462,28,7.487593774,7.487323743,924,86.85627209,12,18,30,27,24,51,4,0.439479,0.454613,0.000006,No
7713,metamorphosis,27,11.80069531,20,7.824066011,7.823875996,540,92.32941909,13,17,30,19,21,40,4,0.421419,0.438492,0.000006,No
1308,trilogy,101,10.48141166,82,6.413079037,6.412268725,8282,67.2181214,26,34,60,68,86,154,4,0.463267,0.474297,0.000003,No
17110,axe,29,11.72923635,22,7.728755831,7.728545813,638,90.65240381,16,20,36,28,25,53,4,0.440013,0.455106,0.000005,No
16939,barley,36,11.51301324,26,7.561701746,7.56145172,936,87.05797231,14,16,30,28,31,59,4,0.407012,0.424633,0.000006,No
8867,lawn,27,11.80069531,21,7.775275846,7.77507583,567,91.75366123,14,16,30,24,21,45,4,0.403762,0.42153,0.000006,No
7547,mirage,18,12.20616042,10,8.517213191,8.517123189,180,103.9624705,10,10,20,14,15,29,4,0.42642,0.442905,0.000009,No
7256,multiplication,42,11.35886256,32,7.354062381,7.35375234,1344,83.53378384,19,17,36,31,37,68,4,0.446128,0.460228,0.000005,No
17955,alec,20,12.1007999,17,7.98658494,7.986424931,340,96.64406628,11,9,20,13,14,27,5,0.333496,0.3389,0.000009,No
14897,collagen,9,12.8993076,4,9.433503923,9.433473923,36,121.6856688,5,4,9,8,4,12,5,0.350015,0.360121,0.00002,No
4085,sage,33,11.60002462,20,7.824066011,7.823875996,660,90.75935832,20,16,36,28,21,49,4,0.436185,0.451726,0.000005,No
9235,kay,23,11.96103796,18,7.929426526,7.929256515,414,94.84417169,17,13,30,19,16,35,4,0.405848,0.423507,0.000006,No
16449,blonde,26,11.83843564,20,7.824066011,7.823875996,520,92.62470191,21,15,36,24,24,48,4,0.410049,0.427638,0.000005,No
9498,jacqueline,24,11.91847835,21,7.775275846,7.77507583,504,92.66945682,18,12,30,19,16,35,5,0.328473,0.33256,0.000006,No
2038,tampa,80,10.71450554,49,6.927977986,6.92749788,3920,74.22985853,19,11,30,62,79,141,4,0.41095,0.428431,0.000006,No
2909,soy,41,11.38296011,21,7.775275846,7.77507583,861,88.50565481,19,11,30,26,34,60,5,0.384754,0.401162,0.000006,No
7676,michel,39,11.43297053,33,7.323290723,7.322970678,1287,83.72696702,24,12,36,33,16,49,4,0.453619,0.46626,0.000005,No
959,valid,42,11.35886256,39,7.156236638,7.155856573,1638,81.28670841,16,29,45,35,37,72,4,0.450888,0.464373,0.000004,No
7774,mention,68,10.87702447,65,6.645411014,6.644770822,4420,72.28229823,18,27,45,46,67,113,4,0.457323,0.469499,0.000004,No
9709,intense,52,11.14528846,49,6.927977986,6.92749788,2548,77.21431309,19,26,45,48,33,81,4,0.440264,0.455449,0.000004,No
1111,uganda,41,11.38296011,21,7.775275846,7.77507583,861,88.50565481,21,24,45,36,36,72,4,0.439926,0.455111,0.000004,No
11294,gm,36,11.51301324,23,7.684304068,7.684084048,828,88.46949447,23,22,45,30,29,59,4,0.444286,0.458772,0.000004,No
13126,dynamic,45,11.28986969,33,7.323290723,7.322970678,1485,82.67899794,26,19,45,40,32,72,5,0.363006,0.376595,0.000004,No
16940,bark,75,10.77904406,48,6.948597273,6.948127172,3600,74.89923619,21,38,59,59,57,116,4,0.460359,0.472086,0.000003,No
3239,sit,92,10.5747436,78,6.463089458,6.462319176,7176,68.34551388,27,32,59,80,84,164,4,0.457854,0.470039,0.000003,No
6910,nirvana,76,10.76579884,38,7.182212124,7.181842063,2888,77.32225094,30,29,59,59,55,114,4,0.449131,0.462918,0.000003,No
16681,berg,53,11.12624026,28,7.487593774,7.487323743,1484,83.30876733,13,31,44,26,41,67,4,0.440275,0.455524,0.000004,No
12689,erosion,49,11.20471188,37,7.208880372,7.208520314,1813,80.77342754,19,25,44,43,43,86,4,0.460467,0.471912,0.000004,No
16323,boom,44,11.31234254,28,7.487593774,7.487323743,1232,84.7022256,19,25,44,38,40,78,4,0.431824,0.448153,0.000004,No
11786,fraser,44,11.31234254,23,7.684304068,7.684084048,1012,86.92747983,19,25,44,38,35,73,4,0.420799,0.438097,0.000004,No
5772,piedmont,51,11.16470654,39,7.156236638,7.155856573,1989,79.89728203,20,24,44,45,46,91,4,0.435372,0.451158,0.000004,No
11013,guidance,22,12.00548972,21,7.775275846,7.77507583,462,93.34599428,11,11,22,21,17,38,4,0.421339,0.438327,0.000008,No
16934,barnes,33,11.60002462,26,7.561701746,7.56145172,858,87.71592639,24,20,44,28,31,59,4,0.412162,0.429722,0.000004,No
13992,dante,52,11.14528846,37,7.208880372,7.208520314,1924,80.34505121,25,19,44,41,24,65,4,0.406434,0.424093,0.000004,No
13030,edwin,38,11.45894602,34,7.29343776,7.293107712,1292,83.57510957,25,19,44,30,24,54,4,0.422784,0.439891,0.000004,No
1098,ulysses,45,11.28986969,26,7.561701746,7.56145172,1170,85.37062733,27,17,44,39,42,81,4,0.451381,0.464528,0.000004,No
1405,transition,66,10.90687744,56,6.794446593,6.793896453,3696,74.10619624,15,20,35,58,41,99,4,0.450464,0.463932,0.000005,No
3999,sandstone,37,11.48561426,27,7.523961418,7.52370139,999,86.41731859,18,17,35,32,25,57,4,0.442536,0.457162,0.000005,No
2715,sri,114,10.36033373,84,6.388981485,6.388151157,9576,66.19198038,33,2,35,98,83,181,5,0.345666,0.354573,0.000005,No
5601,plug,22,12.00548972,14,8.180740955,8.180610949,308,98.21380147,13,12,25,18,20,38,4,0.437745,0.453026,0.000007,No
6916,ninth,98,10.5115647,93,6.287198791,6.286278386,9114,66.08829687,12,46,58,93,75,168,5,0.417033,0.434916,0.000003,No
5386,pouch,37,11.48561426,19,7.875359305,7.875179292,703,90.45333917,9,20,29,36,33,69,4,0.457559,0.46956,0.000006,No
12456,explode,26,11.83843564,24,7.641744454,7.641514432,624,90.46629989,11,18,29,25,23,48,4,0.447388,0.461265,0.000006,No
5450,portal,69,10.86242567,60,6.725453722,6.72486356,4140,73.05474117,26,32,58,46,55,101,4,0.463582,0.47449,0.000003,No
1854,terrain,35,11.54118412,29,7.452502454,7.452222421,1015,86.01070295,14,15,29,25,28,53,4,0.456453,0.468589,0.000006,No
18295,abundant,29,11.72923635,27,7.523961418,7.52370139,783,88.25032174,14,15,29,28,23,51,5,0.399941,0.417448,0.000006,No
6465,orthodoxy,30,11.6953348,22,7.728755831,7.728545813,660,90.390387,14,15,29,26,21,47,4,0.447794,0.461566,0.000006,No
15916,burst,25,11.87765635,13,8.254848927,8.254728922,325,98.04825879,14,15,29,19,19,38,4,0.428644,0.44513,0.000006,No
8207,mali,77,10.75272676,46,6.991156888,6.990706795,3542,75.17399972,28,30,58,71,60,131,4,0.454711,0.467485,0.000003,No
16704,benefit,59,11.01899473,52,6.868554566,6.868044446,3068,75.68456659,32,26,58,53,49,102,4,0.449472,0.463148,0.000003,No
4994,purchase,53,11.12624026,48,6.948597273,6.948127172,2544,77.31176276,17,26,43,48,47,95,4,0.447489,0.461519,0.000004,No
12262,feces,40,11.40765272,22,7.728755831,7.728545813,880,88.1669625,22,21,43,32,28,60,4,0.458362,0.470222,0.000004,No
12713,erasmus,46,11.26789078,14,8.180740955,8.180610949,644,92.17969558,25,18,43,30,35,65,4,0.437206,0.452651,0.000004,No
8038,martinez,12,12.61162553,9,8.622573707,8.622493705,108,108.7446707,9,10,19,11,10,21,4,0.370801,0.385401,0.000009,No
17198,augustine,64,10.93764909,37,7.208880372,7.208520314,2368,78.84820386,32,25,57,49,46,95,4,0.421239,0.438449,0.000003,No
14341,covenant,22,12.00548972,17,7.98658494,7.986424931,374,95.88286343,5,12,17,15,18,33,4,0.44642,0.460364,0.00001,No
3440,shire,50,11.18450917,38,7.182212124,7.181842063,1900,80.32951738,16,18,34,32,45,77,4,0.444475,0.458852,0.000005,No
12029,fleming,36,11.51301324,20,7.824066011,7.823875996,720,90.07857556,17,17,34,28,24,52,4,0.445669,0.459838,0.000005,No
1734,thomson,24,11.91847835,22,7.728755831,7.728545813,528,92.11500902,19,15,34,22,18,40,4,0.430902,0.447055,0.000005,No
10008,improve,150,10.08589688,138,5.892544599,5.891173687,20700,59.43159721,14,42,56,145,125,270,4,0.432382,0.449008,0.000003,No
2707,stack,26,11.83843564,14,8.180740955,8.180610949,364,96.84717527,11,17,28,26,24,50,4,0.449962,0.463425,0.000006,No
15308,chemist,72,10.81986606,68,6.600290579,6.599620368,4896,71.41426001,24,32,56,62,55,117,4,0.430192,0.446745,0.000003,No
2333,sullivan,51,11.16470654,34,7.29343776,7.293107712,1734,81.42909229,24,32,56,45,43,88,4,0.4364,0.452223,0.000003,No
12022,flexible,62,10.96939779,61,6.70892442,6.708324252,3782,73.59286072,25,31,56,53,45,98,4,0.408717,0.426558,0.000003,No
8678,lifestyle,55,11.08919899,49,6.927977986,6.92749788,2695,76.8257265,25,31,56,45,45,90,4,0.454455,0.467307,0.000003,No
2372,successor,104,10.45214128,97,6.245087306,6.244126864,10088,65.27453481,26,30,56,89,90,179,4,0.445278,0.45981,0.000003,No
12364,fairfax,25,11.87765635,18,7.929426526,7.929256515,450,94.18300335,14,14,28,19,23,42,4,0.412382,0.42984,0.000006,No
16819,beatrice,34,11.57017165,24,7.641744454,7.641514432,816,88.41629506,16,12,28,25,17,42,4,0.435565,0.45113,0.000006,No
17562,aperture,28,11.76432767,12,8.334891634,8.334781631,336,98.05439626,5,16,21,22,27,49,4,0.459264,0.470837,0.000008,No
8316,macintosh,36,11.51301324,27,7.523961418,7.52370139,972,86.62346742,8,16,24,24,22,46,4,0.440767,0.455688,0.000007,No
8548,loan,60,11.00218762,38,7.182212124,7.181842063,2280,79.02004529,15,27,42,55,45,100,4,0.462639,0.473678,0.000004,No
4088,saffron,23,11.96103796,6,9.028038815,9.027988815,138,107.984715,9,12,21,16,19,35,4,0.402252,0.419718,0.000008,No
17134,avignon,39,11.43297053,23,7.684304068,7.684084048,897,87.85442197,19,23,42,33,35,68,4,0.451174,0.464504,0.000004,No
2520,stony,19,12.1520932,16,8.047209562,8.047059554,304,97.79044058,10,11,21,13,12,25,5,0.395301,0.412547,0.000008,No
17504,appropriate,46,11.26789078,44,7.03560865,7.035178566,2024,79.27646985,20,22,42,42,35,77,4,0.395839,0.413446,0.000004,No
18314,abroad,45,11.28986969,44,7.03560865,7.035178566,1980,79.43110483,20,22,42,30,35,65,4,0.442304,0.457101,0.000004,No
1622,tina,21,12.05200974,15,8.111748083,8.111608076,315,97.7628669,11,10,21,17,11,28,5,0.38739,0.404054,0.000008,No
10122,icy,19,12.1520932,18,7.929426526,7.929256515,342,96.35913016,13,11,24,19,12,31,4,0.431436,0.44744,0.000007,No
8286,mae,23,11.96103796,19,7.875359305,7.875179292,437,94.19747161,15,9,24,16,12,28,5,0.38472,0.401068,0.000007,No
9,zoology,30,11.6953348,27,7.523961418,7.52370139,810,87.99524778,12,21,33,27,25,52,4,0.458185,0.470044,0.000005,No
2402,styx,29,11.72923635,16,8.047209562,8.047059554,464,94.38762289,16,17,33,23,24,47,4,0.435746,0.451331,0.000005,No
4328,rivalry,43,11.33533206,38,7.182212124,7.181842063,1634,81.41275937,19,14,33,37,41,78,4,0.439729,0.454819,0.000005,No
11375,ginger,34,11.57017165,21,7.775275846,7.77507583,714,89.96127619,19,14,33,26,27,53,4,0.397621,0.415009,0.000005,No
5101,proust,9,12.8993076,3,9.721185996,9.721165996,27,125.3965684,6,9,15,9,9,18,4,0.410779,0.428314,0.000011,No
9514,jackal,12,12.61162553,5,9.210360372,9.210320372,60,116.157616,7,8,15,10,12,22,4,0.430077,0.446341,0.000011,No
11410,ghana,62,10.96939779,42,7.082128666,7.08171859,2604,77.68668655,29,26,55,49,43,92,4,0.448552,0.462392,0.000003,No
1813,thallium,15,12.38848198,2,10.1266511,10.1266411,30,125.4538347,10,5,15,11,14,25,4,0.390699,0.407545,0.000011,No
13676,detail,54,11.10754813,54,6.830814238,6.830284108,2916,75.87359792,17,24,41,52,48,100,4,0.45987,0.471457,0.000004,No
3112,smash,90,10.59672251,37,7.208880372,7.208520314,3330,76.39050488,18,23,41,89,78,167,4,0.401615,0.419282,0.000004,No
1018,urine,50,11.18450917,33,7.323290723,7.322970678,1650,81.90741226,20,21,41,41,39,80,4,0.462772,0.473682,0.000004,No
7618,militia,37,11.48561426,34,7.29343776,7.293107712,1258,83.76961277,21,20,41,30,27,57,4,0.439599,0.454768,0.000004,No
14910,coke,33,11.60002462,16,8.047209562,8.047059554,528,93.34782901,21,20,41,28,30,58,4,0.448439,0.462176,0.000004,No
12973,elect,53,11.12624026,47,6.969650683,6.969190586,2491,77.54600805,22,19,41,46,39,85,4,0.4361,0.451857,0.000004,No
16888,basilica,99,10.50141233,69,6.58569178,6.585011562,6831,69.15906484,18,36,54,80,86,166,4,0.462362,0.473649,0.000003,No
12210,ferry,76,10.76579884,58,6.759355274,6.758785123,4408,72.76985914,25,29,54,53,52,105,4,0.431488,0.447951,0.000003,No
15492,cbs,92,10.5747436,67,6.615105665,6.61444546,6164,69.95304629,27,27,54,71,55,126,4,0.449347,0.463068,0.000003,No
16496,blake,52,11.14528846,33,7.323290723,7.322970678,1716,81.62018757,27,27,54,40,36,76,4,0.408764,0.426539,0.000003,No
15364,characteristic,69,10.86242567,67,6.615105665,6.61444546,4623,71.8560936,28,26,54,55,59,114,4,0.42552,0.442468,0.000003,No
16434,blow,62,10.96939779,56,6.794446593,6.793896453,3472,74.53098746,28,26,54,55,58,113,4,0.458386,0.47033,0.000003,No
6602,olivier,27,11.80069531,19,7.875359305,7.875179292,513,92.93471563,15,12,27,15,15,30,5,0.410665,0.42817,0.000006,No
17978,alberta,89,10.60789581,64,6.660915201,6.660285015,5696,70.65829443,30,24,54,84,78,162,4,0.449575,0.463195,0.000003,No
4281,rodgers,21,12.05200974,15,8.111748083,8.111608076,315,97.7628669,10,13,23,20,19,39,4,0.431698,0.447707,0.000007,No
11697,fructose,18,12.20616042,12,8.334891634,8.334781631,216,101.7370244,11,12,23,16,14,30,5,0.363504,0.376715,0.000007,No
17349,asbestos,25,11.87765635,9,8.622573707,8.622493705,225,102.4159674,12,11,23,16,13,29,4,0.422251,0.439083,0.000007,No
10093,igor,33,11.60002462,31,7.38581108,7.385511041,1023,85.67559033,18,5,23,27,5,32,5,0.39613,0.413298,0.000007,No
8882,laureate,39,11.43297053,28,7.487593774,7.487323743,1092,85.60543897,9,23,32,36,35,71,4,0.41552,0.433121,0.000005,No
3789,scout,41,11.38296011,29,7.452502454,7.452222421,1189,84.83153816,14,18,32,29,24,53,4,0.440253,0.455289,0.000005,No
12173,fierce,33,11.60002462,30,7.418600903,7.418310866,990,86.05595308,15,17,32,24,23,47,4,0.43235,0.448378,0.000005,No
8707,liberia,34,11.57017165,22,7.728755831,7.728545813,748,89.42303163,16,16,32,26,28,54,4,0.43312,0.449031,0.000005,No
17893,alley,27,11.80069531,21,7.775275846,7.77507583,567,91.75366123,16,16,32,20,18,38,4,0.413439,0.430919,0.000005,No
11404,giacomo,15,12.38848198,11,8.421903011,8.421803008,165,104.3345937,9,7,16,11,10,21,5,0.360998,0.373793,0.00001,No
3284,simplicity,14,12.45747485,14,8.180740955,8.180610949,196,101.9113747,10,6,16,13,11,24,4,0.414607,0.431849,0.00001,No
8574,lithuania,139,10.16205824,108,6.137667057,6.136596506,15012,62.37133012,30,50,80,126,108,234,4,0.458516,0.470898,0.000002,No
14258,crete,42,11.35886256,34,7.29343776,7.293107712,1428,82.84515709,16,24,40,40,34,74,4,0.442525,0.457336,0.000004,No
14888,collector,42,11.35886256,33,7.323290723,7.322970678,1386,83.1842528,21,19,40,39,31,70,4,0.447005,0.460998,0.000004,No
14741,compulsory,17,12.26331883,13,8.254848927,8.254728922,221,101.2318443,11,9,20,13,9,22,4,0.407498,0.424981,0.000008,No
12530,excessive,17,12.26331883,16,8.047209562,8.047059554,272,98.68549658,12,8,20,13,9,22,5,0.384679,0.401031,0.000008,No
6388,oyster,15,12.38848198,11,8.421903011,8.421803008,165,104.3345937,12,8,20,14,11,25,5,0.333797,0.339117,0.000008,No
3472,shelter,59,11.01899473,46,6.991156888,6.990706795,2714,77.03552093,26,27,53,51,48,99,4,0.458682,0.470584,0.000003,No
9220,kelsey,4,13.71023782,3,9.721185996,9.721165996,12,133.2797719,2,1,3,2,1,3,5,0.398076,0.415824,0.000053,No
2724,squeaky,3,13.99791989,3,9.721185996,9.721165996,9,136.0763828,2,1,3,2,1,3,5,0.313627,0.317881,0.000053,No
2201,sway,2,14.403385,2,10.1266511,10.1266411,4,145.8580546,2,1,3,2,1,3,5,0.326425,0.330118,0.000053,No
4575,relish,2,14.403385,2,10.1266511,10.1266411,4,145.8580546,2,1,3,2,1,3,6,0.262519,0.267015,0.000053,No
5429,posse,2,14.403385,2,10.1266511,10.1266411,4,145.8580546,2,1,3,2,1,3,5,0.360837,0.373492,0.000053,No
12272,feasible,2,14.403385,2,10.1266511,10.1266411,4,145.8580546,2,1,3,2,1,3,5,0.320149,0.323741,0.000053,No
5719,pipette,3,13.99791989,1,10.81979828,10.81979828,3,151.4546696,2,1,3,3,2,5,5,0.345599,0.354479,0.000053,No
6480,orleans,117,10.33435824,81,6.42534913,6.424548825,9477,66.40185974,7,45,52,115,91,206,4,0.461677,0.473274,0.000003,No
4129,rutabaga,2,14.403385,1,10.81979828,10.81979828,2,155.8417203,1,2,3,1,2,3,6,0.264313,0.269,0.000052,No
6695,occur,197,9.813328449,179,5.632412478,5.630630928,35263,55.27271361,29,49,78,153,171,324,4,0.452036,0.465687,0.000002,No
10369,honduras,41,11.38296011,30,7.418600903,7.418310866,1230,84.44563815,16,23,39,35,34,69,4,0.4513,0.464579,0.000004,No
13812,delhi,85,10.65388092,60,6.725453722,6.72486356,5100,71.65218309,22,30,52,70,62,132,4,0.417946,0.435454,0.000003,No
5697,pituitary,24,11.91847835,6,9.028038815,9.027988815,144,107.6004851,6,7,13,24,21,45,4,0.393034,0.410061,0.000012,No
3345,siegfried,24,11.91847835,11,8.421903011,8.421803008,264,100.3762687,12,14,26,18,17,35,4,0.428986,0.445313,0.000006,No
11698,frozen,47,11.24638458,37,7.208880372,7.208520314,1739,81.07384102,25,27,52,39,34,73,4,0.438556,0.453974,0.000003,No
14316,craft,39,11.43297053,36,7.236279346,7.235929291,1404,82.73216852,19,20,39,35,27,62,4,0.430557,0.446904,0.000004,No
491,webster,33,11.60002462,26,7.561701746,7.56145172,858,87.71592639,19,20,39,29,25,54,4,0.421539,0.438712,0.000004,No
15176,chrysler,35,11.54118412,16,8.047209562,8.047059554,560,92.87432717,13,13,26,28,16,44,4,0.430463,0.446618,0.000006,No
8128,manual,49,11.20471188,46,6.991156888,6.990706795,2254,78.33389863,20,19,39,29,35,64,4,0.415335,0.432821,0.000004,No
5028,pulp,42,11.35886256,32,7.354062381,7.35375234,1344,83.53378384,20,19,39,32,39,71,4,0.440625,0.455618,0.000004,No
7287,mt,39,11.43297053,30,7.418600903,7.418310866,1170,84.8166455,14,12,26,32,18,50,4,0.425929,0.44251,0.000006,No
10357,honolulu,37,11.48561426,22,7.728755831,7.728545813,814,88.76950822,14,12,26,32,27,59,4,0.444575,0.458819,0.000006,No
4280,rodney,26,11.80069531,20,7.824066011,7.823875996,520,92.32941909,14,12,26,19,15,34,4,0.408463,0.426084,0.000006,No
493,webb,19,12.1520932,17,7.98658494,7.986424931,323,97.05372453,14,12,26,16,15,31,4,0.426502,0.443031,0.000006,No
3348,sidney,37,11.48561426,31,7.38581108,7.385511041,1147,84.83057709,22,17,39,24,22,46,5,0.358512,0.370715,0.000004,No
9168,kiddie,3,13.99791989,3,9.721185996,9.721165996,9,136.0763828,2,1,3,2,1,3,1,1,1,0.000052,No
12214,ferric,2,14.403385,2,10.1266511,10.1266411,4,145.8580546,2,1,3,2,1,3,6,0.24252,0.244002,0.000052,No
3720,seaweed,23,11.96103796,17,7.98658494,7.986424931,391,95.52784565,13,18,31,19,18,37,4,0.451277,0.464457,0.000005,No
9993,inactive,28,11.76432767,24,7.641744454,7.641514432,672,89.8999857,14,17,31,26,24,50,4,0.420849,0.437966,0.000005,No
14904,coleman,23,11.96103796,17,7.98658494,7.986424931,391,95.52784565,15,16,31,15,19,34,4,0.436894,0.452341,0.000005,No
12363,fairfield,25,11.87765635,14,8.180740955,8.180610949,350,97.16802977,16,15,31,20,24,44,5,0.372881,0.3879,0.000005,No
17055,bacterial,39,11.43297053,32,7.354062381,7.35375234,1248,84.07877849,20,11,31,32,16,48,5,0.395222,0.412495,0.000005,No
5153,proposal,28,11.76432767,27,7.523961418,7.52370139,756,88.51434748,7,15,22,23,26,49,4,0.440537,0.455495,0.000007,No
3425,shoot,113,10.36914436,94,6.276503502,6.275573088,10622,65.08197088,29,48,77,99,86,185,4,0.459109,0.471358,0.000002,No
16938,barlow,14,12.45747485,10,8.517213191,8.517123189,140,106.1029691,11,11,22,13,12,25,4,0.432255,0.448177,0.000007,No
129,yacht,8,13.01709064,7,8.873888135,8.873828135,56,115.5122061,6,5,11,8,5,13,4,0.399977,0.417296,0.000014,No
4807,rafael,36,11.51301324,34,7.29343776,7.293107712,1224,83.96944548,13,9,22,21,10,31,5,0.410675,0.428396,0.000007,No
4383,rico,121,10.30074163,76,6.489064944,6.488314678,9196,66.84218142,3,48,51,120,94,214,4,0.453584,0.466922,0.000003,No
999,ussr,79,10.72708432,57,6.776747016,6.776186871,4503,72.69473669,12,39,51,77,60,137,4,0.446386,0.460857,0.000003,No
2685,stalk,11,12.6986369,10,8.517213191,8.517123189,110,108.1569978,6,11,17,9,11,20,4,0.455855,0.468044,0.000009,No
9288,justinian,25,11.87765635,15,8.111748083,8.111608076,375,96.34855615,9,8,17,21,20,41,4,0.427828,0.444153,0.000009,No
3334,sigma,17,12.26331883,14,8.180740955,8.180610949,238,100.3230346,9,8,17,9,9,18,4,0.428437,0.444712,0.000009,No
8002,masterpiece,15,12.38848198,15,8.111748083,8.111608076,225,100.4922449,9,8,17,14,11,25,5,0.406527,0.423997,0.000009,No
4998,puppet,62,10.96939779,39,7.156236638,7.155856573,2418,78.49960638,28,23,51,52,45,97,4,0.454944,0.467532,0.000003,No
13174,duncan,49,11.20471188,38,7.182212124,7.181842063,1862,80.47461751,28,23,51,36,35,71,4,0.398031,0.415624,0.000003,No
14632,conrad,56,11.07118049,46,6.991156888,6.990706795,2576,77.40035971,30,21,51,43,41,84,4,0.441721,0.456594,0.000003,No
1574,toilet,51,11.16470654,29,7.452502454,7.452222421,1479,83.20500292,16,22,38,46,42,88,4,0.452866,0.465828,0.000004,No
7807,melt,34,11.57017165,29,7.452502454,7.452222421,986,86.22673264,16,22,38,32,31,63,4,0.456371,0.468664,0.000004,No
6177,paste,40,11.40765272,21,7.775275846,7.77507583,840,88.69764668,17,21,38,37,35,72,4,0.449552,0.463115,0.000004,No
8688,lie,95,10.54265529,78,6.463089458,6.462319176,7410,68.13812423,37,39,76,76,87,163,4,0.454991,0.467884,0.000002,No
11704,frost,36,11.51301324,30,7.418600903,7.418310866,1080,85.41045041,21,17,38,32,25,57,4,0.43518,0.450867,0.000004,No
11290,gnome,48,11.22533117,28,7.487593774,7.487323743,1344,84.05071975,22,16,38,37,33,70,4,0.416007,0.433365,0.000004,No
6879,noisy,15,12.38848198,14,8.180740955,8.180610949,210,101.3469619,12,7,19,14,7,21,5,0.404507,0.422171,0.000008,No
5525,polo,76,10.76579884,52,6.868554566,6.868044446,3952,73.94547675,17,33,50,67,53,120,4,0.447952,0.46203,0.000003,No
14523,convent,41,11.38296011,29,7.452502454,7.452222421,1189,84.83153816,11,19,30,34,39,73,4,0.44887,0.462523,0.000005,No
1240,tsunami,50,11.18450917,29,7.452502454,7.452222421,1450,83.35258205,19,31,50,41,40,81,4,0.452797,0.465946,0.000003,No
2178,swing,46,11.26789078,38,7.182212124,7.181842063,1748,80.92838178,20,30,50,38,43,81,4,0.455224,0.467899,0.000003,No
2287,superior,59,11.01899473,53,6.849506371,6.848986246,3127,75.47467462,21,29,50,51,47,98,4,0.453271,0.466307,0.000003,No
14800,comparative,30,11.6953348,24,7.641744454,7.641514432,720,89.37275981,13,17,30,27,25,52,5,0.382845,0.399289,0.000005,No
15923,burnside,17,12.26331883,10,8.517213191,8.517123189,170,104.4493009,11,14,25,13,15,28,4,0.393819,0.411047,0.000006,No
17569,apache,29,11.72923635,22,7.728755831,7.728545813,638,90.65240381,12,13,25,21,16,37,4,0.394818,0.412075,0.000006,No
1759,theta,16,12.32394346,6,9.028038815,9.027988815,96,111.2610399,12,13,25,12,13,25,4,0.407844,0.425521,0.000006,No
8876,lausanne,27,11.80069531,16,8.047209562,8.047059554,432,94.96266815,15,15,30,23,23,46,4,0.394774,0.412066,0.000005,No
16066,brooke,13,12.53158282,13,8.254848927,8.254728922,169,103.446323,8,7,15,10,7,17,5,0.366317,0.38021,0.00001,No
5272,primrose,12,12.61162553,10,8.517213191,8.517123189,120,107.4159033,8,7,15,9,10,19,5,0.366794,0.38061,0.00001,No
12397,ezra,28,11.76432767,17,7.98658494,7.986424931,476,93.95680218,16,14,30,23,24,47,4,0.433226,0.449087,0.000005,No
15801,caliph,77,10.75272676,51,6.887972651,6.887472536,3927,74.06448782,29,21,50,60,44,104,4,0.448371,0.462152,0.000003,No
6967,niagara,41,11.38296011,26,7.561701746,7.56145172,1066,86.07454935,17,8,25,36,17,53,5,0.383176,0.39959,0.000006,No
1291,tristan,32,11.63079627,17,7.98658494,7.986424931,544,92.89034237,17,8,25,25,12,37,4,0.424421,0.441046,0.000006,No
921,vast,55,11.08919899,55,6.812465099,6.811924964,3025,75.54478111,14,23,37,49,30,79,5,0.386825,0.403655,0.000004,No
4666,rectangular,38,11.45894602,35,7.264450223,7.264110172,1330,83.24294295,15,22,37,33,28,61,4,0.434988,0.450801,0.000004,No
17096,azerbaijan,93,10.56393268,64,6.660915201,6.660285015,5952,70.3654598,33,41,74,86,70,156,4,0.458398,0.470617,0.000002,No
9166,kidnapped,47,11.24638458,43,7.058598169,7.058178089,2021,79.38370957,17,20,37,42,42,84,4,0.450613,0.46396,0.000004,No
9751,inspector,33,11.60002462,25,7.600922459,7.600682435,825,88.17088763,18,19,37,32,27,59,4,0.427045,0.443773,0.000004,No
3336,sight,90,10.59672251,83,6.400957676,6.400137356,7470,67.82917228,36,38,74,75,75,150,4,0.458765,0.470865,0.000002,No
17325,aspect,42,11.35886256,32,7.354062381,7.35375234,1344,83.53378384,22,15,37,35,38,73,4,0.436754,0.452214,0.000004,No
2266,supreme,218,9.712037115,149,5.815851978,5.814370912,32482,56.48377027,49,25,74,190,182,372,5,0.371834,0.387085,0.000002,No
15468,celsius,88,10.61919536,55,6.812465099,6.811924964,4840,72.34289779,16,33,49,37,76,113,4,0.458848,0.470814,0.000003,No
6664,odyssey,63,10.95339745,40,7.13091883,7.130528762,2520,78.10778814,16,33,49,45,47,92,4,0.457937,0.470077,0.000003,No
14207,croydon,50,11.18450917,22,7.728755831,7.728545813,1100,86.44234048,19,30,49,45,46,91,4,0.454036,0.466917,0.000003,No
11523,gateway,57,11.05348091,46,6.991156888,6.990706795,2622,77.27661919,20,29,49,47,51,98,4,0.43312,0.449331,0.000003,No
10349,hook,57,11.05348091,37,7.208880372,7.208520314,2109,79.68322157,20,29,49,44,48,92,4,0.456265,0.46872,0.000003,No
5094,provincial,86,10.64218488,75,6.502310171,6.501569912,6450,69.19878699,21,28,49,71,58,129,5,0.398863,0.416579,0.000003,No
5438,portsmouth,60,11.00218762,38,7.182212124,7.181842063,2280,79.02004529,23,26,49,52,47,99,4,0.441128,0.456171,0.000003,No
13124,dynamo,22,12.00548972,19,7.875359305,7.875179292,418,94.54754521,10,11,21,16,16,32,5,0.408708,0.426241,0.000007,No
5599,plumage,16,12.32394346,14,8.180740955,8.180610949,224,100.8189889,10,11,21,14,15,29,4,0.439262,0.454312,0.000007,No
5877,petty,16,12.32394346,11,8.421903011,8.421803008,176,103.7910565,10,11,21,14,12,26,4,0.42642,0.442937,0.000007,No
2665,stanton,19,12.1520932,16,8.047209562,8.047059554,304,97.79044058,11,10,21,17,14,31,4,0.404093,0.421572,0.000007,No
17511,apply,95,10.54265529,83,6.400957676,6.400137356,7885,67.48309028,26,23,49,86,90,176,4,0.458848,0.470626,0.000003,No
2939,sort,144,10.12671888,133,5.929449156,5.92812831,19152,60.0458647,29,20,49,137,134,271,4,0.456453,0.468673,0.000003,No
10622,hemisphere,235,9.636946663,145,5.843064542,5.841623533,34075,56.30930134,15,58,73,234,199,433,4,0.468043,0.4784,0.000002,No
3928,savanna,27,11.80069531,22,7.728755831,7.728545813,594,91.2046927,13,16,29,18,22,40,4,0.450773,0.464044,0.000005,No
6574,oneself,19,12.1520932,16,8.047209562,8.047059554,304,97.79044058,13,16,29,13,17,30,4,0.441886,0.45666,0.000005,No
16455,blockade,33,11.60002462,17,7.98658494,7.986424931,561,92.6445819,14,15,29,31,30,61,4,0.426154,0.44282,0.000005,No
16235,boyd,22,12.00548972,18,7.929426526,7.929256515,396,95.19664868,15,14,29,16,17,33,4,0.395618,0.412902,0.000005,No
4907,quarterback,83,10.67769157,50,6.907775279,6.907285168,4150,73.75909386,15,33,48,57,74,131,4,0.463509,0.474476,0.000003,No
14806,communion,76,10.76579884,45,7.013135794,7.012695706,3420,75.50200918,16,32,48,67,71,138,4,0.466407,0.476668,0.000003,No
8393,luminosity,9,12.8993076,6,9.028038815,9.027988815,54,116.4554497,5,7,12,5,8,13,4,0.427015,0.443402,0.000012,No
16103,brisbane,63,10.95339745,41,7.106226218,7.105826145,2583,77.83732014,20,28,48,58,52,110,4,0.437756,0.453317,0.000003,No
6768,nun,39,11.43297053,31,7.38581108,7.385511041,1209,84.44176042,15,21,36,35,30,65,4,0.44802,0.461852,0.000004,No
5966,perfume,14,12.45747485,9,8.622573707,8.622493705,126,107.4154951,7,9,16,12,10,22,4,0.40167,0.419094,0.000009,No
16697,bennett,29,11.72923635,25,7.600922459,7.600682435,725,89.15301598,16,20,36,20,21,41,4,0.440548,0.455571,0.000004,No
14500,cookie,27,11.80069531,14,8.180740955,8.180610949,378,96.53843143,11,13,24,19,22,41,4,0.408698,0.426295,0.000006,No
7223,mushroom,51,11.16470654,24,7.641744454,7.641514432,1224,85.31783432,18,18,36,44,36,80,4,0.41268,0.43022,0.000004,No
2492,strand,39,11.43297053,22,7.728755831,7.728545813,858,88.36263766,18,18,36,33,32,65,4,0.458836,0.470532,0.000004,No
18288,ac,78,10.73982335,61,6.70892442,6.708324252,4758,72.05266314,24,24,48,55,55,110,4,0.445311,0.459674,0.000003,No
16425,bluegrass,44,11.31234254,27,7.523961418,7.52370139,1188,85.11362885,19,17,36,29,38,67,4,0.44802,0.461791,0.000004,No
87,yiddish,19,12.1520932,14,8.180740955,8.180610949,266,99.41312651,13,11,24,18,17,35,4,0.440581,0.455425,0.000006,No
8030,marvin,21,12.05200974,18,7.929426526,7.929256515,378,95.56552572,14,10,24,14,10,24,5,0.384871,0.401266,0.000006,No
10121,id,48,11.22533117,27,7.523961418,7.52370139,1296,84.4589586,21,15,36,40,40,80,4,0.428044,0.444491,0.000004,No
18354,abbot,43,11.33533206,36,7.236279346,7.235929291,1548,82.02562928,22,14,36,31,35,66,4,0.44022,0.455162,0.000004,No
16931,barney,20,12.1007999,14,8.180740955,8.180610949,280,98.99350936,10,6,16,13,7,20,4,0.388008,0.405132,0.000009,No
7351,morse,34,11.57017165,18,7.929426526,7.929256515,612,91.74482602,16,8,24,26,28,54,4,0.392548,0.409597,0.000006,No
13611,diane,23,11.96103796,22,7.728755831,7.728545813,506,92.44394189,16,8,24,18,11,29,5,0.399078,0.416974,0.000006,No
13378,domenico,23,11.96103796,22,7.728755831,7.728545813,506,92.44394189,11,2,13,19,5,24,5,0.322587,0.326883,0.000011,No
5619,pledge,9,12.8993076,9,8.622573707,8.622493705,81,111.2252305,6,5,11,8,6,14,5,0.389986,0.406943,0.000013,No
1390,transparent,43,11.33533206,39,7.156236638,7.155856573,1677,81.1183186,17,30,47,33,37,70,4,0.431111,0.447496,0.000003,No
10548,hesse,105,10.44257183,74,6.515733191,6.515002939,7770,68.04101185,18,29,47,96,91,187,4,0.439088,0.454481,0.000003,No
16667,bern,90,10.59672251,50,6.907775279,6.907285168,4500,73.19977777,18,29,47,73,76,149,4,0.452197,0.46542,0.000003,No
337,wildlife,74,10.79246708,65,6.645411014,6.644770822,4810,71.72037963,19,28,47,50,55,105,4,0.443509,0.458218,0.000003,No
5108,prototype,57,11.05348091,49,6.927977986,6.92749788,2793,76.57827241,20,27,47,53,42,95,4,0.403368,0.421263,0.000003,No
12338,famine,52,11.14528846,41,7.106226218,7.105826145,2132,79.20094105,22,25,47,43,43,86,4,0.45905,0.470833,0.000003,No
15441,ceremonial,60,11.00218762,56,6.794446593,6.793896453,3360,74.75377616,23,24,47,47,38,85,4,0.42047,0.437694,0.000003,No
150,wu,60,11.00218762,36,7.236279346,7.235929291,2160,79.614903,24,23,47,51,32,83,4,0.459799,0.471391,0.000003,No
3677,segment,62,10.96939779,45,7.013135794,7.012695706,2790,76.9298763,25,22,47,56,52,108,4,0.456782,0.468978,0.000003,No
16604,biblical,57,11.05348091,49,6.927977986,6.92749788,2793,76.57827241,26,21,47,50,32,82,5,0.387703,0.404594,0.000003,No
6690,oceanic,99,10.50141233,79,6.450350432,6.449570143,7821,67.73778954,32,15,47,80,85,165,5,0.386429,0.403082,0.000003,No
14198,cruise,60,11.00218762,35,7.264450223,7.264110172,2100,79.92484427,32,15,47,53,35,88,4,0.40496,0.422535,0.000003,No
12773,enzyme,43,11.33533206,32,7.354062381,7.35375234,1376,83.3607391,13,15,28,40,20,60,4,0.439838,0.454951,0.000005,No
16585,bike,25,11.87765635,21,7.775275846,7.77507583,525,92.35205455,13,15,28,22,16,38,4,0.406956,0.424568,0.000005,No
2094,taboo,23,11.96103796,16,8.047209562,8.047059554,368,96.25297905,13,15,28,21,20,41,5,0.365834,0.379593,0.000005,No
6940,nightclub,26,11.83843564,22,7.728755831,7.728545813,572,91.49637848,14,14,28,24,20,44,4,0.448427,0.462138,0.000005,No
7130,nasal,47,11.24638458,22,7.728755831,7.728545813,1034,86.92056036,17,11,28,43,22,65,5,0.384787,0.401191,0.000005,No
14945,cod,46,11.26789078,33,7.323290723,7.322970678,1518,82.51804002,15,20,35,37,33,70,4,0.434765,0.450552,0.000004,No
28,zeta,45,11.28986969,17,7.98658494,7.986424931,765,90.16750322,17,18,35,34,29,63,4,0.451955,0.465021,0.000004,No
15391,chance,165,9.990586703,152,5.795917763,5.794406652,25080,57.90461894,37,33,70,149,158,307,4,0.468587,0.478349,0.000002,No
10721,hazel,12,12.61162553,10,8.517213191,8.517123189,120,107.4159033,11,9,20,11,10,21,5,0.35362,0.364631,0.000007,No
1373,trauma,42,11.35886256,27,7.523961418,7.52370139,1134,85.46364365,20,15,35,34,20,54,5,0.402937,0.420664,0.000004,No
468,welcome,51,11.16470654,44,7.03560865,7.035178566,2244,78.55050594,22,13,35,34,48,82,4,0.438361,0.453707,0.000004,No
15458,centaur,24,11.91847835,15,8.111748083,8.111608076,360,96.67969388,6,17,23,21,19,40,4,0.452117,0.465162,0.000006,No
15704,canyon,51,11.16470654,28,7.487593774,7.487323743,1428,83.59678721,16,30,46,43,45,88,4,0.457217,0.46949,0.000003,No
13055,eden,41,11.38296011,27,7.523961418,7.52370139,1107,85.6449527,18,28,46,34,35,69,4,0.446162,0.460458,0.000003,No
2527,stolen,51,11.16470654,44,7.03560865,7.035178566,2244,78.55050594,19,27,46,49,40,89,4,0.453398,0.466345,0.000003,No
4614,regiment,48,11.22533117,27,7.523961418,7.52370139,1296,84.4589586,20,26,46,35,40,75,4,0.45962,0.471302,0.000003,No
431,wharf,20,12.1007999,19,7.875359305,7.875179292,380,95.29814712,11,12,23,14,16,30,4,0.434541,0.450228,0.000006,No
1742,thirteen,118,10.32584755,102,6.194825471,6.193814981,12036,63.96682343,34,35,69,95,63,158,4,0.451553,0.46503,0.000002,No
5907,perth,104,10.45214128,53,6.849506371,6.848986246,5512,71.59200827,35,34,69,90,94,184,4,0.447005,0.46126,0.000002,No
3183,slash,47,11.24638458,17,7.98658494,7.986424931,799,89.82020568,24,22,46,26,30,56,4,0.450556,0.46396,0.000003,No
16713,beneath,48,11.22533117,48,6.948597273,6.948127172,2304,78.00030554,28,18,46,32,46,78,4,0.430745,0.447069,0.000003,No
16131,bride,34,11.57017165,28,7.487593774,7.487323743,952,86.63274523,12,22,34,31,31,62,4,0.459383,0.471053,0.000004,No
10558,herschel,45,11.28986969,25,7.600922459,7.600682435,1125,85.81342407,14,20,34,42,29,71,4,0.436068,0.451712,0.000004,No
16576,billboard,194,9.828674018,140,5.878155862,5.876764922,27160,57.77447779,29,39,68,184,163,347,4,0.448734,0.462791,0.000002,No
7945,maybe,59,11.01899473,58,6.759355274,6.758785123,3422,74.48130016,30,38,68,51,50,101,4,0.451748,0.465213,0.000002,No
10873,hammond,30,11.6953348,21,7.775275846,7.77507583,630,90.93445415,16,18,34,23,23,46,4,0.437864,0.453223,0.000004,No
4086,saga,45,11.28986969,38,7.182212124,7.181842063,1710,81.08623895,17,17,34,29,35,64,4,0.445457,0.459645,0.000004,No
14753,comprehensive,38,11.45894602,37,7.208880372,7.208520314,1406,82.60617103,17,17,34,30,18,48,5,0.388093,0.404937,0.000004,No
17657,anniversary,76,10.76579884,65,6.645411014,6.644770822,4940,71.54315817,18,16,34,58,66,124,4,0.442172,0.456876,0.000004,No
15234,chloride,48,11.22533117,33,7.323290723,7.322970678,1584,82.20636359,18,16,34,41,32,73,4,0.41424,0.431708,0.000004,No
3594,serial,122,10.29251113,71,6.557118407,6.556418176,8662,67.4892142,44,24,68,90,41,131,4,0.43235,0.448623,0.000002,No
11225,gore,48,11.22533117,24,7.641744454,7.641514432,1152,85.78111218,16,29,45,37,44,81,4,0.455096,0.467772,0.000003,No
8346,lynx,24,11.91847835,11,8.421903011,8.421803008,264,100.3762687,11,16,27,15,21,36,4,0.432782,0.448843,0.000005,No
5532,pollen,55,11.08919899,30,7.418600903,7.418310866,1650,82.26634165,19,26,45,44,45,89,4,0.442304,0.457176,0.000003,No
4054,salisbury,46,11.26789078,29,7.452502454,7.452222421,1334,83.9739837,19,26,45,42,39,81,4,0.431877,0.448195,0.000003,No
3547,sexy,13,12.53158282,12,8.334891634,8.334781631,156,104.4493848,7,8,15,8,9,17,5,0.340501,0.347868,0.000009,No
13516,diplomat,66,10.90687744,57,6.776747016,6.776186871,3762,73.91314912,21,24,45,55,60,115,4,0.418261,0.435694,0.000003,No
8598,liqueur,19,12.1520932,6,9.028038815,9.027988815,114,109.7095691,13,14,27,17,17,34,4,0.426779,0.443308,0.000005,No
6760,nutrition,45,11.28986969,36,7.236279346,7.235929291,1620,81.69665084,23,22,45,35,35,70,4,0.447343,0.461336,0.000003,No
838,versus,42,11.35886256,31,7.38581108,7.385511041,1302,83.89441294,23,22,45,27,31,58,4,0.418005,0.43568,0.000003,No
14012,damp,20,12.1007999,19,7.875359305,7.875179292,380,95.29814712,14,13,27,19,14,33,4,0.435404,0.450979,0.000005,No
2026,tango,14,12.45747485,4,9.433503923,9.433473923,56,117.5176378,8,7,15,11,11,22,4,0.431887,0.447778,0.000009,No
15075,claude,64,10.93764909,59,6.74226084,6.741680684,3776,73.74448317,24,21,45,44,36,80,4,0.412172,0.429788,0.000003,No
17844,alternate,63,10.95339745,59,6.74226084,6.741680684,3717,73.8506627,24,21,45,52,37,89,4,0.406676,0.424394,0.000003,No
13794,delivery,49,11.20471188,36,7.236279346,7.235929291,1764,81.08042515,24,21,45,37,40,77,4,0.443232,0.45788,0.000003,No
741,virtue,43,11.33533206,30,7.418600903,7.418310866,1290,84.09230466,24,21,45,34,37,71,4,0.460073,0.471532,0.000003,No
11254,goldman,21,12.05200974,13,8.254848927,8.254728922,273,99.48751966,15,12,27,20,18,38,5,0.413458,0.430841,0.000005,No
7568,minnie,27,11.80069531,11,8.421903011,8.421803008,297,99.38431138,20,7,27,24,19,43,4,0.422643,0.439379,0.000005,No
6812,nottingham,76,10.76579884,30,7.418600903,7.418310866,2280,79.86716497,33,34,67,68,66,134,4,0.435479,0.451519,0.000002,No
933,variety,285,9.444042997,260,5.259116653,5.256523345,74100,49.6673238,41,26,67,276,274,550,4,0.456994,0.469213,0.000002,No
13323,dose,20,12.1007999,10,8.517213191,8.517123189,200,103.0650926,7,12,19,14,17,31,4,0.427828,0.444388,0.000007,No
2478,strauss,60,11.00218762,33,7.323290723,7.322970678,1980,80.57221849,14,30,44,57,50,107,4,0.449711,0.46342,0.000003,No
2995,solve,116,10.34294199,92,6.298009707,6.297099311,10672,65.13994903,15,29,44,107,82,189,4,0.450602,0.464133,0.000003,No
13326,dorset,54,11.10754813,41,7.106226218,7.105826145,2214,78.93274974,17,27,44,47,48,95,4,0.444954,0.459434,0.000003,No
9875,infant,43,11.33533206,33,7.323290723,7.322970678,1419,83.01193213,18,26,44,37,36,73,4,0.428903,0.445487,0.000003,No
9482,janice,11,12.6986369,9,8.622573707,8.622493705,99,109.4949327,5,7,12,5,9,14,5,0.384387,0.400684,0.000011,No
11945,fold,41,11.38296011,24,7.641744454,7.641514432,984,86.98567229,20,24,44,33,32,65,4,0.458599,0.470448,0.000003,No
1049,upright,38,11.45894602,36,7.236279346,7.235929291,1368,82.92013439,21,23,44,26,29,55,4,0.445747,0.460007,0.000003,No
3534,shake,45,11.28986969,32,7.354062381,7.35375234,1440,83.02640596,23,21,44,40,40,80,4,0.447534,0.461434,0.000003,No
14639,connie,17,12.26331883,16,8.047209562,8.047059554,272,98.68549658,12,10,22,13,13,26,5,0.384537,0.400909,0.000006,No
9083,knoxville,18,12.20616042,9,8.622573707,8.622493705,162,105.2485179,12,10,22,15,18,33,5,0.354665,0.365967,0.000006,No
4033,salvation,43,11.33533206,35,7.264450223,7.264110172,1505,82.34495552,24,20,44,40,39,79,4,0.449962,0.463439,0.000003,No
13205,duchess,78,10.73982335,56,6.794446593,6.793896453,4368,72.97115618,30,14,44,71,72,143,4,0.438589,0.453787,0.000003,No
2920,southernmost,44,11.31234254,41,7.106226218,7.105826145,1804,80.38806516,8,25,33,43,37,80,5,0.392747,0.410214,0.000004,No
13187,dull,27,11.80069531,25,7.600922459,7.600682435,675,89.69617003,14,19,33,23,21,44,4,0.423399,0.440318,0.000004,No
12491,exodus,38,11.45894602,29,7.452502454,7.452222421,1102,85.39782332,15,18,33,28,27,55,4,0.447771,0.461608,0.000004,No
5700,pitt,40,11.40765272,16,8.047209562,8.047059554,640,91.79977207,15,18,33,30,33,63,4,0.435127,0.450829,0.000004,No
11219,gorilla,34,11.57017165,13,8.254848927,8.254728922,442,95.51001905,16,17,33,32,27,59,4,0.432772,0.448717,0.000004,No
13506,dirt,75,10.77904406,62,6.692663899,6.692053725,4650,72.14051907,33,33,66,65,63,128,4,0.44929,0.463138,0.000002,No
4104,sacramento,48,11.22533117,26,7.561701746,7.56145172,1248,84.88260628,17,16,33,42,40,82,4,0.428044,0.444482,0.000004,No
6596,omaha,35,11.54118412,18,7.929426526,7.929256515,630,91.51497147,18,15,33,30,29,59,4,0.428303,0.444703,0.000004,No
17825,amadeus,61,10.98565831,50,6.907775279,6.907285168,3050,75.88645892,19,14,33,59,60,119,4,0.421709,0.438802,0.000004,No
12269,feather,43,11.33533206,25,7.600922459,7.600682435,1075,86.15898005,20,13,33,37,20,57,4,0.440504,0.455397,0.000004,No
11777,freddie,30,11.6953348,23,7.684304068,7.684084048,690,89.87050875,20,13,33,23,28,51,4,0.428665,0.445003,0.000004,No
13883,deciduous,46,11.26789078,41,7.106226218,7.105826145,1886,80.07218088,21,12,33,36,28,64,5,0.397274,0.414626,0.000004,No
9321,jules,36,11.51301324,30,7.418600903,7.418310866,1080,85.41045041,22,11,33,25,21,46,4,0.391543,0.408569,0.000004,No
863,verde,53,11.12624026,34,7.29343776,7.293107712,1802,81.14854086,5,21,26,43,28,71,4,0.446757,0.4608,0.000005,No
1517,torch,25,11.87765635,21,7.775275846,7.77507583,525,92.35205455,11,15,26,21,20,41,4,0.43726,0.452749,0.000005,No
13193,duffy,9,12.8993076,8,8.740356743,8.740286741,72,112.7445502,6,7,13,8,9,17,4,0.409755,0.427244,0.00001,No
5865,phantom,37,11.48561426,32,7.354062381,7.35375234,1184,84.46592379,12,14,26,33,33,66,4,0.436464,0.451946,0.000005,No
565,wartime,33,11.60002462,32,7.354062381,7.35375234,1056,85.30730465,12,14,26,30,17,47,4,0.425337,0.441999,0.000005,No
14088,cuttlefish,22,12.00548972,14,8.180740955,8.180610949,308,98.21380147,12,14,26,20,20,40,4,0.433628,0.449449,0.000005,No
16848,baxter,22,12.00548972,11,8.421903011,8.421803008,242,101.1090701,13,13,26,17,15,32,5,0.356389,0.368068,0.000005,No
4266,romanesque,29,11.72923635,25,7.600922459,7.600682435,725,89.15301598,14,12,26,22,22,44,5,0.389772,0.406674,0.000005,No
15619,carnegie,35,11.54118412,23,7.684304068,7.684084048,805,88.68596805,15,11,26,30,32,62,4,0.386143,0.403109,0.000005,No
4514,require,101,10.48141166,91,6.308938778,6.30803839,9191,66.12658447,25,40,65,61,87,148,4,0.451806,0.465415,0.000002,No
16757,beijing,98,10.5115647,70,6.571303042,6.570612818,6860,69.07467708,28,37,65,84,73,157,4,0.446039,0.460537,0.000002,No
17984,albania,73,10.80607274,54,6.830814238,6.830284108,3942,73.8142755,30,35,65,62,53,115,4,0.443764,0.458594,0.000002,No
18047,ago,661,8.602778338,560,4.4918615,4.48625593,370160,38.64248881,7,122,129,100,548,648,4,0.471649,0.482316,0.000001,No
13508,directory,61,10.98565831,42,7.082128666,7.08171859,2562,77.80184565,19,24,43,42,45,87,4,0.457524,0.469612,0.000003,No
15723,cannon,45,11.28986969,36,7.236279346,7.235929291,1620,81.69665084,19,24,43,35,36,71,4,0.445066,0.459481,0.000003,No
6788,nuclei,47,11.24638458,30,7.418600903,7.418310866,1410,83.43243876,20,23,43,41,43,84,4,0.449734,0.463321,0.000003,No
6896,noah,43,11.33533206,30,7.418600903,7.418310866,1290,84.09230466,20,23,43,31,38,69,4,0.448156,0.46203,0.000003,No
4834,rachel,41,11.38296011,34,7.29343776,7.293107712,1394,83.02091109,22,21,43,32,25,57,5,0.388561,0.405547,0.000003,No
7024,nero,45,11.28986969,29,7.452502454,7.452222421,1305,84.13778155,22,21,43,34,30,64,4,0.405589,0.423267,0.000003,No
17734,anarchy,35,11.54118412,26,7.561701746,7.56145172,910,87.27099208,22,21,43,29,28,57,4,0.449301,0.462918,0.000003,No
13073,echo,35,11.54118412,21,7.775275846,7.77507583,735,89.7358901,22,21,43,25,25,50,4,0.444086,0.458608,0.000003,No
18235,achilles,39,11.43297053,17,7.98658494,7.986424931,663,91.31039027,23,20,43,33,30,63,4,0.44596,0.460148,0.000003,No
18026,aim,71,10.8338523,67,6.615105665,6.61444546,4757,71.66707772,24,19,43,58,65,123,4,0.432424,0.448552,0.000003,No
2119,synthetic,58,11.03608917,46,6.991156888,6.990706795,2668,77.15503079,24,19,43,50,24,74,5,0.363445,0.377184,0.000003,No
6347,palatine,34,11.57017165,18,7.929426526,7.929256515,612,91.74482602,11,21,32,25,31,56,4,0.441743,0.456594,0.000004,No
10693,hearst,17,12.26331883,10,8.517213191,8.517123189,170,104.4493009,7,9,16,15,12,27,4,0.425735,0.442285,0.000008,No
1609,tire,29,11.72923635,13,8.254848927,8.254728922,377,96.82307407,14,18,32,26,19,45,4,0.417808,0.435238,0.000004,No
686,volkswagen,34,11.57017165,26,7.561701746,7.56145172,884,87.49018719,16,16,32,29,26,55,4,0.427591,0.444106,0.000004,No
8398,lumber,27,11.80069531,21,7.775275846,7.77507583,567,91.75366123,16,16,32,22,21,43,4,0.416221,0.433577,0.000004,No
844,veronica,32,11.63079627,15,8.111748083,8.111608076,480,94.34608939,17,15,32,20,20,40,4,0.447704,0.46149,0.000004,No
12440,expressway,13,12.53158282,9,8.622573707,8.622493705,117,108.0544965,9,7,16,10,9,19,4,0.447106,0.460838,0.000008,No
12858,emmanuel,34,11.57017165,26,7.561701746,7.56145172,884,87.49018719,18,14,32,31,26,57,4,0.399078,0.416554,0.000004,No
15471,cellular,37,11.48561426,32,7.354062381,7.35375234,1184,84.46592379,20,12,32,32,28,60,5,0.384854,0.401294,0.000004,No
16503,blacksmith,23,11.96103796,17,7.98658494,7.986424931,391,95.52784565,7,14,21,22,16,38,4,0.423147,0.440107,0.000006,No
6314,panda,53,11.12624026,21,7.775275846,7.77507583,1113,86.50958719,14,28,42,41,35,76,4,0.44862,0.46249,0.000003,No
14077,cyclops,17,12.26331883,13,8.254848927,8.254728922,221,101.2318443,5,9,14,16,12,28,4,0.426307,0.442792,0.000009,No
172,wreath,19,12.1520932,12,8.334891634,8.334781631,228,101.2863799,8,13,21,18,18,36,4,0.44258,0.457176,0.000006,No
17006,balloon,51,11.16470654,35,7.264450223,7.264110172,1785,81.10545494,17,25,42,45,38,83,4,0.465405,0.475776,0.000003,No
10927,hades,37,11.48561426,23,7.684304068,7.684084048,851,88.25895242,17,25,42,31,33,64,4,0.442348,0.457209,0.000003,No
9617,iodide,5,13.48709426,4,9.433503923,9.433473923,20,127.2305567,3,4,7,4,4,8,5,0.410399,0.428025,0.000018,No
17797,amherst,43,11.33533206,19,7.875359305,7.875179292,817,89.26981283,18,24,42,38,41,79,4,0.399455,0.417075,0.000003,No
9125,kit,43,11.33533206,35,7.264450223,7.264110172,1505,82.34495552,19,23,42,34,33,67,4,0.456289,0.468612,0.000003,No
11796,franco,41,11.38296011,23,7.684304068,7.684084048,943,87.47012669,19,23,42,29,25,54,4,0.445066,0.459434,0.000003,No
10312,horus,42,11.35886256,16,8.047209562,8.047059554,672,91.4071474,19,23,42,34,35,69,4,0.453665,0.466485,0.000003,No
4321,riviera,24,11.91847835,17,7.98658494,7.986424931,408,95.18793968,10,11,21,20,19,39,4,0.415763,0.433041,0.000006,No
9596,iris,40,11.40765272,25,7.600922459,7.600682435,1000,86.70868379,20,22,42,33,29,62,4,0.435287,0.451054,0.000003,No
15031,climb,87,10.63062406,68,6.600290579,6.599620368,5916,70.16520782,30,33,63,83,67,150,4,0.4642,0.475006,0.000002,No
13913,deborah,11,12.6986369,10,8.517213191,8.517123189,110,108.1569978,7,7,14,9,8,17,4,0.415743,0.433248,0.000009,No
11420,gertrude,14,12.45747485,12,8.334891634,8.334781631,168,103.8317029,9,9,18,10,10,20,4,0.42207,0.43905,0.000007,No
11518,gauge,53,11.12624026,28,7.487593774,7.487323743,1484,83.30876733,21,21,42,45,40,85,4,0.448892,0.462584,0.000003,No
7948,maxwell,39,11.43297053,26,7.561701746,7.56145172,1014,86.45271323,21,21,42,33,29,62,5,0.35865,0.370892,0.000003,No
13394,dogma,34,11.57017165,18,7.929426526,7.929256515,612,91.74482602,21,21,42,28,31,59,4,0.457158,0.469269,0.000003,No
2036,tan,18,12.20616042,15,8.111748083,8.111608076,270,99.01329838,11,10,21,13,12,25,4,0.409028,0.426483,0.000006,No
6399,ox,19,12.1520932,14,8.180740955,8.180610949,266,99.41312651,11,10,21,17,11,28,4,0.408774,0.42623,0.000006,No
988,utility,42,11.35886256,36,7.236279346,7.235929291,1512,82.19590253,22,20,42,34,26,60,4,0.432066,0.448195,0.000003,No
16751,belfast,48,11.22533117,31,7.38581108,7.385511041,1488,82.9081753,22,20,42,45,40,85,4,0.435757,0.451435,0.000003,No
17353,artwork,42,11.35886256,39,7.156236638,7.155856573,1638,81.28670841,23,19,42,32,34,66,4,0.446308,0.460415,0.000003,No
16060,broth,13,12.53158282,7,8.873888135,8.873828135,91,111.2038641,10,8,18,12,10,22,4,0.411141,0.428549,0.000007,No
16479,bleach,35,11.54118412,23,7.684304068,7.684084048,805,88.68596805,24,18,42,27,23,50,4,0.432266,0.448383,0.000003,No
10359,hong,170,9.96073374,105,6.165837934,6.164797414,17850,61.41626995,55,8,63,147,164,311,5,0.386076,0.402533,0.000002,No
4078,sahara,61,10.98565831,43,7.058598169,7.058178089,2623,77.54334765,7,18,25,58,48,106,4,0.445848,0.460012,0.000005,No
3459,sherry,3,13.99791989,3,9.721185996,9.721165996,9,136.0763828,2,3,5,2,3,5,5,0.361321,0.374095,0.000025,No
16141,brewery,34,11.57017165,21,7.775275846,7.77507583,714,89.96127619,12,13,25,22,26,48,4,0.435468,0.45105,0.000005,No
16754,bel,36,11.51301324,22,7.728755831,7.728545813,792,88.9812682,14,11,25,32,30,62,5,0.36982,0.384494,0.000005,No
16162,breathe,103,10.46180319,80,6.43777165,6.436981353,8240,67.35069997,19,43,62,94,89,183,4,0.457712,0.47011,0.000002,No
10463,hiroshima,50,11.18450917,33,7.323290723,7.322970678,1650,81.90741226,13,18,31,28,33,61,4,0.454676,0.467241,0.000004,No
4521,reptile,36,11.51301324,33,7.323290723,7.322970678,1188,84.31314304,14,17,31,26,29,55,4,0.434307,0.450125,0.000004,No
2845,spell,29,11.72923635,26,7.561701746,7.56145172,754,88.69298697,14,17,31,25,22,47,4,0.452878,0.465767,0.000004,No
1522,topology,25,11.87765635,17,7.98658494,7.986424931,425,94.86191135,14,17,31,22,21,43,4,0.454956,0.46741,0.000004,No
12228,ferguson,22,12.00548972,16,8.047209562,8.047059554,352,96.6106917,15,16,31,19,20,39,4,0.437206,0.452622,0.000004,No
9786,innocent,101,10.48141166,89,6.331161914,6.330281545,8989,66.35951431,32,30,62,91,91,182,4,0.441534,0.456589,0.000002,No
6897,noaa,32,11.63079627,19,7.875359305,7.875179292,608,91.59669967,17,14,31,18,21,39,5,0.399096,0.416708,0.000004,No
11435,gerard,29,11.72923635,21,7.775275846,7.77507583,609,91.19804807,18,13,31,21,20,41,5,0.386303,0.402913,0.000004,No
11646,furry,25,11.87765635,17,7.98658494,7.986424931,425,94.86191135,18,13,31,23,18,41,4,0.439468,0.454519,0.000004,No
6989,newcastle,91,10.58567267,60,6.725453722,6.72486356,5460,71.19345166,36,26,62,71,56,127,4,0.435789,0.451552,0.000002,No
4964,puzzle,42,11.35886256,29,7.452502454,7.452222421,1218,84.6519511,16,25,41,37,35,72,4,0.426676,0.443445,0.000003,No
15744,canberra,43,11.33533206,29,7.452502454,7.452222421,1247,84.47659001,18,23,41,39,37,76,4,0.455914,0.468312,0.000003,No
18262,accompaniment,39,11.43297053,24,7.641744454,7.641514432,936,87.36783915,18,23,41,38,32,70,4,0.4497,0.463293,0.000003,No
15852,cache,48,11.22533117,18,7.929426526,7.929256515,864,89.01043872,20,21,41,40,38,78,4,0.462434,0.473415,0.000003,No
6958,nicholson,31,11.66254497,20,7.824066011,7.823875996,620,91.24852172,21,20,41,30,28,58,4,0.418202,0.435529,0.000003,No
940,vanilla,36,11.51301324,15,8.111748083,8.111608076,540,93.39066307,24,17,41,30,24,54,4,0.404029,0.421657,0.000003,No
11356,glacier,132,10.21373025,60,6.725453722,6.72486356,7920,68.69197016,20,41,61,58,104,162,4,0.465991,0.476527,0.000002,No
18095,affect,124,10.27625061,117,6.057624349,6.056463699,14508,62.24966593,23,38,61,95,106,201,4,0.452312,0.465711,0.000002,No
15329,cheap,84,10.66571538,76,6.489064944,6.488314678,6384,69.21051976,31,30,61,75,57,132,4,0.406583,0.424464,0.000002,No
5445,portland,77,10.75272676,50,6.907775279,6.907285168,3850,74.27742006,33,28,61,73,68,141,4,0.414336,0.432041,0.000002,No
14284,creamy,10,12.79394708,10,8.517213191,8.517123189,100,108.9687749,6,6,12,9,8,17,5,0.386311,0.402749,0.00001,No
5559,poisson,7,13.15062203,6,9.028038815,9.027988815,42,118.7243261,6,6,12,6,7,13,5,0.331262,0.3364,0.00001,No
18,zirconium,7,13.15062203,5,9.210360372,9.210320372,35,121.121968,6,6,12,6,6,12,5,0.352713,0.363514,0.00001,No
8342,lyrebird,10,12.79394708,3,9.721185996,9.721165996,30,124.3723392,6,6,12,10,7,17,4,0.421579,0.438539,0.00001,No
5709,piston,31,11.66254497,18,7.929426526,7.929256515,558,92.47729347,12,12,24,28,23,51,4,0.431321,0.447515,0.000005,No
12237,feminist,25,11.87765635,22,7.728755831,7.728545813,550,91.79950579,8,12,20,22,14,36,4,0.436389,0.451838,0.000006,No
5549,policeman,19,12.1520932,18,7.929426526,7.929256515,342,96.35913016,8,12,20,18,16,34,4,0.402007,0.419521,0.000006,No
1147,twilight,47,11.24638458,29,7.452502454,7.452222421,1363,83.81370865,16,24,40,36,44,80,4,0.437228,0.452791,0.000003,No
10728,hayes,35,11.54118412,25,7.600922459,7.600682435,875,87.72364555,17,23,40,30,28,58,4,0.449131,0.46281,0.000003,No
8341,lyric,34,11.57017165,21,7.775275846,7.77507583,714,89.96127619,17,23,40,31,31,62,4,0.409283,0.42707,0.000003,No
11823,fowl,29,11.72923635,10,8.517213191,8.517123189,290,99.90040654,9,11,20,28,23,51,4,0.395187,0.412423,0.000006,No
8722,levy,14,12.45747485,12,8.334891634,8.334781631,168,103.8317029,9,11,20,13,11,24,4,0.432761,0.448632,0.000006,No
8219,malaria,35,11.54118412,22,7.728755831,7.728545813,770,89.19899403,18,22,40,28,29,57,4,0.420043,0.43737,0.000003,No
9969,incident,43,11.33533206,40,7.13091883,7.130528762,1720,80.83133284,19,21,40,36,31,67,4,0.445423,0.459711,0.000003,No
18342,abernathy,4,13.71023782,3,9.721185996,9.721165996,12,133.2797719,2,2,4,2,2,4,5,0.41003,0.427626,0.00003,No
2217,swallowtail,9,12.8993076,5,9.210360372,9.210320372,45,118.8072715,4,4,8,6,5,11,5,0.358932,0.371407,0.000015,No
11657,funk,48,11.22533117,36,7.236279346,7.235929291,1728,81.22963207,20,20,40,38,40,78,4,0.402828,0.420512,0.000003,No
14619,conservatory,52,11.14528846,47,6.969650683,6.969190586,2444,77.67876731,21,19,40,45,51,96,4,0.417474,0.434825,0.000003,No
16700,bengali,48,11.22533117,29,7.452502454,7.452222421,1392,83.65680807,21,19,40,34,29,63,4,0.428789,0.445233,0.000003,No
2302,sunny,39,11.43297053,36,7.236279346,7.235929291,1404,82.73216852,23,17,40,35,29,64,4,0.433353,0.449266,0.000003,No
14845,combustion,62,10.96939779,33,7.323290723,7.322970678,2046,80.33208909,24,16,40,59,47,106,4,0.417033,0.434464,0.000003,No
1331,tribal,81,10.70208302,61,6.70892442,6.708324252,4941,71.79946614,25,15,40,53,31,84,5,0.387416,0.404158,0.000003,No
9245,katharine,21,12.05200974,17,7.98658494,7.986424931,357,96.25439949,13,7,20,14,17,31,5,0.323522,0.326915,0.000006,No
7196,mutual,52,11.14528846,41,7.106226218,7.105826145,2132,79.20094105,28,12,40,41,20,61,5,0.380123,0.396246,0.000003,No
12658,essex,91,10.58567267,78,6.463089458,6.462319176,7098,68.41614944,17,43,60,69,82,151,4,0.443044,0.458143,0.000002,No
17885,alloy,33,11.60002462,23,7.684304068,7.684084048,759,89.13811635,12,18,30,32,32,64,4,0.442128,0.456894,0.000004,No
6643,offspring,66,10.90687744,53,6.849506371,6.848986246,3498,74.70672648,24,36,60,61,56,117,4,0.46164,0.473048,0.000002,No
4483,restoration,84,10.66571538,62,6.692663899,6.692053725,5208,71.38204827,26,34,60,72,77,149,4,0.464224,0.475039,0.000002,No
14054,czechoslovakia,77,10.75272676,51,6.887972651,6.887472536,3927,74.06448782,27,33,60,62,57,119,4,0.447715,0.461828,0.000002,No
5238,procession,11,12.6986369,9,8.622573707,8.622493705,99,109.4949327,7,8,15,10,9,19,5,0.406266,0.423847,0.000008,No
7434,monica,43,11.33533206,30,7.418600903,7.418310866,1290,84.09230466,14,16,30,36,29,65,5,0.360917,0.373584,0.000004,No
6934,nightmare,27,11.80069531,20,7.824066011,7.823875996,540,92.32941909,14,16,30,26,26,52,4,0.439023,0.454195,0.000004,No
6881,noel,23,11.96103796,18,7.929426526,7.929256515,414,94.84417169,15,15,30,16,18,34,4,0.419576,0.436675,0.000004,No
2324,summertime,32,11.63079627,10,8.517213191,8.517123189,320,99.06197145,17,13,30,22,21,43,4,0.421849,0.439036,0.000004,No
2226,sutton,26,11.83843564,20,7.824066011,7.823875996,520,92.62470191,20,10,30,24,17,41,4,0.391915,0.408958,0.000004,No
14201,crude,46,11.26789078,33,7.323290723,7.322970678,1518,82.51804002,21,9,30,34,41,75,5,0.341497,0.34927,0.000004,No
10918,hahn,11,12.6986369,7,8.873888135,8.873828135,77,112.6862834,8,9,17,10,10,20,4,0.423692,0.440398,0.000007,No
4043,salon,15,12.38848198,13,8.254848927,8.254728922,195,102.2650471,9,8,17,13,12,25,4,0.422552,0.439323,0.000007,No
13469,dispute,85,10.65388092,71,6.557118407,6.556418176,6035,69.85875869,26,33,59,76,74,150,4,0.46787,0.477799,0.000002,No
5324,pregnant,76,10.76579884,67,6.615105665,6.61444546,5092,71.21689687,27,32,59,65,71,136,4,0.461029,0.472513,0.000002,No
14099,custom,57,11.05348091,48,6.948597273,6.948127172,2736,76.80618731,30,29,59,53,47,100,4,0.462832,0.473875,0.000002,No
17237,attempt,151,10.07925234,146,5.836191663,5.834740639,22046,58.82444847,38,21,59,112,145,257,4,0.453155,0.466058,0.000002,No
9022,labrador,52,11.14528846,31,7.38581108,7.385511041,1612,82.31699499,13,26,39,49,39,88,4,0.438979,0.454303,0.000003,No
17583,antwerp,109,10.4051843,93,6.287198791,6.286278386,10137,65.41946212,15,24,39,101,102,203,4,0.453259,0.466194,0.000003,No
10961,gutenberg,49,11.20471188,27,7.523961418,7.52370139,1323,84.30381988,16,23,39,44,36,80,4,0.432192,0.448355,0.000003,No
8328,macdonald,32,11.63079627,26,7.561701746,7.56145172,832,87.9486125,17,22,39,27,26,53,4,0.446487,0.460608,0.000003,No
3227,skater,79,10.72708432,48,6.948597273,6.948127172,3792,74.53818889,18,21,39,70,67,137,4,0.442514,0.45727,0.000003,No
15071,clause,45,11.28986969,21,7.775275846,7.77507583,945,87.78185109,19,20,39,31,37,68,4,0.455387,0.467842,0.000003,No
12352,fallacy,13,12.53158282,8,8.740356743,8.740286741,104,109.5305044,7,6,13,11,10,21,4,0.438037,0.45327,0.000009,No
14782,competitive,45,11.28986969,42,7.082128666,7.08171859,1890,79.95630975,21,18,39,37,22,59,5,0.399078,0.416654,0.000003,No
3438,shirley,33,11.60002462,28,7.487593774,7.487323743,924,86.85627209,21,18,39,24,25,49,4,0.401934,0.419535,0.000003,No
7039,neo,34,11.57017165,16,8.047209562,8.047059554,544,93.10759596,23,16,39,28,19,47,4,0.411408,0.428957,0.000003,No
2936,sought,48,11.22533117,44,7.03560865,7.035178566,2112,78.97703706,27,12,39,38,40,78,4,0.452462,0.465307,0.000003,No
3929,savage,30,11.6953348,25,7.600922459,7.600682435,750,88.89533292,15,14,29,27,21,48,5,0.392834,0.409955,0.000004,No
2040,tamil,122,10.29251113,66,6.630143542,6.629493344,8052,68.24082622,33,25,58,101,60,161,4,0.437583,0.453097,0.000002,No
16977,bangor,47,11.24638458,13,8.254848927,8.254728922,611,92.83720564,33,25,58,42,36,78,5,0.389832,0.407171,0.000002,No
12564,everyday,103,10.46180319,99,6.224678434,6.223697973,10197,65.12136069,35,23,58,95,69,164,4,0.437389,0.452913,0.000002,No
15941,burgess,27,11.80069531,17,7.98658494,7.986424931,459,94.24725546,18,11,29,25,25,50,4,0.425581,0.442158,0.000004,No
2440,structural,74,10.79246708,57,6.776747016,6.776186871,4218,73.13781911,36,22,58,62,36,98,4,0.409009,0.426948,0.000002,No
9447,jenny,19,12.1520932,13,8.254848927,8.254728922,247,100.3136935,9,14,23,9,14,23,4,0.426194,0.442792,0.000005,No
16082,brock,22,12.00548972,16,8.047209562,8.047059554,352,96.6106917,11,12,23,17,13,30,4,0.43293,0.448824,0.000005,No
9151,kindergarten,20,12.1007999,12,8.334891634,8.334781631,240,100.8588559,11,12,23,14,17,31,4,0.410456,0.427962,0.000005,No
11601,gale,20,12.1007999,15,8.111748083,8.111608076,300,98.15864042,12,11,23,15,13,28,4,0.430369,0.44658,0.000005,No
14007,dana,22,12.00548972,18,7.929426526,7.929256515,396,95.19664868,13,10,23,15,13,28,4,0.418863,0.435933,0.000005,No
6696,occupy,40,11.40765272,38,7.182212124,7.181842063,1520,81.9321817,14,24,38,25,36,61,4,0.429359,0.446088,0.000003,No
5241,procedure,44,11.31234254,37,7.208880372,7.208520314,1628,81.54932412,16,22,38,30,36,66,4,0.461389,0.472598,0.000003,No
14421,corsica,52,11.14528846,32,7.354062381,7.35375234,1664,81.96314658,16,22,38,46,42,88,4,0.445155,0.459519,0.000003,No
3867,schedule,41,11.38296011,36,7.236279346,7.235929291,1476,82.37027914,16,22,38,33,32,65,4,0.448292,0.462115,0.000003,No
13311,dough,46,11.26789078,22,7.728755831,7.728545813,1012,87.08677657,16,22,38,39,39,78,4,0.455668,0.46811,0.000003,No
8446,louisville,25,11.87765635,18,7.929426526,7.929256515,450,94.18300335,9,10,19,22,20,42,4,0.375135,0.390457,0.000006,No
12608,euler,36,11.51301324,17,7.98658494,7.986424931,612,91.94965815,19,19,38,21,25,46,4,0.438275,0.453594,0.000003,No
17320,ass,17,12.26331883,11,8.421903011,8.421803008,187,103.2804818,10,9,19,15,12,27,4,0.436743,0.452083,0.000006,No
2825,spike,39,11.40765272,24,7.600922459,7.600682435,936,86.70868379,20,18,38,33,33,66,4,0.449654,0.463124,0.000003,No
7035,neon,31,11.66254497,18,7.929426526,7.929256515,558,92.47729347,20,18,38,23,20,43,4,0.415073,0.432534,0.000003,No
2997,solute,23,11.96103796,10,8.517213191,8.517123189,230,101.8747103,11,8,19,22,13,35,4,0.437098,0.452477,0.000006,No
352,wiener,27,11.80069531,16,8.047209562,8.047059554,432,94.96266815,12,7,19,17,7,24,4,0.413352,0.430764,0.000006,No
15335,chattanooga,13,12.53158282,7,8.873888135,8.873828135,91,111.2038641,12,7,19,13,12,25,5,0.34765,0.356995,0.000006,No
10514,hide,96,10.53218399,83,6.400957676,6.400137356,7968,67.41606393,21,36,57,80,84,164,4,0.45027,0.464007,0.000002,No
11140,grave,71,10.8338523,59,6.74226084,6.741680684,4189,73.04465811,24,33,57,60,56,116,4,0.46241,0.473621,0.000002,No
2353,suffolk,76,10.76579884,53,6.849506371,6.848986246,4028,73.74040772,24,33,57,59,69,128,4,0.458114,0.470236,0.000002,No
8216,malay,76,10.76579884,38,7.182212124,7.181842063,2888,77.32225094,27,30,57,61,64,125,4,0.440986,0.45611,0.000002,No
14634,conquest,124,10.27625061,111,6.110268083,6.109167499,13764,62.79064612,34,23,57,116,115,231,4,0.446039,0.460242,0.000002,No
5098,provence,33,11.60002462,28,7.487593774,7.487323743,924,86.85627209,7,21,28,30,30,60,4,0.433427,0.449407,0.000004,No
12994,einstein,75,10.77904406,53,6.849506371,6.848986246,3975,73.83113098,20,36,56,66,59,125,4,0.434148,0.450411,0.000002,No
7610,millennium,110,10.39605181,94,6.276503502,6.275573088,10340,65.2508556,21,35,56,106,71,177,4,0.455177,0.46796,0.000002,No
14740,computation,11,12.6986369,9,8.622573707,8.622493705,99,109.4949327,6,8,14,8,9,17,4,0.420889,0.437863,0.000008,No
3121,slur,11,12.6986369,8,8.740356743,8.740286741,88,110.9906167,6,8,14,10,10,20,4,0.382713,0.399062,0.000008,No
1459,tracy,25,11.87765635,20,7.824066011,7.823875996,500,92.93156735,12,16,28,18,17,35,4,0.43274,0.448848,0.000004,No
10127,icon,60,11.00218762,43,7.058598169,7.058178089,2580,77.66002135,26,30,56,43,52,95,4,0.45304,0.466124,0.000002,No
14974,coastline,74,10.79246708,68,6.600290579,6.599620368,5032,71.23341882,27,29,56,63,67,130,4,0.444965,0.459486,0.000002,No
342,wildcat,17,12.26331883,11,8.421903011,8.421803008,187,103.2804818,8,8,16,14,10,24,4,0.430327,0.446393,0.000007,No
15018,cloak,13,12.53158282,12,8.334891634,8.334781631,156,104.4493848,8,8,16,12,11,23,4,0.417366,0.434478,0.000007,No
7471,molasses,20,12.1007999,10,8.517213191,8.517123189,200,103.0650926,14,14,28,17,18,35,4,0.434978,0.450627,0.000004,No
4072,sailor,67,10.89183956,42,7.082128666,7.08171859,2814,77.13740916,28,28,56,58,51,109,4,0.415607,0.433239,0.000002,No
5647,plato,62,10.96939779,32,7.354062381,7.35375234,1984,80.66963565,28,28,56,48,42,90,4,0.433713,0.449777,0.000002,No
14242,criteria,28,11.76432767,26,7.561701746,7.56145172,728,88.95833706,15,13,28,19,24,43,4,0.430035,0.446341,0.000004,No
12705,erect,25,11.87765635,19,7.875359305,7.875179292,475,93.54081148,15,13,28,21,20,41,4,0.41715,0.434431,0.000004,No
18051,agile,12,12.61162553,12,8.334891634,8.334781631,144,105.1165321,9,7,16,9,7,16,5,0.396387,0.413598,0.000007,No
2140,symposium,4,13.71023782,4,9.433503923,9.433473923,16,129.3355822,4,3,7,4,3,7,5,0.382342,0.399045,0.000016,No
5403,posture,13,12.53158282,13,8.254848927,8.254728922,169,103.446323,8,6,14,8,6,14,4,0.425398,0.441895,0.000008,No
5175,pronunciation,81,10.70208302,70,6.571303042,6.570612818,5670,70.32663072,33,23,56,58,68,126,4,0.431751,0.448008,0.000002,No
15488,cecil,47,11.24638458,27,7.523961418,7.52370139,1269,84.61736364,33,23,56,38,29,67,5,0.360331,0.373079,0.000002,No
17023,bald,44,11.31234254,33,7.323290723,7.322970678,1452,82.8435732,14,23,37,41,39,80,4,0.433395,0.449407,0.000003,No
5463,porcelain,37,11.48561426,17,7.98658494,7.986424931,629,91.73083391,17,20,37,25,30,55,4,0.452866,0.465791,0.000003,No
10916,haiku,28,11.76432767,11,8.421903011,8.421803008,308,99.07802661,18,19,37,21,24,45,4,0.440351,0.455373,0.000003,No
13230,drought,39,11.43297053,32,7.354062381,7.35375234,1248,84.07877849,19,18,37,30,30,60,4,0.455996,0.468283,0.000003,No
4902,quartz,38,11.45894602,20,7.824066011,7.823875996,760,89.65555005,19,18,37,33,29,62,4,0.405487,0.423103,0.000003,No
12928,ellen,35,11.54118412,19,7.875359305,7.875179292,665,90.89097172,19,18,37,28,24,52,5,0.400194,0.417758,0.000003,No
6556,opel,42,11.35886256,15,8.111748083,8.111608076,630,92.14023159,19,18,37,27,23,50,4,0.435191,0.450937,0.000003,No
5990,pepsi,25,11.87765635,13,8.254848927,8.254728922,325,98.04825879,19,18,37,23,20,43,4,0.398004,0.41546,0.000003,No
13359,donna,36,11.51301324,25,7.600922459,7.600682435,900,87.5095209,20,17,37,27,28,55,4,0.393208,0.410475,0.000003,No
4278,roe,28,11.76432767,13,8.254848927,8.254728922,364,97.11274762,25,12,37,26,26,52,4,0.403643,0.421173,0.000003,No
2337,sulfide,26,11.83843564,16,8.047209562,8.047059554,416,95.26637248,7,15,22,25,24,49,4,0.456864,0.468913,0.000005,No
3369,siam,24,11.91847835,19,7.875359305,7.875179292,456,93.86229935,11,11,22,18,15,33,4,0.43014,0.446303,0.000005,No
10338,horatio,23,11.96103796,20,7.824066011,7.823875996,460,93.58395057,16,6,22,19,18,37,5,0.336895,0.343018,0.000005,No
13374,dominant,82,10.68981293,69,6.58569178,6.585011562,5658,70.39981314,17,38,55,76,62,138,4,0.461929,0.473335,0.000002,No
3330,signature,70,10.84803694,49,6.927977986,6.92749788,3430,75.15496108,20,35,55,64,61,125,4,0.452359,0.465673,0.000002,No
277,wish,75,10.77904406,67,6.615105665,6.61444546,5025,71.30451545,29,26,55,69,71,140,4,0.45027,0.46381,0.000002,No
16200,brandenburg,103,10.46180319,70,6.571303042,6.570612818,7210,68.74767912,18,36,54,92,87,179,4,0.452832,0.466077,0.000002,No
15267,childbirth,25,11.87765635,21,7.775275846,7.77507583,525,92.35205455,11,16,27,22,23,45,4,0.439708,0.454749,0.000004,No
5404,postulate,24,11.91847835,10,8.517213191,8.517123189,240,101.512221,11,16,27,24,21,45,4,0.440997,0.45588,0.000004,No
10130,icelandic,56,11.07118049,39,7.156236638,7.155856573,2184,79.22798743,22,32,54,48,41,89,4,0.434509,0.450566,0.000002,No
1507,torque,39,11.43297053,17,7.98658494,7.986424931,663,91.31039027,15,21,36,31,32,63,4,0.451037,0.464345,0.000003,No
1712,thracian,7,13.15062203,6,9.028038815,9.027988815,42,118.7243261,4,5,9,7,6,13,5,0.329021,0.333114,0.000012,No
3537,shaft,59,11.01899473,32,7.354062381,7.35375234,1888,81.03437465,24,30,54,46,49,95,4,0.457359,0.469584,0.000002,No
2864,spectacular,26,11.83843564,26,7.561701746,7.56145172,676,89.51871945,13,14,27,23,16,39,4,0.419626,0.436896,0.000004,No
4616,regent,86,10.64218488,78,6.463089458,6.462319176,6708,68.78139291,26,28,54,62,75,137,4,0.460371,0.471945,0.000002,No
14467,corey,18,12.20616042,17,7.98658494,7.986424931,306,97.48553698,9,9,18,10,15,25,4,0.389815,0.407015,0.000006,No
16020,buck,29,11.72923635,24,7.641744454,7.641514432,696,89.63182681,18,18,36,21,23,44,4,0.442315,0.457026,0.000003,No
16476,bleed,30,11.6953348,21,7.775275846,7.77507583,630,90.93445415,19,17,36,27,21,48,4,0.44785,0.461669,0.000003,No
334,wilfred,7,13.15062203,7,8.873888135,8.873828135,49,116.6971488,5,4,9,5,6,11,5,0.398398,0.416194,0.000012,No
1719,thou,18,12.20616042,14,8.180740955,8.180610949,252,99.85543644,10,8,18,17,12,29,4,0.402189,0.419873,0.000006,No
1603,titanium,13,12.53158282,9,8.622573707,8.622493705,117,108.0544965,10,8,18,10,11,21,4,0.39266,0.409686,0.000006,No
9915,indigo,32,11.63079627,15,8.111748083,8.111608076,480,94.34608939,15,12,27,26,27,53,4,0.405357,0.42291,0.000004,No
16248,bowel,8,13.01709064,8,8.740356743,8.740286741,64,113.7740159,6,3,9,8,5,13,5,0.385205,0.401496,0.000012,No
17221,aubrey,11,12.6986369,11,8.421903011,8.421803008,121,106.9466884,10,2,12,10,6,16,5,0.314199,0.319204,0.000009,No
18219,acre,50,11.18450917,37,7.208880372,7.208520314,1850,80.62778864,20,33,53,44,48,92,4,0.451507,0.464964,0.000002,No
8696,libya,55,11.08919899,41,7.106226218,7.105826145,2255,78.80235661,25,28,53,48,44,92,4,0.44215,0.457096,0.000002,No
3715,secant,2,14.403385,1,10.81979828,10.81979828,2,155.8417203,1,1,2,1,2,3,5,0.384246,0.400407,0.000053,No
25,zigzag,1,15.09653218,1,10.81979828,10.81979828,1,163.341433,1,1,2,1,1,2,5,0.320271,0.323474,0.000053,No
1543,tonk,1,15.09653218,1,10.81979828,10.81979828,1,163.341433,1,1,2,1,1,2,5,0.32338,0.326626,0.000053,No
1678,thump,1,15.09653218,1,10.81979828,10.81979828,1,163.341433,1,1,2,1,1,2,5,0.336034,0.342026,0.000053,No
6583,omniscient,1,15.09653218,1,10.81979828,10.81979828,1,163.341433,1,1,2,1,1,2,5,0.384246,0.400407,0.000053,No
9160,kilgore,1,15.09653218,1,10.81979828,10.81979828,1,163.341433,1,1,2,1,1,2,5,0.398085,0.415828,0.000053,No
12002,floorboard,1,15.09653218,1,10.81979828,10.81979828,1,163.341433,1,1,2,1,1,2,5,0.323245,0.326485,0.000053,No
15118,citrate,1,15.09653218,1,10.81979828,10.81979828,1,163.341433,1,1,2,1,1,2,5,0.320149,0.323382,0.000053,No
16642,bespectacled,1,15.09653218,1,10.81979828,10.81979828,1,163.341433,1,1,2,1,1,2,5,0.319717,0.32343,0.000053,No
16864,bator,1,15.09653218,1,10.81979828,10.81979828,1,163.341433,1,1,2,1,1,2,5,0.345606,0.354483,0.000053,No
10971,guru,89,10.60789581,38,7.182212124,7.181842063,3382,76.18815788,30,23,53,69,40,109,4,0.460013,0.471537,0.000002,No
18034,ahead,71,10.8338523,67,6.615105665,6.61444546,4757,71.66707772,34,19,53,51,66,117,4,0.443553,0.458162,0.000002,No
9702,interception,20,12.1007999,8,8.740356743,8.740286741,160,105.765308,8,13,21,15,18,33,4,0.442029,0.456716,0.000005,No
1237,tub,12,12.61162553,9,8.622573707,8.622493705,108,108.7446707,6,9,15,12,10,22,4,0.414153,0.431591,0.000007,No
10077,illusion,24,11.91847835,19,7.875359305,7.875179292,456,93.86229935,9,12,21,23,22,45,4,0.429224,0.445604,0.000005,No
13832,deformation,19,12.1520932,9,8.622573707,8.622493705,171,104.7823193,9,12,21,18,14,32,4,0.42205,0.439079,0.000005,No
6953,nicosia,15,12.38848198,6,9.028038815,9.027988815,90,111.8436961,9,12,21,13,15,28,4,0.429515,0.445764,0.000005,No
6019,penn,41,11.38296011,26,7.561701746,7.56145172,1066,86.07454935,16,19,35,33,26,59,4,0.434892,0.450627,0.000003,No
14424,corrupt,29,11.72923635,26,7.561701746,7.56145172,754,88.69298697,16,19,35,26,21,47,4,0.438643,0.453937,0.000003,No
10426,hoffman,30,11.6953348,15,8.111748083,8.111608076,450,94.86960961,16,19,35,19,23,42,4,0.409141,0.426769,0.000003,No
15913,burundi,32,11.60002462,13,8.180740955,8.180610949,416,94.89679645,16,19,35,29,28,57,4,0.418271,0.43567,0.000003,No
16266,boulder,22,12.00548972,21,7.775275846,7.77507583,462,93.34599428,10,11,21,21,18,39,4,0.401379,0.41884,0.000005,No
11357,glacial,33,11.60002462,26,7.561701746,7.56145172,858,87.71592639,17,18,35,26,25,51,5,0.385849,0.4025,0.000003,No
15835,cain,17,12.26331883,14,8.180740955,8.180610949,238,100.3230346,11,10,21,14,15,29,5,0.402828,0.420288,0.000005,No
6213,parsley,14,12.45747485,9,8.622573707,8.622493705,126,107.4154951,11,10,21,11,13,24,4,0.402928,0.420404,0.000005,No
11959,fm,39,11.43297053,25,7.600922459,7.600682435,975,86.90112249,20,15,35,27,30,57,4,0.450373,0.463678,0.000003,No
842,versailles,69,10.86242567,50,6.907775279,6.907285168,3450,75.03519553,15,37,52,64,64,128,4,0.456782,0.469293,0.000002,No
17597,antioch,70,10.84803694,54,6.830814238,6.830284108,3780,74.10092515,17,35,52,65,46,111,4,0.443842,0.458646,0.000002,No
14488,copenhagen,76,10.76579884,45,7.013135794,7.012695706,3420,75.50200918,17,35,52,60,65,125,4,0.450945,0.464509,0.000002,No
5755,pill,26,11.83843564,8,8.740356743,8.740286741,208,103.4721508,9,17,26,25,22,47,4,0.452266,0.465255,0.000004,No
6094,peaceful,46,11.26789078,45,7.013135794,7.012695706,2070,79.02324816,21,31,52,38,36,74,4,0.441974,0.456984,0.000002,No
5583,pm,29,11.72923635,23,7.684304068,7.684084048,667,90.13101858,11,15,26,25,26,51,4,0.439937,0.454951,0.000004,No
11928,font,23,11.96103796,15,8.111748083,8.111608076,345,97.02492676,11,15,26,19,20,39,4,0.446589,0.460566,0.000004,No
11463,genoa,62,10.96939779,48,6.948597273,6.948127172,2976,76.22192759,24,28,52,57,48,105,4,0.446892,0.461054,0.000002,No
16631,bet,54,11.10754813,33,7.323290723,7.322970678,1782,81.34380418,24,28,52,40,38,78,4,0.443254,0.458021,0.000002,No
1106,ulan,2,14.403385,2,10.1266511,10.1266411,4,145.8580546,1,1,2,1,1,2,6,0.256851,0.260275,0.000052,No
10358,honky,2,14.403385,2,10.1266511,10.1266411,4,145.8580546,1,1,2,2,1,3,6,0.244369,0.245819,0.000052,No
1397,transmittance,1,15.09653218,1,10.81979828,10.81979828,1,163.341433,1,1,2,1,1,2,1,1,1,0.000052,No
3780,scrawny,1,15.09653218,1,10.81979828,10.81979828,1,163.341433,1,1,2,1,1,2,6,0.242275,0.243954,0.000052,No
6584,omnipotent,1,15.09653218,1,10.81979828,10.81979828,1,163.341433,1,1,2,1,1,2,6,0.277598,0.283494,0.000052,No
10128,icky,1,15.09653218,1,10.81979828,10.81979828,1,163.341433,1,1,2,1,1,2,6,0.25153,0.253922,0.000052,No
10234,humpty,1,15.09653218,1,10.81979828,10.81979828,1,163.341433,1,1,2,1,1,2,1,1,1,0.000052,No
11242,goober,1,15.09653218,1,10.81979828,10.81979828,1,163.341433,1,1,2,1,1,2,6,0.284941,0.291353,0.000052,No
12684,erratic,1,15.09653218,1,10.81979828,10.81979828,1,163.341433,1,1,2,1,1,2,6,0.242589,0.244059,0.000052,No
14270,creepy,1,15.09653218,1,10.81979828,10.81979828,1,163.341433,1,1,2,1,1,2,6,0.244296,0.245744,0.000052,No
14398,cotangent,1,15.09653218,1,10.81979828,10.81979828,1,163.341433,1,1,2,1,1,2,6,0.277598,0.283494,0.000052,No
4355,riley,19,12.1520932,12,8.334891634,8.334781631,228,101.2863799,13,13,26,19,13,32,4,0.390819,0.407799,0.000004,No
3210,skip,20,12.1007999,18,7.929426526,7.929256515,360,95.95240375,15,11,26,17,17,34,4,0.436346,0.451787,0.000004,No
12983,elaine,18,12.20616042,12,8.334891634,8.334781631,216,101.7370244,15,11,26,15,12,27,5,0.388995,0.405986,0.000004,No
4696,rebecca,27,11.80069531,25,7.600922459,7.600682435,675,89.69617003,17,9,26,19,14,33,5,0.386437,0.402984,0.000004,No
6120,paulo,109,10.4051843,67,6.615105665,6.61444546,7303,68.83139357,5,29,34,13,63,76,4,0.459573,0.471326,0.000003,No
3695,sedan,37,11.48561426,17,7.98658494,7.986424931,629,91.73083391,12,22,34,27,33,60,4,0.447692,0.461594,0.000003,No
12645,estuary,51,11.16470654,42,7.082128666,7.08171859,2142,79.06988827,13,21,34,30,47,77,4,0.45161,0.464819,0.000003,No
6414,oven,52,11.14528846,28,7.487593774,7.487323743,1456,83.45139247,13,21,34,44,37,81,4,0.451978,0.465096,0.000003,No
15820,calculate,61,10.98565831,54,6.830814238,6.830284108,3294,75.04099122,14,20,34,58,57,115,4,0.431751,0.447979,0.000003,No
3930,sausage,37,11.48561426,17,7.98658494,7.986424931,629,91.73083391,14,20,34,33,27,60,4,0.419953,0.437196,0.000003,No
9052,krishna,40,11.40765272,27,7.523961418,7.52370139,1080,85.83073896,15,19,34,30,29,59,4,0.443033,0.457655,0.000003,No
14587,consultant,14,12.45747485,13,8.254848927,8.254728922,182,102.8345729,8,9,17,10,13,23,4,0.406872,0.42437,0.000006,No
5915,persona,12,12.61162553,12,8.334891634,8.334781631,144,105.1165321,8,9,17,9,10,19,4,0.42203,0.438877,0.000006,No
2386,substrate,13,12.53158282,4,9.433503923,9.433473923,52,118.2167357,8,9,17,10,10,20,4,0.427477,0.444055,0.000006,No
11397,gibraltar,52,11.14528846,28,7.487593774,7.487323743,1456,83.45139247,24,27,51,47,44,91,4,0.449996,0.463589,0.000002,No
10958,guyana,42,11.35886256,24,7.641744454,7.641514432,1008,86.80152496,24,27,51,36,33,69,4,0.433554,0.449632,0.000002,No
6127,patton,40,11.40765272,14,8.180740955,8.180610949,560,93.32305183,24,27,51,37,34,71,4,0.454979,0.467626,0.000002,No
13211,dual,35,11.54118412,28,7.487593774,7.487323743,980,86.41569833,17,17,34,26,25,51,5,0.364093,0.37763,0.000003,No
10228,hung,26,11.83843564,25,7.600922459,7.600682435,650,89.98303133,17,17,34,22,24,46,4,0.429235,0.445689,0.000003,No
10591,herd,41,11.38296011,21,7.775275846,7.77507583,861,88.50565481,18,16,34,38,32,70,4,0.432434,0.448529,0.000003,No
9830,infrastructure,56,11.07118049,43,7.058598169,7.058178089,2408,78.14701431,27,24,51,41,39,80,4,0.445669,0.459983,0.000002,No
2233,suspension,50,11.18450917,35,7.264450223,7.264110172,1750,81.24931015,19,15,34,37,37,74,4,0.449347,0.462852,0.000003,No
5018,punch,58,11.03608917,28,7.487593774,7.487323743,1624,82.63375254,31,20,51,47,40,87,4,0.432571,0.448641,0.000002,No
11362,giuseppe,44,11.31234254,42,7.082128666,7.08171859,1848,80.11546541,25,9,34,34,23,57,5,0.398899,0.416777,0.000003,No
4762,randy,44,11.31234254,36,7.236279346,7.235929291,1584,81.8592707,27,7,34,35,14,49,5,0.321605,0.325457,0.000003,No
6010,pentagon,33,11.60002462,20,7.824066011,7.823875996,660,90.75935832,4,16,20,33,28,61,4,0.450499,0.4638,0.000005,No
4551,renewal,7,13.15062203,7,8.873888135,8.873828135,49,116.6971488,4,6,10,6,6,12,5,0.411579,0.428921,0.00001,No
5851,phenylalanine,7,13.15062203,2,10.1266511,10.1266411,14,133.1717611,4,6,10,4,6,10,4,0.424107,0.440736,0.00001,No
2998,soluble,21,12.05200974,18,7.929426526,7.929256515,378,95.56552572,12,8,20,17,18,35,5,0.410608,0.428006,0.000005,No
16,zodiac,34,11.57017165,19,7.875359305,7.875179292,646,91.11925899,8,17,25,27,30,57,4,0.4466,0.460589,0.000004,No
6733,obituary,25,11.87765635,20,7.824066011,7.823875996,500,92.93156735,10,15,25,13,23,36,4,0.451128,0.464307,0.000004,No
4035,salvador,80,10.71450554,60,6.725453722,6.72486356,4800,72.05991118,20,30,50,75,45,120,4,0.446196,0.460523,0.000002,No
10828,hansen,27,11.80069531,18,7.929426526,7.929256515,486,93.57274643,12,13,25,14,16,30,5,0.360412,0.372821,0.000004,No
132,xylem,38,11.45894602,15,8.111748083,8.111608076,570,92.95208339,13,12,25,26,17,43,4,0.424472,0.441186,0.000004,No
10273,hub,68,10.87702447,55,6.812465099,6.811924964,3740,74.0993496,26,24,50,57,62,119,4,0.460002,0.471565,0.000002,No
12595,europa,64,10.93764909,26,7.561701746,7.56145172,1664,82.70724025,26,24,50,37,56,93,4,0.456347,0.468654,0.000002,No
16882,basque,75,10.77904406,26,7.561701746,7.56145172,1950,81.50791632,27,23,50,67,57,124,4,0.442668,0.457425,0.000002,No
5009,punjabi,69,10.86242567,45,7.013135794,7.012695706,3105,76.1796663,29,21,50,60,49,109,4,0.443188,0.457833,0.000002,No
8774,lenin,41,11.38296011,27,7.523961418,7.52370139,1107,85.6449527,11,22,33,28,30,58,4,0.42683,0.443557,0.000003,No
10704,heal,36,11.51301324,30,7.418600903,7.418310866,1080,85.41045041,13,20,33,33,28,61,4,0.446678,0.460692,0.000003,No
13315,doubt,37,11.48561426,29,7.452502454,7.452222421,1073,85.5965685,13,20,33,35,33,68,4,0.455902,0.468218,0.000003,No
6611,olfactory,16,12.32394346,5,9.210360372,9.210320372,80,113.5079604,5,6,11,15,14,29,5,0.327431,0.3314,0.000009,No
12096,fishermen,29,11.72923635,24,7.641744454,7.641514432,696,89.63182681,15,18,33,23,24,47,5,0.410077,0.427696,0.000003,No
6491,oriental,69,10.86242567,58,6.759355274,6.758785123,4002,73.42299426,16,17,33,55,51,106,4,0.399986,0.417573,0.000003,No
5807,phylum,56,11.07118049,40,7.13091883,7.130528762,2240,78.9476894,16,17,33,54,32,86,4,0.417739,0.435069,0.000003,No
5318,premiere,39,11.43297053,38,7.182212124,7.181842063,1482,82.11401957,17,16,33,34,37,71,4,0.427313,0.443952,0.000003,No
673,voluntary,28,11.76432767,24,7.641744454,7.641514432,672,89.8999857,17,16,33,25,16,41,4,0.408106,0.42584,0.000003,No
13310,dougherty,6,13.30477271,4,9.433503923,9.433473923,24,125.5106255,6,5,11,6,5,11,5,0.35519,0.366471,0.000009,No
2077,tag,102,10.47155936,57,6.776747016,6.776186871,5814,70.96310868,20,13,33,59,98,157,4,0.436969,0.452482,0.000003,No
8091,marilyn,43,11.33533206,29,7.452502454,7.452222421,1247,84.47659001,24,9,33,30,23,53,4,0.426123,0.442623,0.000003,No
5183,promote,96,10.53218399,95,6.265921393,6.264980969,9120,65.99383695,12,37,49,88,73,161,4,0.446027,0.460523,0.000002,No
13878,deck,72,10.81986606,43,7.058598169,7.058178089,3096,76.37308674,16,33,49,60,64,124,4,0.467796,0.477743,0.000002,No
13064,economist,70,10.84803694,62,6.692663899,6.692053725,4340,72.60226517,18,31,49,49,58,107,4,0.421799,0.43913,0.000002,No
2578,stern,41,11.38296011,23,7.684304068,7.684084048,943,87.47012669,22,27,49,40,32,72,4,0.450202,0.463777,0.000002,No
8416,lucky,61,10.98565831,48,6.948597273,6.948127172,2928,76.3349154,24,25,49,49,42,91,4,0.448393,0.462256,0.000002,No
10863,handel,68,10.87702447,40,7.13091883,7.130528762,2720,77.56317862,24,25,49,33,51,84,4,0.43595,0.451665,0.000002,No
13457,distant,76,10.76579884,73,6.529338843,6.528618598,5548,70.29354852,27,22,49,73,34,107,4,0.400149,0.417807,0.000002,No
2380,suburb,166,9.984544389,152,5.795917763,5.794406652,25232,57.86959818,33,16,49,156,155,311,4,0.45319,0.465988,0.000002,No
3967,sarcastic,12,12.61162553,7,8.873888135,8.873828135,84,111.9141541,6,10,16,10,12,22,4,0.429131,0.44536,0.000006,No
6950,niece,32,11.63079627,32,7.354062381,7.35375234,1024,85.53360135,12,20,32,29,30,59,5,0.407666,0.425358,0.000003,No
8894,latvia,64,10.93764909,43,7.058598169,7.058178089,2752,77.20446986,18,30,48,50,53,103,4,0.455014,0.46772,0.000002,No
1194,turf,34,11.57017165,17,7.98658494,7.986424931,578,92.40615868,13,19,32,28,28,56,4,0.452186,0.465223,0.000003,No
5587,plutonium,28,11.76432767,17,7.98658494,7.986424931,476,93.95680218,13,19,32,24,26,50,4,0.418656,0.435961,0.000003,No
15773,camel,23,11.96103796,18,7.929426526,7.929256515,414,94.84417169,11,13,24,18,14,32,4,0.414191,0.431713,0.000004,No
15920,burr,26,11.83843564,12,8.334891634,8.334781631,312,98.67207817,11,13,24,23,18,41,4,0.434265,0.449998,0.000004,No
14723,concerto,81,10.70208302,48,6.948597273,6.948127172,3888,74.36446491,22,26,48,71,65,136,4,0.45697,0.469213,0.000002,No
2251,surrender,62,10.96939779,53,6.849506371,6.848986246,3286,75.13496006,23,25,48,54,56,110,4,0.454851,0.467509,0.000002,No
6946,niger,57,11.05348091,27,7.523961418,7.52370139,1539,83.1659639,23,25,48,49,47,96,4,0.454129,0.466917,0.000002,No
7241,munson,3,13.99791989,3,9.721185996,9.721165996,9,136.0763828,3,3,6,3,3,6,4,0.406425,0.423981,0.000016,No
7550,mira,14,12.45747485,8,8.740356743,8.740286741,112,108.8827743,8,8,16,9,10,19,4,0.409207,0.426751,0.000006,No
2956,sophie,30,11.6953348,26,7.561701746,7.56145172,780,88.43663355,12,12,24,19,16,35,4,0.430484,0.446627,0.000004,No
9614,ionic,30,11.6953348,19,7.875359305,7.875179292,570,92.10496371,12,12,24,27,16,43,5,0.396458,0.413814,0.000004,No
18128,advent,30,11.6953348,16,8.047209562,8.047059554,480,94.11481,16,16,32,26,28,54,4,0.441019,0.455899,0.000003,No
16501,blackwell,26,11.83843564,14,8.180740955,8.180610949,364,96.84717527,16,16,32,22,17,39,4,0.434211,0.449984,0.000003,No
2730,squash,24,11.91847835,9,8.622573707,8.622493705,216,102.767958,16,16,32,18,18,36,4,0.419041,0.436398,0.000003,No
11207,gouda,25,11.87765635,4,9.433503923,9.433473923,100,112.0479178,16,16,32,20,25,45,4,0.425235,0.441942,0.000003,No
14451,cornish,46,11.26789078,28,7.487593774,7.487323743,1288,84.36938886,24,24,48,40,37,77,4,0.431132,0.447425,0.000002,No
4046,sally,46,11.26789078,33,7.323290723,7.322970678,1518,82.51804002,26,22,48,37,28,65,5,0.399231,0.416852,0.000002,No
18277,accent,45,11.28986969,26,7.561701746,7.56145172,1170,85.37062733,26,22,48,34,39,73,4,0.449575,0.463166,0.000002,No
3555,sewage,16,12.32394346,15,8.111748083,8.111608076,240,99.9687247,9,7,16,12,10,22,5,0.397132,0.414387,0.000006,No
12248,felicity,13,12.53158282,4,9.433503923,9.433473923,52,118.2167357,9,7,16,9,8,17,4,0.428158,0.444463,0.000006,No
8749,lesotho,22,12.00548972,10,8.517213191,8.517123189,220,102.2533154,14,10,24,20,16,36,4,0.402216,0.419681,0.000004,No
4751,rap,60,11.00218762,50,6.907775279,6.907285168,3000,76.00063962,29,19,48,52,42,94,5,0.409566,0.427213,0.000002,No
11377,gin,19,12.1520932,8,8.740356743,8.740286741,152,106.2136297,16,8,24,18,15,33,4,0.405135,0.422624,0.000004,No
16339,bonus,81,10.70208302,62,6.692663899,6.692053725,5022,71.62544469,34,14,48,68,50,118,5,0.395954,0.413462,0.000002,No
12893,embedded,48,11.22533117,38,7.182212124,7.181842063,1824,80.6227096,23,9,32,39,28,67,4,0.427251,0.443853,0.000003,No
14794,compassion,18,12.20616042,15,8.111748083,8.111608076,270,99.01329838,9,10,19,14,13,27,4,0.434807,0.450416,0.000005,No
7635,migratory,16,12.32394346,14,8.180740955,8.180610949,224,100.8189889,9,10,19,14,11,25,4,0.412392,0.429971,0.000005,No
14456,cornelius,21,12.05200974,21,7.775275846,7.77507583,441,93.70770023,11,8,19,12,9,21,5,0.34632,0.355453,0.000005,No
17091,azure,17,12.26331883,6,9.028038815,9.027988815,102,110.7137184,11,8,19,15,14,29,5,0.400203,0.417678,0.000005,No
2031,tangent,18,12.20616042,9,8.622573707,8.622493705,162,105.2485179,12,7,19,16,13,29,4,0.432382,0.448238,0.000005,No
14260,cretaceous,133,10.20618305,106,6.15635919,6.155308659,14098,62.83292881,8,39,47,53,112,165,4,0.465661,0.476231,0.000002,No
4905,quartet,69,10.86242567,35,7.264450223,7.264110172,2415,78.9095506,12,35,47,52,50,102,4,0.45035,0.464044,0.000002,No
16352,bonaparte,79,10.72708432,67,6.615105665,6.61444546,5293,70.96079628,14,33,47,75,48,123,4,0.448597,0.46257,0.000002,No
4024,samoa,55,11.07118049,29,7.418600903,7.418310866,1595,82.13266955,14,33,47,26,47,73,4,0.454071,0.467016,0.000002,No
14530,controversy,80,10.71450554,69,6.58569178,6.585011562,5520,70.56243108,16,31,47,54,73,127,4,0.452335,0.465584,0.000002,No
16245,bowie,46,11.26789078,22,7.728755831,7.728545813,1012,87.08677657,16,31,47,43,40,83,5,0.409897,0.42771,0.000002,No
1228,tudor,65,10.92214491,50,6.907775279,6.907285168,3250,75.44772258,19,28,47,62,57,119,4,0.439588,0.45489,0.000002,No
2358,suffer,64,10.93764909,63,6.676663558,6.676043378,4032,73.02700311,20,27,47,58,63,121,4,0.437831,0.453486,0.000002,No
4681,recipe,45,11.28986969,33,7.323290723,7.322970678,1485,82.67899794,21,26,47,40,37,77,4,0.451484,0.4648,0.000002,No
7675,michelangelo,63,10.95339745,37,7.208880372,7.208520314,2331,78.96173189,23,24,47,52,42,94,4,0.428592,0.445238,0.000002,No
8080,maritime,57,11.05348091,43,7.058598169,7.058178089,2451,78.0220801,24,23,47,38,39,77,4,0.423996,0.440947,0.000002,No
16027,bubble,50,11.18450917,23,7.684304068,7.684084048,1150,85.94516933,25,22,47,35,43,78,4,0.42756,0.444299,0.000002,No
4698,rear,69,10.86242567,60,6.725453722,6.72486356,4140,73.05474117,26,21,47,62,50,112,4,0.447546,0.461481,0.000002,No
14780,compilation,74,10.79246708,66,6.630143542,6.629493344,4884,71.55560594,28,19,47,53,51,104,4,0.439349,0.454524,0.000002,No
6920,nineteen,55,11.08919899,54,6.830814238,6.830284108,2970,75.74825836,28,19,47,46,33,79,4,0.451633,0.464795,0.000002,No
14691,confederate,97,10.5218212,73,6.529338843,6.528618598,7081,68.70053585,29,18,47,87,41,128,4,0.396662,0.414136,0.000002,No
3376,shut,72,10.81986606,58,6.759355274,6.758785123,4176,73.1353187,31,16,47,54,66,120,4,0.425286,0.442013,0.000002,No
702,vladimir,84,10.66571538,73,6.529338843,6.528618598,6132,69.64006971,34,13,47,58,26,84,4,0.424137,0.441003,0.000002,No
3936,saudi,112,10.37803331,82,6.413079037,6.412268725,9184,66.55514784,39,8,47,98,100,198,5,0.331968,0.336697,0.000002,No
9606,ira,26,11.83843564,13,8.254848927,8.254728922,338,97.72449773,13,18,31,26,19,45,4,0.437993,0.453331,0.000003,No
319,willis,32,11.63079627,23,7.684304068,7.684084048,736,89.37457513,14,17,31,30,26,56,4,0.432055,0.448087,0.000003,No
13386,doll,31,11.66254497,19,7.875359305,7.875179292,589,91.84673207,14,17,31,24,25,49,4,0.46079,0.472058,0.000003,No
14896,collapse,61,10.98565831,58,6.759355274,6.758785123,3538,74.25596745,15,16,31,49,55,104,4,0.454071,0.466697,0.000003,No
7358,morphology,37,11.48561426,18,7.929426526,7.929256515,666,91.07433442,15,16,31,20,30,50,4,0.438069,0.453374,0.000003,No
1683,thrust,34,11.57017165,16,8.047209562,8.047059554,544,93.10759596,16,15,31,28,23,51,4,0.440275,0.455294,0.000003,No
12930,ell,24,11.91847835,3,9.721185996,9.721165996,72,115.8617448,16,15,31,19,17,36,4,0.401543,0.419361,0.000003,No
3249,sioux,43,11.33533206,17,7.98658494,7.986424931,731,90.53059234,17,14,31,38,23,61,5,0.35899,0.371227,0.000003,No
8536,loch,47,11.24638458,25,7.600922459,7.600682435,1175,85.48289711,18,13,31,43,27,70,4,0.427704,0.444191,0.000003,No
17975,albrecht,28,11.76432767,23,7.684304068,7.684084048,644,90.40067095,18,13,31,23,16,39,4,0.437508,0.45282,0.000003,No
16868,bathroom,40,11.40765272,17,7.98658494,7.986424931,680,91.10818744,19,12,31,35,17,52,4,0.44069,0.455533,0.000003,No
1359,treason,65,10.92214491,53,6.849506371,6.848986246,3445,74.81130112,14,32,46,59,62,121,4,0.457441,0.469673,0.000002,No
10297,hound,32,11.63079627,23,7.684304068,7.684084048,736,89.37457513,8,15,23,29,30,59,4,0.440177,0.455157,0.000004,No
1967,taxon,27,11.80069531,22,7.728755831,7.728545813,594,91.2046927,8,15,23,22,20,42,4,0.444965,0.459298,0.000004,No
13045,edit,54,11.10754813,40,7.13091883,7.130528762,2160,79.20702412,16,30,46,49,40,89,4,0.443953,0.45866,0.000002,No
1282,trivium,20,12.1007999,10,8.517213191,8.517123189,200,103.0650926,9,14,23,17,19,36,4,0.430536,0.446703,0.000004,No
7062,nectar,38,11.45894602,25,7.600922459,7.600682435,950,87.09856015,18,28,46,33,34,67,4,0.449905,0.463551,0.000002,No
12919,ellison,17,12.26331883,11,8.421903011,8.421803008,187,103.2804818,10,13,23,16,16,32,4,0.423702,0.44059,0.000004,No
18179,adele,18,12.20616042,9,8.622573707,8.622493705,162,105.2485179,10,13,23,13,14,27,5,0.396077,0.4135,0.000004,No
10903,hale,25,11.87765635,20,7.824066011,7.823875996,500,92.93156735,11,12,23,16,19,35,4,0.430463,0.44659,0.000004,No
6285,paperback,30,11.6953348,21,7.775275846,7.77507583,630,90.93445415,12,11,23,23,18,41,4,0.41715,0.434459,0.000004,No
10305,hostess,7,13.15062203,6,9.028038815,9.027988815,42,118.7243261,6,7,13,6,7,13,4,0.415792,0.433069,0.000007,No
8499,lombard,18,12.20616042,17,7.98658494,7.986424931,306,97.48553698,7,6,13,12,10,22,5,0.385724,0.402357,0.000007,No
15027,clint,20,12.1007999,17,7.98658494,7.986424931,340,96.64406628,8,5,13,11,16,27,5,0.364752,0.378189,0.000007,No
10131,iceland,131,10.21373025,95,6.265921393,6.264980969,12445,63.9984309,38,53,91,117,105,222,4,0.460467,0.472443,0.000001,No
3882,scarlatti,8,13.01709064,6,9.028038815,9.027988815,48,117.5187995,2,7,9,5,8,13,4,0.429744,0.445862,0.00001,No
14558,continuo,11,12.6986369,7,8.873888135,8.873828135,77,112.6862834,3,7,10,10,8,18,4,0.408849,0.426328,0.000009,No
14435,corpse,21,12.05200974,16,8.047209562,8.047059554,336,96.98504802,6,12,18,16,17,33,5,0.38996,0.407101,0.000005,No
13669,determine,64,10.93764909,63,6.676663558,6.676043378,4032,73.02700311,10,20,30,57,62,119,4,0.436057,0.45182,0.000003,No
15282,chi,51,11.16470654,37,7.208880372,7.208520314,1887,80.48503386,10,20,30,34,25,59,4,0.434924,0.450679,0.000003,No
12991,eisenhower,31,11.66254497,22,7.728755831,7.728545813,682,90.13696246,10,20,30,29,27,56,4,0.440471,0.455524,0.000003,No
6371,pad,29,11.72923635,21,7.775275846,7.77507583,609,91.19804807,11,19,30,24,25,49,4,0.450099,0.463594,0.000003,No
1545,tonic,27,11.80069531,14,8.180740955,8.180610949,378,96.53843143,12,18,30,26,27,53,4,0.434903,0.450632,0.000003,No
5349,precambrian,5,13.48709426,3,9.721185996,9.721165996,15,131.1105519,4,5,9,4,5,9,5,0.346226,0.355267,0.00001,No
11125,greed,15,12.38848198,12,8.334891634,8.334781631,180,103.2566548,8,10,18,11,13,24,4,0.402727,0.420244,0.000005,No
12298,fatigue,12,12.61162553,11,8.421903011,8.421803008,132,106.213887,8,10,18,10,10,20,4,0.430233,0.44636,0.000005,No
9722,intake,10,12.79394708,10,8.517213191,8.517123189,100,108.9687749,7,8,15,8,10,18,4,0.443797,0.458096,0.000006,No
4504,resignation,42,11.35886256,39,7.156236638,7.155856573,1638,81.28670841,14,16,30,37,36,73,4,0.443177,0.457815,0.000003,No
3324,sikkim,29,11.72923635,22,7.728755831,7.728545813,638,90.65240381,14,16,30,23,26,49,4,0.433692,0.449538,0.000003,No
9450,jenkins,24,11.91847835,20,7.824066011,7.823875996,480,93.25096133,14,16,30,18,20,38,4,0.446252,0.460303,0.000003,No
4766,rand,33,11.60002462,16,8.047209562,8.047059554,528,93.34782901,14,16,30,19,22,41,4,0.446521,0.460519,0.000003,No
3270,sincere,3,13.99791989,3,9.721185996,9.721165996,9,136.0763828,3,3,6,3,3,6,4,0.422452,0.439144,0.000015,No
17620,antelope,20,12.1007999,18,7.929426526,7.929256515,360,95.95240375,9,9,18,12,13,25,4,0.433226,0.449012,0.000005,No
16185,bray,14,12.45747485,11,8.421903011,8.421803008,154,104.9156449,9,9,18,11,10,21,4,0.391138,0.408076,0.000005,No
12220,fernando,46,11.26789078,38,7.182212124,7.181842063,1748,80.92838178,18,12,30,33,16,49,5,0.393898,0.411168,0.000003,No
16247,bowen,15,12.38848198,11,8.421903011,8.421803008,165,104.3345937,11,7,18,13,10,23,4,0.406257,0.423737,0.000005,No
15895,butch,18,12.20616042,15,8.111748083,8.111608076,270,99.01329838,10,5,15,13,7,20,5,0.390638,0.407462,0.000006,No
8233,maintain,79,10.72708432,79,6.450350432,6.449570143,6241,69.19345301,16,29,45,71,67,138,4,0.446095,0.460406,0.000002,No
3997,sandwich,59,11.01899473,34,7.29343776,7.293107712,2006,80.36635226,18,27,45,51,41,92,4,0.46067,0.472142,0.000002,No
17044,baghdad,56,11.07118049,43,7.058598169,7.058178089,2408,78.14701431,20,25,45,49,45,94,4,0.453943,0.466781,0.000002,No
9141,kingston,55,11.08919899,32,7.354062381,7.35375234,1760,81.55066115,21,24,45,41,47,88,4,0.395601,0.413108,0.000002,No
14846,combine,65,10.92214491,60,6.725453722,6.72486356,3900,73.45638012,22,23,45,52,56,108,4,0.441041,0.456049,0.000002,No
12636,ethanol,44,11.31234254,20,7.824066011,7.823875996,880,88.50851479,23,22,45,36,38,74,4,0.446431,0.460561,0.000002,No
14636,conquer,63,10.95339745,59,6.74226084,6.741680684,3717,73.8506627,10,34,44,48,55,103,4,0.42723,0.444111,0.000002,No
13069,eclipse,64,10.93764909,40,7.13091883,7.130528762,2560,77.99548788,13,31,44,56,49,105,4,0.447986,0.462007,0.000002,No
14364,coup,72,10.81986606,54,6.830814238,6.830284108,3888,73.90849512,15,29,44,64,58,122,4,0.451633,0.464993,0.000002,No
916,vaughan,34,11.57017165,20,7.824066011,7.823875996,680,90.52578677,8,14,22,26,17,43,5,0.399752,0.417246,0.000004,No
11165,grandson,82,10.68981293,72,6.543132165,6.542421927,5904,69.94485882,17,27,44,70,69,139,4,0.454583,0.467387,0.000002,No
17985,alba,57,11.05348091,35,7.264450223,7.264110172,1995,80.29746185,17,27,44,47,48,95,4,0.414491,0.432135,0.000002,No
6559,opal,17,12.26331883,11,8.421903011,8.421803008,187,103.2804818,10,12,22,16,15,31,4,0.379587,0.395527,0.000004,No
9870,infantrymen,5,13.48709426,2,10.1266511,10.1266411,10,136.579098,4,4,8,4,5,9,5,0.361072,0.373499,0.000011,No
15626,carlton,17,12.26331883,14,8.180740955,8.180610949,238,100.3230346,11,11,22,12,13,25,5,0.410732,0.428461,0.000004,No
16764,begun,90,10.59672251,87,6.353890166,6.353029813,7830,67.33041092,22,22,44,78,81,159,4,0.440177,0.455303,0.000002,No
9483,janet,24,11.91847835,20,7.824066011,7.823875996,480,93.25096133,12,10,22,21,16,37,5,0.357379,0.369161,0.000004,No
1856,terra,18,12.20616042,18,7.929426526,7.929256515,324,96.78785221,12,10,22,12,11,23,4,0.40949,0.427192,0.000004,No
16310,bordeaux,68,10.87702447,40,7.13091883,7.130528762,2720,77.56317862,24,20,44,56,45,101,4,0.439969,0.455068,0.000002,No
18346,abel,59,11.01899473,40,7.13091883,7.130528762,2360,78.57555703,24,20,44,30,25,55,4,0.428841,0.445257,0.000002,No
12971,electoral,75,10.77904406,54,6.830814238,6.830284108,4050,73.62964766,27,17,44,64,52,116,5,0.385925,0.402575,0.000002,No
13742,denver,65,10.92214491,46,6.991156888,6.990706795,2990,76.3584286,27,17,44,61,49,110,4,0.431163,0.447308,0.000002,No
4929,quadruple,12,12.61162553,7,8.873888135,8.873828135,84,111.9141541,7,4,11,11,6,17,5,0.32213,0.32533,0.000008,No
13687,desperate,30,11.6953348,29,7.452502454,7.452222421,870,87.15951127,14,8,22,23,24,47,4,0.40703,0.424497,0.000004,No
1527,topaz,17,12.26331883,6,9.028038815,9.027988815,102,110.7137184,14,8,22,15,14,29,4,0.408586,0.426197,0.000004,No
13360,donkey,65,10.92214491,32,7.354062381,7.35375234,2080,80.32213499,28,16,44,45,60,105,4,0.450282,0.463631,0.000002,No
9789,innate,12,12.61162553,10,8.517213191,8.517123189,120,107.4159033,8,3,11,10,4,14,5,0.384254,0.400458,0.000008,No
15890,buttercup,17,12.26331883,7,8.873888135,8.873828135,119,108.8233195,8,3,11,12,8,20,5,0.33091,0.336113,0.000008,No
18350,abdomen,46,11.26789078,39,7.156236638,7.155856573,1794,80.63569284,8,21,29,41,40,81,4,0.444297,0.458763,0.000003,No
16580,bilbao,30,11.6953348,15,8.111748083,8.111608076,450,94.86960961,10,19,29,22,26,48,4,0.433967,0.44982,0.000003,No
4867,quinn,23,11.96103796,17,7.98658494,7.986424931,391,95.52784565,10,19,29,18,21,39,4,0.43886,0.454101,0.000003,No
4444,reverend,27,11.80069531,26,7.561701746,7.56145172,702,89.23333834,11,18,29,24,20,44,5,0.388153,0.405068,0.000003,No
10490,hilly,37,11.48561426,37,7.208880372,7.208520314,1369,82.79841923,13,16,29,34,31,65,4,0.449017,0.462584,0.000003,No
17254,atlantis,33,11.60002462,18,7.929426526,7.929256515,594,91.9815429,13,16,29,16,26,42,4,0.448133,0.461861,0.000003,No
2561,stigma,30,11.6953348,10,8.517213191,8.517123189,300,99.6116598,13,16,29,23,24,47,4,0.440592,0.455627,0.000003,No
14408,cosmic,34,11.57017165,29,7.452502454,7.452222421,986,86.22673264,14,15,29,30,17,47,5,0.337164,0.343635,0.000003,No
14895,collar,23,11.96103796,18,7.929426526,7.929256515,414,94.84417169,14,15,29,22,18,40,4,0.442492,0.457148,0.000003,No
17442,ares,27,11.80069531,18,7.929426526,7.929256515,486,93.57274643,15,14,29,24,21,45,4,0.433702,0.449515,0.000003,No
3515,shannon,24,11.91847835,15,8.111748083,8.111608076,360,96.67969388,15,14,29,20,16,36,5,0.376041,0.391437,0.000003,No
3030,sofia,33,11.60002462,24,7.641744454,7.641514432,792,88.64442377,16,13,29,22,20,42,4,0.427323,0.443815,0.000003,No
11553,gardner,25,11.87765635,17,7.98658494,7.986424931,425,94.86191135,16,13,29,21,18,39,4,0.422482,0.439374,0.000003,No
11498,ge,22,12.00548972,13,8.254848927,8.254728922,286,99.10350396,16,13,29,18,13,31,4,0.423571,0.440384,0.000003,No
17920,alicia,27,11.80069531,13,8.254848927,8.254728922,351,97.41295703,17,12,29,21,15,36,5,0.35131,0.361427,0.000003,No
15600,carrie,25,11.87765635,19,7.875359305,7.875179292,475,93.54081148,18,11,29,21,12,33,4,0.417307,0.434562,0.000003,No
14540,contribution,33,11.60002462,32,7.354062381,7.35375234,1056,85.30730465,21,8,29,25,28,53,4,0.410475,0.427985,0.000003,No
271,witchcraft,52,11.14528846,36,7.236279346,7.235929291,1872,80.65042068,17,26,43,45,43,88,4,0.442062,0.45697,0.000002,No
15020,clive,40,11.40765272,30,7.418600903,7.418310866,1200,84.62882279,18,25,43,34,29,63,4,0.412488,0.430192,0.000002,No
8191,maltese,41,11.38296011,19,7.875359305,7.875179292,779,89.64490083,18,25,43,36,35,71,4,0.431866,0.448092,0.000002,No
114,yarn,38,11.45894602,20,7.824066011,7.823875996,760,89.65555005,19,24,43,30,35,65,4,0.450487,0.46396,0.000002,No
10962,gut,42,11.35886256,28,7.487593774,7.487323743,1176,85.05054858,21,22,43,37,33,70,4,0.437368,0.452867,0.000002,No
17471,arcade,58,11.03608917,43,7.058598169,7.058178089,2494,77.89931878,22,21,43,45,44,89,4,0.43418,0.450083,0.000002,No
3114,smallpox,44,11.31234254,23,7.684304068,7.684084048,1012,86.92747983,22,21,43,35,31,66,4,0.435757,0.451538,0.000002,No
1553,tomorrow,35,11.54118412,32,7.354062381,7.35375234,1120,84.87458794,23,20,43,28,28,56,4,0.451255,0.46449,0.000002,No
5690,pizza,41,11.38296011,20,7.824066011,7.823875996,820,89.0610313,24,19,43,35,33,68,4,0.445121,0.459392,0.000002,No
16712,benedict,84,10.66571538,69,6.58569178,6.585011562,5796,70.24111409,25,18,43,75,36,111,5,0.398174,0.415758,0.000002,No
273,wit,12,12.61162553,8,8.740356743,8.740286741,96,110.2301062,8,9,17,10,11,21,4,0.416925,0.434116,0.000005,No
7102,navel,19,12.1520932,6,9.028038815,9.027988815,114,109.7095691,11,6,17,18,15,33,4,0.40042,0.418099,0.000005,No
13372,domingo,55,11.08919899,34,7.29343776,7.293107712,1870,80.87838265,9,19,28,47,39,86,4,0.442492,0.4572,0.000003,No
12224,fermi,14,12.45747485,9,8.622573707,8.622493705,126,107.4154951,5,9,14,11,10,21,5,0.35463,0.3658,0.000006,No
5160,prophecy,33,11.60002462,26,7.561701746,7.56145172,858,87.71592639,10,18,28,30,31,61,4,0.445445,0.459678,0.000003,No
12090,fission,35,11.54118412,20,7.824066011,7.823875996,700,90.29898636,10,18,28,30,32,62,4,0.456653,0.468809,0.000003,No
11131,grease,22,12.00548972,17,7.98658494,7.986424931,374,95.88286343,12,16,28,15,19,34,4,0.440067,0.455073,0.000003,No
16187,bravo,22,12.00548972,20,7.824066011,7.823875996,440,93.93174409,13,15,28,17,16,33,4,0.427725,0.444196,0.000003,No
15873,bypass,27,11.80069531,8,8.740356743,8.740286741,216,103.1422868,14,14,28,24,22,46,4,0.420053,0.437191,0.000003,No
7954,maxim,28,11.76432767,21,7.775275846,7.77507583,588,91.47089276,15,13,28,22,19,41,4,0.429183,0.445496,0.000003,No
18154,admission,23,11.96103796,21,7.775275846,7.77507583,483,93.00036956,19,9,28,21,21,42,4,0.427488,0.443998,0.000003,No
7107,nautical,33,11.60002462,21,7.775275846,7.77507583,693,90.19339121,20,8,28,28,29,57,5,0.398782,0.416612,0.000003,No
15892,butt,12,12.61162553,10,8.517213191,8.517123189,120,107.4159033,4,8,12,6,10,16,4,0.433279,0.449022,0.000007,No
8534,lock,46,11.26789078,30,7.418600903,7.418310866,1380,83.59198472,17,25,42,38,42,80,4,0.452312,0.465415,0.000002,No
16343,bonn,59,11.01899473,43,7.058598169,7.058178089,2537,77.77865604,18,24,42,53,53,106,4,0.448813,0.462556,0.000002,No
6417,oval,45,11.28986969,40,7.13091883,7.130528762,1800,80.50714434,18,24,42,38,36,74,4,0.447331,0.461354,0.000002,No
10729,haydn,45,11.28986969,27,7.523961418,7.52370139,1215,84.94454395,18,24,42,38,39,77,4,0.442216,0.457068,0.000002,No
17092,aztec,74,10.79246708,46,6.991156888,6.990706795,3404,75.45183059,19,23,42,65,45,110,5,0.390364,0.407514,0.000002,No
2121,syntax,36,11.51301324,22,7.728755831,7.728545813,792,88.9812682,19,23,42,26,31,57,4,0.452359,0.465443,0.000002,No
6814,notorious,21,12.05200974,20,7.824066011,7.823875996,420,94.29571976,10,11,21,21,14,35,4,0.397648,0.414958,0.000004,No
6307,pang,15,12.38848198,9,8.622573707,8.622493705,135,106.820599,10,11,21,10,13,23,5,0.392869,0.409979,0.000004,No
1204,tunisia,51,11.16470654,39,7.156236638,7.155856573,1989,79.89728203,20,22,42,46,47,93,4,0.447038,0.461082,0.000002,No
13273,drake,52,11.14528846,35,7.264450223,7.264110172,1820,80.96439323,20,22,42,45,34,79,4,0.444097,0.458589,0.000002,No
11336,glaze,11,12.6986369,4,9.433503923,9.433473923,44,119.7926411,6,6,12,7,8,15,4,0.407077,0.424694,0.000007,No
15221,choline,8,13.01709064,3,9.721185996,9.721165996,24,126.5415592,6,6,12,7,8,15,5,0.35712,0.368939,0.000007,No
2097,tablet,24,11.91847835,22,7.728755831,7.728545813,528,92.11500902,11,10,21,17,13,30,4,0.417553,0.434778,0.000004,No
6124,paula,18,12.20616042,15,8.111748083,8.111608076,270,99.01329838,11,10,21,12,12,24,5,0.328753,0.332825,0.000004,No
4509,resident,52,11.14528846,36,7.236279346,7.235929291,1872,80.65042068,25,17,42,40,41,81,5,0.416172,0.433564,0.000002,No
11642,fury,22,12.00548972,16,8.047209562,8.047059554,352,96.6106917,13,8,21,18,16,34,4,0.443177,0.457585,0.000004,No
7383,moose,18,12.20616042,7,8.873888135,8.873828135,126,108.3161021,14,7,21,15,12,27,4,0.402152,0.419535,0.000004,No
12656,establish,81,10.70208302,77,6.475992862,6.475232589,6237,69.30661327,14,27,41,69,70,139,4,0.447591,0.461603,0.000002,No
13206,dublin,119,10.31740868,83,6.400957676,6.400137356,9877,66.04129632,29,53,82,107,106,213,4,0.45886,0.471222,0.000001,No
8178,manage,73,10.80607274,70,6.571303042,6.570612818,5110,71.00997865,16,25,41,67,63,130,4,0.449449,0.463105,0.000002,No
4860,quit,59,11.01899473,58,6.759355274,6.758785123,3422,74.48130016,18,23,41,52,51,103,4,0.434711,0.450688,0.000002,No
2562,stiff,36,11.51301324,34,7.29343776,7.293107712,1224,83.96944548,20,21,41,33,27,60,4,0.41454,0.432013,0.000002,No
12239,feminine,42,11.35886256,30,7.418600903,7.418310866,1260,84.26686803,20,21,41,35,32,67,4,0.423036,0.440111,0.000002,No
7118,nathan,38,11.45894602,28,7.487593774,7.487323743,1064,85.79993286,21,20,41,26,24,50,5,0.345612,0.354242,0.000002,No
13000,eighteen,48,11.22533117,47,6.969650683,6.969190586,2256,78.23663703,23,18,41,39,26,65,4,0.441721,0.456528,0.000002,No
9660,introduce,40,11.40765272,36,7.236279346,7.235929291,1440,82.54896178,8,19,27,36,32,68,4,0.419645,0.437112,0.000003,No
1424,transcontinental,9,12.8993076,8,8.740356743,8.740286741,72,112.7445502,3,6,9,7,8,15,5,0.328066,0.331915,0.000009,No
13840,definite,33,11.60002462,20,7.824066011,7.823875996,660,90.75935832,10,17,27,31,27,58,5,0.386446,0.403134,0.000003,No
14496,coolidge,25,11.87765635,11,8.421903011,8.421803008,275,100.0324698,10,17,27,22,20,42,4,0.432403,0.448416,0.000003,No
10142,iberia,25,11.87765635,15,8.111748083,8.111608076,375,96.34855615,11,16,27,22,19,41,4,0.434818,0.450533,0.000003,No
11067,gritty,6,13.30477271,5,9.210360372,9.210320372,30,122.5417513,4,5,9,6,5,11,4,0.421489,0.438309,0.000009,No
9475,jargon,27,11.80069531,20,7.824066011,7.823875996,540,92.32941909,12,15,27,21,19,40,4,0.431488,0.447721,0.000003,No
14388,cough,26,11.83843564,20,7.824066011,7.823875996,520,92.62470191,12,15,27,21,20,41,4,0.450087,0.463448,0.000003,No
8879,laurent,25,11.87765635,14,8.180740955,8.180610949,350,97.16802977,12,15,27,20,15,35,5,0.371531,0.386384,0.000003,No
11139,gravel,26,11.83843564,23,7.684304068,7.684084048,598,90.97013915,13,14,27,23,17,40,4,0.41917,0.436346,0.000003,No
2387,substitution,31,11.66254497,19,7.875359305,7.875179292,589,91.84673207,13,14,27,23,26,49,4,0.453445,0.466171,0.000003,No
3988,sank,22,12.00548972,18,7.929426526,7.929256515,396,95.19664868,13,14,27,21,22,43,4,0.45003,0.463401,0.000003,No
4561,removal,42,11.35886256,35,7.264450223,7.264110172,1470,82.51589165,15,12,27,36,36,72,4,0.426348,0.443022,0.000003,No
731,viscount,33,11.60002462,26,7.561701746,7.56145172,858,87.71592639,18,9,27,23,11,34,4,0.427642,0.444031,0.000003,No
6383,pablo,47,11.24638458,33,7.323290723,7.322970678,1551,82.36054383,19,8,27,28,21,49,4,0.394905,0.412343,0.000003,No
16826,beardsley,7,13.15062203,5,9.210360372,9.210320372,35,121.121968,2,6,8,6,7,13,4,0.408689,0.426154,0.00001,No
825,vest,14,12.45747485,6,9.028038815,9.027988815,84,112.4665665,4,12,16,11,12,23,4,0.445647,0.459716,0.000005,No
17760,amphibole,3,13.99791989,2,10.1266511,10.1266411,6,141.7520509,2,2,4,2,2,4,5,0.30815,0.313237,0.00002,No
12832,endemic,17,12.26331883,17,7.98658494,7.986424931,289,97.94203751,8,8,16,15,16,31,4,0.42197,0.438966,0.000005,No
15348,charm,14,12.45747485,12,8.334891634,8.334781631,168,103.8317029,9,7,16,13,13,26,4,0.393871,0.410977,0.000005,No
2695,stain,11,12.6986369,7,8.873888135,8.873828135,77,112.6862834,9,7,16,11,8,19,4,0.408906,0.426361,0.000005,No
437,westward,44,11.31234254,39,7.156236638,7.155856573,1716,80.95380017,14,26,40,17,42,59,4,0.462434,0.473499,0.000002,No
15641,carey,37,11.48561426,25,7.600922459,7.600682435,925,87.30126342,15,25,40,20,30,50,4,0.434818,0.450707,0.000002,No
17963,aldebaran,3,13.99791989,3,9.721185996,9.721165996,9,136.0763828,2,3,5,2,3,5,5,0.326756,0.330752,0.000016,No
13633,dharma,37,11.48561426,14,8.180740955,8.180610949,518,93.960835,16,24,40,25,33,58,4,0.444364,0.458941,0.000002,No
12271,feast,60,11.00218762,48,6.948597273,6.948127172,2880,76.44977086,17,23,40,52,54,106,4,0.447918,0.461828,0.000002,No
7340,mosaic,18,12.20616042,17,7.98658494,7.986424931,306,97.48553698,9,11,20,12,15,27,4,0.415306,0.432619,0.000004,No
9896,indus,164,9.99666575,111,6.110268083,6.109167499,18204,61.08230766,18,22,40,156,142,298,4,0.443465,0.458068,0.000002,No
10779,harsh,40,11.40765272,40,7.13091883,7.130528762,1600,81.34704561,18,22,40,37,23,60,4,0.425011,0.441909,0.000002,No
3474,shelley,37,11.48561426,19,7.875359305,7.875179292,703,90.45333917,18,22,40,25,28,53,4,0.436604,0.452205,0.000002,No
13404,dodd,7,13.15062203,7,8.873888135,8.873828135,49,116.6971488,5,5,10,5,5,10,4,0.425082,0.441623,0.000008,No
1341,trespass,8,13.01709064,3,9.721185996,9.721165996,24,126.5415592,5,5,10,8,7,15,4,0.39473,0.411845,0.000008,No
7137,narcissus,14,12.45747485,5,9.210360372,9.210320372,70,114.7378327,10,10,20,11,10,21,5,0.351373,0.361596,0.000004,No
17580,anxiety,39,11.43297053,28,7.487593774,7.487323743,1092,85.60543897,20,20,40,32,27,59,4,0.427714,0.44429,0.000002,No
362,wichita,41,11.38296011,14,8.180740955,8.180610949,574,93.12104796,20,20,40,33,32,65,4,0.434892,0.450796,0.000002,No
6308,panel,42,11.35886256,29,7.452502454,7.452222421,1218,84.6519511,21,19,40,34,31,65,4,0.455984,0.468279,0.000002,No
6603,olivia,34,11.57017165,26,7.561701746,7.56145172,884,87.49018719,21,19,40,25,28,53,4,0.395927,0.41338,0.000002,No
18324,aboriginal,79,10.72708432,59,6.74226084,6.741680684,4661,72.32480057,22,18,40,49,51,100,5,0.391872,0.409035,0.000002,No
3953,sat,46,11.26789078,40,7.13091883,7.130528762,1840,80.35041454,22,18,40,37,37,74,4,0.435127,0.450951,0.000002,No
9098,knives,50,11.18450917,29,7.452502454,7.452222421,1450,83.35258205,22,18,40,40,40,80,4,0.451794,0.464899,0.000002,No
8024,masculine,30,11.6953348,21,7.775275846,7.77507583,630,90.93445415,23,17,40,29,24,53,5,0.407985,0.42563,0.000002,No
8158,mango,17,12.26331883,15,8.111748083,8.111608076,255,99.47695304,12,8,20,15,9,24,4,0.401961,0.419413,0.000004,No
13515,diplomatic,48,11.22533117,38,7.182212124,7.181842063,1824,80.6227096,25,15,40,39,19,58,5,0.395698,0.413082,0.000002,No
12227,fermat,47,11.24638458,16,8.047209562,8.047059554,752,90.50201349,26,14,40,40,25,65,4,0.429994,0.446219,0.000002,No
12270,feat,39,11.43297053,15,8.111748083,8.111608076,585,92.74137679,26,14,40,28,28,56,4,0.42551,0.442261,0.000002,No
16355,bon,33,11.60002462,24,7.641744454,7.641514432,792,88.64442377,17,3,20,23,12,35,5,0.324071,0.32975,0.000004,No
5580,pneumonia,61,10.98565831,52,6.868554566,6.868044446,3172,75.45559356,13,26,39,53,45,98,4,0.453503,0.466396,0.000002,No
11658,fungus,32,11.63079627,25,7.600922459,7.600682435,800,88.40478062,9,17,26,28,21,49,4,0.431971,0.448036,0.000003,No
8050,marshal,56,11.07118049,46,6.991156888,6.990706795,2576,77.40035971,14,25,39,52,40,92,4,0.443498,0.458176,0.000002,No
17170,autobiography,47,11.24638458,41,7.106226218,7.105826145,1927,79.91935292,14,25,39,46,36,82,4,0.444664,0.459232,0.000002,No
6712,obsolete,27,11.80069531,24,7.641744454,7.641514432,648,90.17789795,10,16,26,17,17,34,4,0.423581,0.440417,0.000003,No
14533,controller,62,10.96939779,34,7.29343776,7.293107712,2108,80.00462006,15,24,39,57,46,103,4,0.463582,0.474354,0.000002,No
4023,sample,56,11.07118049,43,7.058598169,7.058178089,2408,78.14701431,16,23,39,50,51,101,4,0.462362,0.473391,0.000002,No
16219,brady,36,11.51301324,20,7.824066011,7.823875996,720,90.07857556,16,23,39,28,30,58,4,0.437583,0.453054,0.000002,No
5660,plaque,27,11.80069531,18,7.929426526,7.929256515,486,93.57274643,11,15,26,21,22,43,4,0.458303,0.470049,0.000003,No
12651,esther,21,12.05200974,18,7.929426526,7.929256515,378,95.56552572,11,15,26,15,17,32,4,0.42201,0.438971,0.000003,No
12939,eliot,21,12.05200974,16,8.047209562,8.047059554,336,96.98504802,11,15,26,16,15,31,4,0.431593,0.44767,0.000003,No
9935,indeed,33,11.60002462,33,7.323290723,7.322970678,1089,84.95035265,17,22,39,25,29,54,4,0.457972,0.469945,0.000002,No
4961,pygmy,40,11.40765272,28,7.487593774,7.487323743,1120,85.41586951,12,14,26,24,22,46,5,0.348743,0.358542,0.000003,No
16009,budapest,38,11.45894602,31,7.38581108,7.385511041,1178,84.63361046,18,21,39,34,32,66,4,0.444397,0.458838,0.000002,No
16979,bangkok,56,11.07118049,34,7.29343776,7.293107712,1904,80.7469658,19,20,39,38,40,78,4,0.432382,0.448529,0.000002,No
1345,trench,43,11.33533206,18,7.929426526,7.929256515,774,89.88268273,19,20,39,32,35,67,4,0.443542,0.458101,0.000002,No
5146,propylene,4,13.71023782,2,10.1266511,10.1266411,8,138.8387949,3,3,6,4,4,8,5,0.357652,0.369461,0.000013,No
2596,stella,23,11.96103796,16,8.047209562,8.047059554,368,96.25297905,13,13,26,16,15,31,4,0.408341,0.425976,0.000003,No
11908,footwear,25,11.87765635,13,8.254848927,8.254728922,325,98.04825879,13,13,26,22,17,39,4,0.43518,0.450792,0.000003,No
12447,export,40,11.40765272,36,7.236279346,7.235929291,1440,82.54896178,20,19,39,36,33,69,4,0.454245,0.466908,0.000002,No
8380,lung,84,10.66571538,53,6.849506371,6.848986246,4452,73.05488543,21,18,39,70,63,133,4,0.444319,0.458735,0.000002,No
7317,motorcycle,48,11.22533117,36,7.236279346,7.235929291,1728,81.22963207,21,18,39,43,30,73,4,0.418005,0.435398,0.000002,No
2912,sovereignty,39,11.43297053,35,7.264450223,7.264110172,1365,83.05424532,21,18,39,28,36,64,4,0.447613,0.461476,0.000002,No
6598,olympia,44,11.31234254,22,7.728755831,7.728545813,968,87.43033339,22,17,39,37,33,70,4,0.436475,0.451984,0.000002,No
3269,sinclair,31,11.66254497,18,7.929426526,7.929256515,558,92.47729347,22,17,39,26,18,44,5,0.391776,0.408999,0.000002,No
1344,trend,28,11.76432767,27,7.523961418,7.52370139,756,88.51434748,15,11,26,21,23,44,4,0.44092,0.45573,0.000003,No
10270,hubert,24,11.91847835,22,7.728755831,7.728545813,528,92.11500902,16,10,26,20,19,39,5,0.344854,0.35342,0.000003,No
2264,sure,233,9.645493724,219,5.430726554,5.428544218,51027,52.3820389,20,57,77,195,223,418,4,0.457323,0.47011,0.000001,No
8334,macabre,10,12.79394708,10,8.517213191,8.517123189,100,108.9687749,4,7,11,5,8,13,4,0.416759,0.434041,0.000007,No
677,voltmeter,14,12.45747485,5,9.210360372,9.210320372,70,114.7378327,5,6,11,11,10,21,4,0.408548,0.425981,0.000007,No
7927,mccann,6,13.30477271,4,9.433503923,9.433473923,24,125.5106255,5,6,11,5,6,11,5,0.388731,0.405449,0.000007,No
2041,tame,10,12.79394708,8,8.740356743,8.740286741,80,111.8236617,6,5,11,7,8,15,4,0.424452,0.441017,0.000007,No
12925,ellipse,26,11.83843564,15,8.111748083,8.111608076,390,96.0304076,3,16,19,24,23,47,4,0.440297,0.455387,0.000004,No
9922,indicate,63,10.95339745,61,6.70892442,6.708324252,3843,73.48551564,14,24,38,46,55,101,4,0.425929,0.443008,0.000002,No
14591,consul,43,11.33533206,32,7.354062381,7.35375234,1376,83.3607391,14,24,38,37,35,72,4,0.456923,0.469143,0.000002,No
3584,servant,60,11.00218762,52,6.868554566,6.868044446,3120,75.56912598,17,21,38,51,48,99,4,0.451289,0.464561,0.000002,No
8810,legacy,51,11.16470654,41,7.106226218,7.105826145,2091,79.33893036,17,21,38,35,45,80,4,0.44912,0.462763,0.000002,No
14373,counterpoint,19,12.1520932,17,7.98658494,7.986424931,323,97.05372453,9,10,19,12,14,26,4,0.451323,0.464382,0.000004,No
17461,archery,20,12.1007999,13,8.254848927,8.254728922,260,99.8902751,9,10,19,10,13,23,4,0.426235,0.442764,0.000004,No
3206,skirt,15,12.38848198,13,8.254848927,8.254728922,195,102.2650471,9,10,19,14,14,28,4,0.448337,0.461913,0.000004,No
683,volt,13,12.53158282,9,8.622573707,8.622493705,117,108.0544965,9,10,19,13,12,25,4,0.414452,0.431774,0.000004,No
11017,guess,40,11.40765272,34,7.29343776,7.293107712,1360,83.20100512,18,20,38,33,33,66,4,0.45809,0.469974,0.000002,No
3450,shine,31,11.66254497,31,7.38581108,7.385511041,961,86.13735388,19,19,38,23,26,49,4,0.447828,0.461688,0.000002,No
2900,spaghetti,36,11.51301324,19,7.875359305,7.875179292,684,90.66911594,21,17,38,30,28,58,4,0.439969,0.455012,0.000002,No
8980,lambert,29,11.72923635,19,7.875359305,7.875179292,551,92.37195061,21,17,38,24,25,49,4,0.439969,0.455026,0.000002,No
17484,ar,21,12.05200974,13,8.254848927,8.254728922,273,99.48751966,11,8,19,13,8,21,4,0.430317,0.446397,0.000004,No
12122,finn,17,12.26331883,10,8.517213191,8.517123189,170,104.4493009,11,8,19,14,10,24,4,0.440231,0.455059,0.000004,No
14340,coventry,39,11.43297053,25,7.600922459,7.600682435,975,86.90112249,23,15,38,33,33,66,4,0.43986,0.454895,0.000002,No
17995,aladdin,49,11.20471188,18,7.929426526,7.929256515,882,88.84693959,24,14,38,33,34,67,4,0.445882,0.459951,0.000002,No
4680,recipient,42,11.35886256,33,7.323290723,7.322970678,1386,83.1842528,8,17,25,33,33,66,4,0.43273,0.448796,0.000003,No
1726,thornton,18,12.20616042,17,7.98658494,7.986424931,306,97.48553698,10,15,25,13,17,30,5,0.392548,0.409702,0.000003,No
14084,cyanide,23,11.96103796,14,8.180740955,8.180610949,322,97.85015311,10,15,25,16,19,35,4,0.446948,0.460857,0.000003,No
8495,lone,29,11.72923635,24,7.641744454,7.641514432,696,89.63182681,11,14,25,22,26,48,5,0.33381,0.339125,0.000003,No
18268,accidental,31,11.66254497,28,7.487593774,7.487323743,868,87.32439913,12,13,25,27,17,44,5,0.361079,0.37429,0.000003,No
3872,scenery,23,11.96103796,21,7.775275846,7.77507583,483,93.00036956,13,12,25,20,19,39,4,0.437961,0.453195,0.000003,No
13387,dole,19,12.1520932,7,8.873888135,8.873828135,133,107.8363156,13,12,25,17,15,32,4,0.42937,0.445703,0.000003,No
7817,melissa,27,11.80069531,22,7.728755831,7.728545813,594,91.2046927,14,11,25,16,18,34,5,0.387466,0.404162,0.000003,No
10653,heiress,20,12.1007999,18,7.929426526,7.929256515,360,95.95240375,14,11,25,18,18,36,4,0.416543,0.433797,0.000003,No
2088,tacitus,24,11.91847835,15,8.111748083,8.111608076,360,96.67969388,14,11,25,17,13,30,4,0.425469,0.442083,0.000003,No
15974,bullock,17,12.26331883,9,8.622573707,8.622493705,153,105.7413705,14,11,25,17,17,34,5,0.400573,0.418021,0.000003,No
15480,celebrate,89,10.60789581,82,6.413079037,6.412268725,7298,68.02927423,11,26,37,72,77,149,4,0.440931,0.456021,0.000002,No
8123,manuscript,42,11.35886256,30,7.418600903,7.418310866,1260,84.26686803,13,24,37,31,38,69,4,0.454292,0.467077,0.000002,No
8668,lighthouse,39,11.43297053,28,7.487593774,7.487323743,1092,85.60543897,14,23,37,34,36,70,4,0.443598,0.458218,0.000002,No
13597,dickinson,35,11.54118412,16,8.047209562,8.047059554,560,92.87432717,16,21,37,33,24,57,5,0.375619,0.391154,0.000002,No
17556,aphrodite,35,11.54118412,26,7.561701746,7.56145172,910,87.27099208,17,20,37,28,28,56,4,0.439207,0.454434,0.000002,No
14400,costume,39,11.43297053,29,7.452502454,7.452222421,1131,85.20424094,18,19,37,27,34,61,4,0.443786,0.458303,0.000002,No
2300,sunrise,35,11.54118412,30,7.418600903,7.418310866,1050,85.6194389,19,18,37,28,31,59,4,0.453097,0.465936,0.000002,No
4189,rpm,42,11.35886256,17,7.98658494,7.986424931,714,90.71852065,19,18,37,31,26,57,4,0.431101,0.447271,0.000002,No
6527,option,41,11.38296011,37,7.208880372,7.208520314,1517,82.05839771,20,17,37,37,35,72,4,0.459632,0.471157,0.000002,No
1662,tibet,111,10.38700198,71,6.557118407,6.556418176,7881,68.10880185,30,43,73,98,92,190,4,0.446196,0.460777,0.000001,No
17127,avon,58,11.03608917,20,7.824066011,7.823875996,1160,86.34709014,31,42,73,52,56,108,4,0.421889,0.439464,0.000001,No
8689,lid,10,12.79394708,10,8.517213191,8.517123189,100,108.9687749,4,8,12,9,9,18,4,0.433025,0.448792,0.000006,No
14374,counterpart,29,11.72923635,29,7.452502454,7.452222421,841,87.41216266,9,15,24,14,26,40,4,0.438026,0.453388,0.000003,No
6216,parry,23,11.96103796,21,7.775275846,7.77507583,483,93.00036956,9,15,24,19,21,40,4,0.434658,0.450383,0.000003,No
15541,catastrophe,8,13.01709064,8,8.740356743,8.740286741,64,113.7740159,5,7,12,5,8,13,5,0.396343,0.413551,0.000006,No
5781,picnic,17,12.26331883,14,8.180740955,8.180610949,238,100.3230346,8,10,18,12,11,23,4,0.426461,0.442947,0.000004,No
1026,urea,14,12.45747485,8,8.740356743,8.740286741,112,108.8827743,8,10,18,13,11,24,4,0.443919,0.458232,0.000004,No
519,waveform,12,12.61162553,7,8.873888135,8.873828135,84,111.9141541,8,10,18,12,11,23,4,0.419467,0.436576,0.000004,No
8881,laurel,41,11.38296011,25,7.600922459,7.600682435,1025,86.52099716,16,20,36,34,34,68,4,0.413458,0.431013,0.000002,No
8920,larva,26,11.83843564,17,7.98658494,7.986424931,442,94.54867179,11,13,24,22,18,40,4,0.430818,0.447031,0.000003,No
12836,encore,21,12.05200974,11,8.421903011,8.421803008,231,101.5008571,11,13,24,18,17,35,4,0.428086,0.444468,0.000003,No
17479,arachne,14,12.45747485,2,10.1266511,10.1266411,28,126.1525014,11,13,24,12,13,25,5,0.378478,0.394412,0.000003,No
7531,missionary,48,11.22533117,40,7.13091883,7.130528762,1920,80.04692539,17,19,36,41,39,80,4,0.41341,0.430957,0.000002,No
11272,godhead,5,13.48709426,3,9.721185996,9.721165996,15,131.1105519,4,4,8,5,4,9,4,0.420232,0.437389,0.000009,No
1887,tendency,22,12.00548972,19,7.875359305,7.875179292,418,94.54754521,9,9,18,19,22,41,4,0.438037,0.453303,0.000004,No
15846,cadet,22,12.00548972,14,8.180740955,8.180610949,308,98.21380147,12,12,24,20,16,36,5,0.414966,0.43248,0.000003,No
8503,loki,33,11.60002462,20,7.824066011,7.823875996,660,90.75935832,19,17,36,27,30,57,4,0.415442,0.432863,0.000002,No
13988,daphne,31,11.66254497,11,8.421903011,8.421803008,341,98.22082263,19,17,36,24,27,51,4,0.443764,0.45827,0.000002,No
3857,schizophrenia,23,11.96103796,19,7.875359305,7.875179292,437,94.19747161,13,11,24,21,19,40,4,0.412,0.429445,0.000003,No
16708,benefactor,5,13.48709426,5,9.210360372,9.210320372,25,124.2209985,5,4,9,5,5,10,4,0.411474,0.428943,0.000008,No
9201,kermit,21,12.05200974,9,8.622573707,8.622493705,189,103.9193423,10,8,18,15,18,33,4,0.405357,0.422967,0.000004,No
10577,hermaphrodite,16,12.32394346,10,8.517213191,8.517123189,160,104.9656538,10,8,18,14,11,25,4,0.399626,0.416995,0.000004,No
9933,indefinite,12,12.61162553,9,8.622573707,8.622493705,108,108.7446707,7,5,12,9,6,15,5,0.398246,0.416044,0.000006,No
1907,tellurium,7,13.15062203,2,10.1266511,10.1266411,14,133.1717611,7,5,12,7,7,14,4,0.389823,0.406606,0.000006,No
1702,threw,45,11.28986969,43,7.058598169,7.058178089,1935,79.6906535,21,15,36,36,38,74,4,0.423026,0.440149,0.000002,No
1819,textile,43,11.33533206,40,7.13091883,7.130528762,1720,80.83133284,21,15,36,33,23,56,5,0.406928,0.424518,0.000002,No
6959,nichols,14,12.45747485,11,8.421903011,8.421803008,154,104.9156449,11,7,18,11,7,18,5,0.353155,0.363957,0.000004,No
10578,hermann,46,11.26789078,42,7.082128666,7.08171859,1932,79.8006523,23,13,36,29,16,45,5,0.380849,0.397568,0.000002,No
4494,respiratory,29,11.72923635,27,7.523961418,7.52370139,783,88.25032174,16,8,24,24,21,45,5,0.384787,0.401144,0.000003,No
12698,erik,46,11.26789078,30,7.418600903,7.418310866,1380,83.59198472,24,12,36,32,21,53,4,0.405209,0.422901,0.000002,No
10049,immune,109,10.4051843,63,6.676663558,6.676043378,6867,69.4719148,28,8,36,94,98,192,5,0.377368,0.393174,0.000002,No
12743,epithelium,11,12.6986369,5,9.210360372,9.210320372,55,116.9590221,5,9,14,11,9,20,4,0.43834,0.453472,0.000005,No
17739,analyses,11,12.6986369,11,8.421903011,8.421803008,121,106.9466884,6,8,14,7,10,17,4,0.428447,0.444717,0.000005,No
10159,hypochlorite,5,13.48709426,3,9.721185996,9.721165996,15,131.1105519,4,3,7,5,3,8,4,0.389764,0.406503,0.00001,No
15673,caravan,9,12.8993076,9,8.622573707,8.622493705,81,111.2252305,8,6,14,8,6,14,5,0.390991,0.407993,0.000005,No
12992,einsteinium,10,12.79394708,4,9.433503923,9.433473923,40,120.69175,8,6,14,8,8,16,4,0.39063,0.407489,0.000005,No
1961,teach,147,10.10609959,130,5.952263834,5.950973027,19110,60.15417109,20,50,70,125,114,239,4,0.461293,0.473067,0.000001,No
6448,oslo,56,11.07118049,37,7.208880372,7.208520314,2072,79.8108157,12,23,35,51,47,98,4,0.440986,0.456002,0.000002,No
6313,pandemic,35,11.54118412,21,7.775275846,7.77507583,735,89.7358901,13,22,35,32,28,60,4,0.445647,0.459913,0.000002,No
13715,derbyshire,45,11.28986969,35,7.264450223,7.264110172,1575,82.01469637,14,21,35,34,33,67,4,0.43501,0.450792,0.000002,No
17751,ana,55,11.08919899,39,7.156236638,7.155856573,2145,79.35693211,15,20,35,52,34,86,4,0.436496,0.452073,0.000002,No
17492,aquarium,43,11.33533206,24,7.641744454,7.641514432,1032,86.62171091,15,20,35,39,35,74,4,0.435993,0.451618,0.000002,No
6069,pedal,36,11.51301324,13,8.254848927,8.254728922,468,95.03818498,15,20,35,27,30,57,4,0.452105,0.465148,0.000002,No
12225,fermentation,34,11.57017165,22,7.728755831,7.728545813,748,89.42303163,16,19,35,30,29,59,4,0.453607,0.466396,0.000002,No
4173,rudolph,32,11.63079627,26,7.561701746,7.56145172,832,87.9486125,20,15,35,25,26,51,4,0.455516,0.467842,0.000002,No
10036,imperfect,7,13.15062203,5,9.210360372,9.210320372,35,121.121968,6,4,10,7,6,13,5,0.384346,0.40058,0.000007,No
2971,sonata,42,11.35886256,20,7.824066011,7.823875996,840,88.87249047,22,13,35,35,34,69,4,0.42056,0.43767,0.000002,No
906,vegetarian,29,11.72923635,28,7.487593774,7.487323743,812,87.82375705,9,14,23,23,18,41,5,0.410627,0.428161,0.000003,No
15257,chimpanzee,28,11.76432767,11,8.421903011,8.421803008,308,99.07802661,9,14,23,27,23,50,4,0.44669,0.460617,0.000003,No
12323,fare,13,12.53158282,12,8.334891634,8.334781631,156,104.4493848,11,12,23,12,12,24,4,0.411923,0.429469,0.000003,No
10438,hobbes,23,11.96103796,7,8.873888135,8.873828135,161,106.1409129,11,12,23,20,14,34,4,0.389695,0.406634,0.000003,No
9964,inclination,108,10.41440095,94,6.276503502,6.275573088,10152,65.36602403,12,11,23,108,104,212,4,0.426594,0.443163,0.000003,No
10763,hatch,25,11.87765635,22,7.728755831,7.728545813,550,91.79950579,12,11,23,18,21,39,4,0.436615,0.452012,0.000003,No
6126,patty,20,12.1007999,14,8.180740955,8.180610949,280,98.99350936,12,11,23,16,18,34,4,0.390931,0.407902,0.000003,No
9392,johannesburg,17,12.26331883,11,8.421903011,8.421803008,187,103.2804818,12,11,23,16,14,30,4,0.418468,0.435727,0.000003,No
3855,schlesinger,16,12.32394346,6,9.028038815,9.027988815,96,111.2610399,13,10,23,13,10,23,5,0.34676,0.35538,0.000003,No
4402,rhythmic,30,11.6953348,21,7.775275846,7.77507583,630,90.93445415,14,9,23,19,12,31,5,0.385054,0.401463,0.000003,No
2758,spree,18,12.20616042,17,7.98658494,7.986424931,306,97.48553698,4,13,17,13,16,29,4,0.415034,0.432375,0.000004,No
919,vatican,89,10.60789581,63,6.676663558,6.676043378,5607,70.82535136,9,25,34,77,76,153,4,0.458836,0.470668,0.000002,No
502,wealthy,32,11.63079627,32,7.354062381,7.35375234,1024,85.53360135,13,21,34,31,24,55,4,0.401888,0.419563,0.000002,No
17625,antarctica,125,10.26821844,98,6.234830806,6.233860354,12250,64.02060465,26,42,68,114,105,219,4,0.460395,0.472208,0.000001,No
4597,rehearsal,15,12.38848198,9,8.622573707,8.622493705,135,106.820599,7,10,17,14,14,28,4,0.404913,0.42238,0.000004,No
16158,bred,60,11.00218762,45,7.013135794,7.012695706,2700,77.15983578,14,20,34,48,55,103,4,0.430067,0.446487,0.000002,No
11557,garbage,32,11.63079627,22,7.728755831,7.728545813,704,89.89158452,15,19,34,26,23,49,4,0.438567,0.453848,0.000002,No
5501,polytechnic,17,12.26331883,16,8.047209562,8.047059554,272,98.68549658,8,9,17,13,15,28,4,0.426143,0.442651,0.000004,No
13748,dent,13,12.53158282,10,8.517213191,8.517123189,130,106.7341625,8,9,17,12,11,23,4,0.427375,0.443773,0.000004,No
6059,peel,31,11.66254497,25,7.600922459,7.600682435,775,88.64610002,16,18,34,26,24,50,4,0.438253,0.453566,0.000002,No
16437,blossom,28,11.76432767,19,7.875359305,7.875179292,532,92.64830736,16,18,34,25,21,46,4,0.435682,0.451374,0.000002,No
14249,crimson,34,11.57017165,23,7.684304068,7.684084048,782,88.9087171,17,17,34,30,27,57,4,0.406956,0.424586,0.000002,No
11084,griffith,30,11.6953348,18,7.929426526,7.929256515,540,92.73729796,17,17,34,27,25,52,4,0.419566,0.436806,0.000002,No
12289,fauna,16,12.32394346,14,8.180740955,8.180610949,224,100.8189889,9,8,17,12,15,27,4,0.439806,0.454721,0.000004,No
2143,sympathy,16,12.32394346,13,8.254848927,8.254728922,208,101.7322914,9,8,17,13,12,25,4,0.440187,0.455031,0.000004,No
6122,pauli,17,12.26331883,7,8.873888135,8.873828135,119,108.8233195,9,8,17,14,13,27,4,0.402107,0.419695,0.000004,No
4703,realm,40,11.40765272,35,7.264450223,7.264110172,1400,82.87032537,18,16,34,33,36,69,4,0.446532,0.460542,0.000002,No
1781,therapeutic,15,12.38848198,14,8.180740955,8.180610949,210,101.3469619,10,7,17,13,9,22,5,0.384479,0.400787,0.000004,No
971,vaginal,15,12.38848198,11,8.421903011,8.421803008,165,104.3345937,10,7,17,15,11,26,5,0.35646,0.368538,0.000004,No
16427,blueberry,14,12.45747485,11,8.421903011,8.421803008,154,104.9156449,10,7,17,11,9,20,4,0.399321,0.416704,0.000004,No
17034,baja,37,11.48561426,28,7.487593774,7.487323743,1036,85.99961386,13,4,17,32,35,67,5,0.325295,0.328747,0.000004,No
14575,contemporary,88,10.61919536,82,6.413079037,6.412268725,7216,68.10173917,28,39,67,75,59,134,5,0.422754,0.440179,0.000001,No
16782,beet,10,12.79394708,7,8.873888135,8.873828135,70,113.5320552,4,7,11,8,8,16,5,0.371546,0.386386,0.000006,No
3189,slam,59,11.01899473,43,7.058598169,7.058178089,2537,77.77865604,9,13,22,57,25,82,5,0.395319,0.412765,0.000003,No
8140,mann,19,12.1520932,14,8.180740955,8.180610949,266,99.41312651,9,13,22,18,15,33,4,0.430975,0.447083,0.000003,No
9020,labyrinth,21,12.05200974,10,8.517213191,8.517123189,210,102.6495363,9,13,22,19,17,36,4,0.450396,0.463669,0.000003,No
2,zulu,12,12.61162553,8,8.740356743,8.740286741,96,110.2301062,5,6,11,9,7,16,5,0.385246,0.401585,0.000006,No
1770,theresa,37,11.48561426,30,7.418600903,7.418310866,1110,85.20718835,10,12,22,30,32,62,5,0.40761,0.425166,0.000003,No
11447,geographer,21,12.05200974,18,7.929426526,7.929256515,378,95.56552572,10,12,22,19,17,36,4,0.452059,0.465002,0.000003,No
13086,eater,13,12.53158282,13,8.254848927,8.254728922,169,103.446323,10,12,22,12,13,25,4,0.44723,0.461148,0.000003,No
668,voodoo,18,12.20616042,8,8.740356743,8.740286741,144,106.6861965,10,12,22,16,15,31,4,0.408661,0.426173,0.000003,No
15425,cessation,6,13.30477271,6,9.028038815,9.027988815,36,120.1160044,3,3,6,3,5,8,5,0.378761,0.394589,0.000011,No
10974,gunshot,4,13.71023782,4,9.433503923,9.433473923,16,129.3355822,3,3,6,4,3,7,4,0.429017,0.445139,0.000011,No
11815,fragile,19,12.1520932,19,7.875359305,7.875179292,361,95.70210024,11,11,22,17,16,33,4,0.425326,0.441947,0.000003,No
16418,blunt,15,12.38848198,15,8.111748083,8.111608076,225,100.4922449,11,11,22,14,11,25,5,0.371679,0.386358,0.000003,No
5575,pocono,2,14.403385,2,10.1266511,10.1266411,4,145.8580546,2,1,3,2,1,3,6,0.298321,0.304279,0.000022,No
10919,hague,47,11.24638458,34,7.29343776,7.293107712,1598,82.02480592,7,26,33,46,43,89,4,0.440461,0.455603,0.000002,No
12452,explore,54,11.10754813,51,6.887972651,6.887472536,2754,76.50848775,10,23,33,47,47,94,4,0.428189,0.444768,0.000002,No
8745,lesson,32,11.63079627,25,7.600922459,7.600682435,800,88.40478062,10,23,33,29,27,56,4,0.437238,0.452796,0.000002,No
13567,dig,48,11.22533117,35,7.264450223,7.264110172,1680,81.54585949,11,22,33,34,38,72,4,0.446027,0.460228,0.000002,No
14795,compass,44,11.31234254,25,7.600922459,7.600682435,1100,85.98423851,11,22,33,38,36,74,4,0.451955,0.465105,0.000002,No
15223,cholera,32,11.63079627,18,7.929426526,7.929256515,576,92.2255445,13,20,33,24,30,54,4,0.435084,0.45082,0.000002,No
12059,flammable,40,11.40765272,29,7.452502454,7.452222421,1160,85.01555992,14,19,33,31,35,66,4,0.434456,0.450275,0.000002,No
12115,firefly,30,11.6953348,19,7.875359305,7.875179292,570,92.10496371,14,19,33,27,24,51,4,0.448382,0.462129,0.000002,No
2298,sunset,33,11.60002462,30,7.418600903,7.418310866,990,86.05595308,16,17,33,27,29,56,4,0.43595,0.451538,0.000002,No
6866,noon,35,11.54118412,24,7.641744454,7.641514432,840,88.19477971,16,17,33,30,32,62,4,0.457182,0.469218,0.000002,No
9494,jaguar,44,11.31234254,17,7.98658494,7.986424931,748,90.3469846,16,17,33,28,34,62,4,0.434967,0.450693,0.000002,No
8633,lindsay,26,11.83843564,22,7.728755831,7.728545813,572,91.49637848,16,17,33,21,20,41,4,0.430735,0.446923,0.000002,No
9565,irvine,25,11.87765635,19,7.875359305,7.875179292,475,93.54081148,16,17,33,22,21,43,4,0.433639,0.449519,0.000002,No
4595,reid,26,11.83843564,18,7.929426526,7.929256515,468,93.87200559,16,17,33,22,21,43,4,0.417396,0.434717,0.000002,No
2519,stood,88,10.61919536,84,6.388981485,6.388151157,7392,67.84584256,35,31,66,69,86,155,4,0.454013,0.466927,0.000001,No
15486,cedar,44,11.31234254,32,7.354062381,7.35375234,1408,83.19167274,18,15,33,35,25,60,4,0.393139,0.410794,0.000002,No
11543,garrison,30,11.6953348,28,7.487593774,7.487323743,840,87.569916,18,15,33,24,19,43,4,0.428944,0.445421,0.000002,No
5667,planetary,50,11.18450917,44,7.03560865,7.035178566,2200,78.68982948,19,14,33,46,34,80,5,0.330972,0.335915,0.000002,No
17027,baku,26,11.83843564,15,8.111748083,8.111608076,390,96.0304076,19,14,33,23,22,45,4,0.405367,0.422906,0.000002,No
5930,perpendicular,41,11.38296011,33,7.323290723,7.322970678,1353,83.36072618,20,13,33,31,36,67,5,0.389328,0.406361,0.000002,No
11563,gantry,4,13.71023782,3,9.721185996,9.721165996,12,133.2797719,3,2,5,4,2,6,5,0.399878,0.417607,0.000013,No
12188,fibrosis,11,12.6986369,6,9.028038815,9.027988815,66,114.6437869,1,7,8,1,9,10,4,0.406239,0.423812,0.000008,No
5608,pliocene,17,12.26331883,15,8.111748083,8.111608076,255,99.47695304,5,11,16,13,14,27,4,0.44741,0.461171,0.000004,No
17833,alumni,27,11.80069531,24,7.641744454,7.641514432,648,90.17789795,11,21,32,14,21,35,4,0.421039,0.438224,0.000002,No
6808,nouveau,7,13.15062203,7,8.873888135,8.873828135,49,116.6971488,3,5,8,6,5,11,4,0.422653,0.43937,0.000008,No
14516,convert,65,10.92214491,59,6.74226084,6.741680684,3835,73.6399499,12,20,32,60,56,116,4,0.436539,0.452205,0.000002,No
15914,burton,36,11.51301324,31,7.38581108,7.385511041,1116,85.03294074,12,20,32,30,26,56,4,0.4291,0.445524,0.000002,No
16747,belgrade,40,11.40765272,23,7.684304068,7.684084048,920,87.65987223,12,20,32,38,35,73,4,0.430902,0.447261,0.000002,No
3229,skate,32,11.63079627,25,7.600922459,7.600682435,800,88.40478062,12,20,32,31,28,59,4,0.448541,0.46227,0.000002,No
17535,apparatus,44,11.31234254,35,7.264450223,7.264110172,1540,82.17794931,13,19,32,17,34,51,4,0.449245,0.462922,0.000002,No
14655,congressman,30,11.6953348,25,7.600922459,7.600682435,750,88.89533292,13,19,32,22,29,51,4,0.437885,0.453294,0.000002,No
2189,sweep,11,12.6986369,11,8.421903011,8.421803008,121,106.9466884,7,9,16,9,10,19,4,0.433046,0.448975,0.000004,No
1217,tulsa,49,11.20471188,28,7.487593774,7.487323743,1372,83.89633091,14,18,32,41,40,81,4,0.434594,0.450369,0.000002,No
8727,levine,28,11.76432767,19,7.875359305,7.875179292,532,92.64830736,14,18,32,28,23,51,4,0.439381,0.454528,0.000002,No
191,worse,79,10.72708432,78,6.463089458,6.462319176,6162,69.33010561,28,36,64,55,69,124,4,0.446341,0.460735,0.000001,No
888,venetian,39,11.43297053,34,7.29343776,7.293107712,1326,83.38565898,15,17,32,33,24,57,4,0.402855,0.420441,0.000002,No
8533,locke,34,11.57017165,21,7.775275846,7.77507583,714,89.96127619,15,17,32,30,25,55,4,0.40157,0.419117,0.000002,No
1848,terrier,28,11.76432767,12,8.334891634,8.334781631,336,98.05439626,15,17,32,26,22,48,4,0.44383,0.458303,0.000002,No
6753,nyc,11,12.6986369,11,8.421903011,8.421803008,121,106.9466884,8,8,16,9,8,17,4,0.418251,0.43544,0.000004,No
1684,thrush,12,12.61162553,9,8.622573707,8.622493705,108,108.7446707,8,8,16,10,9,19,4,0.380392,0.396489,0.000004,No
10508,higgins,8,13.01709064,4,9.433503923,9.433473923,32,122.7967756,8,8,16,8,8,16,5,0.350838,0.360774,0.000004,No
9053,krill,33,11.60002462,17,7.98658494,7.986424931,561,92.6445819,16,16,32,29,24,53,4,0.430067,0.446299,0.000002,No
6951,nicotine,32,11.63079627,14,8.180740955,8.180610949,448,95.14853142,16,16,32,23,28,51,4,0.43274,0.448815,0.000002,No
16061,broom,32,11.63079627,8,8.740356743,8.740286741,256,101.6573086,16,16,32,23,24,47,5,0.384662,0.401371,0.000002,No
289,winnipeg,51,11.16470654,30,7.418600903,7.418310866,1530,82.82650205,17,15,32,43,33,76,4,0.419348,0.436576,0.000002,No
1551,ton,42,11.35886256,33,7.323290723,7.322970678,1386,83.1842528,17,15,32,38,30,68,4,0.433321,0.449299,0.000002,No
16959,barbados,27,11.80069531,19,7.875359305,7.875179292,513,92.93471563,18,14,32,22,21,43,4,0.434573,0.45028,0.000002,No
4080,sagittarius,29,11.72923635,9,8.622573707,8.622493705,261,101.1362049,18,14,32,19,21,40,4,0.427951,0.444501,0.000002,No
15518,caucasian,28,11.76432767,23,7.684304068,7.684084048,644,90.40067095,19,13,32,23,19,42,4,0.435736,0.45128,0.000002,No
3268,sine,36,11.51301324,13,8.254848927,8.254728922,468,95.03818498,10,6,16,30,23,53,5,0.406108,0.423541,0.000004,No
13573,differential,68,10.87702447,39,7.156236638,7.155856573,2652,77.83856104,23,9,32,49,28,77,4,0.407498,0.424971,0.000002,No
10337,horde,27,11.80069531,23,7.684304068,7.684084048,621,90.68013099,5,16,21,26,21,47,4,0.430265,0.446505,0.000003,No
17209,auditorium,23,11.96103796,19,7.875359305,7.875179292,437,94.19747161,8,13,21,22,20,42,4,0.448461,0.462143,0.000003,No
13584,dielectric,5,13.48709426,4,9.433503923,9.433473923,20,127.2305567,3,4,7,4,4,8,5,0.378188,0.393972,0.000009,No
2674,stance,5,13.48709426,5,9.210360372,9.210320372,25,124.2209985,4,5,9,4,5,9,4,0.41395,0.431342,0.000007,No
9256,karachi,100,10.49136199,50,6.907775279,6.907285168,5000,72.471971,29,34,63,95,68,163,4,0.446476,0.460843,0.000001,No
1566,toll,24,11.91847835,19,7.875359305,7.875179292,456,93.86229935,10,11,21,23,19,42,4,0.441402,0.456157,0.000003,No
1446,tragic,17,12.26331883,17,7.98658494,7.986424931,289,97.94203751,10,11,21,17,13,30,5,0.363437,0.376844,0.000003,No
17010,ballard,17,12.26331883,10,8.517213191,8.517123189,170,104.4493009,10,11,21,15,11,26,4,0.423268,0.440032,0.000003,No
15844,cadmium,14,12.45747485,3,9.721185996,9.721165996,42,121.10143,12,9,21,13,12,25,4,0.390312,0.407207,0.000003,No
12168,fifteen,88,10.61919536,82,6.413079037,6.412268725,7216,68.10173917,38,25,63,74,41,115,4,0.446285,0.460505,0.000001,No
9162,kiev,45,11.28986969,37,7.208880372,7.208520314,1665,81.38731999,8,23,31,41,34,75,4,0.439294,0.454561,0.000002,No
12763,epidemic,30,11.6953348,25,7.600922459,7.600682435,750,88.89533292,11,20,31,29,26,55,4,0.422713,0.439834,0.000002,No
6276,papyrus,29,11.72923635,19,7.875359305,7.875179292,551,92.37195061,11,20,31,18,23,41,4,0.418824,0.436116,0.000002,No
15166,churchill,33,11.60002462,28,7.487593774,7.487323743,924,86.85627209,13,18,31,30,22,52,4,0.44103,0.45596,0.000002,No
18084,afghan,34,11.57017165,23,7.684304068,7.684084048,782,88.9087171,13,18,31,25,24,49,5,0.387475,0.404275,0.000002,No
10554,hertz,26,11.83843564,18,7.929426526,7.929256515,468,93.87200559,13,18,31,22,21,43,4,0.4401,0.455153,0.000002,No
7031,nepal,101,10.48141166,69,6.58569178,6.585011562,6969,69.02734661,27,35,62,90,83,173,4,0.449848,0.463622,0.000001,No
12935,elite,36,11.51301324,33,7.323290723,7.322970678,1188,84.31314304,14,17,31,28,22,50,5,0.398192,0.415746,0.000002,No
966,vale,40,11.40765272,24,7.641744454,7.641514432,960,87.17436693,14,17,31,28,35,63,4,0.438242,0.453543,0.000002,No
4433,rex,35,11.54118412,32,7.354062381,7.35375234,1120,84.87458794,15,16,31,27,18,45,5,0.402234,0.4198,0.000002,No
11544,garrett,29,11.72923635,26,7.561701746,7.56145172,754,88.69298697,15,16,31,26,21,47,4,0.396449,0.413864,0.000002,No
2423,stuff,49,11.20471188,43,7.058598169,7.058178089,2107,79.08955875,31,31,62,43,43,86,4,0.45763,0.469805,0.000001,No
15439,ceres,34,11.57017165,23,7.684304068,7.684084048,782,88.9087171,16,15,31,25,29,54,4,0.43626,0.451806,0.000002,No
17936,algebraic,38,11.45894602,30,7.418600903,7.418310866,1140,85.00934727,17,14,31,36,23,59,5,0.377344,0.393998,0.000002,No
9746,installation,31,11.66254497,26,7.561701746,7.56145172,806,88.18868669,17,14,31,26,24,50,4,0.421249,0.438313,0.000002,No
12916,elm,36,11.51301324,19,7.875359305,7.875179292,684,90.66911594,17,14,31,26,24,50,4,0.405292,0.422854,0.000002,No
16742,bella,26,11.83843564,10,8.517213191,8.517123189,260,100.8304802,18,13,31,19,16,35,4,0.401425,0.418911,0.000002,No
1970,taxi,36,11.51301324,23,7.684304068,7.684084048,828,88.46949447,19,12,31,29,17,46,4,0.438156,0.453392,0.000002,No
8902,latex,28,11.76432767,13,8.254848927,8.254728922,364,97.11274762,19,12,31,22,19,41,4,0.418626,0.435896,0.000002,No
3175,slavic,105,10.44257183,72,6.543132165,6.542421927,7560,68.32712761,39,23,62,93,53,146,4,0.411446,0.429206,0.000001,No
9510,jackie,41,11.38296011,35,7.264450223,7.264110172,1435,82.69094711,20,11,31,25,23,48,4,0.403139,0.420986,0.000002,No
11791,frankfurt,123,10.28434782,78,6.463089458,6.462319176,9594,66.46865999,31,30,61,93,104,197,4,0.445021,0.459523,0.000001,No
6320,panama,84,10.66571538,56,6.794446593,6.793896453,4704,72.46763352,32,29,61,74,67,141,4,0.442536,0.457444,0.000001,No
6929,nihilism,8,13.01709064,5,9.210360372,9.210320372,40,119.8920957,6,6,12,6,6,12,4,0.397826,0.415122,0.000005,No
12074,flack,10,12.79394708,4,9.433503923,9.433473923,40,120.69175,6,6,12,10,7,17,5,0.353169,0.363783,0.000005,No
3903,scala,15,12.38848198,10,8.517213191,8.517123189,150,105.5153421,3,7,10,9,9,18,4,0.422191,0.439121,0.000006,No
7207,mustang,22,12.00548972,14,8.180740955,8.180610949,308,98.21380147,7,13,20,17,19,36,4,0.440308,0.455237,0.000003,No
4812,radium,14,12.45747485,8,8.740356743,8.740286741,112,108.8827743,8,12,20,10,13,23,4,0.431572,0.447646,0.000003,No
5078,psi,16,12.32394346,6,9.028038815,9.027988815,96,111.2610399,10,10,20,10,10,20,5,0.364445,0.377903,0.000003,No
5155,proportion,34,11.57017165,30,7.418600903,7.418310866,1020,85.83448587,12,8,20,30,31,61,4,0.42552,0.442102,0.000003,No
15182,chromosome,35,11.54118412,20,7.824066011,7.823875996,700,90.29898636,11,19,30,33,28,61,4,0.421869,0.439046,0.000002,No
9342,judaism,101,10.48141166,80,6.43777165,6.436981353,8080,67.47693484,22,38,60,80,77,157,4,0.460049,0.471851,0.000001,No
6853,norris,41,11.38296011,24,7.641744454,7.641514432,984,86.98567229,12,18,30,33,31,64,4,0.437303,0.452744,0.000002,No
8021,mash,12,12.61162553,10,8.517213191,8.517123189,120,107.4159033,7,8,15,10,9,19,4,0.426974,0.443379,0.000004,No
3822,schwartz,10,12.79394708,7,8.873888135,8.873828135,70,113.5320552,7,8,15,8,9,17,4,0.425755,0.442271,0.000004,No
1403,translate,36,11.51301324,33,7.323290723,7.322970678,1188,84.31314304,14,16,30,34,30,64,4,0.457052,0.469086,0.000002,No
11479,genealogy,28,11.76432767,24,7.641744454,7.641514432,672,89.8999857,14,16,30,25,23,48,4,0.454245,0.466852,0.000002,No
1263,trout,29,11.72923635,19,7.875359305,7.875179292,551,92.37195061,14,16,30,27,24,51,4,0.397951,0.415427,0.000002,No
15360,chariot,27,11.80069531,15,8.111748083,8.111608076,405,95.72426757,14,16,30,26,23,49,4,0.443055,0.457608,0.000002,No
12565,everybody,66,10.90687744,57,6.776747016,6.776186871,3762,73.91314912,29,31,60,49,40,89,4,0.436743,0.452566,0.000001,No
2007,tapir,16,12.32394346,4,9.433503923,9.433473923,64,116.2579689,8,7,15,10,9,19,4,0.443177,0.457556,0.000004,No
10247,humanitarian,33,11.60002462,30,7.418600903,7.418310866,990,86.05595308,16,14,30,24,20,44,5,0.386631,0.403298,0.000002,No
8300,madden,26,11.83843564,12,8.334891634,8.334781631,312,98.67207817,16,14,30,24,17,41,5,0.403753,0.421358,0.000002,No
9953,incomplete,24,11.91847835,21,7.775275846,7.77507583,504,92.66945682,17,13,30,21,21,42,4,0.429235,0.44552,0.000002,No
11383,giles,23,11.96103796,20,7.824066011,7.823875996,460,93.58395057,17,13,30,21,18,39,5,0.398711,0.416105,0.000002,No
6922,nina,26,11.83843564,14,8.180740955,8.180610949,364,96.84717527,17,13,30,17,15,32,4,0.415413,0.432689,0.000002,No
2029,tangerine,14,12.45747485,11,8.421903011,8.421803008,154,104.9156449,9,6,15,11,11,22,4,0.393548,0.410611,0.000004,No
13192,dug,33,11.60002462,29,7.452502454,7.452222421,957,86.44921192,19,11,30,27,30,57,5,0.38184,0.398069,0.000002,No
16489,blank,29,11.72923635,21,7.775275846,7.77507583,609,91.19804807,20,10,30,24,23,47,4,0.411131,0.428704,0.000002,No
244,wolfgang,74,10.79246708,69,6.58569178,6.585011562,5106,71.07586176,22,8,30,55,51,106,5,0.323658,0.327422,0.000002,No
5263,prior,88,10.61919536,84,6.388981485,6.388151157,7392,67.84584256,46,14,60,58,82,140,4,0.42937,0.445778,0.000001,No
387,whitehall,49,11.20471188,19,7.875359305,7.875179292,931,88.24113196,29,30,59,46,44,90,4,0.438675,0.454125,0.000001,No
8760,leone,40,11.40765272,29,7.452502454,7.452222421,1160,85.01555992,5,24,29,31,32,63,4,0.453144,0.466101,0.000002,No
3922,savoy,52,11.14528846,44,7.03560865,7.035178566,2288,78.41388789,6,23,29,49,34,83,4,0.43698,0.452547,0.000002,No
9359,joule,29,11.72923635,11,8.421903011,8.421803008,319,98.78249092,11,18,29,25,24,49,4,0.435554,0.451237,0.000002,No
6859,norm,25,11.87765635,11,8.421903011,8.421803008,275,100.0324698,11,18,29,14,19,33,4,0.385221,0.402001,0.000002,No
489,wedge,30,11.6953348,16,8.047209562,8.047059554,480,94.11481,12,17,29,25,21,46,4,0.439392,0.454519,0.000002,No
15857,cabin,19,12.1520932,18,7.929426526,7.929256515,342,96.35913016,13,16,29,18,18,36,4,0.433989,0.449792,0.000002,No
2111,systematic,29,11.72923635,29,7.452502454,7.452222421,841,87.41216266,14,15,29,23,18,41,5,0.368484,0.382802,0.000002,No
17331,asiatic,32,11.63079627,24,7.641744454,7.641514432,768,88.87957293,14,15,29,28,22,50,5,0.385539,0.402101,0.000002,No
11205,gould,22,12.00548972,16,8.047209562,8.047059554,352,96.6106917,14,15,29,18,17,35,4,0.377304,0.392973,0.000002,No
7747,merlin,20,12.1007999,12,8.334891634,8.334781631,240,100.8588559,14,15,29,17,16,33,4,0.420839,0.438013,0.000002,No
9773,insane,24,11.91847835,22,7.728755831,7.728545813,528,92.11500902,16,13,29,21,18,39,5,0.393435,0.410683,0.000002,No
9277,kahn,23,11.96103796,9,8.622573707,8.622493705,207,103.1349314,16,13,29,20,16,36,4,0.406667,0.424211,0.000002,No
9543,isotope,41,11.38296011,31,7.38581108,7.385511041,1271,84.07239291,18,11,29,35,34,69,5,0.400492,0.41799,0.000002,No
15194,christine,27,11.80069531,24,7.641744454,7.641514432,648,90.17789795,19,10,29,21,13,34,5,0.407189,0.424696,0.000002,No
7738,mesa,18,12.20616042,14,8.180740955,8.180610949,252,99.85543644,9,10,19,13,13,26,4,0.425367,0.441956,0.000003,No
10382,hominid,18,12.20616042,13,8.254848927,8.254728922,234,100.7600102,9,10,19,15,15,30,4,0.415802,0.433107,0.000003,No
15527,cathode,33,11.60002462,18,7.929426526,7.929256515,594,91.9815429,10,9,19,30,29,59,4,0.431982,0.4479,0.000003,No
3155,slight,20,12.1007999,20,7.824066011,7.823875996,400,94.67745723,10,9,19,16,9,25,5,0.398559,0.41641,0.000003,No
10565,heroic,16,12.32394346,15,8.111748083,8.111608076,240,99.9687247,10,9,19,15,9,24,5,0.337459,0.344125,0.000003,No
18270,accessory,15,12.38848198,13,8.254848927,8.254728922,195,102.2650471,10,9,19,14,12,26,4,0.401116,0.418516,0.000003,No
2820,spinach,17,12.26331883,10,8.517213191,8.517123189,170,104.4493009,10,9,19,13,14,27,4,0.437745,0.45296,0.000003,No
11029,guanine,14,12.45747485,7,8.873888135,8.873828135,98,110.5462382,10,9,19,12,11,23,4,0.394274,0.411413,0.000003,No
8096,marianne,24,11.91847835,16,8.047209562,8.047059554,384,95.91049292,11,8,19,16,8,24,5,0.339427,0.346286,0.000003,No
1275,troop,16,12.32394346,14,8.180740955,8.180610949,224,100.8189889,11,8,19,13,8,21,4,0.414636,0.431952,0.000003,No
2018,tantric,15,12.38848198,12,8.334891634,8.334781631,180,103.2566548,11,8,19,12,8,20,5,0.324717,0.328182,0.000003,No
8418,lucius,33,11.60002462,30,7.418600903,7.418310866,990,86.05595308,12,7,19,26,13,39,5,0.385188,0.401561,0.000003,No
9650,invade,71,10.8338523,70,6.571303042,6.570612818,4970,71.19252658,13,44,57,52,61,113,4,0.427683,0.444698,0.000001,No
15517,caucasus,102,10.47155936,58,6.759355274,6.758785123,5916,70.78099001,19,38,57,97,77,174,4,0.460563,0.472274,0.000001,No
15355,charlemagne,69,10.86242567,45,7.013135794,7.012695706,3105,76.1796663,21,36,57,54,55,109,4,0.457417,0.469748,0.000001,No
15790,calm,57,11.05348091,57,6.776747016,6.776186871,3249,74.90664377,26,31,57,50,48,98,4,0.440362,0.455632,0.000001,No
2690,stake,37,11.48561426,37,7.208880372,7.208520314,1369,82.79841923,8,20,28,35,35,70,4,0.455282,0.467758,0.000002,No
4503,resist,31,11.66254497,29,7.452502454,7.452222421,899,86.91514503,8,20,28,29,25,54,4,0.420371,0.437863,0.000002,No
11855,forth,85,10.65388092,67,6.615105665,6.61444546,5695,70.47654803,16,40,56,78,74,152,4,0.462446,0.473757,0.000001,No
829,verve,5,13.48709426,2,10.1266511,10.1266411,10,136.579098,3,4,7,4,4,8,4,0.422824,0.43951,0.000008,No
2579,sterling,30,11.6953348,20,7.824066011,7.823875996,600,91.50507146,12,16,28,23,25,48,4,0.41837,0.435661,0.000002,No
15053,clef,34,11.57017165,11,8.421903011,8.421803008,374,97.44286348,12,16,28,30,30,60,4,0.452531,0.465448,0.000002,No
4625,refuge,29,11.72923635,26,7.561701746,7.56145172,754,88.69298697,13,15,28,27,24,51,4,0.446589,0.46058,0.000002,No
6483,orion,32,11.63079627,21,7.775275846,7.77507583,672,90.43264935,13,15,28,26,25,51,4,0.439926,0.454927,0.000002,No
4284,rode,26,11.83843564,23,7.684304068,7.684084048,598,90.97013915,13,15,28,21,23,44,4,0.437281,0.452796,0.000002,No
15565,cassette,33,11.60002462,17,7.98658494,7.986424931,561,92.6445819,13,15,28,31,22,53,4,0.434148,0.449998,0.000002,No
16902,barton,23,11.96103796,19,7.875359305,7.875179292,437,94.19747161,13,15,28,19,17,36,4,0.40868,0.426314,0.000002,No
11741,friar,12,12.61162553,12,8.334891634,8.334781631,144,105.1165321,7,7,14,9,9,18,5,0.408576,0.426015,0.000004,No
16331,booklet,10,12.79394708,10,8.517213191,8.517123189,100,108.9687749,7,7,14,8,8,16,5,0.398433,0.415744,0.000004,No
2985,somehow,22,12.00548972,22,7.728755831,7.728545813,484,92.78749871,14,14,28,20,14,34,5,0.370685,0.385525,0.000002,No
6081,pearson,27,11.80069531,15,8.111748083,8.111608076,405,95.72426757,14,14,28,22,20,42,5,0.390974,0.408108,0.000002,No
5345,precious,42,11.35886256,36,7.236279346,7.235929291,1512,82.19590253,15,13,28,37,25,62,5,0.389815,0.406669,0.000002,No
4711,re,28,11.76432767,24,7.641744454,7.641514432,672,89.8999857,15,13,28,18,15,33,4,0.441787,0.4565,0.000002,Yes
9375,jonas,35,11.54118412,27,7.523961418,7.52370139,945,86.83542401,16,12,28,23,13,36,4,0.433025,0.448886,0.000002,No
1335,triangular,28,11.76432767,26,7.561701746,7.56145172,728,88.95833706,16,12,28,23,17,40,5,0.368676,0.382937,0.000002,No
12191,fiat,37,11.48561426,19,7.875359305,7.875179292,703,90.45333917,16,12,28,32,26,58,4,0.420003,0.437154,0.000002,No
17758,amplitude,33,11.60002462,20,7.824066011,7.823875996,660,90.75935832,16,12,28,25,23,48,4,0.423005,0.439872,0.000002,No
3317,silicate,28,11.76432767,17,7.98658494,7.986424931,476,93.95680218,16,12,28,28,20,48,5,0.362029,0.374845,0.000002,No
1666,thyroid,38,11.45894602,13,8.254848927,8.254728922,494,94.59186824,16,12,28,36,32,68,4,0.427302,0.443773,0.000002,No
12165,fifty,80,10.71450554,77,6.475992862,6.475232589,6160,69.38706142,32,24,56,68,34,102,4,0.447399,0.461406,0.000001,No
11151,graphic,85,10.65388092,61,6.70892442,6.708324252,5185,71.47608188,38,18,56,63,48,111,5,0.386194,0.402871,0.000001,No
14443,coronary,20,12.1007999,7,8.873888135,8.873828135,140,107.3811447,11,3,14,17,13,30,5,0.321529,0.324785,0.000004,No
14892,collateral,9,12.8993076,5,9.210360372,9.210320372,45,118.8072715,5,6,11,6,8,14,5,0.385255,0.401604,0.000005,No
5399,potash,6,13.30477271,4,9.433503923,9.433473923,24,125.5106255,5,6,11,5,6,11,4,0.391215,0.408127,0.000005,No
9294,juror,11,12.6986369,5,9.210360372,9.210320372,55,116.9590221,7,4,11,10,4,14,4,0.409755,0.427258,0.000005,No
6550,operate,99,10.50141233,92,6.298009707,6.297099311,9108,66.13799678,17,38,55,75,87,162,4,0.452843,0.466115,0.000001,No
6852,norse,160,10.02135836,121,6.024007739,6.022807042,19360,60.36874032,23,32,55,153,131,284,4,0.451484,0.464917,0.000001,No
13207,dubious,4,13.71023782,4,9.433503923,9.433473923,16,129.3355822,3,2,5,3,2,5,5,0.325295,0.329062,0.000011,No
8169,mandarin,69,10.86242567,45,7.013135794,7.012695706,3105,76.1796663,33,22,55,59,54,113,4,0.442712,0.457444,0.000001,No
4607,registry,31,11.66254497,21,7.775275846,7.77507583,651,90.67950424,7,20,27,24,25,49,4,0.44714,0.461143,0.000002,No
9442,jericho,27,11.80069531,18,7.929426526,7.929256515,486,93.57274643,9,18,27,22,24,46,4,0.454827,0.467359,0.000002,No
1975,tavern,23,11.96103796,17,7.98658494,7.986424931,391,95.52784565,9,18,27,20,21,41,4,0.442967,0.457594,0.000002,No
267,withdrawn,42,11.35886256,38,7.182212124,7.181842063,1596,81.58176039,10,17,27,39,40,79,4,0.451576,0.464697,0.000002,No
13325,dortmund,36,11.51301324,23,7.684304068,7.684084048,828,88.46949447,10,17,27,18,29,47,4,0.439392,0.454533,0.000002,No
2267,supremacy,26,11.83843564,20,7.824066011,7.823875996,520,92.62470191,10,17,27,23,23,46,4,0.448915,0.462537,0.000002,No
2071,tailor,17,12.26331883,14,8.180740955,8.180610949,238,100.3230346,7,11,18,16,13,29,4,0.446442,0.460383,0.000003,No
12357,falcon,35,11.54118412,30,7.418600903,7.418310866,1050,85.6194389,11,16,27,25,25,50,4,0.446398,0.460411,0.000002,No
3067,snout,33,11.60002462,30,7.418600903,7.418310866,990,86.05595308,11,16,27,21,28,49,4,0.439055,0.454204,0.000002,No
3914,sawyer,26,11.83843564,14,8.180740955,8.180610949,364,96.84717527,11,16,27,18,21,39,4,0.39747,0.414925,0.000002,No
11549,garland,16,12.32394346,15,8.111748083,8.111608076,240,99.9687247,8,10,18,16,10,26,4,0.440231,0.455125,0.000003,No
8466,lorenz,17,12.26331883,13,8.254848927,8.254728922,221,101.2318443,8,10,18,10,11,21,5,0.405515,0.423025,0.000003,No
3601,serenade,20,12.1007999,11,8.421903011,8.421803008,220,101.9117632,12,15,27,20,19,39,4,0.439588,0.45474,0.000002,No
986,utopia,24,11.91847835,13,8.254848927,8.254728922,312,98.38523819,13,14,27,17,22,39,4,0.434477,0.4502,0.000002,No
8160,manganese,25,11.87765635,10,8.517213191,8.517123189,250,101.1645314,13,14,27,18,22,40,4,0.433776,0.449571,0.000002,No
11487,gelatinous,3,13.99791989,3,9.721185996,9.721165996,9,136.0763828,3,3,6,3,3,6,5,0.324593,0.328013,0.000009,No
16308,borden,10,12.79394708,5,9.210360372,9.210320372,50,117.8368632,9,9,18,10,9,19,4,0.413497,0.430769,0.000003,No
15554,casual,35,11.54118412,33,7.323290723,7.322970678,1155,84.51944657,14,13,27,31,23,54,5,0.395486,0.412791,0.000002,No
13079,eccentric,27,11.80069531,21,7.775275846,7.77507583,567,91.75366123,14,13,27,22,23,45,4,0.434786,0.450425,0.000002,No
36,zebra,33,11.60002462,11,8.421903011,8.421803008,363,97.69428224,14,13,27,20,16,36,4,0.439055,0.454148,0.000002,No
2617,steak,22,12.00548972,11,8.421903011,8.421803008,242,101.1090701,14,13,27,20,18,38,4,0.42499,0.441684,0.000002,No
7144,naomi,25,11.87765635,13,8.254848927,8.254728922,325,98.04825879,15,12,27,15,13,28,4,0.446476,0.460406,0.000002,No
472,weir,20,12.1007999,12,8.334891634,8.334781631,240,100.8588559,15,12,27,19,17,36,4,0.393348,0.410512,0.000002,No
9706,intent,21,12.05200974,20,7.824066011,7.823875996,420,94.29571976,11,7,18,20,20,40,4,0.435907,0.451425,0.000003,No
17713,andre,20,12.1007999,18,7.929426526,7.929256515,360,95.95240375,11,7,18,16,8,24,5,0.371531,0.386276,0.000003,No
8035,marty,25,11.87765635,14,8.180740955,8.180610949,350,97.16802977,17,10,27,21,13,34,4,0.426082,0.442618,0.000002,No
16990,banana,28,11.76432767,20,7.824066011,7.823875996,560,92.04487624,19,8,27,26,14,40,4,0.402325,0.41976,0.000002,No
7851,medicinal,19,12.1520932,17,7.98658494,7.986424931,323,97.05372453,13,5,18,16,9,25,5,0.328376,0.332586,0.000003,No
17152,autumn,97,10.5218212,82,6.413079037,6.412268725,7954,67.47727096,21,32,53,84,89,173,4,0.452578,0.465814,0.000001,No
10506,highland,67,10.89183956,56,6.794446593,6.793896453,3752,74.00402218,22,31,53,48,51,99,4,0.420142,0.437548,0.000001,No
2925,southampton,56,11.07118049,33,7.323290723,7.322970678,1848,81.07747335,24,29,53,47,47,94,4,0.45363,0.466589,0.000001,No
8898,latitude,75,10.77904406,54,6.830814238,6.830284108,4050,73.62964766,26,27,53,65,63,128,4,0.465747,0.476076,0.000001,No
10483,hindi,83,10.67769157,65,6.645411014,6.644770822,5395,70.95764916,30,23,53,69,67,136,4,0.452601,0.465631,0.000001,No
13091,eastwood,16,12.32394346,10,8.517213191,8.517123189,160,104.9656538,4,9,13,12,14,26,4,0.398326,0.415657,0.000004,No
818,veteran,26,11.83843564,25,7.600922459,7.600682435,650,89.98303133,9,17,26,25,21,46,5,0.410979,0.428579,0.000002,No
9884,inertia,25,11.87765635,13,8.254848927,8.254728922,325,98.04825879,9,17,26,22,23,45,4,0.450202,0.463584,0.000002,No
3367,siberia,66,10.90687744,53,6.849506371,6.848986246,3498,74.70672648,20,32,52,60,51,111,4,0.461737,0.473072,0.000001,No
13944,daytime,31,11.66254497,25,7.600922459,7.600682435,775,88.64610002,11,15,26,25,18,43,4,0.429567,0.445858,0.000002,No
10563,heroine,25,11.87765635,22,7.728755831,7.728545813,550,91.79950579,11,15,26,23,23,46,4,0.418517,0.435769,0.000002,No
17806,amelia,20,12.1007999,16,8.047209562,8.047059554,320,97.37767269,11,15,26,14,16,30,5,0.408351,0.425903,0.000002,No
15385,chandler,20,12.1007999,15,8.111748083,8.111608076,300,98.15864042,11,15,26,13,17,30,4,0.428055,0.444482,0.000002,No
15771,camelot,21,12.05200974,11,8.421903011,8.421803008,231,101.5008571,11,15,26,20,17,37,4,0.432403,0.448383,0.000002,No
15208,chorus,51,11.16470654,40,7.13091883,7.130528762,2040,79.61461613,22,30,52,41,46,87,4,0.45304,0.466129,0.000001,No
8142,mankind,47,11.24638458,37,7.208880372,7.208520314,1739,81.07384102,22,30,52,43,40,83,4,0.453329,0.466359,0.000001,No
14172,crystalline,23,11.96103796,23,7.684304068,7.684084048,529,91.91225267,12,14,26,18,16,34,5,0.359594,0.372414,0.000002,No
5322,prejudice,26,11.83843564,20,7.824066011,7.823875996,520,92.62470191,12,14,26,24,23,47,4,0.440253,0.455195,0.000002,No
9197,kerouac,27,11.80069531,10,8.517213191,8.517123189,270,100.5090378,12,14,26,25,21,46,4,0.396325,0.413667,0.000002,No
15644,careful,53,11.12624026,49,6.927977986,6.92749788,2597,77.08234762,24,28,52,52,44,96,4,0.461233,0.472617,0.000001,No
17357,artillery,48,11.22533117,37,7.208880372,7.208520314,1776,80.92206951,25,27,52,39,33,72,4,0.460706,0.472171,0.000001,No
5076,psyche,22,12.00548972,12,8.334891634,8.334781631,264,100.0644559,13,13,26,17,19,36,4,0.428458,0.444797,0.000002,No
9672,intimacy,24,11.91847835,7,8.873888135,8.873828135,168,105.7632436,13,13,26,15,19,34,4,0.404554,0.422075,0.000002,No
12650,estimate,73,10.80607274,68,6.600290579,6.599620368,4964,71.32322008,27,25,52,56,60,116,4,0.456676,0.46895,0.000001,No
8117,mar,28,11.76432767,22,7.728755831,7.728545813,616,90.92361605,14,12,26,22,17,39,4,0.414743,0.432257,0.000002,No
6171,pastry,25,11.87765635,16,8.047209562,8.047059554,400,95.58198977,14,12,26,18,18,36,4,0.406937,0.424624,0.000002,No
3039,sock,25,11.87765635,12,8.334891634,8.334781631,300,98.99897857,14,12,26,19,16,35,4,0.425877,0.442529,0.000002,No
6026,penicillin,21,12.05200974,9,8.622573707,8.622493705,189,103.9193423,14,12,26,15,18,33,4,0.426686,0.443182,0.000002,No
16662,bernhard,27,11.80069531,24,7.641744454,7.641514432,648,90.17789795,15,11,26,19,17,36,4,0.434201,0.449914,0.000002,No
13943,dayton,24,11.91847835,17,7.98658494,7.986424931,408,95.18793968,15,11,26,20,22,42,5,0.351248,0.361725,0.000002,No
15290,chestnut,20,12.1007999,17,7.98658494,7.986424931,340,96.64406628,15,11,26,18,15,33,4,0.431373,0.447411,0.000002,No
7460,molly,15,12.32394346,13,8.180740955,8.180610949,195,100.8189889,8,5,13,9,9,18,5,0.357235,0.369358,0.000004,No
3764,scrooge,63,10.95339745,14,8.180740955,8.180610949,882,89.60690712,33,19,52,55,31,86,4,0.412392,0.429966,0.000001,No
9564,irving,27,11.80069531,17,7.98658494,7.986424931,459,94.24725546,19,7,26,25,18,43,5,0.397719,0.415011,0.000002,No
6524,opus,27,11.80069531,7,8.873888135,8.873828135,189,104.7180501,20,6,26,22,6,28,4,0.425062,0.441754,0.000002,No
4634,referred,448,8.991738945,427,4.763014271,4.758745257,191296,42.82778092,46,6,52,278,447,725,5,0.384595,0.401056,0.000001,No
10289,housewife,16,12.32394346,14,8.180740955,8.180610949,224,100.8189889,5,12,17,15,15,30,4,0.405505,0.423009,0.000003,No
9232,keaton,16,12.32394346,13,8.254848927,8.254728922,208,101.7322914,5,12,17,12,14,26,4,0.433067,0.448928,0.000003,No
18067,afternoon,62,10.96939779,50,6.907775279,6.907285168,3100,75.77413489,18,33,51,52,52,104,4,0.460061,0.471767,0.000001,No
11313,glossary,20,12.1007999,19,7.875359305,7.875179292,380,95.29814712,7,10,17,10,13,23,4,0.417936,0.435206,0.000003,No
1893,temptation,13,12.53158282,9,8.622573707,8.622493705,117,108.0544965,7,10,17,8,10,18,4,0.409642,0.427103,0.000003,No
910,veda,19,12.1520932,11,8.421903011,8.421803008,209,102.3437503,8,9,17,13,13,26,4,0.439196,0.454214,0.000003,No
12878,emeritus,16,12.32394346,12,8.334891634,8.334781631,192,102.7187332,9,8,17,14,15,29,5,0.390098,0.407103,0.000003,No
17495,apt,15,12.38848198,11,8.421903011,8.421803008,165,104.3345937,9,8,17,10,11,21,4,0.416817,0.434065,0.000003,No
10267,huckleberry,15,12.38848198,9,8.622573707,8.622493705,135,106.820599,9,8,17,15,14,29,5,0.37756,0.393266,0.000003,No
2750,sprite,13,12.53158282,6,9.028038815,9.027988815,78,113.1356161,9,8,17,11,9,20,4,0.419041,0.436196,0.000003,No
16993,bambi,65,10.92214491,12,8.334891634,8.334781631,780,91.03489422,29,22,51,44,60,104,4,0.449859,0.463382,0.000001,No
7715,metamorphic,28,11.76432767,18,7.929426526,7.929256515,504,93.28437187,10,7,17,26,22,48,4,0.390123,0.406968,0.000003,No
8788,leland,12,12.61162553,8,8.740356743,8.740286741,96,110.2301062,10,7,17,11,10,21,4,0.391138,0.408066,0.000003,No
6872,nominee,25,11.87765635,22,7.728755831,7.728545813,550,91.79950579,11,6,17,21,21,42,5,0.403882,0.421424,0.000003,No
7012,neumann,8,13.01709064,8,8.740356743,8.740286741,64,113.7740159,3,7,10,7,7,14,4,0.413487,0.430891,0.000005,No
3319,silhouette,6,13.30477271,3,9.721185996,9.721165996,18,129.3381701,6,4,10,6,4,10,4,0.406173,0.423666,0.000005,No
17807,ambush,10,12.79394708,8,8.740356743,8.740286741,80,111.8236617,7,3,10,9,3,12,5,0.378204,0.393972,0.000005,No
17264,atheist,28,11.76432767,23,7.684304068,7.684084048,644,90.40067095,6,19,25,26,25,51,4,0.457736,0.469692,0.000002,No
9381,joke,63,10.95339745,47,6.969650683,6.969190586,2961,76.34135402,15,35,50,57,52,109,4,0.463945,0.474837,0.000001,No
269,withdraw,28,11.76432767,24,7.641744454,7.641514432,672,89.8999857,9,16,25,24,22,46,4,0.441062,0.455932,0.000002,No
14939,cody,27,11.80069531,18,7.929426526,7.929256515,486,93.57274643,10,15,25,19,24,43,4,0.431782,0.447825,0.000002,No
15196,christie,22,12.00548972,18,7.929426526,7.929256515,396,95.19664868,10,15,25,16,19,35,4,0.432424,0.448407,0.000002,No
4873,quiet,41,11.38296011,40,7.13091883,7.130528762,1640,81.1709646,21,29,50,36,34,70,4,0.433046,0.449224,0.000001,No
9629,invisible,48,11.22533117,36,7.236279346,7.235929291,1728,81.22963207,21,29,50,40,41,81,4,0.436325,0.452092,0.000001,No
6751,nymph,35,11.54118412,25,7.600922459,7.600682435,875,87.72364555,11,14,25,34,22,56,4,0.3902,0.407348,0.000002,No
3051,soar,19,12.1520932,7,8.873888135,8.873828135,133,107.8363156,11,14,25,15,15,30,4,0.409358,0.427056,0.000002,No
9276,kaiser,29,11.72923635,25,7.600922459,7.600682435,725,89.15301598,12,13,25,21,24,45,4,0.439446,0.454505,0.000002,No
3561,seventy,25,11.87765635,24,7.641744454,7.641514432,600,90.76601456,12,13,25,22,14,36,4,0.410865,0.428356,0.000002,No
8715,lexington,28,11.76432767,21,7.775275846,7.77507583,588,91.47089276,12,13,25,24,26,50,4,0.393627,0.41085,0.000002,No
11556,garcia,24,11.91847835,23,7.684304068,7.684084048,552,91.58521165,12,13,25,19,16,35,4,0.428592,0.444947,0.000002,No
14826,comment,22,12.00548972,22,7.728755831,7.728545813,484,92.78749871,12,13,25,19,21,40,4,0.418982,0.436177,0.000002,No
12330,fantasia,20,12.1007999,13,8.254848927,8.254728922,260,99.8902751,12,13,25,16,17,33,4,0.449461,0.462875,0.000002,No
16579,bile,24,11.91847835,10,8.517213191,8.517123189,240,101.512221,12,13,25,19,17,36,4,0.413468,0.430905,0.000002,No
7994,mate,60,11.00218762,45,7.013135794,7.012695706,2700,77.15983578,24,26,50,39,43,82,4,0.440559,0.455693,0.000001,No
2991,somalia,46,11.26789078,28,7.487593774,7.487323743,1288,84.36938886,24,26,50,43,37,80,4,0.445166,0.459599,0.000001,No
3517,shanghai,50,11.18450917,35,7.264450223,7.264110172,1750,81.24931015,25,25,50,47,37,84,4,0.440329,0.455467,0.000001,No
5313,preparation,30,11.6953348,28,7.487593774,7.487323743,840,87.569916,13,12,25,24,27,51,4,0.435885,0.451402,0.000002,No
12864,emission,30,11.6953348,21,7.775275846,7.77507583,630,90.93445415,13,12,25,23,26,49,4,0.421349,0.438459,0.000002,No
12740,epoch,21,12.05200974,17,7.98658494,7.986424931,357,96.25439949,13,12,25,18,15,33,5,0.419913,0.437034,0.000002,No
8540,lobster,19,12.1520932,15,8.111748083,8.111608076,285,98.57471871,13,12,25,13,14,27,4,0.395601,0.412859,0.000002,No
5696,pity,20,12.1007999,14,8.180740955,8.180610949,280,98.99350936,13,12,25,14,15,29,4,0.437562,0.452834,0.000002,No
11674,fulton,36,11.51301324,18,7.929426526,7.929256515,648,91.29159257,15,10,25,31,33,64,4,0.392357,0.409404,0.000002,No
1465,trace,30,11.6953348,30,7.418600903,7.418310866,900,86.76302127,16,9,25,24,20,44,4,0.426246,0.442872,0.000002,No
4916,quantum,101,10.48141166,60,6.725453722,6.72486356,6060,70.49224906,33,17,50,76,31,107,5,0.388765,0.405864,0.000001,No
3628,sensory,35,11.54118412,26,7.561701746,7.56145172,910,87.27099208,18,7,25,30,18,48,5,0.328503,0.33275,0.000002,No
4789,raise,104,10.45214128,98,6.234830806,6.233860354,10192,65.16733243,18,31,49,95,87,182,4,0.449415,0.463195,0.000001,No
16153,bremen,62,10.96939779,40,7.13091883,7.130528762,2480,78.22188527,20,29,49,41,48,89,4,0.457088,0.469335,0.000001,No
13059,ecuador,70,10.84803694,51,6.887972651,6.887472536,3570,74.72098173,21,28,49,57,57,114,4,0.445647,0.460026,0.000001,No
1878,tense,47,11.24638458,21,7.775275846,7.77507583,987,87.44374235,21,28,49,36,39,75,4,0.46235,0.473476,0.000001,No
2462,stretch,56,11.07118049,51,6.887972651,6.887472536,2856,76.25798841,23,26,49,45,48,93,4,0.465331,0.475729,0.000001,No
9851,infinity,46,11.26789078,32,7.354062381,7.35375234,1472,82.86477171,24,25,49,40,42,82,4,0.43899,0.454327,0.000001,No
17016,bali,61,10.98565831,26,7.561701746,7.56145172,1586,83.07027165,26,23,49,56,49,105,4,0.438145,0.453524,0.000001,No
11022,guatemala,56,11.07118049,43,7.058598169,7.058178089,2408,78.14701431,27,22,49,47,47,94,4,0.436679,0.452256,0.000001,No
14692,confederacy,41,11.38296011,33,7.323290723,7.322970678,1353,83.36072618,6,18,24,33,35,68,4,0.458919,0.470607,0.000002,No
12086,fitch,15,12.38848198,9,8.622573707,8.622493705,135,106.820599,5,11,16,7,12,19,4,0.43486,0.450571,0.000003,No
8465,lorraine,49,11.20471188,41,7.106226218,7.105826145,2009,79.62321732,17,31,48,43,44,87,4,0.410399,0.428234,0.000001,No
17232,attic,16,12.32394346,14,8.180740955,8.180610949,224,100.8189889,6,10,16,15,11,26,4,0.43611,0.451683,0.000003,No
1419,transduction,14,12.45747485,6,9.028038815,9.027988815,84,112.4665665,6,10,16,14,11,25,4,0.440625,0.455542,0.000003,No
5478,pooh,13,12.53158282,5,9.210360372,9.210320372,65,115.4203938,6,10,16,10,11,21,4,0.419903,0.436905,0.000003,No
9942,incredible,11,12.6986369,9,8.622573707,8.622493705,99,109.4949327,5,7,12,8,9,17,5,0.375842,0.392493,0.000004,No
1468,toxin,10,12.79394708,8,8.740356743,8.740286741,80,111.8236617,5,7,12,7,8,15,4,0.401525,0.418953,0.000004,No
1422,transcript,23,11.96103796,12,8.334891634,8.334781631,276,99.69395524,10,14,24,14,17,31,4,0.447106,0.460998,0.000002,No
7756,mercy,49,11.20471188,36,7.236279346,7.235929291,1764,81.08042515,20,28,48,47,42,89,4,0.444731,0.459251,0.000001,No
13810,deliberate,13,12.53158282,13,8.254848927,8.254728922,169,103.446323,7,9,16,12,9,21,5,0.359332,0.371473,0.000003,No
15312,cheetah,21,12.05200974,9,8.622573707,8.622493705,189,103.9193423,7,9,16,18,12,30,4,0.424371,0.441017,0.000003,No
5396,potatoes,64,10.93764909,44,7.03560865,7.035178566,2816,76.95301858,21,27,48,40,49,89,4,0.442735,0.457561,0.000001,No
9717,integrity,24,11.91847835,22,7.728755831,7.728545813,528,92.11500902,11,13,24,19,19,38,4,0.425592,0.442247,0.000002,No
6884,node,28,11.76432767,18,7.929426526,7.929256515,504,93.28437187,11,13,24,22,18,40,4,0.430745,0.446951,0.000002,No
6365,pagan,46,11.26789078,39,7.156236638,7.155856573,1794,80.63569284,23,25,48,37,32,69,5,0.40291,0.420664,0.000001,No
4047,sallow,3,13.99791989,3,9.721185996,9.721165996,9,136.0763828,3,3,6,3,3,6,5,0.398112,0.415899,0.000008,No
3339,sieve,13,12.53158282,11,8.421903011,8.421803008,143,105.5397751,6,6,12,11,10,21,4,0.409481,0.426863,0.000004,No
7265,mule,13,12.53158282,11,8.421903011,8.421803008,143,105.5397751,6,6,12,10,10,20,4,0.417631,0.434825,0.000004,No
17969,alchemist,15,12.38848198,15,8.111748083,8.111608076,225,100.4922449,8,8,16,12,8,20,5,0.398156,0.415486,0.000003,No
3949,satin,13,12.53158282,3,9.721185996,9.721165996,39,121.8218474,8,8,16,10,12,22,5,0.382738,0.399064,0.000003,No
15305,chen,27,11.80069531,13,8.254848927,8.254728922,351,97.41295703,12,12,24,21,20,41,4,0.408614,0.42615,0.000002,No
10944,ha,18,12.20616042,15,8.111748083,8.111608076,270,99.01329838,12,12,24,13,15,28,4,0.434946,0.450571,0.000002,No
15419,ceylon,13,12.53158282,11,8.421903011,8.421803008,143,105.5397751,12,12,24,13,13,26,4,0.404443,0.421967,0.000002,No
13240,driven,70,10.84803694,68,6.600290579,6.599620368,4760,71.60019599,24,24,48,60,66,126,4,0.440526,0.455627,0.000001,No
13332,dormant,27,11.80069531,24,7.641744454,7.641514432,648,90.17789795,13,11,24,23,21,44,4,0.437023,0.452359,0.000002,No
13402,dodge,21,12.05200974,14,8.180740955,8.180610949,294,98.59436966,13,11,24,19,14,33,4,0.4027,0.420192,0.000002,No
16152,brenda,16,12.32394346,12,8.334891634,8.334781631,192,102.7187332,13,11,24,13,15,28,5,0.36606,0.380026,0.000002,No
7898,mcintosh,17,12.26331883,10,8.517213191,8.517123189,170,104.4493009,13,11,24,14,14,28,4,0.392495,0.409587,0.000002,No
14199,cruelty,22,12.00548972,15,8.111748083,8.111608076,330,97.38550826,9,7,16,18,17,35,4,0.416075,0.433271,0.000003,No
3564,seventeen,52,11.14528846,50,6.907775279,6.907285168,2600,76.98914809,27,21,48,41,30,71,4,0.440942,0.455932,0.000001,No
7668,micro,32,11.63079627,26,7.561701746,7.56145172,832,87.9486125,14,10,24,20,15,35,4,0.42684,0.443299,0.000002,No
11318,gloria,22,12.00548972,18,7.929426526,7.929256515,396,95.19664868,14,10,24,17,15,32,4,0.432445,0.448327,0.000002,No
98,yellowstone,27,11.80069531,15,8.111748083,8.111608076,405,95.72426757,14,10,24,23,14,37,5,0.347405,0.35651,0.000002,No
16623,betrayal,22,12.00548972,5,9.210360372,9.210320372,110,110.5748868,14,10,24,16,21,37,4,0.422532,0.439454,0.000002,No
12159,fiji,39,11.43297053,26,7.561701746,7.56145172,1014,86.45271323,28,20,48,35,35,70,4,0.445188,0.459486,0.000001,No
620,walcott,6,13.30477271,5,9.210360372,9.210320372,30,122.5417513,5,3,8,6,4,10,5,0.39968,0.417321,0.000006,No
14541,contribute,22,12.00548972,22,7.728755831,7.728545813,484,92.78749871,11,5,16,18,14,32,4,0.41316,0.43045,0.000003,No
17236,attend,75,10.77904406,72,6.543132165,6.542421927,5400,70.52870992,16,31,47,67,64,131,4,0.436078,0.451998,0.000001,No
3132,slovenia,58,11.03608917,40,7.13091883,7.130528762,2320,78.69745605,20,27,47,47,49,96,4,0.408661,0.42646,0.000001,No
14727,concern,53,11.12624026,51,6.887972651,6.887472536,2703,76.63723865,21,26,47,45,47,92,4,0.456735,0.46903,0.000001,No
929,vary,144,10.12671888,137,5.899817358,5.89845646,19728,59.74579182,23,24,47,88,98,186,4,0.452428,0.465532,0.000001,No
6981,newport,51,11.16470654,37,7.208880372,7.208520314,1887,80.48503386,23,24,47,38,37,75,4,0.429577,0.44605,0.000001,No
14629,conscious,40,11.40765272,33,7.323290723,7.322970678,1320,83.54155736,23,24,47,35,32,67,4,0.450556,0.464026,0.000001,No
9266,kangaroo,70,10.84803694,30,7.418600903,7.418310866,2100,80.4772566,25,22,47,55,46,101,4,0.436872,0.452435,0.000001,No
6925,nile,120,10.30904043,65,6.645411014,6.644770822,7800,68.50781085,7,39,46,116,106,222,4,0.45968,0.471593,0.000001,No
16409,boar,29,11.72923635,15,8.111748083,8.111608076,435,95.14461046,6,17,23,27,23,50,4,0.435982,0.451566,0.000002,No
9335,judiciary,25,11.87765635,17,7.98658494,7.986424931,425,94.86191135,7,16,23,24,19,43,4,0.448077,0.461814,0.000002,No
6658,offenbach,20,12.1007999,11,8.421903011,8.421803008,220,101.9117632,7,16,23,17,17,34,4,0.41551,0.432938,0.000002,No
2616,steal,66,10.90687744,59,6.74226084,6.741680684,3894,73.53701262,14,32,46,63,54,117,4,0.441227,0.456359,0.000001,No
13248,drift,31,11.66254497,19,7.875359305,7.875179292,589,91.84673207,8,15,23,21,28,49,4,0.442007,0.456725,0.000002,No
11649,furnace,22,12.00548972,18,7.929426526,7.929256515,396,95.19664868,8,15,23,21,18,39,4,0.434647,0.450453,0.000002,No
8576,lithosphere,30,11.6953348,11,8.421903011,8.421803008,330,98.49697534,8,15,23,29,25,54,4,0.445971,0.460054,0.000002,No
255,wizard,67,10.89183956,44,7.03560865,7.035178566,2948,76.63072061,17,29,46,60,60,120,4,0.461233,0.47264,0.000001,No
11076,grind,19,12.1520932,16,8.047209562,8.047059554,304,97.79044058,9,14,23,17,17,34,4,0.454478,0.466997,0.000002,No
13152,durham,76,10.76579884,47,6.969650683,6.969190586,3572,75.03385721,19,27,46,68,65,133,4,0.446532,0.460744,0.000001,No
984,utrecht,59,11.01899473,35,7.264450223,7.264110172,2065,80.04693875,19,27,46,48,40,88,4,0.452312,0.465481,0.000001,No
16942,baritone,27,11.80069531,21,7.775275846,7.77507583,567,91.75366123,10,13,23,21,18,39,5,0.404858,0.422523,0.000002,No
15777,cambrian,29,11.72923635,16,8.047209562,8.047059554,464,94.38762289,10,13,23,28,21,49,4,0.419269,0.436487,0.000002,No
1972,taxa,17,12.26331883,14,8.180740955,8.180610949,238,100.3230346,10,13,23,13,14,27,4,0.424056,0.440938,0.000002,No
10137,icarus,18,12.20616042,5,9.210360372,9.210320372,90,112.4231362,10,13,23,15,14,29,4,0.411474,0.428952,0.000002,No
9298,jura,153,10.06609426,101,6.204677767,6.203677287,15453,62.45687123,20,26,46,135,129,264,4,0.45809,0.4701,0.000001,No
3434,shiva,66,10.90687744,29,7.452502454,7.452222421,1914,81.28353085,20,26,46,58,58,116,4,0.453225,0.46618,0.000001,No
477,weigh,122,10.29251113,110,6.119317918,6.118227346,13420,62.9831478,21,25,46,98,110,208,4,0.445501,0.459951,0.000001,No
1519,tor,27,11.80069531,15,8.111748083,8.111608076,405,95.72426757,11,12,23,16,17,33,4,0.440209,0.455247,0.000002,No
11633,fuzzy,18,12.20616042,13,8.254848927,8.254728922,234,100.7600102,11,12,23,16,16,32,5,0.349698,0.359347,0.000002,No
8015,masonry,18,12.20616042,8,8.740356743,8.740286741,144,106.6861965,11,12,23,13,15,28,4,0.425541,0.442168,0.000002,No
1066,unix,66,10.90687744,45,7.013135794,7.012695706,2970,76.49141255,22,24,46,58,36,94,4,0.454373,0.467077,0.000001,No
2563,sticky,47,11.24638458,36,7.236279346,7.235929291,1692,81.38198042,22,24,46,43,35,78,4,0.424929,0.441834,0.000001,No
13370,dominican,215,9.725894149,131,5.944600961,5.943300141,28165,57.81655971,23,23,46,198,72,270,5,0.349189,0.358959,0.000001,No
8781,lena,24,11.91847835,13,8.254848927,8.254728922,312,98.38523819,12,11,23,17,12,29,4,0.392365,0.409442,0.000002,No
18053,aggression,15,12.38848198,12,8.334891634,8.334781631,180,103.2566548,12,11,23,15,13,28,4,0.421529,0.438618,0.000002,No
11255,goldfish,16,12.32394346,4,9.433503923,9.433473923,64,116.2579689,12,11,23,13,12,25,4,0.408896,0.426511,0.000002,No
6994,nevertheless,40,11.40765272,39,7.156236638,7.155856573,1560,81.63586237,24,22,46,26,34,60,4,0.414414,0.432046,0.000001,No
4784,raleigh,26,11.83843564,15,8.111748083,8.111608076,390,96.0304076,13,10,23,21,23,44,4,0.392791,0.409878,0.000002,No
14290,crayfish,20,12.1007999,11,8.421903011,8.421803008,220,101.9117632,13,10,23,15,17,32,5,0.398944,0.416363,0.000002,No
15769,cameo,17,12.26331883,10,8.517213191,8.517123189,170,104.4493009,13,10,23,16,13,29,4,0.415403,0.432778,0.000002,No
596,waltham,17,12.26331883,5,9.210360372,9.210320372,85,112.9495858,13,10,23,14,12,26,5,0.348955,0.358603,0.000002,No
13018,effort,76,10.76579884,73,6.529338843,6.528618598,5548,70.29354852,26,20,46,65,68,133,4,0.451473,0.464687,0.000001,No
16046,bruegel,7,13.15062203,2,10.1266511,10.1266411,14,133.1717611,3,6,9,3,6,9,4,0.42201,0.438956,0.000005,No
4288,rockwell,13,12.53158282,8,8.740356743,8.740286741,104,109.5305044,5,10,15,8,13,21,4,0.397755,0.415103,0.000003,No
5357,prank,10,12.79394708,9,8.622573707,8.622493705,90,110.3167517,6,9,15,8,10,18,4,0.416974,0.434206,0.000003,No
5498,pomegranate,13,12.53158282,6,9.028038815,9.027988815,78,113.1356161,6,9,15,13,9,22,4,0.418972,0.435999,0.000003,No
3982,sao,12,12.61162553,6,9.028038815,9.027988815,72,113.8582448,7,8,15,9,10,19,5,0.371104,0.385816,0.000003,No
13975,dart,25,11.87765635,13,8.254848927,8.254728922,325,98.04825879,9,6,15,23,15,38,5,0.401779,0.419185,0.000003,No
10383,homicide,6,13.30477271,5,9.210360372,9.210320372,30,122.5417513,6,3,9,6,3,9,5,0.384262,0.400468,0.000005,No
5051,puberty,53,11.12624026,34,7.29343776,7.293107712,1802,81.14854086,16,29,45,43,47,90,4,0.455586,0.468147,0.000001,No
12907,elsewhere,67,10.89183956,67,6.615105665,6.61444546,4489,72.05066956,17,28,45,46,55,101,4,0.456982,0.469236,0.000001,No
3546,seymour,45,11.28986969,24,7.641744454,7.641514432,1080,86.27429907,18,27,45,40,42,82,4,0.44642,0.46065,0.000001,No
534,waterloo,70,10.84803694,49,6.927977986,6.92749788,3430,75.15496108,19,26,45,62,65,127,4,0.453526,0.466467,0.000001,No
2618,steady,49,11.20471188,47,6.969650683,6.969190586,2303,78.0929278,19,26,45,43,40,83,4,0.418143,0.435609,0.000001,No
6964,nicaragua,53,11.12624026,35,7.264450223,7.264110172,1855,80.82601856,20,25,45,42,41,83,4,0.458753,0.470603,0.000001,No
5326,preferred,60,11.00218762,55,6.812465099,6.811924964,3300,74.95201914,21,24,45,51,50,101,4,0.399518,0.417263,0.000001,No
729,vishnu,76,10.76579884,40,7.13091883,7.130528762,3040,76.77003765,21,24,45,56,59,115,4,0.456289,0.468598,0.000001,No
2783,sponsor,56,11.07118049,37,7.208880372,7.208520314,2072,79.8108157,21,24,45,47,45,92,4,0.455504,0.468006,0.000001,No
222,woodstock,48,11.22533117,23,7.684304068,7.684084048,1104,86.25885795,23,22,45,42,43,85,4,0.43452,0.450378,0.000001,No
5845,philharmonic,81,10.70208302,56,6.794446593,6.793896453,4536,72.71473154,25,20,45,78,77,155,4,0.43517,0.450909,0.000001,No
2977,sometime,53,11.12624026,52,6.868554566,6.868044446,2756,76.42118836,31,14,45,38,43,81,4,0.400899,0.418643,0.000001,No
8731,lever,24,11.91847835,15,8.111748083,8.111608076,360,96.67969388,7,15,22,22,19,41,4,0.43064,0.44689,0.000002,No
3490,sheath,9,12.8993076,8,8.740356743,8.740286741,72,112.7445502,4,7,11,7,9,16,4,0.418182,0.435304,0.000004,No
18257,accord,9,12.8993076,8,8.740356743,8.740286741,72,112.7445502,4,7,11,8,9,17,4,0.40609,0.423596,0.000004,No
1886,tendon,8,13.01709064,5,9.210360372,9.210320372,40,119.8920957,4,7,11,7,7,14,4,0.417347,0.434572,0.000004,No
7638,mighty,40,11.40765272,30,7.418600903,7.418310866,1200,84.62882279,8,14,22,37,19,56,4,0.3731,0.38825,0.000002,No
17241,attach,22,12.00548972,20,7.824066011,7.823875996,440,93.93174409,9,13,22,18,20,38,4,0.416436,0.433858,0.000002,No
5793,picasso,26,11.83843564,14,8.180740955,8.180610949,364,96.84717527,9,13,22,22,20,42,4,0.428499,0.444858,0.000002,No
3256,sink,49,11.20471188,36,7.236279346,7.235929291,1764,81.08042515,18,26,44,48,44,92,4,0.45697,0.469204,0.000001,No
5099,proven,61,10.98565831,51,6.887972651,6.887472536,3111,75.66891402,19,25,44,52,56,108,4,0.443011,0.457763,0.000001,No
10322,horseback,12,12.61162553,12,8.334891634,8.334781631,144,105.1165321,5,6,11,12,7,19,5,0.397043,0.414246,0.000004,No
11314,gloss,8,13.01709064,7,8.873888135,8.873828135,56,115.5122061,5,6,11,7,6,13,4,0.400068,0.417455,0.000004,No
862,verdi,25,11.87765635,18,7.929426526,7.929256515,450,94.18300335,10,12,22,20,22,42,4,0.394484,0.411705,0.000002,No
13926,dear,17,12.26331883,17,7.98658494,7.986424931,289,97.94203751,10,12,22,11,13,24,4,0.416397,0.433755,0.000002,No
5476,poole,22,12.00548972,11,8.421903011,8.421803008,242,101.1090701,10,12,22,18,16,34,4,0.40484,0.422371,0.000002,No
8635,linden,16,12.32394346,12,8.334891634,8.334781631,192,102.7187332,10,12,22,13,16,29,4,0.411017,0.428506,0.000002,No
6030,penelope,16,12.32394346,8,8.740356743,8.740286741,128,107.7156623,10,12,22,14,14,28,4,0.396865,0.414169,0.000002,No
5756,pilgrimage,56,11.07118049,45,7.013135794,7.012695706,2520,77.64369216,20,24,44,53,47,100,4,0.452739,0.465795,0.000001,No
16611,bhutan,51,11.16470654,37,7.208880372,7.208520314,1887,80.48503386,20,24,44,43,43,86,4,0.437756,0.453237,0.000001,No
7789,mendel,35,11.54118412,15,8.111748083,8.111608076,525,93.61917813,11,11,22,15,20,35,4,0.411341,0.428948,0.000002,No
1903,temperate,91,10.58567267,82,6.413079037,6.412268725,7462,67.8867555,23,21,44,89,54,143,4,0.435319,0.451059,0.000001,No
5305,preservation,48,11.22533117,35,7.264450223,7.264110172,1680,81.54585949,23,21,44,43,40,83,4,0.442249,0.45704,0.000001,No
18115,advisory,25,11.87765635,21,7.775275846,7.77507583,525,92.35205455,12,10,22,18,20,38,5,0.378947,0.394972,0.000002,No
8308,macon,21,12.05200974,11,8.421903011,8.421803008,231,101.5008571,12,10,22,19,21,40,4,0.426789,0.443257,0.000002,No
627,wait,57,11.05348091,51,6.887972651,6.887472536,2907,76.13607421,25,19,44,54,54,108,4,0.451243,0.464481,0.000001,No
13269,dramatist,29,11.72923635,29,7.452502454,7.452222421,841,87.41216266,13,9,22,23,18,41,5,0.410086,0.427518,0.000002,No
10655,heinz,30,11.6953348,17,7.98658494,7.986424931,510,93.40578475,13,9,22,26,18,44,5,0.330147,0.334544,0.000002,No
14816,committing,23,11.96103796,20,7.824066011,7.823875996,460,93.58395057,13,9,22,20,18,38,4,0.425031,0.441942,0.000002,No
7119,nate,19,12.1520932,13,8.254848927,8.254728922,247,100.3136935,13,9,22,15,12,27,5,0.341701,0.349119,0.000002,No
1536,toolkit,10,12.79394708,8,8.740356743,8.740286741,80,111.8236617,7,4,11,9,4,13,4,0.40689,0.424464,0.000004,No
9441,jerk,16,12.32394346,5,9.210360372,9.210320372,80,113.5079604,14,8,22,14,15,29,5,0.37966,0.395629,0.000002,No
13945,daylight,64,10.93764909,45,7.013135794,7.012695706,2880,76.70721837,28,16,44,57,30,87,4,0.440024,0.455045,0.000001,No
11929,fond,16,12.32394346,16,8.047209562,8.047059554,256,99.17335561,8,3,11,12,16,28,5,0.378736,0.39458,0.000004,No
1871,tenth,85,10.65388092,79,6.450350432,6.449570143,6715,68.7212654,11,32,43,82,58,140,4,0.415919,0.433562,0.000001,No
10051,immortal,39,11.43297053,33,7.323290723,7.322970678,1287,83.72696702,17,26,43,35,35,70,4,0.433999,0.449998,0.000001,No
9084,knox,43,11.33533206,23,7.684304068,7.684084048,989,87.10413828,17,26,43,34,36,70,4,0.452335,0.465504,0.000001,No
104,yeast,54,11.10754813,25,7.600922459,7.600682435,1350,84.42761206,18,25,43,40,38,78,4,0.445971,0.460256,0.000001,No
4516,reputation,58,11.03608917,56,6.794446593,6.793896453,3248,74.98411844,20,23,43,53,53,106,4,0.436969,0.45259,0.000001,No
97,yemen,46,11.26789078,31,7.38581108,7.385511041,1426,83.22251257,20,23,43,34,36,70,4,0.445904,0.460124,0.000001,No
7729,messiah,43,11.33533206,27,7.523961418,7.52370139,1161,85.28660109,20,23,43,38,36,74,4,0.440089,0.455218,0.000001,No
14797,comparison,75,10.77904406,66,6.630143542,6.629493344,4950,71.46660939,21,22,43,58,63,121,4,0.46061,0.472011,0.000001,No
17715,andorra,40,11.40765272,24,7.641744454,7.641514432,960,87.17436693,21,22,43,35,32,67,4,0.453909,0.466687,0.000001,No
3638,senegal,41,11.38296011,30,7.418600903,7.418310866,1230,84.44563815,22,21,43,35,35,70,4,0.437831,0.453256,0.000001,No
3448,shinto,53,11.12624026,35,7.264450223,7.264110172,1855,80.82601856,24,19,43,45,37,82,4,0.450613,0.463936,0.000001,No
16549,birch,42,11.35886256,23,7.684304068,7.684084048,966,87.28495377,26,17,43,30,38,68,4,0.433787,0.449632,0.000001,No
17155,autonomous,159,10.02762798,120,6.032306541,6.031115857,19080,60.48972583,27,16,43,131,81,212,5,0.381021,0.397362,0.000001,No
17302,associate,57,11.05348091,49,6.927977986,6.92749788,2793,76.57827241,27,16,43,50,41,91,4,0.437767,0.45312,0.000001,No
17965,alcoholic,75,10.77904406,64,6.660915201,6.660285015,4800,71.79829846,29,14,43,66,42,108,5,0.400266,0.417744,0.000001,No
14352,courthouse,15,12.38848198,15,8.111748083,8.111608076,225,100.4922449,5,9,14,13,13,26,4,0.433649,0.449378,0.000003,No
3378,shuffle,15,12.38848198,5,9.210360372,9.210320372,75,114.1023835,5,9,14,5,13,18,4,0.409151,0.426666,0.000003,No
7657,middlesex,22,12.00548972,21,7.775275846,7.77507583,462,93.34599428,6,8,14,11,20,31,5,0.396679,0.413932,0.000003,No
5366,practitioner,12,12.61162553,12,8.334891634,8.334781631,144,105.1165321,6,8,14,9,10,19,4,0.430714,0.446773,0.000003,No
12933,elizabethan,12,12.61162553,11,8.421903011,8.421803008,132,106.213887,6,8,14,10,10,20,5,0.396024,0.413251,0.000003,No
16674,berkelium,11,12.6986369,3,9.721185996,9.721165996,33,123.4458112,6,8,14,7,9,16,4,0.375762,0.391091,0.000003,No
1692,thrombosis,5,13.48709426,5,9.210360372,9.210320372,25,124.2209985,4,3,7,5,3,8,5,0.361204,0.37397,0.000006,No
18122,adverse,21,12.05200974,11,8.421903011,8.421803008,231,101.5008571,8,6,14,16,14,30,4,0.407245,0.424948,0.000003,No
8157,mangrove,14,12.45747485,13,8.254848927,8.254728922,182,102.8345729,8,6,14,12,8,20,5,0.32489,0.328341,0.000003,No
13986,dar,14,12.45747485,6,9.028038815,9.027988815,84,112.4665665,8,6,14,9,6,15,4,0.424665,0.441247,0.000003,No
6328,palo,17,12.26331883,12,8.334891634,8.334781631,204,102.2134336,10,4,14,15,17,32,5,0.348052,0.35768,0.000003,No
6845,northernmost,43,11.33533206,39,7.156236638,7.155856573,1677,81.1183186,5,16,21,43,35,78,5,0.406016,0.423621,0.000002,No
13768,demon,46,11.26789078,26,7.561701746,7.56145172,1196,85.20442939,13,29,42,41,37,78,4,0.456441,0.468823,0.000001,No
3557,seville,49,11.20471188,33,7.323290723,7.322970678,1617,82.05536256,16,26,42,43,42,85,4,0.455037,0.467678,0.000001,No
8889,laugh,37,11.48561426,26,7.561701746,7.56145172,962,86.85078944,17,25,42,32,33,65,4,0.458422,0.47034,0.000001,No
6182,passive,19,12.1520932,15,8.111748083,8.111608076,285,98.57471871,9,12,21,15,15,30,5,0.362947,0.3761,0.000002,No
7074,nebulae,22,12.00548972,12,8.334891634,8.334781631,264,100.0644559,9,12,21,17,20,37,4,0.425837,0.442445,0.000002,No
5554,polaris,17,12.26331883,7,8.873888135,8.873828135,119,108.8233195,9,12,21,15,16,31,4,0.434562,0.45036,0.000002,No
1102,ulster,43,11.33533206,30,7.418600903,7.418310866,1290,84.09230466,18,24,42,41,34,75,4,0.435704,0.451468,0.000001,No
3779,scream,35,11.54118412,22,7.728755831,7.728545813,770,89.19899403,19,23,42,31,31,62,4,0.408341,0.426089,0.000001,No
16541,birthplace,97,10.5218212,90,6.319988614,6.319098235,8730,66.49779017,10,11,21,94,97,191,4,0.409793,0.42737,0.000002,No
13494,discrete,24,11.91847835,21,7.775275846,7.77507583,504,92.66945682,10,11,21,20,13,33,5,0.359507,0.372303,0.000002,No
4222,rotary,22,12.00548972,16,8.047209562,8.047059554,352,96.6106917,10,11,21,17,13,30,5,0.328109,0.332213,0.000002,No
10735,hawkins,15,12.38848198,13,8.254848927,8.254728922,195,102.2650471,10,11,21,15,11,26,5,0.389063,0.406063,0.000002,No
4741,rash,20,12.1007999,10,8.517213191,8.517123189,200,103.0650926,10,11,21,18,13,31,5,0.392947,0.410167,0.000002,No
3148,slippery,15,12.38848198,11,8.421903011,8.421803008,165,104.3345937,10,11,21,14,12,26,5,0.397612,0.414974,0.000002,No
17905,allah,58,11.03608917,40,7.13091883,7.130528762,2320,78.69745605,20,22,42,44,36,80,4,0.441743,0.456636,0.000001,No
8361,luxury,36,11.51301324,33,7.323290723,7.322970678,1188,84.31314304,20,22,42,31,25,56,4,0.432708,0.448792,0.000001,No
3357,sideboard,3,13.99791989,3,9.721185996,9.721165996,9,136.0763828,3,3,6,3,3,6,4,0.405181,0.422751,0.000007,No
236,wonderful,42,11.35886256,39,7.156236638,7.155856573,1638,81.28670841,21,21,42,39,31,70,4,0.432255,0.448383,0.000001,No
16481,blaze,17,12.26331883,11,8.421903011,8.421803008,187,103.2804818,11,10,21,14,13,27,4,0.429577,0.445937,0.000002,No
10116,identical,88,10.61919536,77,6.475992862,6.475232589,6776,68.76983337,22,20,42,64,69,133,4,0.431467,0.447735,0.000001,No
1252,trump,62,10.96939779,28,7.487593774,7.487323743,1736,82.13439461,22,20,42,56,35,91,4,0.427169,0.443867,0.000001,No
17817,amber,49,11.20471188,26,7.561701746,7.56145172,1274,84.72668938,23,19,42,35,33,68,4,0.441611,0.456425,0.000001,No
9697,interference,41,11.38296011,26,7.561701746,7.56145172,1066,86.07454935,23,19,42,30,35,65,4,0.441699,0.456547,0.000001,No
17870,almond,39,11.43297053,11,8.421903011,8.421803008,429,96.28736895,23,19,42,35,30,65,5,0.364977,0.378586,0.000001,No
3452,shin,24,11.91847835,20,7.824066011,7.823875996,480,93.25096133,12,9,21,12,9,21,4,0.411579,0.429051,0.000002,No
5042,pueblo,21,12.05200974,18,7.929426526,7.929256515,378,95.56552572,12,9,21,18,14,32,4,0.419457,0.436647,0.000002,No
4000,sandra,22,12.00548972,17,7.98658494,7.986424931,374,95.88286343,12,9,21,17,18,35,5,0.336454,0.342279,0.000002,No
15763,camilla,16,12.32394346,6,9.028038815,9.027988815,96,111.2610399,12,9,21,15,15,30,4,0.426984,0.443407,0.000002,No
2487,strategic,72,10.81986606,60,6.725453722,6.72486356,4320,72.76850845,27,15,42,55,28,83,5,0.38653,0.403181,0.000001,No
867,verbal,19,12.1520932,16,8.047209562,8.047059554,304,97.79044058,14,7,21,15,9,24,5,0.395072,0.412256,0.000002,No
8761,leonardo,68,10.87702447,47,6.969650683,6.969190586,3196,75.80906104,33,9,42,54,15,69,4,0.411065,0.428469,0.000001,No
17582,anus,53,11.12624026,35,7.264450223,7.264110172,1855,80.82601856,9,32,41,47,46,93,4,0.45949,0.471311,0.000001,No
12503,exeter,48,11.22533117,37,7.208880372,7.208520314,1776,80.92206951,11,30,41,38,44,82,4,0.45428,0.467133,0.000001,No
13438,diverse,54,11.10754813,54,6.830814238,6.830284108,2916,75.87359792,17,24,41,47,38,85,4,0.44452,0.459016,0.000001,No
12351,fallen,54,11.10754813,49,6.927977986,6.92749788,2646,76.95284893,17,24,41,48,43,91,4,0.397096,0.414779,0.000001,No
15048,clergy,40,11.40765272,37,7.208880372,7.208520314,1480,82.2364038,17,24,41,36,37,73,4,0.459335,0.471049,0.000001,No
2906,spa,55,11.08919899,30,7.418600903,7.418310866,1650,82.26634165,18,23,41,38,45,83,4,0.435202,0.451036,0.000001,No
17267,ate,50,11.18450917,46,6.991156888,6.990706795,2300,78.19265833,19,22,41,39,37,76,4,0.426861,0.443764,0.000001,No
724,visitor,39,11.43297053,33,7.323290723,7.322970678,1287,83.72696702,19,22,41,31,27,58,4,0.413487,0.431121,0.000001,No
15775,camden,40,11.40765272,23,7.684304068,7.684084048,920,87.65987223,19,22,41,34,38,72,4,0.418488,0.43591,0.000001,No
12780,entropy,44,11.31234254,16,8.047209562,8.047059554,704,91.03279108,19,22,41,36,40,76,4,0.453769,0.466546,0.000001,No
7037,neolithic,70,10.84803694,48,6.948597273,6.948127172,3360,75.37863987,20,21,41,56,52,108,4,0.43367,0.449623,0.000001,No
17533,apparent,50,11.18450917,41,7.106226218,7.105826145,2050,79.47965231,20,21,41,48,41,89,4,0.416075,0.433539,0.000001,No
16744,belize,38,11.43297053,26,7.523961418,7.52370139,988,86.02122917,20,21,41,33,29,62,4,0.441633,0.456528,0.000001,No
15742,cancelled,56,11.07118049,53,6.849506371,6.848986246,2968,75.83212127,21,20,41,54,47,101,4,0.437195,0.452674,0.000001,No
6449,osiris,41,11.38296011,13,8.254848927,8.254728922,533,93.96461605,21,20,41,34,34,68,4,0.403148,0.420826,0.000001,No
13734,dependent,58,11.03608917,48,6.948597273,6.948127172,2784,76.68533909,26,15,41,50,50,100,4,0.417838,0.435135,0.000001,No
14032,dairy,47,11.24638458,37,7.208880372,7.208520314,1739,81.07384102,26,15,41,38,19,57,4,0.419774,0.436891,0.000001,No
5738,pinhole,15,12.38848198,5,9.210360372,9.210320372,75,114.1023835,4,4,8,13,13,26,4,0.387873,0.404972,0.000005,No
5526,pollux,6,13.30477271,5,9.210360372,9.210320372,30,122.5417513,4,4,8,6,5,11,5,0.384346,0.40058,0.000005,No
4010,sanction,4,13.71023782,4,9.433503923,9.433473923,16,129.3355822,4,4,8,4,4,8,5,0.390132,0.406904,0.000005,No
17624,antares,4,13.71023782,3,9.721185996,9.721165996,12,133.2797719,1,4,5,1,4,5,5,0.346226,0.355046,0.000008,No
9893,indy,17,12.26331883,12,8.334891634,8.334781631,204,102.2134336,7,13,20,14,16,30,4,0.411026,0.428689,0.000002,No
7864,mecca,66,10.90687744,46,6.991156888,6.990706795,3036,76.25169131,14,26,40,55,57,112,4,0.449563,0.463223,0.000001,No
972,vagina,68,10.87702447,43,7.058598169,7.058178089,2924,76.77654502,14,26,40,68,58,126,4,0.457901,0.469955,0.000001,No
10173,hyena,10,12.79394708,6,9.028038815,9.027988815,60,115.5042509,4,6,10,4,8,12,4,0.43986,0.454716,0.000004,No
4943,qatar,43,11.33533206,28,7.487593774,7.487323743,1204,84.87436177,16,24,40,32,32,64,4,0.409207,0.42691,0.000001,No
10628,helpful,47,11.24638458,45,7.013135794,7.012695706,2115,78.87242223,17,23,40,43,41,84,4,0.414511,0.432088,0.000001,No
8034,martyr,43,11.33533206,35,7.264450223,7.264110172,1505,82.34495552,17,23,40,38,36,74,4,0.44802,0.461918,0.000001,No
15912,bury,43,11.33533206,31,7.38581108,7.385511041,1333,83.72062113,17,23,40,31,34,65,4,0.451404,0.46465,0.000001,No
9719,integral,28,11.76432767,25,7.600922459,7.600682435,700,89.41974238,9,11,20,26,27,53,4,0.415724,0.433004,0.000002,No
5507,polynomial,27,11.80069531,10,8.517213191,8.517123189,270,100.5090378,9,11,20,26,18,44,4,0.394598,0.411855,0.000002,No
4293,rockefeller,17,12.26331883,12,8.334891634,8.334781631,204,102.2134336,9,11,20,17,13,30,4,0.40051,0.417962,0.000002,No
15617,carnival,46,11.26789078,29,7.452502454,7.452222421,1334,83.9739837,19,21,40,34,37,71,4,0.447941,0.4618,0.000001,No
14713,concord,35,11.54118412,19,7.875359305,7.875179292,665,90.89097172,19,21,40,33,28,61,4,0.447478,0.461415,0.000001,No
11475,generic,29,11.72923635,27,7.523961418,7.52370139,783,88.25032174,10,10,20,25,20,45,5,0.362843,0.376202,0.000002,No
5636,playboy,20,12.1007999,16,8.047209562,8.047059554,320,97.37767269,10,10,20,16,19,35,4,0.403468,0.42092,0.000002,No
4365,riga,21,12.05200974,15,8.111748083,8.111608076,315,97.7628669,10,10,20,18,18,36,4,0.433438,0.4492,0.000002,No
4279,rodriguez,19,12.1520932,15,8.111748083,8.111608076,285,98.57471871,10,10,20,15,13,28,4,0.433311,0.449087,0.000002,No
7314,mould,13,12.53158282,10,8.517213191,8.517123189,130,106.7341625,10,10,20,11,10,21,5,0.375627,0.3912,0.000002,No
8197,malnutrition,13,12.53158282,10,8.517213191,8.517123189,130,106.7341625,10,10,20,11,12,23,4,0.40472,0.422197,0.000002,No
10586,hereditary,51,11.16470654,42,7.082128666,7.08171859,2142,79.06988827,20,20,40,47,34,81,4,0.429255,0.445674,0.000001,No
7492,moderate,60,11.00218762,58,6.759355274,6.758785123,3480,74.36769488,21,19,40,46,39,85,4,0.405357,0.423037,0.000001,No
11153,graph,55,11.08919899,39,7.156236638,7.155856573,2145,79.35693211,21,19,40,50,44,94,4,0.456817,0.468955,0.000001,No
8686,liechtenstein,43,11.33533206,27,7.523961418,7.52370139,1161,85.28660109,21,19,40,36,37,73,4,0.436797,0.452303,0.000001,No
17681,angus,38,11.45894602,22,7.728755831,7.728545813,836,88.56339585,21,19,40,28,32,60,4,0.410846,0.428469,0.000001,No
1635,tilt,32,11.63079627,26,7.561701746,7.56145172,832,87.9486125,11,9,20,32,24,56,4,0.43152,0.447604,0.000002,No
11102,grenade,16,12.32394346,9,8.622573707,8.622493705,144,106.2641108,11,9,20,13,11,24,4,0.401026,0.418441,0.000002,No
17499,apricot,16,12.32394346,9,8.622573707,8.622493705,144,106.2641108,11,9,20,12,12,24,4,0.394985,0.412183,0.000002,No
11289,gnostic,13,12.53158282,8,8.740356743,8.740286741,104,109.5305044,11,9,20,12,9,21,5,0.356833,0.369012,0.000002,No
1415,transferred,94,10.5532374,83,6.400957676,6.400137356,7802,67.55082592,22,18,40,89,91,180,4,0.436894,0.452392,0.000001,No
11305,glue,30,11.6953348,18,7.929426526,7.929256515,540,92.73729796,22,18,40,26,27,53,4,0.437357,0.452796,0.000001,No
17220,auburn,52,11.14528846,26,7.561701746,7.56145172,1352,84.2773472,23,17,40,37,30,67,4,0.380988,0.397217,0.000001,No
5795,piazza,20,12.1007999,17,7.98658494,7.986424931,340,96.64406628,12,8,20,16,10,26,4,0.40197,0.419404,0.000002,No
6956,nickel,51,11.16470654,28,7.487593774,7.487323743,1428,83.59678721,25,15,40,42,46,88,4,0.447241,0.461101,0.000001,No
3231,sixty,24,11.91847835,24,7.641744454,7.641514432,576,91.07796581,13,7,20,19,8,27,4,0.393052,0.410094,0.000002,No
17845,alter,29,11.72923635,19,7.875359305,7.875179292,551,92.37195061,14,6,20,22,22,44,4,0.408877,0.426521,0.000002,No
14126,curie,52,11.14528846,18,7.929426526,7.929256515,936,88.37574595,12,27,39,41,42,83,4,0.446431,0.460641,0.000001,No
15582,caruso,3,13.99791989,3,9.721185996,9.721165996,9,136.0763828,1,2,3,3,2,5,5,0.400664,0.418377,0.000013,No
1311,trill,2,14.403385,2,10.1266511,10.1266411,4,145.8580546,1,2,3,1,2,3,5,0.385623,0.401942,0.000013,No
12084,fitzpatrick,9,12.8993076,7,8.873888135,8.873828135,63,114.4670127,5,8,13,6,8,14,4,0.42881,0.445116,0.000003,No
8488,longitude,52,11.14528846,34,7.29343776,7.293107712,1768,81.28746769,15,24,39,44,47,91,4,0.451346,0.464664,0.000001,No
6162,patent,77,10.75272676,51,6.887972651,6.887472536,3927,74.06448782,16,23,39,55,52,107,4,0.461329,0.472584,0.000001,No
6891,nobleman,50,11.18450917,47,6.969650683,6.969190586,2350,77.95212198,16,23,39,44,38,82,4,0.442801,0.457552,0.000001,No
7365,mormon,50,11.18450917,34,7.29343776,7.293107712,1700,81.57352152,16,23,39,46,35,81,4,0.440997,0.456068,0.000001,No
16693,bent,37,11.48561426,27,7.523961418,7.52370139,999,86.41731859,16,23,39,30,31,61,4,0.436196,0.451881,0.000001,No
12690,eros,35,11.54118412,15,8.111748083,8.111608076,525,93.61917813,16,23,39,27,31,58,4,0.440155,0.45528,0.000001,No
17226,attract,65,10.92214491,50,6.907775279,6.907285168,3250,75.44772258,17,22,39,52,44,96,4,0.440537,0.455589,0.000001,No
10788,harpsichord,45,11.28986969,31,7.38581108,7.385511041,1395,83.38484463,17,22,39,41,35,76,4,0.44501,0.459378,0.000001,No
11155,grapefruit,12,12.61162553,9,8.622573707,8.622493705,108,108.7446707,6,7,13,8,8,16,4,0.393418,0.410475,0.000003,No
3527,shale,10,12.79394708,8,8.740356743,8.740286741,80,111.8236617,6,7,13,10,8,18,5,0.384662,0.401176,0.000003,No
11230,gooseberry,10,12.79394708,8,8.740356743,8.740286741,80,111.8236617,6,7,13,9,9,18,4,0.425959,0.442445,0.000003,No
3864,schema,13,12.53158282,5,9.210360372,9.210320372,65,115.4203938,6,7,13,10,9,19,4,0.415685,0.432933,0.000003,No
16145,breton,60,11.00218762,35,7.264450223,7.264110172,2100,79.92484427,18,21,39,50,52,102,4,0.418074,0.435403,0.000001,No
415,whenever,40,11.40765272,40,7.13091883,7.130528762,1600,81.34704561,18,21,39,20,36,56,4,0.427735,0.44451,0.000001,No
17531,appeal,39,11.43297053,33,7.323290723,7.322970678,1287,83.72696702,18,21,39,32,35,67,4,0.452497,0.465537,0.000001,No
4544,rent,33,11.60002462,23,7.684304068,7.684084048,759,89.13811635,18,21,39,25,25,50,4,0.442602,0.457406,0.000001,No
10345,hoover,38,11.45894602,18,7.929426526,7.929256515,684,90.86287052,18,21,39,34,34,68,4,0.434946,0.450726,0.000001,No
1378,trap,41,11.38296011,32,7.354062381,7.35375234,1312,83.71099874,19,20,39,35,29,64,4,0.434073,0.449956,0.000001,No
6833,norwich,42,11.35886256,26,7.561701746,7.56145172,1092,85.89233085,19,20,39,40,35,75,4,0.454932,0.467471,0.000001,No
7084,neal,12,12.61162553,12,8.334891634,8.334781631,144,105.1165321,7,6,13,8,7,15,5,0.385038,0.401378,0.000003,No
2818,spindle,18,12.20616042,6,9.028038815,9.027988815,108,110.19769,7,6,13,14,12,26,4,0.390501,0.40778,0.000003,No
3749,sd,10,12.79394708,9,8.622573707,8.622493705,90,110.3167517,7,6,13,7,6,13,4,0.407339,0.425042,0.000003,No
15874,bye,11,12.6986369,7,8.873888135,8.873828135,77,112.6862834,7,6,13,11,11,22,4,0.412555,0.430037,0.000003,No
14757,compost,11,12.6986369,5,9.210360372,9.210320372,55,116.9590221,7,6,13,8,9,17,5,0.383151,0.399563,0.000003,No
15108,civilian,50,11.18450917,49,6.927977986,6.92749788,2450,77.48603333,21,18,39,42,24,66,4,0.414017,0.431525,0.000001,No
15044,clerk,43,11.33533206,43,7.058598169,7.058178089,1849,80.01155413,21,18,39,40,41,81,4,0.433522,0.449491,0.000001,No
11760,freight,54,11.10754813,37,7.208880372,7.208520314,1998,80.0729857,22,17,39,50,28,78,4,0.432182,0.448233,0.000001,No
4508,residential,38,11.45894602,35,7.264450223,7.264110172,1330,83.24294295,22,17,39,31,25,56,4,0.428644,0.445074,0.000001,No
4608,registration,39,11.43297053,27,7.523961418,7.52370139,1053,86.02122917,22,17,39,33,33,66,4,0.442956,0.45758,0.000001,No
234,wong,15,12.38848198,7,8.873888135,8.873828135,105,109.9340032,9,4,13,11,4,15,4,0.391258,0.408367,0.000003,No
6510,orchestral,52,11.14528846,47,6.969650683,6.969190586,2444,77.67876731,28,11,39,49,33,82,5,0.38518,0.401641,0.000001,No
991,uterus,52,11.14528846,23,7.684304068,7.684084048,1196,85.64378545,9,29,38,50,49,99,4,0.45737,0.469593,0.000001,No
682,volta,40,11.40765272,22,7.728755831,7.728545813,880,88.1669625,12,26,38,16,32,48,4,0.450282,0.4638,0.000001,No
14165,cube,64,10.93764909,29,7.452502454,7.452222421,1856,81.51285672,13,25,38,53,53,106,4,0.450773,0.464213,0.000001,No
11309,gloucester,47,11.24638458,33,7.323290723,7.322970678,1551,82.36054383,13,25,38,43,39,82,4,0.439349,0.454627,0.000001,No
10424,hogan,17,12.26331883,14,8.180740955,8.180610949,238,100.3230346,7,12,19,15,12,27,4,0.4235,0.440332,0.000002,No
887,veneto,39,11.43297053,29,7.452502454,7.452222421,1131,85.20424094,8,11,19,33,38,71,4,0.438556,0.453702,0.000002,No
15816,calder,25,11.87765635,18,7.929426526,7.929256515,450,94.18300335,8,11,19,19,22,41,4,0.425847,0.44243,0.000002,No
10468,hippopotamus,23,11.96103796,14,8.180740955,8.180610949,322,97.85015311,8,11,19,19,15,34,4,0.441468,0.456167,0.000002,No
2308,sunflower,15,12.38848198,12,8.334891634,8.334781631,180,103.2566548,8,11,19,14,13,27,4,0.427128,0.443571,0.000002,No
918,vaudeville,17,12.26331883,11,8.421903011,8.421803008,187,103.2804818,8,11,19,12,13,25,4,0.427457,0.443886,0.000002,No
2652,stark,20,12.1007999,9,8.622573707,8.622493705,180,104.3400391,8,11,19,14,12,26,5,0.373202,0.388276,0.000002,No
18048,agnostic,13,12.53158282,11,8.421903011,8.421803008,143,105.5397751,8,11,19,11,11,22,4,0.403762,0.421239,0.000002,No
808,vibrate,39,11.43297053,31,7.38581108,7.385511041,1209,84.44176042,16,22,38,31,35,66,4,0.451197,0.464471,0.000001,No
12287,faust,34,11.57017165,12,8.334891634,8.334781631,408,96.43612692,16,22,38,24,29,53,4,0.407844,0.425568,0.000001,No
9678,interval,49,11.20471188,31,7.38581108,7.385511041,1519,82.75588514,17,21,38,40,44,84,4,0.449586,0.463148,0.000001,No
12369,fail,37,11.48561426,36,7.236279346,7.235929291,1332,83.11311328,17,21,38,25,36,61,4,0.44383,0.458373,0.000001,No
16884,basket,54,11.10754813,26,7.561701746,7.56145172,1404,83.9919661,17,21,38,40,44,84,4,0.440635,0.45574,0.000001,No
4168,rufus,23,11.96103796,20,7.824066011,7.823875996,460,93.58395057,9,10,19,14,14,28,4,0.3934,0.410521,0.000002,No
17470,arcadia,24,11.91847835,16,8.047209562,8.047059554,384,95.91049292,9,10,19,16,16,32,4,0.414966,0.432323,0.000002,No
17061,backward,17,12.26331883,14,8.180740955,8.180610949,238,100.3230346,9,10,19,13,13,26,4,0.429962,0.446116,0.000002,No
13299,downey,19,12.1520932,8,8.740356743,8.740286741,152,106.2136297,9,10,19,18,14,32,4,0.419894,0.436881,0.000002,No
3403,showcase,14,12.45747485,9,8.622573707,8.622493705,126,107.4154951,9,10,19,14,12,26,4,0.440997,0.455787,0.000002,No
15459,cent,50,11.18450917,33,7.323290723,7.322970678,1650,81.90741226,18,20,38,40,34,74,4,0.446207,0.46035,0.000001,No
42,zambia,34,11.57017165,24,7.641744454,7.641514432,816,88.41629506,18,20,38,31,28,59,4,0.440997,0.455937,0.000001,No
11799,franciscan,21,12.05200974,21,7.775275846,7.77507583,441,93.70770023,10,9,19,20,18,38,5,0.349374,0.359319,0.000002,No
7449,mona,23,11.96103796,19,7.875359305,7.875179292,437,94.19747161,10,9,19,20,19,39,4,0.390733,0.407662,0.000002,No
6079,peat,14,12.45747485,11,8.421903011,8.421803008,154,104.9156449,10,9,19,12,11,23,4,0.399896,0.417296,0.000002,No
7208,mustache,15,12.38848198,9,8.622573707,8.622493705,135,106.820599,10,9,19,15,13,28,4,0.444731,0.458894,0.000002,No
9852,infinitive,19,12.1520932,6,9.028038815,9.027988815,114,109.7095691,10,9,19,19,18,37,4,0.437605,0.452932,0.000002,No
11845,forty,60,11.00218762,55,6.812465099,6.811924964,3300,74.95201914,20,18,38,52,26,78,4,0.438264,0.45358,0.000001,No
8367,lutheran,49,11.20471188,43,7.058598169,7.058178089,2107,79.08955875,20,18,38,43,31,74,5,0.403955,0.421598,0.000001,No
13561,digging,41,11.38296011,36,7.236279346,7.235929291,1476,82.37027914,20,18,38,33,30,63,4,0.439697,0.454829,0.000001,No
8791,leisure,41,11.38296011,28,7.487593774,7.487323743,1148,85.23098125,20,18,38,34,25,59,4,0.448938,0.462575,0.000001,No
10960,guthrie,32,11.63079627,15,8.111748083,8.111608076,480,94.34608939,20,18,38,26,22,48,4,0.446892,0.460875,0.000001,No
15652,cardiff,48,11.22533117,29,7.452502454,7.452222421,1392,83.65680807,21,17,38,43,34,77,4,0.440964,0.455871,0.000001,No
11382,gill,24,11.91847835,18,7.929426526,7.929256515,432,94.50669836,11,8,19,16,8,24,4,0.402088,0.419671,0.000002,No
10253,hulk,22,12.00548972,13,8.254848927,8.254728922,286,99.10350396,11,8,19,18,19,37,4,0.406266,0.423915,0.000002,No
16340,bonnie,34,11.57017165,27,7.523961418,7.52370139,918,87.05352512,22,16,38,27,22,49,5,0.386623,0.403294,0.000001,No
3036,socrates,43,11.33533206,22,7.728755831,7.728545813,946,87.60801377,22,16,38,33,28,61,4,0.437864,0.453181,0.000001,No
2965,sonny,23,11.96103796,16,8.047209562,8.047059554,368,96.25297905,12,7,19,15,10,25,5,0.388569,0.405275,0.000002,No
12736,epsilon,22,12.00548972,7,8.873888135,8.873828135,154,106.5353728,12,7,19,17,10,27,4,0.388893,0.405606,0.000002,No
12613,eugenia,15,12.38848198,8,8.740356743,8.740286741,120,108.279752,12,7,19,12,9,21,4,0.409349,0.426765,0.000002,No
6146,patriarch,76,10.76579884,55,6.812465099,6.811924964,4180,73.34162884,25,13,38,54,65,119,4,0.412315,0.429788,0.000001,No
8301,madame,19,12.1520932,17,7.98658494,7.986424931,323,97.05372453,13,6,19,14,9,23,5,0.379481,0.395476,0.000002,No
8352,lymph,20,12.1007999,11,8.421903011,8.421803008,220,101.9117632,13,6,19,15,10,25,4,0.398389,0.415972,0.000002,No
12946,eleventh,51,11.16470654,45,7.013135794,7.012695706,2295,78.2996031,10,27,37,51,42,93,5,0.408604,0.426377,0.000001,No
3373,shuttle,60,11.00218762,31,7.38581108,7.385511041,1860,81.26007919,10,27,37,57,42,99,4,0.433967,0.449975,0.000001,No
8803,legion,59,11.01899473,30,7.418600903,7.418310866,1770,81.74552427,13,24,37,35,45,80,4,0.428872,0.445468,0.000001,No
10645,helicopter,41,11.38296011,30,7.418600903,7.418310866,1230,84.44563815,13,24,37,36,32,68,4,0.426994,0.443834,0.000001,No
12292,fault,37,11.48561426,21,7.775275846,7.77507583,777,89.30381917,13,24,37,25,33,58,4,0.447794,0.461749,0.000001,No
15654,cardboard,34,11.57017165,19,7.875359305,7.875179292,646,91.11925899,14,23,37,25,29,54,4,0.429172,0.445698,0.000001,No
2218,swallow,34,11.57017165,27,7.523961418,7.52370139,918,87.05352512,15,22,37,30,29,59,4,0.454094,0.466828,0.000001,No
6626,ok,30,11.6953348,24,7.641744454,7.641514432,720,89.37275981,16,21,37,23,24,47,4,0.445501,0.459786,0.000001,No
14843,comeback,35,11.54118412,20,7.824066011,7.823875996,700,90.29898636,16,21,37,31,30,61,4,0.438253,0.453693,0.000001,No
16092,britten,41,11.38296011,17,7.98658494,7.986424931,697,90.91097779,17,20,37,37,31,68,4,0.441842,0.456702,0.000001,No
14556,continuum,33,11.60002462,18,7.929426526,7.929256515,594,91.9815429,17,20,37,29,23,52,4,0.436679,0.452223,0.000001,No
10238,humorous,38,11.45894602,38,7.182212124,7.181842063,1444,82.30058102,18,19,37,34,25,59,4,0.431824,0.44797,0.000001,No
8318,machinery,37,11.48561426,35,7.264450223,7.264110172,1295,83.4366731,18,19,37,30,29,59,4,0.452393,0.46541,0.000001,No
18077,afraid,50,11.18450917,45,7.013135794,7.012695706,2250,78.43848162,19,18,37,45,46,91,4,0.423298,0.440276,0.000001,No
10225,hungry,28,11.76432767,27,7.523961418,7.52370139,756,88.51434748,19,18,37,24,24,48,4,0.437066,0.452543,0.000001,No
641,wade,28,11.76432767,21,7.775275846,7.77507583,588,91.47089276,21,16,37,25,22,47,4,0.433268,0.449172,0.000001,No
18074,afrikaans,32,11.63079627,18,7.929426526,7.929256515,576,92.2255445,21,16,37,30,26,56,4,0.436851,0.452303,0.000001,No
8018,mason,39,11.43297053,34,7.29343776,7.293107712,1326,83.38565898,22,15,37,30,24,54,4,0.399177,0.416653,0.000001,No
1653,tidal,42,11.35886256,30,7.418600903,7.418310866,1260,84.26686803,22,15,37,32,26,58,5,0.343652,0.351673,0.000001,No
3325,sikh,44,11.31234254,28,7.487593774,7.487323743,1232,84.7022256,23,14,37,39,27,66,4,0.431268,0.447355,0.000001,No
14164,cubic,70,10.84803694,42,7.082128666,7.08171859,2940,76.82719335,24,13,37,61,27,88,4,0.423409,0.44021,0.000001,No
11115,greenhouse,64,10.93764909,33,7.323290723,7.322970678,2112,80.09958414,26,11,37,61,61,122,4,0.401407,0.419098,0.000001,No
18362,ababa,14,12.45747485,4,9.433503923,9.433473923,56,117.5176378,2,7,9,14,9,23,5,0.370755,0.385337,0.000004,No
7049,negro,39,11.43297053,20,7.824066011,7.823875996,780,89.45231613,10,26,36,23,31,54,4,0.454118,0.466927,0.000001,No
6444,osprey,7,13.15062203,3,9.721185996,9.721165996,21,127.8396427,2,4,6,5,4,9,5,0.347344,0.356751,0.000006,No
8969,lancelot,11,12.6986369,5,9.210360372,9.210320372,55,116.9590221,4,8,12,8,10,18,5,0.413112,0.430457,0.000003,No
7978,matisse,10,12.79394708,5,9.210360372,9.210320372,50,117.8368632,4,8,12,8,8,16,5,0.39771,0.415016,0.000003,No
8423,lucia,30,11.6953348,18,7.929426526,7.929256515,540,92.73729796,6,12,18,28,21,49,4,0.432013,0.448116,0.000002,No
3359,sickle,17,12.26331883,11,8.421903011,8.421803008,187,103.2804818,6,12,18,14,17,31,4,0.442525,0.457087,0.000002,No
16910,barrymore,17,12.26331883,10,8.517213191,8.517123189,170,104.4493009,6,12,18,15,16,31,4,0.415753,0.433074,0.000002,No
3342,siena,48,11.22533117,31,7.38581108,7.385511041,1488,82.9081753,12,24,36,36,40,76,4,0.436164,0.451838,0.000001,No
2994,solvent,40,11.40765272,21,7.775275846,7.77507583,840,88.69764668,13,23,36,38,36,74,4,0.451484,0.464734,0.000001,No
17409,armada,24,11.91847835,19,7.875359305,7.875179292,456,93.86229935,7,11,18,23,23,46,4,0.432856,0.448763,0.000002,No
2185,swell,15,12.38848198,14,8.180740955,8.180610949,210,101.3469619,7,11,18,13,14,27,4,0.435298,0.450843,0.000002,No
7918,mccoy,13,12.53158282,11,8.421903011,8.421803008,143,105.5397751,7,11,18,12,12,24,4,0.417818,0.435074,0.000002,No
15706,cantor,31,11.66254497,10,8.517213191,8.517123189,310,99.33238189,14,22,36,17,26,43,4,0.422905,0.439956,0.000001,No
14401,costello,14,12.45747485,7,8.873888135,8.873828135,98,110.5462382,5,7,12,8,9,17,4,0.40836,0.425798,0.000003,No
11204,gourd,9,12.8993076,8,8.740356743,8.740286741,72,112.7445502,5,7,12,7,7,14,5,0.363653,0.376923,0.000003,No
17915,alike,34,11.57017165,33,7.323290723,7.322970678,1122,84.73173073,15,21,36,25,30,55,4,0.457913,0.46987,0.000001,No
12817,engel,5,13.48709426,5,9.210360372,9.210320372,25,124.2209985,4,5,9,4,5,9,4,0.390896,0.407756,0.000004,No
5606,plover,5,13.48709426,3,9.721185996,9.721165996,15,131.1105519,4,5,9,5,5,10,5,0.372748,0.387642,0.000004,No
16937,barn,15,12.38848198,12,8.334891634,8.334781631,180,103.2566548,8,10,18,15,12,27,4,0.422854,0.439811,0.000002,No
2207,swarm,16,12.32394346,11,8.421903011,8.421803008,176,103.7910565,8,10,18,12,11,23,4,0.411894,0.4293,0.000002,No
1927,tehran,60,11.00218762,37,7.208880372,7.208520314,2220,79.31345434,16,20,36,48,52,100,4,0.442018,0.456852,0.000001,No
11831,fountain,43,11.33533206,34,7.29343776,7.293107712,1462,82.67353888,16,20,36,38,38,76,4,0.442823,0.457509,0.000001,No
16356,bombay,51,11.16470654,29,7.452502454,7.452222421,1479,83.20500292,16,20,36,48,34,82,4,0.439349,0.454557,0.000001,No
14022,dalton,30,11.6953348,17,7.98658494,7.986424931,510,93.40578475,16,20,36,24,23,47,4,0.44568,0.459894,0.000001,No
9451,jellyfish,29,11.72923635,13,8.254848927,8.254728922,377,96.82307407,16,20,36,24,26,50,4,0.415675,0.433168,0.000001,No
2937,souffle,2,14.403385,2,10.1266511,10.1266411,4,145.8580546,2,2,4,2,2,4,4,0.398926,0.416573,0.000009,No
15303,cherish,3,13.99791989,3,9.721185996,9.721165996,9,136.0763828,3,3,6,3,3,6,5,0.402426,0.420189,0.000006,No
17938,algal,3,13.99791989,3,9.721185996,9.721165996,9,136.0763828,3,3,6,3,3,6,5,0.313406,0.317783,0.000006,No
9415,jimmie,11,12.6986369,10,8.517213191,8.517123189,110,108.1569978,6,6,12,8,8,16,5,0.320595,0.324226,0.000003,No
532,watermelon,10,12.79394708,7,8.873888135,8.873828135,70,113.5320552,6,6,12,9,7,16,5,0.373006,0.387989,0.000003,No
1016,urn,10,12.79394708,6,9.028038815,9.027988815,60,115.5042509,6,6,12,8,7,15,5,0.401216,0.418922,0.000003,No
10775,hartman,10,12.79394708,5,9.210360372,9.210320372,50,117.8368632,6,6,12,8,8,16,4,0.412977,0.43037,0.000003,No
15012,clone,26,11.83843564,20,7.824066011,7.823875996,520,92.62470191,9,9,18,21,16,37,4,0.445658,0.459688,0.000002,No
17971,albuquerque,15,12.38848198,11,8.421903011,8.421803008,165,104.3345937,9,9,18,13,14,27,5,0.406667,0.424133,0.000002,No
18297,absurd,14,12.45747485,11,8.421903011,8.421803008,154,104.9156449,9,9,18,13,11,24,4,0.433776,0.449472,0.000002,No
6425,ourselves,12,12.61162553,11,8.421903011,8.421803008,132,106.213887,9,9,18,10,10,20,4,0.428924,0.445177,0.000002,Yes
3931,saunders,12,12.61162553,7,8.873888135,8.873828135,84,111.9141541,9,9,18,9,11,20,4,0.423925,0.440618,0.000002,No
5053,ptolemy,40,11.40765272,31,7.38581108,7.385511041,1240,84.25476788,18,18,36,24,24,48,4,0.455925,0.468227,0.000001,No
1562,tomahawk,6,13.30477271,6,9.028038815,9.027988815,36,120.1160044,5,4,9,5,5,10,5,0.376208,0.392742,0.000004,No
16473,bless,13,12.53158282,8,8.740356743,8.740286741,104,109.5305044,10,8,18,12,13,25,4,0.401134,0.418854,0.000002,No
10192,hydraulic,31,11.66254497,20,7.824066011,7.823875996,620,91.24852172,20,16,36,28,25,53,5,0.395521,0.41288,0.000001,No
2152,sylvester,11,12.6986369,9,8.622573707,8.622493705,99,109.4949327,7,5,12,7,5,12,4,0.422633,0.439351,0.000003,No
11971,fluoride,9,12.8993076,9,8.622573707,8.622493705,81,111.2252305,7,5,12,7,6,13,4,0.399195,0.416535,0.000003,No
15253,chinatown,9,12.8993076,8,8.740356743,8.740286741,72,112.7445502,7,5,12,7,8,15,4,0.433512,0.449177,0.000003,No
10783,harrisburg,16,12.32394346,11,8.421903011,8.421803008,176,103.7910565,11,7,18,13,14,27,4,0.408774,0.426281,0.000002,No
17638,anorexia,21,12.05200974,9,8.622573707,8.622493705,189,103.9193423,11,7,18,18,8,26,5,0.373485,0.388625,0.000002,No
10805,hare,35,11.54118412,23,7.684304068,7.684084048,805,88.68596805,22,14,36,30,16,46,5,0.396413,0.413861,0.000001,No
20,zip,47,11.24638458,20,7.824066011,7.823875996,940,87.9924553,23,13,36,33,34,67,5,0.376567,0.392191,0.000001,No
15691,capitoline,9,12.8993076,9,8.622573707,8.622493705,81,111.2252305,6,3,9,8,8,16,5,0.32291,0.326082,0.000004,No
12870,emile,12,12.61162553,11,8.421903011,8.421803008,132,106.213887,8,4,12,9,5,14,5,0.322329,0.326531,0.000003,No
15549,catalogue,23,11.96103796,20,7.824066011,7.823875996,460,93.58395057,12,6,18,19,18,37,5,0.391802,0.408798,0.000002,No
10680,heavyweight,146,10.11292556,72,6.543132165,6.542421927,10512,66.17020849,24,12,36,128,62,190,4,0.401216,0.418732,0.000001,No
14626,consecutive,51,11.16470654,44,7.03560865,7.035178566,2244,78.55050594,24,12,36,48,15,63,5,0.339882,0.346964,0.000001,No
3595,sergei,24,11.91847835,18,7.929426526,7.929256515,432,94.50669836,14,4,18,16,6,22,5,0.36712,0.380978,0.000002,No
4633,referring,74,10.79246708,69,6.58569178,6.585011562,5106,71.07586176,32,4,36,53,71,124,5,0.361572,0.374386,0.000001,No
9955,incompatible,5,13.48709426,4,9.433503923,9.433473923,20,127.2305567,3,4,7,4,4,8,5,0.347868,0.357149,0.000005,No
13776,demise,5,13.48709426,4,9.433503923,9.433473923,20,127.2305567,4,3,7,5,4,9,4,0.424269,0.440975,0.000005,No
13675,detect,48,11.22533117,41,7.106226218,7.105826145,1968,79.76974264,8,27,35,47,33,80,4,0.453109,0.466129,0.000001,No
1777,thereafter,34,11.57017165,33,7.323290723,7.322970678,1122,84.73173073,12,23,35,15,32,47,4,0.443509,0.458143,0.000001,No
15601,carriage,45,11.28986969,41,7.106226218,7.105826145,1845,80.22836797,13,22,35,38,31,69,4,0.448484,0.462284,0.000001,No
12848,employee,38,11.45894602,31,7.38581108,7.385511041,1178,84.63361046,14,21,35,33,30,63,4,0.419526,0.436783,0.000001,No
2297,sunshine,33,11.60002462,29,7.452502454,7.452222421,957,86.44921192,15,20,35,29,30,59,4,0.421879,0.439008,0.000001,No
14145,cumberland,37,11.48561426,32,7.354062381,7.35375234,1184,84.46592379,16,19,35,30,30,60,4,0.437066,0.452552,0.000001,No
16531,bison,49,11.20471188,18,7.929426526,7.929256515,882,88.84693959,16,19,35,28,34,62,4,0.436926,0.45243,0.000001,No
4064,salary,35,11.54118412,22,7.728755831,7.728545813,770,89.19899403,16,19,35,31,31,62,4,0.454455,0.467072,0.000001,No
4557,renault,42,11.35886256,17,7.98658494,7.986424931,714,90.71852065,16,19,35,35,32,67,4,0.435084,0.450815,0.000001,No
7651,midland,58,11.03608917,51,6.887972651,6.887472536,2958,76.01628036,17,18,35,51,50,101,4,0.428065,0.444562,0.000001,No
9295,jurisdiction,34,11.57017165,26,7.561701746,7.56145172,884,87.49018719,17,18,35,30,32,62,4,0.425908,0.442628,0.000001,No
459,wellington,40,11.40765272,21,7.775275846,7.77507583,840,88.69764668,17,18,35,36,32,68,5,0.359427,0.371704,0.000001,No
15469,cellulose,36,11.51301324,22,7.728755831,7.728545813,792,88.9812682,17,18,35,32,29,61,4,0.420222,0.437374,0.000001,No
17877,ally,35,11.54118412,34,7.29343776,7.293107712,1190,84.17490802,18,17,35,28,27,55,4,0.444553,0.458913,0.000001,No
17724,anchorage,32,11.63079627,19,7.875359305,7.875179292,608,91.59669967,18,17,35,30,31,61,4,0.436078,0.451627,0.000001,No
4656,reddish,38,11.45894602,37,7.208880372,7.208520314,1406,82.60617103,19,16,35,35,28,63,4,0.420371,0.437619,0.000001,No
266,withdrew,40,11.40765272,33,7.323290723,7.322970678,1320,83.54155736,22,13,35,27,37,64,4,0.426717,0.443383,0.000001,No
10777,hartford,49,11.20471188,28,7.487593774,7.487323743,1372,83.89633091,22,13,35,39,34,73,4,0.393802,0.41101,0.000001,No
6031,pendulum,26,11.83843564,14,8.180740955,8.180610949,364,96.84717527,4,13,17,18,20,38,4,0.42939,0.445801,0.000002,No
18236,achieve,65,10.92214491,59,6.74226084,6.741680684,3835,73.6399499,9,25,34,63,51,114,4,0.422371,0.439778,0.000001,No
10436,hobby,38,11.45894602,33,7.323290723,7.322970678,1254,83.91719306,11,23,34,34,31,65,4,0.433798,0.449876,0.000001,No
12531,excess,24,11.91847835,20,7.824066011,7.823875996,480,93.25096133,6,11,17,18,20,38,5,0.379749,0.395775,0.000002,No
11781,fray,25,11.87765635,13,8.254848927,8.254728922,325,98.04825879,6,11,17,22,19,41,4,0.423389,0.440402,0.000002,No
3285,simplex,14,12.45747485,11,8.421903011,8.421803008,154,104.9156449,6,11,17,12,12,24,4,0.414027,0.431469,0.000002,No
6137,patrol,40,11.40765272,32,7.354062381,7.35375234,1280,83.89258975,12,22,34,39,31,70,4,0.438881,0.454162,0.000001,No
12359,faithful,36,11.51301324,27,7.523961418,7.52370139,972,86.62346742,12,22,34,34,28,62,4,0.440767,0.455791,0.000001,No
11308,glove,35,11.54118412,19,7.875359305,7.875179292,665,90.89097172,12,22,34,27,29,56,4,0.418123,0.435595,0.000001,No
7348,mortal,33,11.60002462,26,7.561701746,7.56145172,858,87.71592639,13,21,34,29,30,59,4,0.431258,0.447482,0.000001,No
13423,dizzy,15,12.38848198,13,8.254848927,8.254728922,195,102.2650471,7,10,17,8,15,23,4,0.42852,0.444829,0.000002,No
15910,busch,17,12.26331883,10,8.517213191,8.517123189,170,104.4493009,7,10,17,14,13,27,4,0.415812,0.433145,0.000002,No
2413,sturgeon,11,12.6986369,7,8.873888135,8.873828135,77,112.6862834,7,10,17,7,10,17,4,0.436271,0.451702,0.000002,No
5353,pray,54,11.10754813,49,6.927977986,6.92749788,2646,76.95284893,14,20,34,47,49,96,4,0.445524,0.459772,0.000001,No
12257,fee,52,11.14528846,39,7.156236638,7.155856573,2028,79.75832161,14,20,34,38,42,80,4,0.462603,0.473518,0.000001,No
2734,squad,41,11.38296011,36,7.236279346,7.235929291,1476,82.37027914,14,20,34,25,31,56,4,0.45968,0.471246,0.000001,No
1323,trick,36,11.51301324,29,7.452502454,7.452222421,1044,85.80075942,14,20,34,29,30,59,4,0.463013,0.473842,0.000001,No
3568,settle,72,10.81986606,66,6.630143542,6.629493344,4752,71.73726507,15,19,34,59,59,118,4,0.449404,0.462955,0.000001,No
3978,sapphire,29,11.72923635,9,8.622573707,8.622493705,261,101.1362049,15,19,34,25,25,50,4,0.441897,0.456678,0.000001,No
15957,bunny,17,12.26331883,16,8.047209562,8.047059554,272,98.68549658,8,9,17,10,13,23,4,0.390115,0.406991,0.000002,No
15045,cleric,15,12.38848198,15,8.111748083,8.111608076,225,100.4922449,8,9,17,15,11,26,4,0.420331,0.437417,0.000002,No
3731,seaport,40,11.40765272,40,7.13091883,7.130528762,1600,81.34704561,16,18,34,32,32,64,4,0.436282,0.451867,0.000001,No
6494,orgasm,40,11.40765272,20,7.824066011,7.823875996,800,89.25422793,16,18,34,38,31,69,4,0.452347,0.465335,0.000001,No
6890,noblemen,26,11.83843564,25,7.600922459,7.600682435,650,89.98303133,16,18,34,23,25,48,4,0.447433,0.461354,0.000001,No
8092,marijuana,32,11.63079627,20,7.824066011,7.823875996,640,91.00011781,16,18,34,23,25,48,4,0.409575,0.42722,0.000001,No
2876,spear,26,11.83843564,22,7.728755831,7.728545813,572,91.49637848,16,18,34,24,22,46,4,0.4408,0.455763,0.000001,No
1505,torrance,32,11.63079627,7,8.873888135,8.873828135,224,103.2103851,16,18,34,23,27,50,5,0.375285,0.390789,0.000001,No
14886,collegiate,46,11.26789078,37,7.208880372,7.208520314,1702,81.22887668,17,17,34,29,43,72,5,0.386303,0.402979,0.000001,No
7312,mound,40,11.40765272,28,7.487593774,7.487323743,1120,85.41586951,17,17,34,32,29,61,4,0.431184,0.447397,0.000001,No
3488,shed,32,11.63079627,29,7.452502454,7.452222421,928,86.67853778,17,17,34,31,28,59,4,0.445983,0.460115,0.000001,No
4390,richardson,32,11.63079627,21,7.775275846,7.77507583,672,90.43264935,17,17,34,22,25,47,4,0.436948,0.452388,0.000001,No
11722,fringe,14,12.45747485,13,8.254848927,8.254728922,182,102.8345729,9,8,17,12,11,23,4,0.423561,0.440417,0.000002,No
16319,boost,13,12.53158282,13,8.254848927,8.254728922,169,103.446323,9,8,17,11,10,21,4,0.445826,0.45981,0.000002,No
3662,selfish,12,12.61162553,12,8.334891634,8.334781631,144,105.1165321,9,8,17,11,10,21,5,0.388178,0.404866,0.000002,No
13662,deuce,11,12.6986369,11,8.421903011,8.421803008,121,106.9466884,9,8,17,9,9,18,5,0.36138,0.373878,0.000002,No
9155,kimberly,11,12.6986369,8,8.740356743,8.740286741,88,110.9906167,9,8,17,9,8,17,4,0.418557,0.435605,0.000002,No
17132,avocado,13,12.53158282,6,9.028038815,9.027988815,78,113.1356161,9,8,17,10,10,20,5,0.368752,0.383161,0.000002,No
15313,cheesecake,10,12.79394708,5,9.210360372,9.210320372,50,117.8368632,9,8,17,10,10,20,4,0.418241,0.435299,0.000002,No
5536,polk,37,11.48561426,21,7.775275846,7.77507583,777,89.30381917,18,16,34,33,31,64,4,0.386236,0.403043,0.000001,No
10594,herbivore,19,12.1520932,19,7.875359305,7.875179292,361,95.70210024,10,7,17,18,11,29,4,0.425643,0.442168,0.000002,No
15074,claudia,20,12.1007999,16,8.047209562,8.047059554,320,97.37767269,10,7,17,14,9,23,5,0.385456,0.401857,0.000002,No
11707,frontal,18,12.20616042,16,8.047209562,8.047059554,288,98.22553084,10,7,17,16,13,29,5,0.384837,0.401181,0.000002,No
13329,dorothea,14,12.45747485,10,8.517213191,8.517123189,140,106.1029691,10,7,17,13,8,21,4,0.419249,0.436384,0.000002,No
34,zen,36,11.51301324,22,7.728755831,7.728545813,792,88.9812682,20,14,34,28,28,56,4,0.440275,0.455233,0.000001,No
8607,lionel,22,12.00548972,19,7.875359305,7.875179292,418,94.54754521,11,6,17,16,11,27,5,0.378922,0.394847,0.000002,No
18105,aerobic,18,12.20616042,10,8.517213191,8.517123189,180,103.9624705,11,6,17,14,16,30,5,0.385506,0.401914,0.000002,No
8740,lethal,19,12.1520932,14,8.180740955,8.180610949,266,99.41312651,13,4,17,18,7,25,5,0.321087,0.324411,0.000002,No
10177,hydrothermal,20,12.1007999,8,8.740356743,8.740286741,160,105.765308,14,3,17,16,9,25,5,0.322722,0.326005,0.000002,No
6275,par,15,12.38848198,14,8.180740955,8.180610949,210,101.3469619,4,7,11,9,10,19,4,0.415539,0.432722,0.000003,No
5273,primordial,9,12.8993076,9,8.622573707,8.622493705,81,111.2252305,5,6,11,8,6,14,4,0.399006,0.416742,0.000003,No
8604,lipid,11,12.6986369,6,9.028038815,9.027988815,66,114.6437869,5,6,11,11,8,19,5,0.357422,0.369363,0.000003,No
380,whitman,8,13.01709064,7,8.873888135,8.873828135,56,115.5122061,5,6,11,6,7,13,4,0.424513,0.441294,0.000003,No
2898,spalding,7,13.15062203,5,9.210360372,9.210320372,35,121.121968,5,6,11,7,6,13,5,0.36245,0.375482,0.000003,No
3844,scholastic,8,13.01709064,7,8.873888135,8.873828135,56,115.5122061,6,5,11,6,6,12,5,0.360939,0.373698,0.000003,No
2569,stew,9,12.8993076,7,8.873888135,8.873828135,63,114.4670127,7,4,11,8,5,13,4,0.399527,0.417052,0.000003,No
9805,inhuman,10,12.79394708,9,8.622573707,8.622493705,90,110.3167517,8,3,11,9,8,17,5,0.366627,0.380555,0.000003,No
15962,bundestag,46,11.26789078,30,7.418600903,7.418310866,1380,83.59198472,8,25,33,42,37,79,4,0.443509,0.458185,0.000001,No
12657,est,49,11.20471188,42,7.082128666,7.08171859,2058,79.35321119,12,21,33,41,40,81,4,0.435778,0.451472,0.000001,No
14465,corinth,33,11.60002462,20,7.824066011,7.823875996,660,90.75935832,12,21,33,29,30,59,4,0.448065,0.461889,0.000001,No
14209,crowley,30,11.6953348,16,8.047209562,8.047059554,480,94.11481,12,21,33,13,26,39,4,0.407254,0.424915,0.000001,No
12126,finite,53,11.12624026,27,7.523961418,7.52370139,1431,83.71340247,13,20,33,44,31,75,4,0.447941,0.461763,0.000001,No
12301,fate,51,11.16470654,34,7.29343776,7.293107712,1734,81.42909229,14,19,33,42,44,86,4,0.452312,0.465349,0.000001,No
14079,cyclist,36,11.51301324,26,7.561701746,7.56145172,936,87.05797231,14,19,33,23,33,56,4,0.425714,0.442501,0.000001,No
17839,altogether,27,11.80069531,27,7.523961418,7.52370139,729,88.78797623,14,19,33,15,24,39,4,0.441457,0.456406,0.000001,No
1061,update,31,11.66254497,24,7.641744454,7.641514432,744,89.12218836,14,19,33,18,24,42,4,0.459478,0.471058,0.000001,No
6129,patterson,27,11.80069531,14,8.180740955,8.180610949,378,96.53843143,14,19,33,21,23,44,4,0.433289,0.449242,0.000001,No
15151,cincinnati,59,11.01899473,37,7.208880372,7.208520314,2183,79.43461485,15,18,33,54,38,92,4,0.40448,0.422108,0.000001,No
5880,petrol,39,11.43297053,30,7.418600903,7.418310866,1170,84.8166455,15,18,33,28,24,52,4,0.408341,0.425995,0.000001,No
10280,howe,38,11.45894602,27,7.523961418,7.52370139,1026,86.21666773,15,18,33,28,31,59,5,0.396458,0.413903,0.000001,No
7962,mauritania,26,11.83843564,21,7.775275846,7.77507583,546,92.04710269,15,18,33,23,24,47,4,0.427622,0.444149,0.000001,No
13779,demeter,29,11.72923635,14,8.180740955,8.180610949,406,95.95384415,15,18,33,22,26,48,4,0.405468,0.423122,0.000001,No
4038,salty,31,11.66254497,28,7.487593774,7.487323743,868,87.32439913,16,17,33,24,26,50,4,0.435907,0.451496,0.000001,No
17783,ammunition,34,11.57017165,23,7.684304068,7.684084048,782,88.9087171,16,17,33,29,26,55,4,0.432392,0.448411,0.000001,No
479,wei,33,11.60002462,23,7.684304068,7.684084048,759,89.13811635,16,17,33,26,22,48,4,0.429131,0.445496,0.000001,No
5125,prostitution,31,11.66254497,20,7.824066011,7.823875996,620,91.24852172,16,17,33,26,30,56,4,0.439033,0.454219,0.000001,No
9913,indirect,32,11.63079627,30,7.418600903,7.418310866,960,86.28423574,17,16,33,27,19,46,5,0.358998,0.371775,0.000001,No
1861,terminology,28,11.76432767,24,7.641744454,7.641514432,672,89.8999857,17,16,33,19,20,39,4,0.412095,0.429708,0.000001,No
91,yesterday,21,12.05200974,20,7.824066011,7.823875996,420,94.29571976,17,16,33,19,17,36,4,0.448043,0.461791,0.000001,No
2033,tang,64,10.93764909,44,7.03560865,7.035178566,2816,76.95301858,18,15,33,58,53,111,4,0.416847,0.434149,0.000001,No
8702,libra,28,11.76432767,11,8.421903011,8.421803008,308,99.07802661,18,15,33,21,25,46,4,0.434967,0.450613,0.000001,No
3888,scarborough,26,11.83843564,10,8.517213191,8.517123189,260,100.8304802,18,15,33,24,25,49,4,0.394598,0.41208,0.000001,No
10243,humid,79,10.72708432,72,6.543132165,6.542421927,5688,70.18873048,19,14,33,77,36,113,4,0.434658,0.450355,0.000001,No
12025,fletcher,32,11.63079627,24,7.641744454,7.641514432,768,88.87957293,19,14,33,23,24,47,5,0.39014,0.407129,0.000001,No
12377,faculty,69,10.86242567,42,7.082128666,7.08171859,2898,76.92909624,20,13,33,51,60,111,4,0.44193,0.456632,0.000001,No
6610,olga,32,11.63079627,16,8.047209562,8.047059554,512,93.59545499,20,13,33,24,15,39,5,0.39699,0.414457,0.000001,No
13274,drainage,45,11.28986969,32,7.354062381,7.35375234,1440,83.02640596,21,12,33,41,35,76,4,0.417513,0.434736,0.000001,No
8915,larynx,19,12.1520932,8,8.740356743,8.740286741,152,106.2136297,3,13,16,17,16,33,4,0.407451,0.425183,0.000002,No
8863,lawsuit,26,11.83843564,21,7.775275846,7.77507583,546,92.04710269,4,12,16,24,19,43,4,0.42822,0.444646,0.000002,No
17148,avalanche,46,11.26789078,27,7.523961418,7.52370139,1242,84.7791755,10,22,32,44,38,82,4,0.408257,0.426051,0.000001,No
4638,referee,40,11.40765272,25,7.600922459,7.600682435,1000,86.70868379,10,22,32,35,32,67,4,0.44558,0.459866,0.000001,No
5878,petrology,5,13.48709426,5,9.210360372,9.210320372,25,124.2209985,3,5,8,3,5,8,4,0.422452,0.439468,0.000004,No
18049,agnew,5,13.48709426,2,10.1266511,10.1266411,10,136.579098,3,5,8,4,5,9,4,0.391638,0.408808,0.000004,No
9350,joyce,31,11.66254497,24,7.641744454,7.641514432,744,89.12218836,12,20,32,29,24,53,4,0.429744,0.446191,0.000001,No
7926,mccarthy,24,11.91847835,18,7.929426526,7.929256515,432,94.50669836,12,20,32,19,21,40,4,0.45067,0.46403,0.000001,No
5342,precise,39,11.43297053,39,7.156236638,7.155856573,1521,81.8170426,13,19,32,39,24,63,5,0.388476,0.405387,0.000001,No
846,vernon,36,11.51301324,22,7.728755831,7.728545813,792,88.9812682,13,19,32,31,29,60,4,0.429089,0.445501,0.000001,No
2138,synagogue,38,11.45894602,15,8.111748083,8.111608076,570,92.95208339,13,19,32,31,33,64,4,0.45267,0.46564,0.000001,No
16033,bryant,27,11.80069531,18,7.929426526,7.929256515,486,93.57274643,13,19,32,22,21,43,4,0.430442,0.446712,0.000001,No
4360,righteous,20,12.1007999,17,7.98658494,7.986424931,340,96.64406628,7,9,16,17,10,27,5,0.336098,0.342508,0.000002,No
10264,hue,14,12.45747485,13,8.254848927,8.254728922,182,102.8345729,7,9,16,10,9,19,4,0.379319,0.395208,0.000002,No
8836,lease,12,12.61162553,11,8.421903011,8.421803008,132,106.213887,7,9,16,11,10,21,4,0.42214,0.439111,0.000002,No
13365,donahue,9,12.8993076,5,9.210360372,9.210320372,45,118.8072715,7,9,16,8,9,17,4,0.407301,0.424798,0.000002,No
15861,cab,33,11.60002462,28,7.487593774,7.487323743,924,86.85627209,14,18,32,24,22,46,4,0.446375,0.460453,0.000001,No
2327,sumatra,32,11.63079627,24,7.641744454,7.641514432,768,88.87957293,14,18,32,29,29,58,4,0.439729,0.454829,0.000001,No
7158,nail,30,11.6953348,17,7.98658494,7.986424931,510,93.40578475,14,18,32,28,19,47,4,0.429297,0.445848,0.000001,No
5924,persecution,35,11.54118412,26,7.561701746,7.56145172,910,87.27099208,15,17,32,27,33,60,4,0.440668,0.455627,0.000001,No
7162,nagasaki,39,11.43297053,22,7.728755831,7.728545813,858,88.36263766,15,17,32,32,33,65,4,0.433936,0.449777,0.000001,No
12880,emerald,32,11.63079627,15,8.111748083,8.111608076,480,94.34608939,15,17,32,25,29,54,4,0.436819,0.452298,0.000001,No
9435,jess,5,13.48709426,4,9.433503923,9.433473923,20,127.2305567,2,2,4,2,4,6,5,0.293056,0.299274,0.000008,No
4949,pyroxene,6,13.30477271,6,9.028038815,9.027988815,36,120.1160044,4,4,8,6,4,10,4,0.400311,0.417925,0.000004,No
12899,em,16,12.32394346,10,8.517213191,8.517123189,160,104.9656538,8,8,16,9,8,17,4,0.390372,0.407254,0.000002,No
15122,citation,11,12.6986369,10,8.517213191,8.517123189,110,108.1569978,8,8,16,8,9,17,4,0.407311,0.424765,0.000002,No
5382,pour,51,11.16470654,38,7.182212124,7.181842063,1938,80.18729071,16,16,32,27,37,64,5,0.426994,0.443869,0.000001,No
8829,lebanese,41,11.38296011,25,7.600922459,7.600682435,1025,86.52099716,16,16,32,38,24,62,4,0.406201,0.42384,0.000001,No
17125,awake,33,11.60002462,22,7.728755831,7.728545813,726,89.65375789,16,16,32,32,31,63,4,0.441809,0.456566,0.000001,No
14680,configuration,32,11.63079627,27,7.523961418,7.52370139,864,87.50966243,17,15,32,26,25,51,4,0.43698,0.452411,0.000001,No
16441,bloody,28,11.76432767,28,7.487593774,7.487323743,784,88.0865066,17,15,32,26,20,46,5,0.365284,0.378954,0.000001,No
4125,rutherford,33,11.60002462,24,7.641744454,7.641514432,792,88.64442377,17,15,32,32,27,59,5,0.408144,0.425724,0.000001,No
15384,chang,33,11.60002462,21,7.775275846,7.77507583,693,90.19339121,17,15,32,24,19,43,4,0.405302,0.422896,0.000001,No
1593,toad,33,11.60002462,19,7.875359305,7.875179292,627,91.3543618,17,15,32,28,25,53,4,0.450145,0.46349,0.000001,No
10620,hemp,24,11.91847835,11,8.421903011,8.421803008,264,100.3762687,17,15,32,21,22,43,4,0.410172,0.42776,0.000001,No
3610,sequential,13,12.53158282,12,8.334891634,8.334781631,156,104.4493848,9,7,16,12,7,19,5,0.362569,0.375598,0.000002,No
9326,juicy,11,12.6986369,11,8.421903011,8.421803008,121,106.9466884,9,7,16,10,8,18,4,0.422683,0.439435,0.000002,No
15685,capsule,11,12.6986369,8,8.740356743,8.740286741,88,110.9906167,9,7,16,11,8,19,4,0.413805,0.431121,0.000002,No
10484,hind,40,11.40765272,34,7.29343776,7.293107712,1360,83.20100512,18,14,32,32,21,53,4,0.417209,0.434591,0.000001,No
3983,santo,75,10.77904406,49,6.927977986,6.92749788,3675,74.67697999,19,13,32,52,51,103,4,0.394309,0.411517,0.000001,No
17577,anybody,28,11.76432767,26,7.561701746,7.56145172,728,88.95833706,19,13,32,21,22,43,5,0.396768,0.414321,0.000001,No
5189,prometheus,30,11.6953348,16,8.047209562,8.047059554,480,94.11481,19,13,32,22,21,43,4,0.423641,0.440412,0.000001,No
5495,pomp,6,13.30477271,3,9.721185996,9.721165996,18,129.3381701,5,3,8,6,6,12,5,0.390561,0.40734,0.000004,No
750,viral,20,12.1007999,15,8.111748083,8.111608076,300,98.15864042,10,6,16,19,8,27,5,0.324421,0.328106,0.000002,No
16458,bloc,62,10.96939779,40,7.13091883,7.130528762,2480,78.22188527,20,12,32,48,51,99,4,0.432098,0.448055,0.000001,No
9781,inorganic,33,11.60002462,27,7.523961418,7.52370139,891,87.27813766,20,12,32,29,16,45,5,0.361086,0.37424,0.000001,No
18169,adhesive,26,11.83843564,16,8.047209562,8.047059554,416,95.26637248,20,12,32,21,24,45,4,0.436872,0.452228,0.000001,No
13210,duane,13,12.53158282,11,8.421903011,8.421803008,143,105.5397751,11,5,16,11,6,17,5,0.384437,0.400693,0.000002,No
14635,conqueror,48,11.22533117,45,7.013135794,7.012695706,2160,78.72477181,7,24,31,40,40,80,4,0.448609,0.462415,0.000001,No
6723,oboe,29,11.72923635,14,8.180740955,8.180610949,406,95.95384415,8,23,31,27,27,54,4,0.436518,0.452148,0.000001,No
8045,marsupial,37,11.48561426,29,7.452502454,7.452222421,1073,85.5965685,10,21,31,22,29,51,4,0.453874,0.46664,0.000001,No
15864,byzantium,39,11.43297053,31,7.38581108,7.385511041,1209,84.44176042,11,20,31,35,29,64,4,0.414733,0.432248,0.000001,No
13619,dialogue,32,11.63079627,31,7.38581108,7.385511041,992,85.90286399,11,20,31,25,28,53,4,0.442768,0.457462,0.000001,No
1577,togo,29,11.72923635,16,8.047209562,8.047059554,464,94.38762289,12,19,31,21,21,42,4,0.446802,0.46081,0.000001,No
11683,fuji,33,11.60002462,15,8.111748083,8.111608076,495,94.09647744,13,18,31,30,25,55,4,0.42435,0.44128,0.000001,No
4387,richter,48,11.22533117,29,7.452502454,7.452222421,1392,83.65680807,14,17,31,40,41,81,4,0.430609,0.446801,0.000001,No
5937,permit,27,11.80069531,24,7.641744454,7.641514432,648,90.17789795,14,17,31,24,23,47,4,0.452635,0.465551,0.000001,No
11075,grip,27,11.80069531,24,7.641744454,7.641514432,648,90.17789795,14,17,31,19,25,44,4,0.45184,0.464917,0.000001,No
16953,barber,29,11.72923635,19,7.875359305,7.875179292,551,92.37195061,14,17,31,29,26,55,4,0.437972,0.453298,0.000001,No
7187,myers,26,11.83843564,17,7.98658494,7.986424931,442,94.54867179,14,17,31,26,21,47,4,0.407975,0.425605,0.000001,No
6716,observe,41,11.38296011,36,7.236279346,7.235929291,1476,82.37027914,15,16,31,35,32,67,4,0.441556,0.456331,0.000001,No
13565,digest,36,11.51301324,33,7.323290723,7.322970678,1188,84.31314304,15,16,31,28,27,55,4,0.416202,0.433656,0.000001,No
8662,likewise,26,11.83843564,26,7.561701746,7.56145172,676,89.51871945,16,15,31,18,21,39,4,0.442801,0.457392,0.000001,No
15446,ceramic,33,11.60002462,22,7.728755831,7.728545813,726,89.65375789,16,15,31,28,20,48,4,0.405848,0.423469,0.000001,No
3380,shu,28,11.76432767,15,8.111748083,8.111608076,420,95.4292624,16,15,31,18,21,39,4,0.432698,0.44866,0.000001,No
10057,immigrant,43,11.33533206,40,7.13091883,7.130528762,1720,80.83133284,17,14,31,39,34,73,4,0.406471,0.424079,0.000001,No
17122,aware,46,11.26789078,37,7.208880372,7.208520314,1702,81.22887668,17,14,31,40,43,83,4,0.433967,0.449824,0.000001,No
2204,swat,44,11.31234254,28,7.487593774,7.487323743,1232,84.7022256,17,14,31,32,28,60,4,0.441019,0.455866,0.000001,No
6034,pencil,38,11.45894602,25,7.600922459,7.600682435,950,87.09856015,17,14,31,34,24,58,4,0.439566,0.454613,0.000001,No
9119,kitty,35,11.54118412,18,7.929426526,7.929256515,630,91.51497147,17,14,31,29,29,58,4,0.415073,0.432492,0.000001,No
10465,hire,35,11.54118412,32,7.354062381,7.35375234,1120,84.87458794,18,13,31,32,25,57,4,0.445949,0.460002,0.000001,No
12589,eva,31,11.66254497,25,7.600922459,7.600682435,775,88.64610002,19,12,31,22,14,36,5,0.397817,0.415241,0.000001,No
5922,perseus,36,11.51301324,19,7.875359305,7.875179292,684,90.66911594,19,12,31,28,17,45,4,0.403817,0.421338,0.000001,No
1128,typesetting,5,13.48709426,5,9.210360372,9.210320372,25,124.2209985,3,3,6,4,4,8,4,0.399258,0.41692,0.000005,No
16400,bobbie,4,13.71023782,3,9.721185996,9.721165996,12,133.2797719,3,3,6,4,3,7,5,0.360032,0.372593,0.000005,No
4775,rampage,9,12.8993076,7,8.873888135,8.873828135,63,114.4670127,2,8,10,8,8,16,4,0.427673,0.444008,0.000003,No
15377,chao,8,13.01709064,8,8.740356743,8.740286741,64,113.7740159,5,5,10,5,5,10,4,0.422673,0.439384,0.000003,No
1062,upbeat,6,13.30477271,6,9.028038815,9.027988815,36,120.1160044,5,5,10,6,5,11,4,0.39008,0.406827,0.000003,No
6403,owens,6,13.30477271,6,9.028038815,9.027988815,36,120.1160044,5,5,10,5,5,10,5,0.389738,0.406909,0.000003,No
17812,ambition,6,13.30477271,6,9.028038815,9.027988815,36,120.1160044,5,5,10,5,5,10,5,0.369558,0.383999,0.000003,No
1332,triassic,62,10.96939779,45,7.013135794,7.012695706,2790,76.9298763,6,24,30,38,54,92,4,0.451014,0.464373,0.000001,No
1356,treasury,49,11.20471188,35,7.264450223,7.264110172,1715,81.39607171,8,22,30,47,38,85,4,0.447117,0.461148,0.000001,No
908,vega,51,11.16470654,29,7.452502454,7.452222421,1479,83.20500292,8,22,30,46,43,89,4,0.440909,0.455923,0.000001,No
6067,pedestrian,10,12.79394708,6,9.028038815,9.027988815,60,115.5042509,5,10,15,9,10,19,4,0.425011,0.441632,0.000002,No
16980,bang,60,11.00218762,39,7.156236638,7.155856573,2340,78.73425811,10,20,30,36,44,80,4,0.435693,0.451355,0.000001,No
13796,deliver,39,11.43297053,38,7.182212124,7.181842063,1482,82.11401957,10,20,30,31,31,62,4,0.43108,0.447425,0.000001,No
4449,revelation,35,11.54118412,24,7.641744454,7.641514432,840,88.19477971,11,19,30,28,30,58,4,0.459573,0.471138,0.000001,No
5862,pharmacy,33,11.60002462,20,7.824066011,7.823875996,660,90.75935832,11,19,30,25,28,53,4,0.434307,0.450148,0.000001,No
10525,hiatus,14,12.45747485,13,8.254848927,8.254728922,182,102.8345729,6,9,15,13,13,26,4,0.439012,0.454064,0.000002,No
17415,ark,46,11.26789078,25,7.600922459,7.600682435,1150,85.64636411,12,18,30,40,33,73,4,0.446285,0.460425,0.000001,No
10954,gymnasium,37,11.48561426,24,7.641744454,7.641514432,888,87.77012911,12,18,30,28,29,57,4,0.413998,0.431483,0.000001,No
7115,nationwide,26,11.83843564,25,7.600922459,7.600682435,650,89.98303133,12,18,30,21,22,43,4,0.4052,0.422817,0.000001,No
7021,ness,32,11.63079627,10,8.517213191,8.517123189,320,99.06197145,12,18,30,25,29,54,4,0.409037,0.426812,0.000001,No
16946,bare,28,11.76432767,27,7.523961418,7.52370139,756,88.51434748,13,17,30,22,19,41,4,0.41916,0.436398,0.000001,No
3870,scent,28,11.76432767,25,7.600922459,7.600682435,700,89.41974238,13,17,30,19,20,39,4,0.447794,0.461598,0.000001,No
6518,oratorio,33,11.60002462,21,7.775275846,7.77507583,693,90.19339121,13,17,30,33,27,60,4,0.446386,0.460425,0.000001,No
7772,menu,25,11.87765635,21,7.775275846,7.77507583,525,92.35205455,13,17,30,20,19,39,4,0.405923,0.423554,0.000001,No
11004,guilt,25,11.87765635,20,7.824066011,7.823875996,500,92.93156735,13,17,30,21,21,42,4,0.444542,0.45888,0.000001,No
9589,ironic,12,12.61162553,12,8.334891634,8.334781631,144,105.1165321,7,8,15,10,11,21,5,0.395319,0.412528,0.000002,No
3479,sheila,11,12.6986369,10,8.517213191,8.517123189,110,108.1569978,7,8,15,8,8,16,4,0.422663,0.439435,0.000002,No
5002,pupae,8,13.01709064,7,8.873888135,8.873828135,56,115.5122061,7,8,15,8,8,16,4,0.430494,0.446571,0.000002,No
2868,specimen,35,11.54118412,23,7.684304068,7.684084048,805,88.68596805,14,16,30,28,31,59,4,0.431163,0.447369,0.000001,No
9452,jelly,25,11.87765635,19,7.875359305,7.875179292,475,93.54081148,14,16,30,17,22,39,4,0.428592,0.445003,0.000001,No
17968,alchemy,25,11.87765635,17,7.98658494,7.986424931,425,94.86191135,14,16,30,19,24,43,4,0.433702,0.449529,0.000001,No
6998,neutron,47,11.24638458,31,7.38581108,7.385511041,1457,83.06367181,15,15,30,43,33,76,4,0.435127,0.450792,0.000001,No
1379,transylvania,36,11.51301324,27,7.523961418,7.52370139,972,86.62346742,15,15,30,31,35,66,4,0.440603,0.455538,0.000001,No
11876,forgotten,28,11.76432767,26,7.561701746,7.56145172,728,88.95833706,15,15,30,19,25,44,4,0.435116,0.450773,0.000001,No
17563,ape,30,11.6953348,24,7.641744454,7.641514432,720,89.37275981,15,15,30,26,26,52,4,0.441106,0.455941,0.000001,No
10517,hid,24,11.91847835,23,7.684304068,7.684084048,552,91.58521165,15,15,30,18,24,42,4,0.432888,0.448815,0.000001,No
2881,spatial,11,12.6986369,10,8.517213191,8.517123189,110,108.1569978,8,7,15,10,7,17,5,0.384537,0.400848,0.000002,No
5888,peterson,9,12.8993076,8,8.740356743,8.740286741,72,112.7445502,8,7,15,8,7,15,4,0.430296,0.446529,0.000002,No
3646,seminole,24,11.91847835,19,7.875359305,7.875179292,456,93.86229935,16,14,30,22,21,43,5,0.357436,0.369368,0.000001,No
16411,bmw,41,11.38296011,13,8.254848927,8.254728922,533,93.96461605,16,14,30,35,28,63,4,0.433173,0.44905,0.000001,No
9473,jasper,28,11.76432767,14,8.180740955,8.180610949,392,96.24091715,16,14,30,20,22,42,4,0.401153,0.418713,0.000001,No
9618,io,29,11.72923635,11,8.421903011,8.421803008,319,98.78249092,16,14,30,22,26,48,4,0.426953,0.443482,0.000001,No
8126,manufacture,32,11.63079627,31,7.38581108,7.385511041,992,85.90286399,17,13,30,32,27,59,4,0.447704,0.461458,0.000001,No
13355,donovan,24,11.91847835,21,7.775275846,7.77507583,504,92.66945682,17,13,30,19,17,36,4,0.429058,0.44536,0.000001,No
1733,thong,15,12.38848198,8,8.740356743,8.740286741,120,108.279752,9,6,15,11,11,22,5,0.368546,0.382841,0.000002,No
15813,caleb,12,12.61162553,7,8.873888135,8.873828135,84,111.9141541,9,6,15,10,7,17,5,0.33447,0.339709,0.000002,No
8154,mania,27,11.80069531,8,8.740356743,8.740286741,216,103.1422868,20,10,30,23,24,47,4,0.434839,0.450421,0.000001,No
10630,helmut,23,11.96103796,18,7.929426526,7.929256515,414,94.84417169,11,4,15,15,8,23,5,0.316728,0.32089,0.000002,No
8089,marin,16,12.32394346,12,8.334891634,8.334781631,192,102.7187332,11,4,15,14,10,24,5,0.384921,0.401214,0.000002,No
15073,claudio,24,11.91847835,22,7.728755831,7.728545813,528,92.11500902,13,2,15,15,10,25,5,0.300122,0.305897,0.000002,No
9673,intestine,47,11.24638458,27,7.523961418,7.52370139,1269,84.61736364,6,23,29,45,39,84,4,0.442194,0.457031,0.000001,No
13229,drove,27,11.80069531,27,7.523961418,7.52370139,729,88.78797623,9,20,29,18,24,42,4,0.443575,0.458237,0.000001,No
14819,commit,47,11.24638458,45,7.013135794,7.012695706,2115,78.87242223,10,19,29,39,37,76,4,0.42822,0.444933,0.000001,No
8962,landlocked,49,11.20471188,31,7.38581108,7.385511041,1519,82.75588514,10,19,29,39,39,78,4,0.433861,0.449745,0.000001,No
1396,transmitted,57,11.05348091,48,6.948597273,6.948127172,2736,76.80618731,11,18,29,33,33,66,4,0.4046,0.422333,0.000001,No
6841,northumberland,31,11.66254497,23,7.684304068,7.684084048,713,89.61854178,11,18,29,26,24,50,4,0.407872,0.425483,0.000001,No
5695,pius,67,10.89183956,48,6.948597273,6.948127172,3216,75.68300665,12,17,29,55,55,110,5,0.39137,0.408467,0.000001,No
5572,poe,30,11.6953348,17,7.98658494,7.986424931,510,93.40578475,12,17,29,26,22,48,4,0.447275,0.461171,0.000001,No
16915,barrett,23,11.96103796,14,8.180740955,8.180610949,322,97.85015311,12,17,29,12,18,30,4,0.443642,0.458139,0.000001,No
16537,bisexual,34,11.57017165,28,7.487593774,7.487323743,952,86.63274523,13,16,29,25,28,53,4,0.440887,0.455772,0.000001,No
8291,madonna,39,11.43297053,23,7.684304068,7.684084048,897,87.85442197,13,16,29,30,27,57,4,0.419635,0.436778,0.000001,No
10794,harmonica,33,11.60002462,25,7.600922459,7.600682435,825,88.17088763,13,16,29,26,22,48,4,0.446117,0.460185,0.000001,No
16233,boyle,20,12.1007999,19,7.875359305,7.875179292,380,95.29814712,13,16,29,17,19,36,4,0.403744,0.421342,0.000001,No
9555,isis,29,11.72923635,13,8.254848927,8.254728922,377,96.82307407,13,16,29,22,20,42,4,0.419219,0.436389,0.000001,No
12197,feudal,39,11.43297053,38,7.182212124,7.181842063,1482,82.11401957,14,15,29,36,25,61,5,0.337414,0.343614,0.000001,No
1679,thumb,36,11.51301324,30,7.418600903,7.418310866,1080,85.41045041,14,15,29,35,28,63,4,0.449074,0.462627,0.000001,No
15571,casino,27,11.80069531,22,7.728755831,7.728545813,594,91.2046927,14,15,29,20,19,39,4,0.403624,0.421183,0.000001,No
9192,ketchup,26,11.83843564,13,8.254848927,8.254728922,338,97.72449773,14,15,29,21,20,41,4,0.431415,0.447501,0.000001,No
10390,homeland,59,11.01899473,43,7.058598169,7.058178089,2537,77.77865604,15,14,29,54,36,90,4,0.449837,0.463242,0.000001,No
8666,lightweight,27,11.80069531,24,7.641744454,7.641514432,648,90.17789795,15,14,29,22,19,41,4,0.431017,0.447134,0.000001,No
15707,cantonese,31,11.66254497,17,7.98658494,7.986424931,527,93.14390604,15,14,29,22,27,49,4,0.427797,0.444228,0.000001,No
6795,nowhere,23,11.96103796,20,7.824066011,7.823875996,460,93.58395057,15,14,29,20,20,40,4,0.43596,0.451529,0.000001,No
16304,bore,22,12.00548972,19,7.875359305,7.875179292,418,94.54754521,15,14,29,19,22,41,4,0.436894,0.452308,0.000001,No
11491,geisha,28,11.76432767,7,8.873888135,8.873828135,196,104.3953277,15,14,29,20,18,38,4,0.411617,0.429206,0.000001,No
7200,mutiny,35,11.54118412,23,7.684304068,7.684084048,805,88.68596805,16,13,29,29,30,59,4,0.415121,0.432464,0.000001,No
5147,propulsion,25,11.87765635,20,7.824066011,7.823875996,500,92.93156735,16,13,29,20,19,39,4,0.442657,0.457242,0.000001,No
2151,sylvia,24,11.91847835,17,7.98658494,7.986424931,408,95.18793968,16,13,29,19,17,36,5,0.356138,0.367601,0.000001,No
12419,extraordinary,29,11.72923635,28,7.487593774,7.487323743,812,87.82375705,17,12,29,24,13,37,5,0.331392,0.336141,0.000001,No
16091,brittle,28,11.76432767,19,7.875359305,7.875179292,532,92.64830736,17,12,29,24,14,38,4,0.423925,0.440661,0.000001,No
10908,hairy,24,11.91847835,21,7.775275846,7.77507583,504,92.66945682,17,12,29,20,19,39,4,0.430338,0.446501,0.000001,No
3742,seafood,23,11.96103796,19,7.875359305,7.875179292,437,94.19747161,17,12,29,20,17,37,4,0.409434,0.426948,0.000001,No
2014,tao,27,11.80069531,13,8.254848927,8.254728922,351,97.41295703,17,12,29,22,16,38,4,0.429287,0.445623,0.000001,No
15156,cider,29,11.72923635,12,8.334891634,8.334781631,348,97.76191391,17,12,29,25,19,44,4,0.420102,0.437295,0.000001,No
8436,lowland,38,11.45894602,34,7.29343776,7.293107712,1292,83.57510957,18,11,29,33,13,46,5,0.396653,0.41395,0.000001,No
14967,cobalt,35,11.54118412,11,8.421903011,8.421803008,385,97.19873326,19,10,29,27,25,52,4,0.414404,0.43183,0.000001,No
5613,plenty,39,11.43297053,37,7.208880372,7.208520314,1443,82.41891685,21,8,29,38,38,76,5,0.410542,0.427997,0.000001,No
17716,andes,58,11.03608917,48,6.948597273,6.948127172,2784,76.68533909,7,21,28,55,41,96,4,0.447749,0.461655,0.000001,No
5864,pharmacist,15,12.38848198,12,8.334891634,8.334781631,180,103.2566548,4,10,14,11,11,22,4,0.394844,0.412324,0.000002,No
3902,scalar,14,12.45747485,12,8.334891634,8.334781631,168,103.8317029,4,10,14,12,13,25,5,0.356367,0.368514,0.000002,No
8505,loire,979,8.210000535,960,3.952865,3.943228913,939840,32.45302376,8,20,28,972,960,1932,4,0.4642,0.474753,0.000001,No
13599,dickens,32,11.63079627,23,7.684304068,7.684084048,736,89.37457513,8,20,28,30,27,57,4,0.428799,0.445393,0.000001,No
13642,devout,17,12.26331883,16,8.047209562,8.047059554,272,98.68549658,5,9,14,14,13,27,5,0.376511,0.392212,0.000002,No
10755,hathaway,14,12.45747485,11,8.421903011,8.421803008,154,104.9156449,5,9,14,11,11,22,5,0.402417,0.41987,0.000002,No
14648,conjecture,32,11.63079627,15,8.111748083,8.111608076,480,94.34608939,10,18,28,18,27,45,4,0.430223,0.446482,0.000001,No
7299,mouthpiece,40,11.40765272,10,8.517213191,8.517123189,400,97.16141026,10,18,28,36,32,68,4,0.448631,0.462331,0.000001,No
6102,payne,26,11.83843564,15,8.111748083,8.111608076,390,96.0304076,11,17,28,20,24,44,4,0.431268,0.447407,0.000001,No
11486,gem,22,12.00548972,16,8.047209562,8.047059554,352,96.6106917,11,17,28,18,18,36,4,0.41912,0.436384,0.000001,No
5742,pineapple,27,11.80069531,13,8.254848927,8.254728922,351,97.41295703,11,17,28,24,21,45,4,0.441776,0.456566,0.000001,No
4924,quake,22,12.00548972,12,8.334891634,8.334781631,264,100.0644559,11,17,28,19,20,39,4,0.403496,0.42108,0.000001,No
12984,elaborate,17,12.26331883,16,8.047209562,8.047059554,272,98.68549658,6,8,14,16,9,25,5,0.386875,0.403449,0.000002,No
6253,paranoid,11,12.6986369,8,8.740356743,8.740286741,88,110.9906167,6,8,14,7,9,16,4,0.409094,0.426699,0.000002,No
15047,clergyman,32,11.63079627,31,7.38581108,7.385511041,992,85.90286399,12,16,28,29,26,55,4,0.434243,0.450031,0.000001,No
1978,taurus,37,11.48561426,21,7.775275846,7.77507583,777,89.30381917,12,16,28,26,28,54,4,0.430651,0.446843,0.000001,No
9096,knock,26,11.83843564,19,7.875359305,7.875179292,494,93.23193427,12,16,28,22,23,45,4,0.425031,0.441947,0.000001,No
9492,jakarta,23,11.96103796,16,8.047209562,8.047059554,368,96.25297905,12,16,28,13,23,36,4,0.424188,0.441093,0.000001,No
13164,dunn,22,12.00548972,13,8.254848927,8.254728922,286,99.10350396,12,16,28,16,19,35,4,0.427766,0.444224,0.000001,No
874,venture,35,11.54118412,22,7.728755831,7.728545813,770,89.19899403,13,15,28,28,30,58,4,0.39381,0.411122,0.000001,No
16617,beverage,23,11.96103796,21,7.775275846,7.77507583,483,93.00036956,13,15,28,20,19,39,4,0.402636,0.420197,0.000001,No
15606,carpet,26,11.83843564,18,7.929426526,7.929256515,468,93.87200559,13,15,28,21,17,38,4,0.405052,0.422699,0.000001,No
379,whitney,22,12.00548972,19,7.875359305,7.875179292,418,94.54754521,13,15,28,19,21,40,4,0.419318,0.436543,0.000001,No
13075,echidna,35,11.54118412,12,8.334891634,8.334781631,420,96.19451894,13,15,28,34,21,55,4,0.433723,0.449552,0.000001,No
6158,paterson,24,11.91847835,11,8.421903011,8.421803008,264,100.3762687,13,15,28,20,18,38,4,0.403404,0.420929,0.000001,No
5031,pullman,19,12.1520932,10,8.517213191,8.517123189,190,103.5019685,13,15,28,17,18,35,4,0.437109,0.452585,0.000001,No
298,winfield,14,12.45747485,12,8.334891634,8.334781631,168,103.8317029,7,7,14,13,14,27,5,0.34697,0.356253,0.000002,No
786,viennese,13,12.53158282,10,8.517213191,8.517123189,130,106.7341625,7,7,14,10,8,18,5,0.384829,0.401158,0.000002,No
618,waldo,13,12.53158282,9,8.622573707,8.622493705,117,108.0544965,7,7,14,12,10,22,4,0.391379,0.408329,0.000002,No
11758,frenchman,10,12.79394708,10,8.517213191,8.517123189,100,108.9687749,7,7,14,10,8,18,5,0.341319,0.34877,0.000002,No
10013,imprint,11,12.6986369,8,8.740356743,8.740286741,88,110.9906167,7,7,14,9,9,18,4,0.429879,0.446106,0.000002,No
11880,forgetting,9,12.8993076,8,8.740356743,8.740286741,72,112.7445502,7,7,14,8,9,17,4,0.397488,0.415094,0.000002,No
15981,bulk,26,11.83843564,24,7.641744454,7.641514432,624,90.46629989,14,14,28,23,18,41,5,0.411703,0.429194,0.000001,No
2388,substitute,25,11.87765635,23,7.684304068,7.684084048,575,91.27152303,14,14,28,24,20,44,4,0.446971,0.460965,0.000001,No
5765,pigeon,25,11.87765635,11,8.421903011,8.421803008,275,100.0324698,14,14,28,21,19,40,4,0.428665,0.445027,0.000001,No
698,vodka,20,12.1007999,12,8.334891634,8.334781631,240,100.8588559,14,14,28,16,20,36,4,0.413709,0.43114,0.000001,No
5540,polite,21,12.05200974,20,7.824066011,7.823875996,420,94.29571976,15,13,28,20,20,40,4,0.40985,0.427366,0.000001,No
1036,upward,21,12.05200974,18,7.929426526,7.929256515,378,95.56552572,15,13,28,16,16,32,4,0.434871,0.450515,0.000001,No
5256,privacy,21,12.05200974,18,7.929426526,7.929256515,378,95.56552572,15,13,28,21,16,37,4,0.450727,0.463941,0.000001,No
1952,tear,22,12.00548972,14,8.180740955,8.180610949,308,98.21380147,15,13,28,19,21,40,5,0.413295,0.430823,0.000001,No
18063,agamemnon,26,11.83843564,11,8.421903011,8.421803008,286,99.70215676,15,13,28,21,22,43,4,0.437131,0.452496,0.000001,No
3089,snail,18,12.20616042,12,8.334891634,8.334781631,216,101.7370244,15,13,28,18,15,33,4,0.433173,0.449172,0.000001,No
5017,puncture,4,13.71023782,4,9.433503923,9.433473923,16,129.3355822,4,3,7,4,3,7,4,0.399635,0.417286,0.000004,No
2354,suffocate,4,13.71023782,3,9.721185996,9.721165996,12,133.2797719,4,3,7,4,3,7,5,0.355283,0.36704,0.000004,No
11456,gentlemen,15,12.38848198,13,8.254848927,8.254728922,195,102.2650471,8,6,14,12,11,23,4,0.43518,0.450679,0.000002,No
6440,oswald,11,12.6986369,11,8.421903011,8.421803008,121,106.9466884,8,6,14,8,7,15,4,0.433734,0.449411,0.000002,No
14229,croix,11,12.6986369,10,8.517213191,8.517123189,110,108.1569978,8,6,14,10,7,17,4,0.400149,0.417742,0.000002,No
17800,ames,12,12.61162553,7,8.873888135,8.873828135,84,111.9141541,8,6,14,9,8,17,4,0.39081,0.408033,0.000002,No
4069,sal,11,12.6986369,7,8.873888135,8.873828135,77,112.6862834,8,6,14,10,7,17,4,0.433057,0.448792,0.000002,No
4647,redwood,8,13.01709064,8,8.740356743,8.740286741,64,113.7740159,8,6,14,8,6,14,5,0.342142,0.349762,0.000002,No
221,woodward,27,11.80069531,17,7.98658494,7.986424931,459,94.24725546,16,12,28,19,19,38,4,0.428313,0.444665,0.000001,No
15871,byrd,23,11.96103796,12,8.334891634,8.334781631,276,99.69395524,16,12,28,23,18,41,4,0.387036,0.403977,0.000001,No
17425,arid,32,11.63079627,28,7.487593774,7.487323743,896,87.08667777,17,11,28,31,16,47,4,0.404664,0.422183,0.000001,No
5609,pliny,26,11.83843564,16,8.047209562,8.047059554,416,95.26637248,17,11,28,21,26,47,4,0.401225,0.41892,0.000001,No
16905,bartholomew,21,12.05200974,18,7.929426526,7.929256515,378,95.56552572,17,11,28,20,17,37,4,0.426409,0.442933,0.000001,No
5688,pl,18,12.20616042,13,8.254848927,8.254728922,234,100.7600102,9,5,14,10,5,15,5,0.357523,0.369427,0.000002,No
17946,alexei,20,12.1007999,12,8.334891634,8.334781631,240,100.8588559,9,5,14,9,8,17,4,0.434743,0.45027,0.000002,No
18041,agreeing,12,12.61162553,12,8.334891634,8.334781631,144,105.1165321,9,5,14,9,12,21,4,0.412287,0.429675,0.000002,No
8619,lingua,11,12.6986369,11,8.421903011,8.421803008,121,106.9466884,9,5,14,9,7,16,4,0.400872,0.418554,0.000002,No
9597,iridium,11,12.6986369,5,9.210360372,9.210320372,55,116.9590221,9,5,14,10,9,19,4,0.399806,0.417117,0.000002,No
12386,facial,29,11.72923635,28,7.487593774,7.487323743,812,87.82375705,18,10,28,23,19,42,5,0.394897,0.412129,0.000001,No
5953,peripheral,34,11.57017165,24,7.641744454,7.641514432,816,88.41629506,18,10,28,27,20,47,4,0.397844,0.415207,0.000001,No
16648,bertrand,25,11.87765635,20,7.824066011,7.823875996,500,92.93156735,18,10,28,19,24,43,5,0.387036,0.403622,0.000001,No
15148,cindy,29,11.72923635,16,8.047209562,8.047059554,464,94.38762289,19,9,28,26,15,41,5,0.342129,0.349929,0.000001,No
451,werner,20,12.1007999,20,7.824066011,7.823875996,400,94.67745723,10,4,14,10,11,21,5,0.361204,0.373987,0.000002,No
4454,retrograde,79,10.72708432,66,6.630143542,6.629493344,5214,71.12210886,20,8,28,76,20,96,4,0.400582,0.418296,0.000001,No
1305,trinidad,52,11.14528846,35,7.264450223,7.264110172,1820,80.96439323,20,8,28,37,42,79,4,0.444386,0.458599,0.000001,No
11209,gotten,33,11.60002462,31,7.38581108,7.385511041,1023,85.67559033,6,21,27,32,26,58,4,0.431856,0.448083,0.000001,No
16259,bounty,45,11.28986969,28,7.487593774,7.487323743,1260,84.53395798,8,19,27,30,25,55,4,0.400555,0.418169,0.000001,No
15036,climactic,2,14.403385,2,10.1266511,10.1266411,4,145.8580546,1,2,3,1,2,3,5,0.317873,0.321506,0.000009,No
7992,mater,13,12.53158282,12,8.334891634,8.334781631,156,104.4493848,3,6,9,7,6,13,4,0.395707,0.412878,0.000003,No
8985,lama,50,11.18450917,26,7.561701746,7.56145172,1300,84.57392254,9,18,27,12,29,41,4,0.442878,0.457514,0.000001,No
10201,huxley,36,11.51301324,23,7.684304068,7.684084048,828,88.46949447,9,18,27,19,28,47,4,0.418705,0.436051,0.000001,No
8773,leningrad,30,11.6953348,21,7.775275846,7.77507583,630,90.93445415,9,18,27,26,24,50,4,0.434488,0.450294,0.000001,No
5338,predecessor,38,11.45894602,38,7.182212124,7.181842063,1444,82.30058102,10,17,27,28,32,60,4,0.444932,0.459228,0.000001,No
14190,crush,32,11.63079627,27,7.523961418,7.52370139,864,87.50966243,10,17,27,21,26,47,4,0.445792,0.459932,0.000001,No
8954,lang,30,11.6953348,25,7.600922459,7.600682435,750,88.89533292,10,17,27,18,22,40,4,0.432708,0.448698,0.000001,No
7505,mob,25,11.87765635,19,7.875359305,7.875179292,475,93.54081148,10,17,27,22,20,42,5,0.401488,0.419215,0.000001,No
10717,headache,27,11.80069531,16,8.047209562,8.047059554,432,94.96266815,10,17,27,22,23,45,4,0.414956,0.432417,0.000001,No
15341,chassis,22,12.00548972,12,8.334891634,8.334781631,264,100.0644559,10,17,27,18,17,35,4,0.444787,0.45911,0.000001,No
14048,dad,28,11.76432767,22,7.728755831,7.728545813,616,90.92361605,11,16,27,19,23,42,4,0.447128,0.461016,0.000001,No
7786,mendelssohn,27,11.80069531,20,7.824066011,7.823875996,540,92.32941909,11,16,27,22,25,47,4,0.407236,0.424859,0.000001,No
10575,hermes,27,11.80069531,16,8.047209562,8.047059554,432,94.96266815,11,16,27,20,24,44,4,0.41395,0.431436,0.000001,No
11238,goodman,23,11.96103796,14,8.180740955,8.180610949,322,97.85015311,11,16,27,21,18,39,4,0.417082,0.434384,0.000001,No
11285,goa,22,12.00548972,13,8.254848927,8.254728922,286,99.10350396,11,16,27,20,20,40,4,0.448892,0.462486,0.000001,No
16237,boyce,6,13.30477271,5,9.210360372,9.210320372,30,122.5417513,4,5,9,4,5,9,4,0.391483,0.408385,0.000003,No
16930,barnum,5,13.48709426,4,9.433503923,9.433473923,20,127.2305567,4,5,9,4,5,9,5,0.348066,0.357713,0.000003,No
2689,stalactite,8,13.01709064,2,10.1266511,10.1266411,16,131.8195353,4,5,9,7,7,14,4,0.426235,0.442656,0.000003,No
4610,regis,36,11.51301324,21,7.775275846,7.77507583,756,89.51685376,12,15,27,19,28,47,4,0.42853,0.444914,0.000001,No
2488,strata,25,11.87765635,25,7.600922459,7.600682435,625,90.28114493,12,15,27,22,20,42,4,0.441809,0.456571,0.000001,No
8711,liar,34,11.57017165,20,7.824066011,7.823875996,680,90.52578677,12,15,27,31,24,55,4,0.428024,0.444454,0.000001,No
7204,mutant,33,11.60002462,18,7.929426526,7.929256515,594,91.9815429,12,15,27,29,20,49,5,0.370739,0.385635,0.000001,No
6084,pear,22,12.00548972,12,8.334891634,8.334781631,264,100.0644559,12,15,27,19,17,36,4,0.413873,0.431309,0.000001,No
10414,hollister,20,12.1007999,5,9.210360372,9.210320372,100,111.4527279,12,15,27,14,18,32,4,0.419516,0.436647,0.000001,No
5534,poll,37,11.48561426,33,7.323290723,7.322970678,1221,84.11249239,13,14,27,28,27,55,4,0.445155,0.45935,0.000001,No
7056,needle,35,11.54118412,21,7.775275846,7.77507583,735,89.7358901,13,14,27,33,22,55,4,0.40791,0.425478,0.000001,No
14407,cosmology,26,11.83843564,19,7.875359305,7.875179292,494,93.23193427,13,14,27,20,24,44,4,0.446454,0.460429,0.000001,No
2262,surf,28,11.76432767,18,7.929426526,7.929256515,504,93.28437187,13,14,27,18,21,39,5,0.389558,0.406477,0.000001,No
17553,apocalypse,24,11.91847835,17,7.98658494,7.986424931,408,95.18793968,13,14,27,22,23,45,4,0.435436,0.451054,0.000001,No
10439,hobart,21,12.05200974,14,8.180740955,8.180610949,294,98.59436966,13,14,27,19,19,38,4,0.43015,0.446341,0.000001,No
16797,bedroom,21,12.05200974,14,8.180740955,8.180610949,294,98.59436966,13,14,27,19,16,35,4,0.440843,0.455702,0.000001,No
1177,turquoise,21,12.05200974,12,8.334891634,8.334781631,252,100.4521952,13,14,27,18,18,36,4,0.434711,0.450402,0.000001,No
13576,differ,56,11.07118049,53,6.849506371,6.848986246,2968,75.83212127,14,13,27,31,49,80,4,0.405357,0.422929,0.000001,No
8232,maintenance,27,11.80069531,27,7.523961418,7.52370139,729,88.78797623,14,13,27,20,24,44,4,0.436754,0.452167,0.000001,No
13406,documentation,26,11.83843564,23,7.684304068,7.684084048,598,90.97013915,14,13,27,21,19,40,4,0.414085,0.431473,0.000001,No
17062,backup,25,11.87765635,22,7.728755831,7.728545813,550,91.79950579,14,13,27,21,14,35,4,0.403432,0.420967,0.000001,No
11146,grassland,25,11.87765635,21,7.775275846,7.77507583,525,92.35205455,14,13,27,20,17,37,4,0.444553,0.458829,0.000001,No
9885,inert,24,11.91847835,12,8.334891634,8.334781631,288,99.33922547,14,13,27,20,20,40,4,0.408557,0.426112,0.000001,No
7466,mole,27,11.80069531,11,8.421903011,8.421803008,297,99.38431138,14,13,27,23,24,47,5,0.392192,0.409422,0.000001,No
13424,dixon,19,12.1520932,14,8.180740955,8.180610949,266,99.41312651,14,13,27,15,15,30,5,0.360866,0.373558,0.000001,No
13125,dynamite,22,12.00548972,12,8.334891634,8.334781631,264,100.0644559,14,13,27,20,19,39,4,0.402937,0.420488,0.000001,No
17579,anxious,6,13.30477271,6,9.028038815,9.027988815,36,120.1160044,5,4,9,5,5,10,5,0.368515,0.382793,0.000003,No
10787,harriet,21,12.05200974,19,7.875359305,7.875179292,399,94.91390705,15,12,27,15,12,27,5,0.345491,0.354213,0.000001,No
10028,implementation,33,11.60002462,31,7.38581108,7.385511041,1023,85.67559033,16,11,27,25,31,56,4,0.44226,0.456876,0.000001,No
3141,slogan,29,11.72923635,24,7.641744454,7.641514432,696,89.63182681,16,11,27,22,24,46,4,0.422834,0.439736,0.000001,No
12283,fay,30,11.6953348,9,8.622573707,8.622493705,270,100.8438863,16,11,27,24,16,40,5,0.365367,0.37899,0.000001,No
14960,coca,31,11.66254497,16,8.047209562,8.047059554,496,93.85094342,17,10,27,24,24,48,5,0.362428,0.375328,0.000001,No
14168,cub,10,12.79394708,7,8.873888135,8.873828135,70,113.5320552,6,3,9,8,3,11,5,0.356203,0.368167,0.000003,No
5954,periodic,166,9.984544389,122,6.015777239,6.014566531,20252,60.06479488,18,9,27,147,156,303,5,0.334685,0.340061,0.000001,No
16004,buddy,36,11.51301324,28,7.487593774,7.487323743,1008,86.20476625,18,9,27,20,25,45,5,0.333333,0.33857,0.000001,No
10593,herbivorous,39,11.43297053,30,7.418600903,7.418310866,1170,84.8166455,19,8,27,33,12,45,5,0.395768,0.412997,0.000001,No
4511,reservation,11,12.6986369,10,8.517213191,8.517123189,110,108.1569978,3,10,13,4,10,14,4,0.45237,0.465227,0.000002,No
14211,crowd,43,11.33533206,38,7.182212124,7.181842063,1634,81.41275937,6,20,26,41,29,70,4,0.451473,0.464692,0.000001,No
4195,rowland,34,11.57017165,18,7.929426526,7.929256515,612,91.74482602,8,18,26,29,25,54,5,0.395143,0.412495,0.000001,No
14611,consonant,33,11.60002462,20,7.824066011,7.823875996,660,90.75935832,9,17,26,28,26,54,4,0.438491,0.45374,0.000001,No
13790,delphi,17,12.26331883,14,8.180740955,8.180610949,238,100.3230346,9,17,26,16,17,33,4,0.422542,0.439595,0.000001,No
3800,scorpion,24,11.91847835,8,8.740356743,8.740286741,192,104.1717526,9,17,26,18,22,40,5,0.401379,0.419102,0.000001,No
7755,mere,13,12.53158282,13,8.254848927,8.254728922,169,103.446323,5,8,13,12,8,20,5,0.410153,0.42786,0.000002,No
4826,radial,15,12.38848198,11,8.421903011,8.421803008,165,104.3345937,5,8,13,13,12,25,5,0.384762,0.401111,0.000002,No
878,vent,12,12.61162553,7,8.873888135,8.873828135,84,111.9141541,5,8,13,11,8,19,5,0.365691,0.379428,0.000002,No
8674,ligament,13,12.53158282,6,9.028038815,9.027988815,78,113.1356161,5,8,13,10,10,20,4,0.415092,0.432511,0.000002,No
1946,tech,43,11.33533206,32,7.354062381,7.35375234,1376,83.3607391,10,16,26,39,23,62,4,0.395407,0.412751,0.000001,No
13904,debussy,27,11.80069531,18,7.929426526,7.929256515,486,93.57274643,10,16,26,19,19,38,5,0.391345,0.408425,0.000001,No
17051,badge,32,11.63079627,25,7.600922459,7.600682435,800,88.40478062,11,15,26,25,30,55,4,0.43086,0.447055,0.000001,No
17157,automotive,23,11.96103796,22,7.728755831,7.728545813,506,92.44394189,11,15,26,16,17,33,4,0.420202,0.43729,0.000001,No
3830,schubert,24,11.91847835,21,7.775275846,7.77507583,504,92.66945682,11,15,26,21,22,43,4,0.428406,0.444815,0.000001,No
11174,grandchildren,21,12.05200974,20,7.824066011,7.823875996,420,94.29571976,11,15,26,21,18,39,4,0.443011,0.457566,0.000001,No
5024,pulse,20,12.1007999,20,7.824066011,7.823875996,400,94.67745723,11,15,26,18,18,36,4,0.419289,0.436492,0.000001,No
9225,keller,21,12.05200974,17,7.98658494,7.986424931,357,96.25439949,11,15,26,18,17,35,4,0.405524,0.423108,0.000001,No
10488,hilton,29,11.72923635,13,8.254848927,8.254728922,377,96.82307407,11,15,26,20,19,39,4,0.406723,0.424295,0.000001,No
4118,rye,25,11.87765635,14,8.180740955,8.180610949,350,97.16802977,11,15,26,19,24,43,4,0.399833,0.417315,0.000001,No
12312,farrell,21,12.05200974,13,8.254848927,8.254728922,273,99.48751966,11,15,26,14,17,31,4,0.400365,0.417854,0.000001,No
14439,corporal,11,12.6986369,9,8.622573707,8.622493705,99,109.4949327,6,7,13,9,8,17,5,0.363869,0.377152,0.000002,No
9715,intellect,11,12.6986369,8,8.740356743,8.740286741,88,110.9906167,6,7,13,11,9,20,4,0.434828,0.450378,0.000002,No
2237,susie,10,12.79394708,8,8.740356743,8.740286741,80,111.8236617,6,7,13,6,7,13,5,0.329742,0.334135,0.000002,No
968,vail,9,12.8993076,5,9.210360372,9.210320372,45,118.8072715,6,7,13,7,7,14,5,0.354439,0.365587,0.000002,No
7888,mclean,26,11.83843564,15,8.111748083,8.111608076,390,96.0304076,12,14,26,22,18,40,4,0.426164,0.44275,0.000001,No
8329,macbeth,26,11.83843564,14,8.180740955,8.180610949,364,96.84717527,12,14,26,21,22,43,4,0.449666,0.463176,0.000001,No
10195,hydra,24,11.91847835,13,8.254848927,8.254728922,312,98.38523819,12,14,26,18,20,38,4,0.440155,0.455129,0.000001,No
4341,ripley,21,12.05200974,12,8.334891634,8.334781631,252,100.4521952,12,14,26,17,17,34,4,0.41833,0.435647,0.000001,No
1992,tarzan,22,12.00548972,10,8.517213191,8.517123189,220,102.2533154,12,14,26,16,18,34,4,0.442503,0.457124,0.000001,No
13093,eastman,18,12.20616042,8,8.740356743,8.740286741,144,106.6861965,12,14,26,16,17,33,4,0.400917,0.418422,0.000001,No
11039,grub,18,12.20616042,3,9.721185996,9.721165996,54,118.6583557,12,14,26,14,16,30,4,0.42072,0.43782,0.000001,No
14759,composite,50,11.18450917,33,7.323290723,7.322970678,1650,81.90741226,13,13,26,40,29,69,4,0.433723,0.449538,0.000001,No
4618,regard,33,11.60002462,33,7.323290723,7.322970678,1089,84.95035265,13,13,26,22,31,53,4,0.423672,0.440571,0.000001,No
880,venomous,35,11.54118412,24,7.641744454,7.641514432,840,88.19477971,13,13,26,28,15,43,4,0.425225,0.441881,0.000001,No
17011,ballad,27,11.80069531,25,7.600922459,7.600682435,675,89.69617003,13,13,26,23,20,43,5,0.397283,0.414699,0.000001,No
9863,inferior,26,11.83843564,24,7.641744454,7.641514432,624,90.46629989,13,13,26,21,20,41,4,0.430923,0.447041,0.000001,No
15216,chopin,27,11.80069531,21,7.775275846,7.77507583,567,91.75366123,13,13,26,16,21,37,5,0.390355,0.407345,0.000001,No
17740,analogy,24,11.91847835,20,7.824066011,7.823875996,480,93.25096133,13,13,26,23,23,46,4,0.450224,0.463594,0.000001,No
10172,hygiene,24,11.91847835,18,7.929426526,7.929256515,432,94.50669836,13,13,26,23,16,39,4,0.424097,0.440867,0.000001,No
14396,cottage,24,11.91847835,18,7.929426526,7.929256515,432,94.50669836,13,13,26,22,21,43,4,0.41452,0.431933,0.000001,No
13445,ditch,24,11.91847835,13,8.254848927,8.254728922,312,98.38523819,13,13,26,23,22,45,4,0.399375,0.416812,0.000001,No
1548,tong,17,12.26331883,15,8.111748083,8.111608076,255,99.47695304,7,6,13,7,8,15,4,0.414966,0.432262,0.000002,No
14909,col,13,12.53158282,22,8.421903011,8.421803008,286,105.5397751,7,6,13,10,8,18,5,0.326227,0.330125,0.000002,No
15034,climatic,13,12.53158282,10,8.517213191,8.517123189,130,106.7341625,7,6,13,9,7,16,5,0.326257,0.330015,0.000002,No
10250,hum,11,12.6986369,9,8.622573707,8.622493705,99,109.4949327,7,6,13,8,8,16,4,0.418903,0.435886,0.000002,No
14390,couch,9,12.8993076,9,8.622573707,8.622493705,81,111.2252305,7,6,13,9,6,15,5,0.380964,0.397105,0.000002,No
619,walden,8,13.01709064,7,8.873888135,8.873828135,56,115.5122061,7,6,13,8,7,15,5,0.415413,0.433071,0.000002,No
9286,jute,8,13.01709064,7,8.873888135,8.873828135,56,115.5122061,7,6,13,8,7,15,5,0.385372,0.401735,0.000002,No
14574,contempt,9,12.8993076,2,10.1266511,10.1266411,18,130.6267875,7,6,13,7,8,15,4,0.409547,0.426948,0.000002,No
13863,decrease,35,11.54118412,33,7.323290723,7.322970678,1155,84.51944657,14,12,26,32,33,65,4,0.437324,0.452702,0.000001,No
11721,frisian,35,11.54118412,21,7.775275846,7.77507583,735,89.7358901,14,12,26,27,17,44,4,0.430818,0.446933,0.000001,No
15465,cement,25,11.87765635,23,7.684304068,7.684084048,575,91.27152303,14,12,26,20,20,40,4,0.432382,0.448322,0.000001,No
13291,downward,23,11.96103796,21,7.775275846,7.77507583,483,93.00036956,14,12,26,20,18,38,4,0.431835,0.447829,0.000001,No
12314,farmland,22,12.00548972,21,7.775275846,7.77507583,462,93.34599428,14,12,26,16,18,34,4,0.454431,0.466922,0.000001,No
1293,tripoli,24,11.91847835,16,8.047209562,8.047059554,384,95.91049292,14,12,26,23,18,41,4,0.444008,0.458345,0.000001,No
9231,keats,24,11.91847835,10,8.517213191,8.517123189,240,101.512221,14,12,26,24,15,39,4,0.425163,0.441797,0.000001,No
8527,locomotion,22,12.00548972,10,8.517213191,8.517123189,220,102.2533154,14,12,26,18,18,36,4,0.412593,0.430079,0.000001,No
9243,kathleen,27,11.80069531,25,7.600922459,7.600682435,675,89.69617003,15,11,26,20,12,32,5,0.370407,0.385013,0.000001,No
16791,beech,21,12.05200974,13,8.254848927,8.254728922,273,99.48751966,15,11,26,16,16,32,5,0.357609,0.369357,0.000001,No
5809,phylogenetic,15,12.38848198,14,8.180740955,8.180610949,210,101.3469619,8,5,13,10,8,18,5,0.323953,0.327301,0.000002,No
10573,hermit,17,12.26331883,10,8.517213191,8.517123189,170,104.4493009,8,5,13,17,14,31,5,0.386412,0.40289,0.000002,No
11583,gallus,12,12.61162553,10,8.517213191,8.517123189,120,107.4159033,8,5,13,9,8,17,4,0.431709,0.447562,0.000002,No
11619,gag,15,12.38848198,7,8.873888135,8.873828135,105,109.9340032,8,5,13,9,10,19,4,0.425622,0.442102,0.000002,No
4250,rookie,32,11.63079627,28,7.487593774,7.487323743,896,87.08667777,16,10,26,24,28,52,5,0.398523,0.415913,0.000001,No
12688,erotic,30,11.6953348,18,7.929426526,7.929256515,540,92.73729796,16,10,26,24,15,39,5,0.38845,0.405372,0.000001,No
16625,bethlehem,28,11.76432767,17,7.98658494,7.986424931,476,93.95680218,16,10,26,23,21,44,4,0.395152,0.412366,0.000001,No
18167,adjacent,34,11.57017165,32,7.354062381,7.35375234,1088,85.0877641,17,9,26,27,20,47,5,0.38569,0.402406,0.000001,No
4259,romulus,35,11.54118412,21,7.775275846,7.77507583,735,89.7358901,17,9,26,23,27,50,4,0.429432,0.445627,0.000001,No
17875,alma,17,12.26331883,13,8.254848927,8.254728922,221,101.2318443,9,4,13,13,9,22,5,0.331083,0.335926,0.000002,No
12938,elisabeth,29,11.72923635,27,7.523961418,7.52370139,783,88.25032174,18,8,26,24,16,40,5,0.38058,0.396659,0.000001,No
13002,ehrlich,4,13.71023782,3,9.721185996,9.721165996,12,133.2797719,2,3,5,3,3,6,4,0.385766,0.402649,0.000005,No
8294,madhya,13,12.53158282,12,8.334891634,8.334781631,156,104.4493848,4,1,5,8,13,21,5,0.317515,0.321093,0.000005,No
5617,pleistocene,38,11.45894602,31,7.38581108,7.385511041,1178,84.63361046,6,19,25,33,29,62,4,0.431425,0.44759,0.000001,No
8085,marino,40,11.40765272,28,7.487593774,7.487323743,1120,85.41586951,7,18,25,38,29,67,4,0.408906,0.426539,0.000001,No
15429,cervantes,22,12.00548972,16,8.047209562,8.047059554,352,96.6106917,8,17,25,20,19,39,4,0.445882,0.460021,0.000001,No
1112,ucla,21,12.05200974,12,8.334891634,8.334781631,252,100.4521952,8,17,25,17,19,36,4,0.427632,0.444294,0.000001,No
8752,lesbian,29,11.72923635,25,7.600922459,7.600682435,725,89.15301598,9,16,25,18,24,42,4,0.438177,0.453453,0.000001,No
10665,heel,24,11.91847835,20,7.824066011,7.823875996,480,93.25096133,9,16,25,18,20,38,4,0.439871,0.454918,0.000001,No
6411,overture,29,11.72923635,17,7.98658494,7.986424931,493,93.67654237,9,16,25,28,21,49,4,0.450247,0.463603,0.000001,No
15815,caldera,18,12.20616042,13,8.254848927,8.254728922,234,100.7600102,9,16,25,14,17,31,4,0.430338,0.446674,0.000001,No
3588,sermon,37,11.48561426,22,7.728755831,7.728545813,814,88.76950822,10,15,25,34,32,66,4,0.443941,0.458401,0.000001,No
6644,offshore,29,11.72923635,23,7.684304068,7.684084048,667,90.13101858,10,15,25,11,23,34,4,0.436894,0.452435,0.000001,No
8283,mafia,25,11.87765635,18,7.929426526,7.929256515,450,94.18300335,10,15,25,24,19,43,5,0.395989,0.41342,0.000001,No
13762,dempsey,19,12.1520932,10,8.517213191,8.517123189,190,103.5019685,10,15,25,16,16,32,4,0.407535,0.425098,0.000001,No
7177,myself,37,11.48561426,25,7.600922459,7.600682435,925,87.30126342,11,14,25,33,36,69,4,0.438545,0.453744,0.000001,Yes
9813,inherit,22,12.00548972,20,7.824066011,7.823875996,440,93.93174409,11,14,25,18,19,37,4,0.426707,0.443491,0.000001,No
10724,hazard,25,11.87765635,18,7.929426526,7.929256515,450,94.18300335,11,14,25,17,18,35,4,0.43214,0.448238,0.000001,No
636,wage,25,11.87765635,17,7.98658494,7.986424931,425,94.86191135,11,14,25,24,21,45,4,0.444508,0.458815,0.000001,No
100,yellowish,19,12.1520932,18,7.929426526,7.929256515,342,96.35913016,11,14,25,18,17,35,4,0.408088,0.425652,0.000001,No
13639,dewey,25,11.87765635,14,8.180740955,8.180610949,350,97.16802977,11,14,25,16,21,37,4,0.404563,0.422117,0.000001,No
13985,dare,17,12.26331883,15,8.111748083,8.111608076,255,99.47695304,11,14,25,17,17,34,4,0.433904,0.449693,0.000001,No
2747,spruce,21,12.05200974,8,8.740356743,8.740286741,168,105.3388646,11,14,25,13,15,28,5,0.368316,0.382702,0.000001,No
13530,diocese,35,11.54118412,33,7.323290723,7.322970678,1155,84.51944657,12,13,25,33,34,67,4,0.425123,0.441909,0.000001,No
1866,teresa,29,11.72923635,27,7.523961418,7.52370139,783,88.25032174,12,13,25,19,19,38,5,0.384529,0.401096,0.000001,No
3701,sect,25,11.87765635,22,7.728755831,7.728545813,550,91.79950579,12,13,25,17,23,40,4,0.418685,0.435938,0.000001,No
435,wetland,26,11.83843564,19,7.875359305,7.875179292,494,93.23193427,12,13,25,18,15,33,4,0.444497,0.458786,0.000001,No
5656,plaster,18,12.20616042,11,8.421903011,8.421803008,198,102.7990992,12,13,25,17,14,31,4,0.412248,0.429685,0.000001,No
15110,civic,32,11.63079627,26,7.561701746,7.56145172,832,87.9486125,13,12,25,27,16,43,5,0.353085,0.364018,0.000001,No
3767,scripture,21,12.05200974,20,7.824066011,7.823875996,420,94.29571976,13,12,25,16,19,35,4,0.449643,0.46304,0.000001,No
14514,convex,28,11.76432767,16,8.047209562,8.047059554,448,94.67001009,13,12,25,25,23,48,4,0.434392,0.450087,0.000001,No
6179,password,19,12.1520932,18,7.929426526,7.929256515,342,96.35913016,13,12,25,19,14,33,4,0.43402,0.449763,0.000001,No
6194,pasadena,25,11.87765635,14,8.180740955,8.180610949,350,97.16802977,13,12,25,23,24,47,4,0.402882,0.420404,0.000001,No
8579,lithium,24,11.91847835,14,8.180740955,8.180610949,336,97.50198393,13,12,25,16,18,34,5,0.387602,0.404496,0.000001,No
15705,canvas,19,12.1520932,16,8.047209562,8.047059554,304,97.79044058,13,12,25,18,13,31,4,0.448631,0.462181,0.000001,No
9563,irwin,22,12.00548972,12,8.334891634,8.334781631,264,100.0644559,13,12,25,15,16,31,4,0.393409,0.410583,0.000001,No
2585,stephenson,17,12.26331883,13,8.254848927,8.254728922,221,101.2318443,13,12,25,16,16,32,5,0.389669,0.406538,0.000001,No
10362,honeydew,19,12.1520932,5,9.210360372,9.210320372,95,111.9251576,13,12,25,16,16,32,4,0.429172,0.445454,0.000001,No
9064,kowloon,18,12.20616042,5,9.210360372,9.210320372,90,112.4231362,13,12,25,17,16,33,4,0.42756,0.44397,0.000001,No
14923,cognitive,32,11.63079627,22,7.728755831,7.728545813,704,89.89158452,14,11,25,26,19,45,5,0.338275,0.344896,0.000001,No
9241,katie,26,11.83843564,25,7.600922459,7.600682435,650,89.98303133,14,11,25,22,18,40,5,0.329754,0.334302,0.000001,No
9598,irene,31,11.66254497,18,7.929426526,7.929256515,558,92.47729347,14,11,25,20,19,39,4,0.440329,0.455204,0.000001,No
15498,cavendish,19,12.1520932,10,8.517213191,8.517123189,190,103.5019685,14,11,25,19,14,33,5,0.39959,0.417072,0.000001,No
7694,metric,45,11.28986969,34,7.29343776,7.293107712,1530,82.34196188,15,10,25,42,31,73,5,0.376767,0.392426,0.000001,No
8183,mammalian,20,12.1007999,20,7.824066011,7.823875996,400,94.67745723,15,10,25,18,12,30,5,0.329993,0.334717,0.000001,No
3182,slate,20,12.1007999,18,7.929426526,7.929256515,360,95.95240375,15,10,25,17,14,31,4,0.432614,0.448496,0.000001,No
10836,hanna,25,11.87765635,15,8.111748083,8.111608076,375,96.34855615,16,9,25,22,16,38,5,0.412574,0.429949,0.000001,No
9341,judas,26,11.83843564,17,7.98658494,7.986424931,442,94.54867179,18,7,25,20,17,37,5,0.377633,0.394165,0.000001,No
12295,fatty,31,11.66254497,21,7.775275846,7.77507583,651,90.67950424,19,6,25,25,13,38,5,0.385497,0.401876,0.000001,No
16070,bronx,45,11.28986969,34,7.29343776,7.293107712,1530,82.34196188,7,17,24,44,40,84,4,0.436582,0.452092,0.000001,No
340,wilderness,26,11.83843564,20,7.824066011,7.823875996,520,92.62470191,8,16,24,22,21,43,4,0.442668,0.457303,0.000001,No
12158,fijian,5,13.48709426,4,9.433503923,9.433473923,20,127.2305567,3,5,8,4,5,9,5,0.332335,0.337177,0.000003,No
6693,occurring,31,11.66254497,29,7.452502454,7.452222421,899,86.91514503,9,15,24,10,24,34,4,0.415481,0.432886,0.000001,No
7386,moor,25,11.87765635,23,7.684304068,7.684084048,575,91.27152303,9,15,24,13,19,32,4,0.453943,0.466584,0.000001,No
9877,infamous,23,11.96103796,23,7.684304068,7.684084048,529,91.91225267,9,15,24,22,17,39,5,0.362709,0.375807,0.000001,No
10824,haploid,24,11.91847835,17,7.98658494,7.986424931,408,95.18793968,9,15,24,22,17,39,5,0.371282,0.385954,0.000001,No
17567,apartheid,25,11.87765635,16,8.047209562,8.047059554,400,95.58198977,9,15,24,20,23,43,4,0.442845,0.457472,0.000001,No
13305,dove,21,12.05200974,13,8.254848927,8.254728922,273,99.48751966,9,15,24,14,17,31,4,0.423247,0.440177,0.000001,No
8075,marketplace,10,12.79394708,9,8.622573707,8.622493705,90,110.3167517,5,7,12,7,9,16,4,0.435255,0.450745,0.000002,No
15642,caretaker,11,12.6986369,8,8.740356743,8.740286741,88,110.9906167,5,7,12,7,7,14,4,0.409566,0.426976,0.000002,No
7349,mort,11,12.6986369,7,8.873888135,8.873828135,77,112.6862834,5,7,12,8,8,16,4,0.421349,0.438492,0.000002,No
14135,cupboard,9,12.8993076,7,8.873888135,8.873828135,63,114.4670127,5,7,12,7,8,15,5,0.373934,0.389102,0.000002,No
5012,punish,27,11.80069531,25,7.600922459,7.600682435,675,89.69617003,10,14,24,26,25,51,4,0.441512,0.456275,0.000001,No
9448,jennings,32,11.63079627,22,7.728755831,7.728545813,704,89.89158452,10,14,24,27,31,58,4,0.393933,0.411169,0.000001,No
9204,kepler,26,11.83843564,17,7.98658494,7.986424931,442,94.54867179,10,14,24,24,14,38,5,0.391077,0.408096,0.000001,No
17458,archimedes,22,12.00548972,14,8.180740955,8.180610949,308,98.21380147,10,14,24,15,16,31,4,0.425847,0.442492,0.000001,No
4416,rhinoceros,30,11.6953348,11,8.421903011,8.421803008,330,98.49697534,10,14,24,23,20,43,4,0.433152,0.449017,0.000001,No
1124,typhoon,31,11.66254497,20,7.824066011,7.823875996,620,91.24852172,11,13,24,26,15,41,4,0.423702,0.440586,0.000001,No
4848,quote,25,11.87765635,21,7.775275846,7.77507583,525,92.35205455,11,13,24,20,21,41,4,0.419516,0.43668,0.000001,No
1192,turing,39,11.43297053,15,8.111748083,8.111608076,585,92.74137679,11,13,24,35,36,71,4,0.384896,0.401761,0.000001,No
16853,bauer,28,11.76432767,18,7.929426526,7.929256515,504,93.28437187,11,13,24,16,20,36,4,0.418143,0.435421,0.000001,No
5948,perjury,17,12.26331883,5,9.210360372,9.210320372,85,112.9495858,11,13,24,15,16,31,4,0.42207,0.438971,0.000001,No
13981,darlene,2,14.403385,2,10.1266511,10.1266411,4,145.8580546,2,2,4,2,2,4,5,0.323805,0.327201,0.000006,No
16554,biotite,2,14.403385,2,10.1266511,10.1266411,4,145.8580546,2,2,4,2,2,4,5,0.384296,0.400482,0.000006,No
7965,maureen,6,13.30477271,6,9.028038815,9.027988815,36,120.1160044,3,3,6,3,3,6,5,0.313999,0.318267,0.000004,No
3861,scherzo,5,13.48709426,5,9.210360372,9.210320372,25,124.2209985,3,3,6,4,5,9,4,0.389781,0.406522,0.000004,No
7003,neurosis,3,13.99791989,3,9.721185996,9.721165996,9,136.0763828,3,3,6,3,3,6,5,0.369213,0.383341,0.000004,No
3693,sedge,4,13.71023782,2,10.1266511,10.1266411,8,138.8387949,3,3,6,4,3,7,5,0.3307,0.335898,0.000004,No
3046,sociable,6,13.30477271,6,9.028038815,9.027988815,36,120.1160044,4,4,8,6,4,10,5,0.316858,0.320818,0.000003,No
13970,dashboard,6,13.30477271,6,9.028038815,9.027988815,36,120.1160044,4,4,8,5,4,9,4,0.422935,0.439614,0.000003,No
15101,clam,14,12.45747485,10,8.517213191,8.517123189,140,106.1029691,6,6,12,13,10,23,4,0.394432,0.411545,0.000002,No
1487,toto,9,12.8993076,8,8.740356743,8.740286741,72,112.7445502,6,6,12,6,7,13,4,0.405505,0.423108,0.000002,No
16150,brennan,9,12.8993076,8,8.740356743,8.740286741,72,112.7445502,6,6,12,7,7,14,4,0.395963,0.41315,0.000002,No
5023,puma,10,12.79394708,6,9.028038815,9.027988815,60,115.5042509,6,6,12,9,7,16,4,0.433554,0.449228,0.000002,No
15232,chloroform,10,12.79394708,5,9.210360372,9.210320372,50,117.8368632,6,6,12,7,9,16,5,0.358244,0.370066,0.000002,No
16629,betelgeuse,8,13.01709064,5,9.210360372,9.210320372,40,119.8920957,6,6,12,6,8,14,4,0.408473,0.425896,0.000002,No
13965,datum,7,13.15062203,5,9.210360372,9.210320372,35,121.121968,6,6,12,7,6,13,4,0.408454,0.425985,0.000002,No
8856,layout,28,11.76432767,25,7.600922459,7.600682435,700,89.41974238,12,12,24,23,21,44,4,0.443664,0.458068,0.000001,No
15676,caracas,26,11.83843564,17,7.98658494,7.986424931,442,94.54867179,12,12,24,22,25,47,4,0.426297,0.442848,0.000001,No
11083,grill,25,11.87765635,12,8.334891634,8.334781631,300,98.99897857,12,12,24,22,18,40,4,0.434722,0.450369,0.000001,No
1971,taxation,16,12.32394346,15,8.111748083,8.111608076,240,99.9687247,12,12,24,16,16,32,4,0.446431,0.460387,0.000001,No
17218,auction,18,12.20616042,13,8.254848927,8.254728922,234,100.7600102,12,12,24,15,16,31,4,0.432034,0.44812,0.000001,No
16866,bathurst,19,12.1520932,12,8.334891634,8.334781631,228,101.2863799,12,12,24,15,18,33,4,0.434275,0.449979,0.000001,No
1526,topeka,22,12.00548972,10,8.517213191,8.517123189,220,102.2533154,12,12,24,22,21,43,4,0.398782,0.416207,0.000001,No
7944,mayer,21,12.05200974,9,8.622573707,8.622493705,189,103.9193423,12,12,24,20,16,36,4,0.445781,0.459829,0.000001,No
8960,landmark,38,11.45894602,34,7.29343776,7.293107712,1292,83.57510957,13,11,24,30,30,60,4,0.429515,0.44582,0.000001,No
9464,jealous,35,11.54118412,27,7.523961418,7.52370139,945,86.83542401,13,11,24,26,29,55,5,0.407713,0.425208,0.000001,No
13736,departure,27,11.80069531,25,7.600922459,7.600682435,675,89.69617003,13,11,24,22,24,46,4,0.422341,0.439356,0.000001,No
14,zoe,25,11.87765635,14,8.180740955,8.180610949,350,97.16802977,13,11,24,19,17,36,4,0.413314,0.430844,0.000001,No
12038,flax,22,12.00548972,14,8.180740955,8.180610949,308,98.21380147,13,11,24,20,14,34,4,0.422582,0.439595,0.000001,No
16608,bias,18,12.20616042,14,8.180740955,8.180610949,252,99.85543644,13,11,24,15,13,28,4,0.43062,0.446707,0.000001,No
16874,batavia,20,12.1007999,13,8.254848927,8.254728922,260,99.8902751,13,11,24,20,19,39,4,0.381537,0.397682,0.000001,No
7942,mayhem,26,11.87765635,8,8.873888135,8.873828135,208,105.4009938,13,11,24,19,22,41,4,0.417317,0.434586,0.000001,No
4978,pursuit,15,12.38848198,12,8.334891634,8.334781631,180,103.2566548,7,5,12,14,13,27,5,0.379368,0.395326,0.000002,No
10900,halfway,50,11.18450917,46,6.991156888,6.990706795,2300,78.19265833,14,10,24,33,49,82,5,0.366991,0.381043,0.000001,No
10672,hector,25,11.87765635,22,7.728755831,7.728545813,550,91.79950579,14,10,24,16,20,36,4,0.41157,0.428981,0.000001,No
1059,upgrade,22,12.00548972,17,7.98658494,7.986424931,374,95.88286343,14,10,24,20,21,41,4,0.410941,0.428412,0.000001,No
17359,artifact,23,11.96103796,9,8.622573707,8.622493705,207,103.1349314,14,10,24,18,15,33,4,0.412968,0.430492,0.000001,No
4332,ritter,8,13.01709064,8,8.740356743,8.740286741,64,113.7740159,5,3,8,5,6,11,5,0.384687,0.400942,0.000003,No
1159,twa,6,13.30477271,5,9.210360372,9.210320372,30,122.5417513,5,3,8,5,3,8,5,0.364632,0.378015,0.000003,No
2436,strut,5,13.48709426,3,9.721185996,9.721165996,15,131.1105519,5,3,8,5,3,8,5,0.398112,0.415899,0.000003,No
4405,rhubarb,5,13.48709426,3,9.721185996,9.721165996,15,131.1105519,5,3,8,5,4,9,4,0.405172,0.422741,0.000003,No
5984,percentage,62,10.96939779,55,6.812465099,6.811924964,3410,74.72863962,15,9,24,45,55,100,4,0.426933,0.443501,0.000001,No
16144,brett,44,11.31234254,37,7.208880372,7.208520314,1628,81.54932412,16,8,24,32,9,41,5,0.369928,0.384541,0.000001,No
14544,contrary,12,12.61162553,10,8.517213191,8.517123189,120,107.4159033,9,3,12,9,11,20,4,0.413564,0.430938,0.000002,No
8354,lyle,8,13.01709064,5,9.210360372,9.210320372,40,119.8920957,5,1,6,6,1,7,5,0.283368,0.289541,0.000004,No
13453,distinguish,60,11.00218762,60,6.725453722,6.72486356,3600,73.99470365,5,18,23,57,54,111,4,0.442867,0.4575,0.000001,No
12033,flee,34,11.57017165,32,7.354062381,7.35375234,1088,85.0877641,6,17,23,31,31,62,4,0.452924,0.465819,0.000001,No
12699,erie,34,11.57017165,22,7.728755831,7.728545813,748,89.42303163,6,17,23,32,32,64,4,0.403038,0.420657,0.000001,No
14109,curtain,27,11.80069531,23,7.684304068,7.684084048,621,90.68013099,8,15,23,27,23,50,4,0.442536,0.457171,0.000001,No
5199,projector,30,11.6953348,19,7.875359305,7.875179292,570,92.10496371,8,15,23,26,23,49,4,0.437734,0.453139,0.000001,No
13010,ego,27,11.80069531,13,8.254848927,8.254728922,351,97.41295703,8,15,23,26,26,52,4,0.434296,0.450045,0.000001,No
17391,arousal,23,11.96103796,14,8.180740955,8.180610949,322,97.85015311,8,15,23,23,18,41,4,0.443343,0.457847,0.000001,No
7990,maternal,38,11.45894602,30,7.418600903,7.418310866,1140,85.00934727,9,14,23,34,30,64,5,0.347514,0.356439,0.000001,No
5298,prestigious,26,11.83843564,26,7.561701746,7.56145172,676,89.51871945,9,14,23,25,14,39,4,0.389413,0.406287,0.000001,No
14908,cola,26,11.83843564,19,7.875359305,7.875179292,494,93.23193427,9,14,23,21,16,37,4,0.410751,0.42829,0.000001,No
8825,lecture,20,12.1007999,17,7.98658494,7.986424931,340,96.64406628,9,14,23,16,16,32,4,0.38723,0.404113,0.000001,No
12293,faulkner,18,12.20616042,13,8.254848927,8.254728922,234,100.7600102,9,14,23,16,16,32,4,0.428489,0.444994,0.000001,No
8611,lint,27,11.80069531,5,9.210360372,9.210320372,135,108.6886565,9,14,23,22,25,47,4,0.392956,0.410324,0.000001,No
4471,retain,27,11.80069531,24,7.641744454,7.641514432,648,90.17789795,10,13,23,23,25,48,4,0.430672,0.446989,0.000001,No
10599,herald,24,11.91847835,21,7.775275846,7.77507583,504,92.66945682,10,13,23,16,17,33,4,0.428406,0.444886,0.000001,No
317,wilma,24,11.91847835,11,8.421903011,8.421803008,264,100.3762687,10,13,23,22,21,43,4,0.43062,0.446848,0.000001,No
13173,dune,21,12.05200974,11,8.421903011,8.421803008,231,101.5008571,10,13,23,17,16,33,4,0.428551,0.444947,0.000001,No
17765,ampere,20,12.1007999,10,8.517213191,8.517123189,200,103.0650926,10,13,23,17,14,31,4,0.418893,0.436159,0.000001,No
4840,rabies,16,12.32394346,9,8.622573707,8.622493705,144,106.2641108,10,13,23,14,14,28,4,0.417592,0.434905,0.000001,No
4398,riboflavin,15,12.38848198,3,9.721185996,9.721165996,45,120.4307375,10,13,23,15,14,29,4,0.438773,0.453918,0.000001,No
18143,adoption,27,11.80069531,24,7.641744454,7.641514432,648,90.17789795,11,12,23,20,24,44,4,0.431572,0.447674,0.000001,No
16111,brilliant,25,11.87765635,24,7.641744454,7.641514432,600,90.76601456,11,12,23,24,14,38,5,0.369028,0.383529,0.000001,No
162,wrist,26,11.83843564,22,7.728755831,7.728545813,572,91.49637848,11,12,23,23,17,40,4,0.4408,0.455636,0.000001,No
3362,sicilian,23,11.96103796,19,7.875359305,7.875179292,437,94.19747161,11,12,23,22,15,37,4,0.410143,0.42776,0.000001,No
12014,flip,23,11.96103796,18,7.929426526,7.929256515,414,94.84417169,11,12,23,19,15,34,4,0.421119,0.438144,0.000001,No
14137,cunningham,20,12.1007999,17,7.98658494,7.986424931,340,96.64406628,11,12,23,13,17,30,4,0.393296,0.410442,0.000001,No
18367,aaa,16,12.32394346,14,8.180740955,8.180610949,224,100.8189889,11,12,23,12,14,26,5,0.379052,0.395104,0.000001,No
17695,angelo,21,12.05200974,11,8.421903011,8.421803008,231,101.5008571,11,12,23,14,15,29,5,0.375071,0.390468,0.000001,No
6512,orchard,17,12.26331883,12,8.334891634,8.334781631,204,102.2134336,11,12,23,15,15,30,4,0.397942,0.415455,0.000001,No
14383,counsel,18,12.20616042,10,8.517213191,8.517123189,180,103.9624705,11,12,23,17,13,30,4,0.454164,0.466711,0.000001,No
16553,bipedal,29,11.72923635,21,7.775275846,7.77507583,609,91.19804807,12,11,23,27,16,43,4,0.42684,0.443327,0.000001,No
6410,ovid,29,11.72923635,19,7.875359305,7.875179292,551,92.37195061,12,11,23,16,15,31,4,0.420949,0.437961,0.000001,No
8036,martinique,22,12.00548972,18,7.929426526,7.929256515,396,95.19664868,12,11,23,19,16,35,4,0.434956,0.450533,0.000001,No
8624,linen,20,12.1007999,14,8.180740955,8.180610949,280,98.99350936,12,11,23,12,16,28,4,0.445591,0.459655,0.000001,No
13956,davidson,16,12.32394346,13,8.254848927,8.254728922,208,101.7322914,12,11,23,14,14,28,4,0.435811,0.451317,0.000001,No
4715,razor,23,11.96103796,10,8.517213191,8.517123189,230,101.8747103,12,11,23,16,15,31,4,0.404904,0.42245,0.000001,No
16722,beluga,17,12.26331883,4,9.433503923,9.433473923,68,115.6860663,12,11,23,15,14,29,5,0.360888,0.373596,0.000001,No
738,virtuoso,24,11.91847835,17,7.98658494,7.986424931,408,95.18793968,13,10,23,21,19,40,4,0.401334,0.41877,0.000001,No
5128,prostate,25,11.87765635,15,8.111748083,8.111608076,375,96.34855615,13,10,23,24,23,47,4,0.406704,0.42445,0.000001,No
4155,runaway,20,12.1007999,16,8.047209562,8.047059554,320,97.37767269,13,10,23,17,14,31,4,0.416524,0.43376,0.000001,No
7458,molten,17,12.26331883,17,7.98658494,7.986424931,289,97.94203751,13,10,23,16,14,30,5,0.37016,0.384743,0.000001,No
16076,bromine,15,12.38848198,8,8.740356743,8.740286741,120,108.279752,13,10,23,13,12,25,4,0.437907,0.453101,0.000001,No
9984,inc,34,11.45894602,30,7.29343776,7.293107712,1020,83.57510957,14,9,23,16,22,38,4,0.439577,0.454533,0.000001,No
7578,miniature,24,11.91847835,21,7.775275846,7.77507583,504,92.66945682,14,9,23,18,14,32,5,0.384629,0.400989,0.000001,No
7486,modular,24,11.91847835,17,7.98658494,7.986424931,408,95.18793968,14,9,23,19,20,39,5,0.385414,0.401834,0.000001,No
9846,inflammation,24,11.91847835,22,7.728755831,7.728545813,528,92.11500902,15,8,23,18,19,37,4,0.416631,0.433835,0.000001,No
13384,dolly,26,11.83843564,18,7.929426526,7.929256515,468,93.87200559,15,8,23,20,9,29,4,0.400374,0.418066,0.000001,No
17838,alton,22,12.00548972,14,8.180740955,8.180610949,308,98.21380147,15,8,23,18,13,31,4,0.413429,0.430816,0.000001,No
8060,marquess,39,11.43297053,27,7.523961418,7.52370139,1053,86.02122917,16,7,23,27,38,65,4,0.428272,0.444562,0.000001,No
6256,paramilitary,29,11.72923635,22,7.728755831,7.728545813,638,90.65240381,16,7,23,23,10,33,4,0.390312,0.40717,0.000001,No
5783,pickup,36,11.51301324,18,7.929426526,7.929256515,648,91.29159257,16,7,23,28,22,50,4,0.406872,0.424441,0.000001,No
1590,tobago,35,11.54118412,23,7.684304068,7.684084048,805,88.68596805,1,21,22,33,25,58,4,0.441512,0.456397,0.000001,No
12036,fleck,12,12.61162553,11,8.421903011,8.421803008,132,106.213887,2,9,11,6,10,16,4,0.413208,0.430502,0.000002,No
12617,eucharist,13,12.53158282,8,8.740356743,8.740286741,104,109.5305044,3,8,11,11,13,24,4,0.417033,0.434309,0.000002,No
7605,millionaire,24,11.91847835,18,7.929426526,7.929256515,432,94.50669836,7,15,22,20,21,41,4,0.453387,0.466133,0.000001,No
1025,urethra,26,11.83843564,16,8.047209562,8.047059554,416,95.26637248,7,15,22,26,22,48,4,0.453503,0.466241,0.000001,No
12757,epilepsy,17,12.26331883,13,8.254848927,8.254728922,221,101.2318443,7,15,22,14,15,29,4,0.429349,0.44567,0.000001,No
16880,bassett,8,13.01709064,6,9.028038815,9.027988815,48,117.5187995,4,7,11,4,7,11,4,0.406797,0.424408,0.000002,No
9426,jewel,22,12.00548972,10,8.517213191,8.517123189,220,102.2533154,8,14,22,20,20,40,4,0.449199,0.462706,0.000001,No
210,wordsworth,18,12.20616042,10,8.517213191,8.517123189,180,103.9624705,8,14,22,17,16,33,4,0.390862,0.407869,0.000001,No
10906,haitian,42,11.35886256,35,7.264450223,7.264110172,1470,82.51589165,9,13,22,37,31,68,5,0.386185,0.402763,0.000001,No
10998,gujarat,30,11.6953348,26,7.561701746,7.56145172,780,88.43663355,9,13,22,27,24,51,4,0.448359,0.461993,0.000001,No
17669,ankle,23,11.96103796,20,7.824066011,7.823875996,460,93.58395057,9,13,22,19,15,34,4,0.421759,0.438703,0.000001,No
3558,severn,22,12.00548972,18,7.929426526,7.929256515,396,95.19664868,9,13,22,21,18,39,4,0.425459,0.442083,0.000001,No
7940,mayo,25,11.87765635,16,8.047209562,8.047059554,400,95.58198977,9,13,22,19,19,38,4,0.400609,0.418094,0.000001,No
2942,sorrow,16,12.32394346,16,8.047209562,8.047059554,256,99.17335561,9,13,22,14,14,28,4,0.435106,0.450768,0.000001,No
16423,bluff,20,12.1007999,13,8.254848927,8.254728922,260,99.8902751,9,13,22,15,18,33,5,0.370283,0.384832,0.000001,No
2227,sutherland,19,12.1520932,12,8.334891634,8.334781631,228,101.2863799,9,13,22,14,16,30,4,0.433427,0.449238,0.000001,No
15525,cathy,7,13.15062203,7,8.873888135,8.873828135,49,116.6971488,5,6,11,6,6,12,5,0.398926,0.416701,0.000002,No
16173,breakdown,24,11.91847835,23,7.684304068,7.684084048,552,91.58521165,10,12,22,19,21,40,4,0.409264,0.426765,0.000001,No
1022,uri,27,11.80069531,20,7.824066011,7.823875996,540,92.32941909,10,12,22,17,19,36,4,0.455341,0.467645,0.000001,No
17419,aristocratic,23,11.96103796,21,7.775275846,7.77507583,483,93.00036956,10,12,22,22,15,37,5,0.336454,0.342593,0.000001,No
18066,afterward,21,12.05200974,21,7.775275846,7.77507583,441,93.70770023,10,12,22,12,18,30,4,0.416104,0.433506,0.000001,No
12945,elgin,23,11.96103796,15,8.111748083,8.111608076,345,97.02492676,10,12,22,18,15,33,5,0.372435,0.387407,0.000001,No
7090,nc,16,12.32394346,13,8.254848927,8.254728922,208,101.7322914,10,12,22,13,12,25,4,0.403111,0.420882,0.000001,No
16758,beige,14,12.45747485,7,8.873888135,8.873828135,98,110.5462382,10,12,22,11,13,24,4,0.438892,0.453989,0.000001,No
8737,letterman,17,12.26331883,6,9.028038815,9.027988815,102,110.7137184,10,12,22,16,13,29,4,0.426881,0.443487,0.000001,No
13026,eerily,1,15.09653218,1,10.81979828,10.81979828,1,163.341433,1,1,2,1,1,2,5,0.398085,0.415828,0.000011,No
1783,theorist,31,11.66254497,31,7.38581108,7.385511041,961,86.13735388,11,11,22,27,25,52,4,0.411017,0.42845,0.000001,No
4632,reflect,29,11.72923635,28,7.487593774,7.487323743,812,87.82375705,11,11,22,22,28,50,4,0.42351,0.440571,0.000001,No
15333,chaucer,28,11.76432767,19,7.875359305,7.875179292,532,92.64830736,11,11,22,27,18,45,4,0.428168,0.444524,0.000001,No
5299,prestige,22,12.00548972,22,7.728755831,7.728545813,484,92.78749871,11,11,22,15,17,32,4,0.445714,0.459763,0.000001,No
17150,auxiliary,24,11.91847835,20,7.824066011,7.823875996,480,93.25096133,11,11,22,18,15,33,5,0.35027,0.360321,0.000001,No
12932,elk,22,12.00548972,17,7.98658494,7.986424931,374,95.88286343,11,11,22,14,20,34,4,0.429994,0.446167,0.000001,No
12026,fleshy,21,12.05200974,16,8.047209562,8.047059554,336,96.98504802,11,11,22,20,14,34,4,0.407788,0.425516,0.000001,No
16010,bud,19,12.1520932,15,8.111748083,8.111608076,285,98.57471871,11,11,22,13,13,26,4,0.426215,0.442872,0.000001,No
15681,captive,17,12.26331883,16,8.047209562,8.047059554,272,98.68549658,11,11,22,15,13,28,4,0.432319,0.448322,0.000001,No
1277,trolley,25,11.87765635,12,8.334891634,8.334781631,300,98.99897857,11,11,22,19,19,38,4,0.4291,0.445365,0.000001,No
5836,phloem,24,11.91847835,12,8.334891634,8.334781631,288,99.33922547,11,11,22,21,18,39,4,0.413603,0.430994,0.000001,No
7561,minsk,23,11.96103796,11,8.421903011,8.421803008,253,100.7347016,11,11,22,19,15,34,5,0.376575,0.392144,0.000001,No
18185,addison,19,12.1520932,11,8.421903011,8.421803008,209,102.3437503,11,11,22,14,14,28,5,0.367242,0.381147,0.000001,No
8134,mansfield,14,12.45747485,12,8.334891634,8.334781631,168,103.8317029,11,11,22,11,11,22,4,0.392808,0.409935,0.000001,No
6268,paradox,19,12.1520932,9,8.622573707,8.622493705,171,104.7823193,11,11,22,18,16,34,4,0.412593,0.429985,0.000001,No
15204,chow,15,12.38848198,8,8.740356743,8.740286741,120,108.279752,11,11,22,12,11,23,4,0.423894,0.440604,0.000001,No
16509,blackfoot,7,13.15062203,6,9.028038815,9.027988815,42,118.7243261,6,5,11,6,6,12,4,0.391483,0.408381,0.000002,No
5137,proselyte,9,12.8993076,2,10.1266511,10.1266411,18,130.6267875,6,5,11,7,6,13,4,0.390218,0.407357,0.000002,No
10800,harlem,35,11.54118412,27,7.523961418,7.52370139,945,86.83542401,12,10,22,31,27,58,4,0.403817,0.421281,0.000001,No
9608,iq,24,11.91847835,16,8.047209562,8.047059554,384,95.91049292,12,10,22,20,19,39,4,0.422985,0.439909,0.000001,No
13304,dow,27,11.80069531,13,8.254848927,8.254728922,351,97.41295703,12,10,22,22,22,44,5,0.373155,0.388177,0.000001,No
13548,dim,16,12.32394346,15,8.111748083,8.111608076,240,99.9687247,12,10,22,16,13,29,4,0.400311,0.417718,0.000001,No
14962,cobra,20,12.1007999,9,8.622573707,8.622493705,180,104.3400391,12,10,22,17,13,30,4,0.419269,0.436318,0.000001,No
10004,impulse,20,12.1007999,14,8.180740955,8.180610949,280,98.99350936,13,9,22,19,16,35,4,0.42201,0.439018,0.000001,No
16689,benton,21,12.05200974,12,8.334891634,8.334781631,252,100.4521952,13,9,22,19,19,38,5,0.366257,0.380011,0.000001,No
17109,axial,21,12.05200974,16,8.047209562,8.047059554,336,96.98504802,7,4,11,19,20,39,5,0.398103,0.415908,0.000002,No
13604,diatomic,10,12.79394708,8,8.740356743,8.740286741,80,111.8236617,7,4,11,10,7,17,5,0.329583,0.334219,0.000002,No
17394,aromatic,21,12.05200974,20,7.824066011,7.823875996,420,94.29571976,14,8,22,18,10,28,5,0.386673,0.403214,0.000001,No
17493,aqua,27,11.80069531,14,8.180740955,8.180610949,378,96.53843143,14,8,22,19,14,33,5,0.349746,0.359655,0.000001,No
1546,toni,20,12.1007999,16,8.047209562,8.047059554,320,97.37767269,15,7,22,15,8,23,5,0.328345,0.332145,0.000001,No
5075,psychiatric,31,11.66254497,23,7.684304068,7.684084048,713,89.61854178,16,6,22,24,11,35,5,0.327533,0.33118,0.000001,No
13562,digestive,41,11.38296011,35,7.264450223,7.264110172,1435,82.69094711,17,5,22,38,29,67,5,0.326281,0.33017,0.000001,No
8366,lutz,6,13.30477271,6,9.028038815,9.027988815,36,120.1160044,3,4,7,3,4,7,5,0.399312,0.417016,0.000003,No
533,waterman,5,13.48709426,4,9.433503923,9.433473923,20,127.2305567,3,4,7,5,4,9,4,0.41341,0.430783,0.000003,No
3248,sip,4,13.71023782,3,9.721185996,9.721165996,12,133.2797719,3,4,7,4,4,8,5,0.385146,0.401468,0.000003,No
15825,calamus,4,13.71023782,2,10.1266511,10.1266411,8,138.8387949,3,4,7,3,4,7,5,0.362999,0.375987,0.000003,No
849,vernal,9,12.8993076,9,8.622573707,8.622493705,81,111.2252305,4,3,7,9,8,17,5,0.309057,0.31401,0.000003,No
1616,tinsel,4,13.71023782,1,10.81979828,10.81979828,4,148.3420076,4,3,7,4,4,8,5,0.395204,0.412317,0.000003,No
6273,parabolic,5,13.48709426,4,9.433503923,9.433473923,20,127.2305567,5,2,7,5,2,7,5,0.384262,0.400449,0.000003,No
8442,louvre,28,11.76432767,17,7.98658494,7.986424931,476,93.95680218,4,17,21,27,27,54,4,0.44126,0.456195,0.000001,No
11274,godfather,39,11.43297053,26,7.561701746,7.56145172,1014,86.45271323,5,16,21,35,38,73,4,0.443919,0.458354,0.000001,No
8230,majesty,31,11.66254497,25,7.600922459,7.600682435,775,88.64610002,7,14,21,31,27,58,4,0.440122,0.455096,0.000001,No
12837,enclave,21,12.05200974,15,8.111748083,8.111608076,315,97.7628669,7,14,21,20,18,38,4,0.421159,0.438158,0.000001,No
18357,abbas,24,11.87765635,13,8.254848927,8.254728922,312,98.04825879,7,14,21,12,19,31,5,0.36028,0.37284,0.000001,No
13085,eaton,19,12.1520932,12,8.334891634,8.334781631,228,101.2863799,7,14,21,17,18,35,5,0.384371,0.400881,0.000001,No
5335,predict,41,11.38296011,39,7.156236638,7.155856573,1599,81.45915619,8,13,21,35,36,71,4,0.408764,0.426492,0.000001,No
4686,receptor,24,11.91847835,16,8.047209562,8.047059554,384,95.91049292,8,13,21,18,16,34,4,0.400555,0.418023,0.000001,No
7404,monterey,19,12.1520932,16,8.047209562,8.047059554,304,97.79044058,8,13,21,15,18,33,4,0.427642,0.444074,0.000001,No
761,vineyard,19,12.1520932,15,8.111748083,8.111608076,285,98.57471871,8,13,21,18,14,32,4,0.432888,0.448782,0.000001,No
13137,dwarves,21,12.05200974,14,8.180740955,8.180610949,294,98.59436966,8,13,21,17,17,34,4,0.400275,0.417779,0.000001,No
16190,braun,16,12.32394346,7,8.873888135,8.873828135,112,109.3612956,8,13,21,15,13,28,5,0.351951,0.362314,0.000001,No
9686,interpret,23,11.96103796,23,7.684304068,7.684084048,529,91.91225267,9,12,21,20,17,37,4,0.441446,0.456181,0.000001,No
7095,nazareth,19,12.1520932,18,7.929426526,7.929256515,342,96.35913016,9,12,21,17,16,33,4,0.449529,0.462936,0.000001,No
7347,mortar,24,11.91847835,15,8.111748083,8.111608076,360,96.67969388,9,12,21,14,20,34,4,0.432213,0.448172,0.000001,No
7335,mosquito,19,12.1520932,12,8.334891634,8.334781631,228,101.2863799,9,12,21,16,12,28,4,0.427622,0.444055,0.000001,No
18110,aeneas,21,12.05200974,11,8.421903011,8.421803008,231,101.5008571,9,12,21,16,14,30,4,0.393147,0.410287,0.000001,No
12136,finch,16,12.32394346,13,8.254848927,8.254728922,208,101.7322914,9,12,21,9,15,24,4,0.409472,0.426995,0.000001,No
3765,scroll,15,12.38848198,13,8.254848927,8.254728922,195,102.2650471,9,12,21,14,14,28,4,0.421859,0.438867,0.000001,No
16670,berlioz,19,12.1520932,11,8.421903011,8.421803008,209,102.3437503,9,12,21,16,17,33,4,0.425826,0.442398,0.000001,No
15964,bun,15,12.38848198,11,8.421903011,8.421803008,165,104.3345937,9,12,21,13,13,26,4,0.427004,0.443538,0.000001,No
3721,seawater,13,12.53158282,9,8.622573707,8.622493705,117,108.0544965,9,12,21,13,12,25,4,0.429432,0.445717,0.000001,No
12164,fig,25,11.87765635,14,8.180740955,8.180610949,350,97.16802977,10,11,21,20,17,37,4,0.392539,0.409906,0.000001,No
15123,citadel,19,12.1520932,15,8.111748083,8.111608076,285,98.57471871,10,11,21,16,15,31,4,0.436808,0.452186,0.000001,No
6752,nylon,20,12.1007999,14,8.180740955,8.180610949,280,98.99350936,10,11,21,12,13,25,4,0.433925,0.449641,0.000001,No
2168,swollen,18,12.20616042,15,8.111748083,8.111608076,270,99.01329838,10,11,21,12,13,25,5,0.395795,0.413087,0.000001,No
11565,gangster,15,12.38848198,14,8.180740955,8.180610949,210,101.3469619,10,11,21,11,12,23,4,0.409774,0.427352,0.000001,No
15669,carbohydrate,14,12.45747485,12,8.334891634,8.334781631,168,103.8317029,10,11,21,14,13,27,4,0.411226,0.428675,0.000001,No
16485,blasphemy,12,12.61162553,6,9.028038815,9.027988815,72,113.8582448,10,11,21,10,11,21,4,0.434999,0.450712,0.000001,No
10070,imagery,18,12.20616042,18,7.929426526,7.929256515,324,96.78785221,11,10,21,13,14,27,4,0.441754,0.45642,0.000001,No
12367,faint,17,12.26331883,16,8.047209562,8.047059554,272,98.68549658,11,10,21,15,10,25,5,0.365089,0.378748,0.000001,No
4322,riverside,18,12.20616042,15,8.111748083,8.111608076,270,99.01329838,11,10,21,15,13,28,4,0.39747,0.41477,0.000001,No
4052,saliva,20,12.1007999,13,8.254848927,8.254728922,260,99.8902751,11,10,21,16,14,30,4,0.443166,0.457589,0.000001,No
13028,eel,19,12.1520932,12,8.334891634,8.334781631,228,101.2863799,11,10,21,16,17,33,4,0.394642,0.411822,0.000001,No
7840,meg,17,12.26331883,12,8.334891634,8.334781631,204,102.2134336,11,10,21,13,15,28,5,0.359827,0.372325,0.000001,No
2489,strap,16,12.32394346,11,8.421903011,8.421803008,176,103.7910565,11,10,21,14,13,27,4,0.416075,0.433511,0.000001,No
8296,madeline,20,12.1007999,9,8.622573707,8.622493705,180,104.3400391,11,10,21,18,15,33,4,0.394519,0.411705,0.000001,No
7805,melville,16,12.32394346,10,8.517213191,8.517123189,160,104.9656538,11,10,21,14,16,30,5,0.387027,0.40366,0.000001,No
16055,browne,15,12.38848198,10,8.517213191,8.517123189,150,105.5153421,11,10,21,13,13,26,4,0.418804,0.436055,0.000001,No
15531,catfish,17,12.26331883,9,8.622573707,8.622493705,153,105.7413705,11,10,21,12,14,26,4,0.399716,0.417146,0.000001,No
1668,thymine,15,12.38848198,9,8.622573707,8.622493705,135,106.820599,11,10,21,12,15,27,4,0.41769,0.434863,0.000001,No
12157,filament,14,12.45747485,8,8.740356743,8.740286741,112,108.8827743,11,10,21,11,10,21,4,0.417376,0.434511,0.000001,No
3664,selenium,16,12.32394346,6,9.028038815,9.027988815,96,111.2610399,11,10,21,14,14,28,4,0.428179,0.444477,0.000001,No
4107,sack,21,12.05200974,19,7.875359305,7.875179292,399,94.91390705,12,9,21,16,18,34,4,0.428013,0.444463,0.000001,No
5824,phosphate,23,11.96103796,15,8.111748083,8.111608076,345,97.02492676,12,9,21,18,15,33,4,0.425939,0.442454,0.000001,No
7123,nat,23,11.96103796,15,8.111748083,8.111608076,345,97.02492676,12,9,21,18,16,34,4,0.428096,0.444416,0.000001,No
13145,dusty,19,12.1520932,16,8.047209562,8.047059554,304,97.79044058,12,9,21,15,18,33,5,0.327679,0.331491,0.000001,No
17352,aruba,22,12.00548972,12,8.334891634,8.334781631,264,100.0644559,12,9,21,13,13,26,4,0.426031,0.442529,0.000001,No
815,veto,16,12.32394346,11,8.421903011,8.421803008,176,103.7910565,12,9,21,15,13,28,4,0.421589,0.438586,0.000001,No
1581,tofu,17,12.26331883,5,9.210360372,9.210320372,85,112.9495858,12,9,21,15,12,27,4,0.430557,0.446646,0.000001,No
14098,customary,30,11.6953348,27,7.523961418,7.52370139,810,87.99524778,13,8,21,25,18,43,4,0.395963,0.413197,0.000001,No
1191,turk,24,11.91847835,19,7.875359305,7.875179292,456,93.86229935,13,8,21,20,11,31,4,0.429796,0.446045,0.000001,No
12418,extraterrestrial,21,12.05200974,18,7.929426526,7.929256515,378,95.56552572,13,8,21,18,15,33,5,0.403744,0.421546,0.000001,No
13974,dartmouth,20,12.1007999,12,8.334891634,8.334781631,240,100.8588559,13,8,21,17,18,35,4,0.420929,0.438111,0.000001,No
7653,midge,4,13.71023782,4,9.433503923,9.433473923,16,129.3355822,2,1,3,4,1,5,6,0.284745,0.291168,0.000007,No
8093,marigold,16,12.32394346,1,10.81979828,10.81979828,16,133.3425823,14,7,21,14,9,23,5,0.36922,0.383654,0.000001,No
173,wreak,1,15.09653218,1,10.81979828,10.81979828,1,163.341433,1,1,2,1,1,2,5,0.284134,0.290476,0.00001,No
14640,conner,4,13.71023782,4,9.433503923,9.433473923,16,129.3355822,2,2,4,3,4,7,5,0.364789,0.378275,0.000005,No
3980,sapiens,37,11.48561426,24,7.641744454,7.641514432,888,87.77012911,3,17,20,36,25,61,4,0.441172,0.456049,0.000001,No
1296,triplet,5,13.48709426,2,10.1266511,10.1266411,10,136.579098,1,4,5,3,4,7,4,0.404314,0.42192,0.000004,No
17137,avesta,10,12.79394708,7,8.873888135,8.873828135,70,113.5320552,3,7,10,5,7,12,4,0.43152,0.447613,0.000002,No
1327,tribune,19,12.1520932,16,8.047209562,8.047059554,304,97.79044058,6,14,20,15,17,32,4,0.424574,0.441445,0.000001,No
16678,bergman,19,12.1520932,12,8.334891634,8.334781631,228,101.2863799,7,13,20,7,17,24,5,0.405515,0.423067,0.000001,No
4076,saigon,15,12.38848198,10,8.517213191,8.517123189,150,105.5153421,7,13,20,11,14,25,4,0.442547,0.457209,0.000001,No
1924,telegram,16,12.32394346,7,8.873888135,8.873828135,112,109.3612956,7,13,20,14,14,28,5,0.378987,0.394998,0.000001,No
7894,mckenna,6,13.30477271,6,9.028038815,9.027988815,36,120.1160044,2,3,5,4,6,10,5,0.398603,0.416401,0.000004,No
10430,hodges,3,13.99791989,3,9.721185996,9.721165996,9,136.0763828,2,3,5,2,3,5,5,0.395583,0.412688,0.000004,No
2874,spearmint,3,13.99791989,2,10.1266511,10.1266411,6,141.7520509,2,3,5,3,3,6,5,0.355297,0.36704,0.000004,No
8401,lullaby,8,13.01709064,6,9.028038815,9.027988815,48,117.5187995,4,6,10,6,6,12,5,0.400808,0.418269,0.000002,No
12674,escarpment,6,13.30477271,5,9.210360372,9.210320372,30,122.5417513,4,6,10,6,6,12,4,0.413458,0.430905,0.000002,No
1674,thurman,7,13.15062203,3,9.721185996,9.721165996,21,127.8396427,4,6,10,4,6,10,4,0.390449,0.407573,0.000002,No
2635,stationary,20,12.1007999,18,7.929426526,7.929256515,360,95.95240375,8,12,20,15,16,31,5,0.36372,0.377321,0.000001,No
14584,consume,16,12.32394346,15,8.111748083,8.111608076,240,99.9687247,8,12,20,16,15,31,4,0.424087,0.440989,0.000001,No
2862,spector,18,12.20616042,12,8.334891634,8.334781631,216,101.7370244,8,12,20,18,12,30,4,0.415929,0.433159,0.000001,No
8636,lindbergh,19,12.1520932,9,8.622573707,8.622493705,171,104.7823193,8,12,20,13,15,28,5,0.394011,0.411303,0.000001,No
16955,barbecue,16,12.32394346,9,8.622573707,8.622493705,144,106.2641108,8,12,20,12,13,25,4,0.423996,0.440872,0.000001,No
10272,hubbard,15,12.38848198,8,8.740356743,8.740286741,120,108.279752,8,12,20,10,13,23,4,0.441842,0.456509,0.000001,No
17160,automaton,15,12.38848198,5,9.210360372,9.210320372,75,114.1023835,8,12,20,15,14,29,4,0.427642,0.444078,0.000001,No
11173,granddaughter,28,11.76432767,26,7.561701746,7.56145172,728,88.95833706,9,11,20,27,24,51,4,0.396378,0.41377,0.000001,No
11551,garibaldi,25,11.87765635,13,8.254848927,8.254728922,325,98.04825879,9,11,20,25,21,46,4,0.42989,0.446064,0.000001,No
17374,arson,18,12.20616042,16,8.047209562,8.047059554,288,98.22553084,9,11,20,15,14,29,4,0.436035,0.4515,0.000001,No
14677,confirmation,17,12.26331883,13,8.254848927,8.254728922,221,101.2318443,9,11,20,13,15,28,4,0.436175,0.451655,0.000001,No
7707,meteorite,15,12.38848198,13,8.254848927,8.254728922,195,102.2650471,9,11,20,12,11,23,4,0.429214,0.445491,0.000001,No
8196,malone,16,12.32394346,12,8.334891634,8.334781631,192,102.7187332,9,11,20,11,14,25,5,0.400266,0.417781,0.000001,No
3421,shoreline,13,12.53158282,11,8.421903011,8.421803008,143,105.5397751,9,11,20,13,12,25,4,0.44226,0.456857,0.000001,No
13521,diphtheria,16,12.32394346,9,8.622573707,8.622493705,144,106.2641108,9,11,20,13,14,27,5,0.390226,0.407124,0.000001,No
7263,mullen,15,12.38848198,8,8.740356743,8.740286741,120,108.279752,9,11,20,15,14,29,4,0.400971,0.41846,0.000001,No
15960,bundy,14,12.45747485,6,9.028038815,9.027988815,84,112.4665665,9,11,20,13,13,26,4,0.400077,0.417474,0.000001,No
8124,manure,13,12.53158282,6,9.028038815,9.027988815,78,113.1356161,9,11,20,11,12,23,4,0.409888,0.427384,0.000001,No
17617,anterior,12,12.61162553,8,8.740356743,8.740286741,96,110.2301062,5,5,10,12,8,20,5,0.331367,0.335964,0.000002,No
12995,eileen,10,12.79394708,9,8.622573707,8.622493705,90,110.3167517,5,5,10,8,7,15,4,0.398442,0.416141,0.000002,No
1750,thigh,9,12.8993076,9,8.622573707,8.622493705,81,111.2252305,5,5,10,8,7,15,5,0.412843,0.43017,0.000002,No
3180,slaughter,7,13.15062203,7,8.873888135,8.873828135,49,116.6971488,5,5,10,6,6,12,5,0.41222,0.429527,0.000002,No
4930,quadrupedal,8,13.01709064,6,9.028038815,9.027988815,48,117.5187995,5,5,10,5,6,11,4,0.424879,0.441421,0.000002,No
4466,retention,7,13.15062203,6,9.028038815,9.027988815,42,118.7243261,5,5,10,7,5,12,5,0.385154,0.401695,0.000002,No
8869,lawful,6,13.30477271,6,9.028038815,9.027988815,36,120.1160044,5,5,10,5,5,10,5,0.32932,0.333412,0.000002,No
4492,respond,32,11.63079627,28,7.487593774,7.487323743,896,87.08667777,10,10,20,27,29,56,4,0.426399,0.44298,0.000001,No
5760,pike,27,11.80069531,21,7.775275846,7.77507583,567,91.75366123,10,10,20,19,25,44,4,0.401334,0.418789,0.000001,No
18183,additive,17,12.26331883,15,8.111748083,8.111608076,255,99.47695304,10,10,20,17,14,31,5,0.390398,0.407519,0.000001,No
332,wilhelmina,16,12.32394346,13,8.254848927,8.254728922,208,101.7322914,10,10,20,15,12,27,4,0.426123,0.442754,0.000001,No
7975,matrices,17,12.26331883,12,8.334891634,8.334781631,204,102.2134336,10,10,20,13,14,27,4,0.437993,0.453322,0.000001,No
15854,cabot,15,12.38848198,12,8.334891634,8.334781631,180,103.2566548,10,10,20,15,11,26,4,0.396839,0.414122,0.000001,No
10850,handsome,13,12.53158282,13,8.254848927,8.254728922,169,103.446323,10,10,20,13,12,25,4,0.396617,0.41392,0.000001,No
16466,bliss,15,12.38848198,10,8.517213191,8.517123189,150,105.5153421,10,10,20,12,12,24,4,0.436765,0.452129,0.000001,No
5835,phobos,17,12.26331883,8,8.740356743,8.740286741,136,107.1857815,10,10,20,13,14,27,4,0.431069,0.44712,0.000001,No
14067,cypress,12,12.61162553,9,8.622573707,8.622493705,108,108.7446707,10,10,20,10,10,20,4,0.392192,0.409249,0.000001,No
11110,greenwood,11,12.6986369,9,8.622573707,8.622493705,99,109.4949327,10,10,20,10,11,21,4,0.412651,0.430107,0.000001,No
670,vomit,13,12.53158282,7,8.873888135,8.873828135,91,111.2038641,10,10,20,11,10,21,4,0.422703,0.43959,0.000001,No
9228,keenan,16,12.32394346,5,9.210360372,9.210320372,80,113.5079604,10,10,20,15,13,28,4,0.432382,0.448271,0.000001,No
7354,morrissey,14,12.45747485,5,9.210360372,9.210320372,70,114.7378327,10,10,20,12,11,23,4,0.433321,0.449111,0.000001,No
8101,margin,26,11.83843564,23,7.684304068,7.684084048,598,90.97013915,11,9,20,18,25,43,4,0.436003,0.451529,0.000001,No
5557,pol,22,12.00548972,15,8.111748083,8.111608076,330,97.38550826,11,9,20,17,20,37,4,0.395707,0.41293,0.000001,No
9529,ithaca,22,12.00548972,14,8.180740955,8.180610949,308,98.21380147,11,9,20,20,16,36,4,0.400935,0.418329,0.000001,No
17437,argon,17,12.26331883,13,8.254848927,8.254728922,221,101.2318443,11,9,20,15,14,29,4,0.392799,0.409864,0.000001,No
5590,plutarch,18,12.20616042,11,8.421903011,8.421803008,198,102.7990992,11,9,20,14,13,27,4,0.431268,0.447383,0.000001,No
10895,hallelujah,15,12.38848198,10,8.517213191,8.517123189,150,105.5153421,11,9,20,13,12,25,4,0.42821,0.44452,0.000001,No
3477,sheldon,14,12.45747485,10,8.517213191,8.517123189,140,106.1029691,11,9,20,12,10,22,4,0.392869,0.409968,0.000001,No
13598,dickey,3,13.99791989,3,9.721185996,9.721165996,9,136.0763828,3,2,5,3,2,5,5,0.3804,0.396415,0.000004,No
17450,arcturus,3,13.99791989,3,9.721185996,9.721165996,9,136.0763828,3,2,5,3,2,5,5,0.384254,0.400439,0.000004,No
7085,ne,13,12.53158282,12,8.334891634,8.334781631,156,104.4493848,6,4,10,6,5,11,4,0.400374,0.417991,0.000002,No
10096,ignition,9,12.8993076,7,8.873888135,8.873828135,63,114.4670127,6,4,10,8,6,14,5,0.362014,0.374889,0.000002,No
14579,contagious,7,13.15062203,6,9.028038815,9.027988815,42,118.7243261,6,4,10,6,4,10,5,0.371375,0.386097,0.000002,No
592,wand,6,13.30477271,5,9.210360372,9.210320372,30,122.5417513,6,4,10,6,6,12,4,0.437249,0.452439,0.000002,No
9264,kannada,27,11.80069531,14,8.180740955,8.180610949,378,96.53843143,12,8,20,20,21,41,4,0.401461,0.418873,0.000001,No
15849,cactus,16,12.32394346,9,8.622573707,8.622493705,144,106.2641108,12,8,20,14,9,23,4,0.422733,0.439637,0.000001,No
16510,blackburn,26,11.83843564,16,8.047209562,8.047059554,416,95.26637248,13,7,20,20,10,30,4,0.400266,0.417624,0.000001,No
6766,nursery,20,12.1007999,17,7.98658494,7.986424931,340,96.64406628,13,7,20,18,12,30,4,0.399689,0.41707,0.000001,No
10964,gustavus,10,12.79394708,9,8.622573707,8.622493705,90,110.3167517,7,3,10,10,10,20,5,0.346104,0.355126,0.000002,No
1888,tend,97,10.5218212,89,6.331161914,6.330281545,8633,66.61535365,18,2,20,51,96,147,5,0.361329,0.37417,0.000001,No
12277,fe,38,11.45894602,22,7.728755831,7.728545813,836,88.56339585,3,16,19,35,28,63,4,0.409878,0.427417,0.000001,No
8148,manifesto,19,12.1520932,18,7.929426526,7.929256515,342,96.35913016,3,16,19,5,19,24,4,0.443,0.45758,0.000001,No
3273,sinai,24,11.91847835,17,7.98658494,7.986424931,408,95.18793968,4,15,19,24,23,47,4,0.434233,0.450003,0.000001,No
7855,median,31,11.66254497,14,8.180740955,8.180610949,434,95.40825929,5,14,19,28,29,57,4,0.416163,0.433487,0.000001,No
13411,doctorate,40,11.40765272,36,7.236279346,7.235929291,1440,82.54896178,6,13,19,39,34,73,4,0.43533,0.450989,0.000001,No
2554,stimulant,21,12.05200974,16,8.047209562,8.047059554,336,96.98504802,6,13,19,20,19,39,4,0.416915,0.434206,0.000001,No
16854,baudelaire,23,11.96103796,13,8.254848927,8.254728922,299,98.73656138,6,13,19,23,17,40,4,0.432793,0.448688,0.000001,No
17627,antagonist,20,12.1007999,14,8.180740955,8.180610949,280,98.99350936,6,13,19,19,19,38,4,0.435918,0.451561,0.000001,No
11826,fourteenth,28,11.76432767,27,7.523961418,7.52370139,756,88.51434748,7,12,19,26,19,45,4,0.413709,0.431102,0.000001,No
13446,disturbance,21,12.05200974,19,7.875359305,7.875179292,399,94.91390705,7,12,19,14,20,34,5,0.395592,0.412936,0.000001,No
8776,lengthy,17,12.26331883,17,7.98658494,7.986424931,289,97.94203751,7,12,19,17,12,29,5,0.40532,0.422861,0.000001,No
5850,phi,21,12.05200974,14,8.180740955,8.180610949,294,98.59436966,7,12,19,10,17,27,4,0.433914,0.449651,0.000001,No
16024,buchanan,18,12.20616042,11,8.421903011,8.421803008,198,102.7990992,7,12,19,17,14,31,4,0.393933,0.411108,0.000001,No
1276,trombone,17,12.26331883,11,8.421903011,8.421803008,187,103.2804818,7,12,19,16,14,30,4,0.454991,0.467368,0.000001,No
4995,purcell,14,12.45747485,10,8.517213191,8.517123189,140,106.1029691,7,12,19,13,13,26,4,0.427786,0.444186,0.000001,No
3913,sax,15,12.38848198,5,9.210360372,9.210320372,75,114.1023835,7,12,19,9,12,21,5,0.398103,0.415528,0.000001,No
14524,convenient,18,12.20616042,17,7.98658494,7.986424931,306,97.48553698,8,11,19,18,14,32,4,0.397327,0.414681,0.000001,No
1388,transplant,19,12.1520932,14,8.180740955,8.180610949,266,99.41312651,8,11,19,17,17,34,5,0.414598,0.432067,0.000001,No
1401,translucent,16,12.32394346,14,8.180740955,8.180610949,224,100.8189889,8,11,19,14,12,26,4,0.422723,0.439543,0.000001,No
9198,kerosene,15,12.38848198,10,8.517213191,8.517123189,150,105.5153421,8,11,19,10,13,23,4,0.421409,0.438384,0.000001,No
8785,lemonade,14,12.45747485,8,8.740356743,8.740286741,112,108.8827743,8,11,19,10,13,23,4,0.411293,0.428736,0.000001,No
14637,connotation,11,12.6986369,9,8.622573707,8.622493705,99,109.4949327,8,11,19,8,11,19,4,0.439653,0.454632,0.000001,No
15963,bunch,27,11.80069531,25,7.600922459,7.600682435,675,89.69617003,9,10,19,26,26,52,5,0.388603,0.405544,0.000001,No
9638,inverse,30,11.6953348,19,7.875359305,7.875179292,570,92.10496371,9,10,19,26,19,45,5,0.418222,0.4354,0.000001,No
1173,tuscan,23,11.96103796,18,7.929426526,7.929256515,414,94.84417169,9,10,19,20,21,41,5,0.330953,0.335328,0.000001,No
18113,advocate,18,12.20616042,18,7.929426526,7.929256515,324,96.78785221,9,10,19,14,17,31,4,0.412574,0.430149,0.000001,No
11100,grenoble,19,12.1520932,15,8.111748083,8.111608076,285,98.57471871,9,10,19,15,16,31,4,0.405719,0.423173,0.000001,No
11457,gentleman,17,12.26331883,16,8.047209562,8.047059554,272,98.68549658,9,10,19,17,17,34,5,0.406788,0.424283,0.000001,No
7502,mobility,19,12.1520932,13,8.254848927,8.254728922,247,100.3136935,9,10,19,18,15,33,4,0.438502,0.453627,0.000001,No
12130,fingerprint,20,12.1007999,10,8.517213191,8.517123189,200,103.0650926,9,10,19,19,15,34,4,0.417141,0.434384,0.000001,No
2664,stanza,26,11.83843564,8,8.740356743,8.740286741,208,103.4721508,9,10,19,16,20,36,4,0.401416,0.418831,0.000001,No
4232,rosenberg,14,12.45747485,12,8.334891634,8.334781631,168,103.8317029,9,10,19,10,12,22,5,0.400745,0.418213,0.000001,No
12667,espionage,14,12.45747485,12,8.334891634,8.334781631,168,103.8317029,9,10,19,11,11,22,4,0.410998,0.42852,0.000001,No
15956,bunsen,19,12.1520932,9,8.622573707,8.622493705,171,104.7823193,9,10,19,16,10,26,4,0.425245,0.44183,0.000001,No
9975,incense,14,12.45747485,10,8.517213191,8.517123189,140,106.1029691,9,10,19,10,14,24,4,0.402645,0.420117,0.000001,No
1035,uracil,16,12.32394346,9,8.622573707,8.622493705,144,106.2641108,9,10,19,13,13,26,4,0.434839,0.450463,0.000001,No
4965,putty,19,12.1520932,7,8.873888135,8.873828135,133,107.8363156,9,10,19,15,13,28,4,0.41396,0.431389,0.000001,No
7345,mortgage,16,12.32394346,7,8.873888135,8.873828135,112,109.3612956,9,10,19,15,14,29,4,0.434031,0.449726,0.000001,No
11812,fragmentation,15,12.38848198,4,9.433503923,9.433473923,60,116.8667933,9,10,19,12,10,22,4,0.392721,0.410183,0.000001,No
13397,doge,23,11.96103796,16,8.047209562,8.047059554,368,96.25297905,10,9,19,13,19,32,4,0.415112,0.432516,0.000001,No
18347,abe,25,11.87765635,14,8.180740955,8.180610949,350,97.16802977,10,9,19,13,12,25,4,0.42435,0.441003,0.000001,No
11200,governance,19,12.1520932,14,8.180740955,8.180610949,266,99.41312651,10,9,19,17,16,33,4,0.420919,0.4379,0.000001,No
4345,rip,22,12.00548972,12,8.334891634,8.334781631,264,100.0644559,10,9,19,15,15,30,5,0.330885,0.335603,0.000001,No
14942,codex,18,12.20616042,13,8.254848927,8.254728922,234,100.7600102,10,9,19,13,11,24,4,0.422613,0.439534,0.000001,No
10447,hitchcock,17,12.26331883,12,8.334891634,8.334781631,204,102.2134336,10,9,19,17,10,27,4,0.43014,0.446257,0.000001,No
17225,attribute,16,12.32394346,12,8.334891634,8.334781631,192,102.7187332,10,9,19,13,15,28,4,0.425326,0.442046,0.000001,No
4791,rainwater,13,12.53158282,12,8.334891634,8.334781631,156,104.4493848,10,9,19,12,12,24,4,0.4313,0.447336,0.000001,No
14977,coarse,13,12.53158282,12,8.334891634,8.334781631,156,104.4493848,10,9,19,13,9,22,4,0.434201,0.449862,0.000001,No
12119,fir,17,12.26331883,9,8.622573707,8.622493705,153,105.7413705,10,9,19,15,13,28,4,0.405784,0.423403,0.000001,No
814,vex,14,12.45747485,5,9.210360372,9.210320372,70,114.7378327,10,9,19,12,11,23,4,0.392678,0.410033,0.000001,No
9602,iraqi,30,11.6953348,23,7.684304068,7.684084048,690,89.87050875,11,8,19,28,11,39,5,0.334275,0.339574,0.000001,No
331,wilkes,25,11.87765635,19,7.875359305,7.875179292,475,93.54081148,11,8,19,25,24,49,4,0.40014,0.417516,0.000001,No
18271,accession,22,12.00548972,19,7.875359305,7.875179292,418,94.54754521,11,8,19,19,22,41,4,0.434509,0.450228,0.000001,No
14773,complementary,23,11.96103796,15,8.111748083,8.111608076,345,97.02492676,11,8,19,19,14,33,5,0.372138,0.387052,0.000001,No
5190,promenade,22,12.00548972,13,8.254848927,8.254728922,286,99.10350396,11,8,19,19,15,34,4,0.42644,0.442891,0.000001,No
4216,rotten,24,11.91847835,20,7.824066011,7.823875996,480,93.25096133,12,7,19,18,21,39,4,0.411007,0.428596,0.000001,No
2595,stellar,22,12.00548972,18,7.929426526,7.929256515,396,95.19664868,12,7,19,15,10,25,5,0.324338,0.327949,0.000001,No
15344,chartreuse,18,12.20616042,8,8.740356743,8.740286741,144,106.6861965,12,7,19,13,17,30,5,0.4006,0.418387,0.000001,No
7103,nave,18,12.20616042,9,8.622573707,8.622493705,162,105.2485179,4,14,18,16,18,34,4,0.448563,0.462176,0.000001,No
16891,bash,22,12.00548972,11,8.421903011,8.421803008,242,101.1090701,5,13,18,6,15,21,4,0.439012,0.454101,0.000001,No
14951,cockroach,4,13.71023782,3,9.721185996,9.721165996,12,133.2797719,2,4,6,3,4,7,5,0.346997,0.356216,0.000003,No
8592,lisle,6,13.30477271,4,9.433503923,9.433473923,24,125.5106255,3,6,9,5,6,11,5,0.370407,0.384938,0.000002,No
2468,strengthen,24,11.91847835,23,7.684304068,7.684084048,552,91.58521165,6,12,18,22,22,44,4,0.45067,0.463861,0.000001,No
1002,usgs,23,11.96103796,16,8.047209562,8.047059554,368,96.25297905,6,12,18,12,13,25,5,0.374423,0.389708,0.000001,No
10878,hamburger,22,12.00548972,16,8.047209562,8.047059554,352,96.6106917,6,12,18,19,12,31,5,0.374573,0.38975,0.000001,No
12392,fable,21,12.05200974,10,8.517213191,8.517123189,210,102.6495363,6,12,18,18,18,36,4,0.442084,0.456768,0.000001,No
1205,tunis,16,12.32394346,11,8.421903011,8.421803008,176,103.7910565,6,12,18,12,14,26,4,0.414927,0.432389,0.000001,No
5513,polyhedron,15,12.38848198,9,8.622573707,8.622493705,135,106.820599,6,12,18,15,13,28,4,0.42965,0.445994,0.000001,No
4601,regulate,25,11.87765635,24,7.641744454,7.641514432,600,90.76601456,7,11,18,23,24,47,4,0.42429,0.440985,0.000001,No
8641,lin,22,12.00548972,16,8.047209562,8.047059554,352,96.6106917,7,11,18,9,14,23,5,0.398487,0.415875,0.000001,No
10535,hexadecimal,21,12.05200974,15,8.111748083,8.111608076,315,97.7628669,7,11,18,18,17,35,4,0.424706,0.441637,0.000001,No
13519,diploid,19,12.1520932,13,8.254848927,8.254728922,247,100.3136935,7,11,18,15,12,27,4,0.400338,0.417761,0.000001,No
11136,graveyard,17,12.26331883,13,8.254848927,8.254728922,221,101.2318443,7,11,18,15,17,32,4,0.442624,0.457181,0.000001,No
14686,confession,19,12.1520932,12,8.334891634,8.334781631,228,101.2863799,7,11,18,10,18,28,4,0.409566,0.42715,0.000001,No
13622,dial,15,12.38848198,13,8.254848927,8.254728922,195,102.2650471,7,11,18,10,15,25,4,0.439055,0.454214,0.000001,No
7591,min,16,12.32394346,12,8.334891634,8.334781631,192,102.7187332,7,11,18,10,11,21,4,0.382787,0.399062,0.000001,No
11837,foul,15,12.38848198,12,8.334891634,8.334781631,180,103.2566548,7,11,18,12,12,24,5,0.353697,0.364622,0.000001,No
3860,schiller,15,12.38848198,11,8.421903011,8.421803008,165,104.3345937,7,11,18,15,12,27,4,0.439937,0.454866,0.000001,No
6463,orthography,15,12.38848198,9,8.622573707,8.622493705,135,106.820599,7,11,18,8,14,22,4,0.440417,0.455298,0.000001,No
18146,adolphus,12,12.61162553,12,8.334891634,8.334781631,144,105.1165321,4,5,9,12,9,21,5,0.379092,0.394974,0.000002,No
11900,forbid,10,12.79394708,9,8.622573707,8.622493705,90,110.3167517,4,5,9,6,7,13,4,0.400104,0.417761,0.000002,No
2633,statistician,7,13.15062203,7,8.873888135,8.873828135,49,116.6971488,4,5,9,5,6,11,4,0.399303,0.416986,0.000002,No
14006,danbury,8,13.01709064,5,9.210360372,9.210320372,40,119.8920957,4,5,9,6,8,14,4,0.391301,0.408193,0.000002,No
3829,schultz,7,13.15062203,4,9.433503923,9.433473923,28,124.0564445,4,5,9,7,6,13,4,0.417533,0.434562,0.000002,No
10298,houghton,5,13.48709426,4,9.433503923,9.433473923,20,127.2305567,4,5,9,4,5,9,4,0.407357,0.424948,0.000002,No
7845,medlar,9,12.8993076,2,10.1266511,10.1266411,18,130.6267875,4,5,9,9,6,15,5,0.351442,0.361769,0.000002,No
5676,plainfield,6,13.30477271,2,10.1266511,10.1266411,12,134.7327912,4,5,9,5,5,10,4,0.406546,0.424145,0.000002,No
5209,programmed,22,12.00548972,21,7.775275846,7.77507583,462,93.34599428,8,10,18,17,18,35,5,0.392157,0.409261,0.000001,No
5307,prescription,21,12.05200974,15,8.111748083,8.111608076,315,97.7628669,8,10,18,16,12,28,5,0.380091,0.396169,0.000001,No
4296,robust,18,12.20616042,15,8.111748083,8.111608076,270,99.01329838,8,10,18,16,10,26,4,0.391837,0.408841,0.000001,No
9585,iroquois,15,12.38848198,15,8.111748083,8.111608076,225,100.4922449,8,10,18,14,13,27,4,0.437217,0.452519,0.000001,No
5602,pluck,19,12.1520932,12,8.334891634,8.334781631,228,101.2863799,8,10,18,13,17,30,4,0.424777,0.441726,0.000001,No
2722,squeeze,13,12.53158282,13,8.254848927,8.254728922,169,103.446323,8,10,18,13,13,26,4,0.430359,0.446482,0.000001,No
12171,fiesta,16,12.32394346,10,8.517213191,8.517123189,160,104.9656538,8,10,18,13,14,27,5,0.40005,0.41757,0.000001,No
8844,leak,12,12.61162553,10,8.517213191,8.517123189,120,107.4159033,8,10,18,9,12,21,4,0.422975,0.439891,0.000001,No
11746,fresno,16,12.32394346,8,8.740356743,8.740286741,128,107.7156623,8,10,18,12,15,27,4,0.414578,0.431985,0.000001,No
5347,precedent,16,12.32394346,6,9.028038815,9.027988815,96,111.2610399,8,10,18,13,12,25,4,0.41916,0.436318,0.000001,No
13553,dilemma,16,12.32394346,6,9.028038815,9.027988815,96,111.2610399,8,10,18,12,13,25,4,0.397488,0.414986,0.000001,No
2332,sully,6,13.30477271,4,9.433503923,9.433473923,24,125.5106255,3,3,6,3,3,6,5,0.3457,0.354652,0.000003,No
10725,hayward,3,13.99791989,3,9.721185996,9.721165996,9,136.0763828,3,3,6,3,3,6,4,0.424269,0.44083,0.000003,No
171,wreck,21,12.05200974,17,7.98658494,7.986424931,357,96.25439949,9,9,18,20,15,35,4,0.437098,0.452392,0.000001,No
5435,pose,19,12.1520932,16,8.047209562,8.047059554,304,97.79044058,9,9,18,17,13,30,4,0.441578,0.456237,0.000001,No
2777,spoon,18,12.20616042,12,8.334891634,8.334781631,216,101.7370244,9,9,18,16,12,28,4,0.393627,0.410742,0.000001,No
4400,rib,15,12.38848198,13,8.254848927,8.254728922,195,102.2650471,9,9,18,15,13,28,4,0.44614,0.460091,0.000001,No
4738,raspberry,21,12.05200974,10,8.517213191,8.517123189,210,102.6495363,9,9,18,20,13,33,5,0.368768,0.383177,0.000001,No
17514,appliance,15,12.38848198,11,8.421903011,8.421803008,165,104.3345937,9,9,18,12,10,22,4,0.421609,0.438731,0.000001,No
131,xylophone,15,12.38848198,10,8.517213191,8.517123189,150,105.5153421,9,9,18,15,10,25,4,0.43485,0.450444,0.000001,No
13433,divination,13,12.53158282,9,8.622573707,8.622493705,117,108.0544965,9,9,18,12,11,23,4,0.405682,0.423131,0.000001,No
7509,mnemonic,15,12.38848198,8,8.740356743,8.740286741,120,108.279752,9,9,18,15,10,25,5,0.37406,0.389292,0.000001,No
14954,cock,12,12.61162553,9,8.622573707,8.622493705,108,108.7446707,9,9,18,10,10,20,4,0.396537,0.413803,0.000001,No
11228,gopher,14,12.45747485,7,8.873888135,8.873828135,98,110.5462382,9,9,18,10,9,19,4,0.426953,0.443383,0.000001,No
15025,clio,14,12.45747485,7,8.873888135,8.873828135,98,110.5462382,9,9,18,13,13,26,4,0.410172,0.42768,0.000001,No
1020,urinary,11,12.6986369,11,8.421903011,8.421803008,121,106.9466884,5,4,9,10,9,19,5,0.325694,0.329405,0.000002,No
283,winthrop,9,12.8993076,9,8.622573707,8.622493705,81,111.2252305,5,4,9,9,6,15,4,0.399393,0.417033,0.000002,No
983,utter,6,13.30477271,6,9.028038815,9.027988815,36,120.1160044,5,4,9,6,4,10,5,0.384337,0.400571,0.000002,No
7043,nellie,6,13.30477271,6,9.028038815,9.027988815,36,120.1160044,5,4,9,5,4,9,5,0.304127,0.309822,0.000002,No
3937,saud,7,13.15062203,5,9.210360372,9.210320372,35,121.121968,5,4,9,7,5,12,4,0.422562,0.439266,0.000002,No
16243,bowman,6,13.30477271,5,9.210360372,9.210320372,30,122.5417513,5,4,9,5,4,9,5,0.362695,0.37563,0.000002,No
7247,muncie,7,13.15062203,2,10.1266511,10.1266411,14,133.1717611,5,4,9,5,6,11,4,0.399824,0.417117,0.000002,No
9418,jill,18,12.20616042,18,7.929426526,7.929256515,324,96.78785221,10,8,18,13,8,21,5,0.347296,0.356636,0.000001,No
10648,helene,17,12.26331883,13,8.254848927,8.254728922,221,101.2318443,10,8,18,14,10,24,5,0.352622,0.36323,0.000001,No
2575,steroid,20,12.1007999,11,8.421903011,8.421803008,220,101.9117632,10,8,18,18,10,28,5,0.375476,0.390825,0.000001,No
16320,boone,15,12.38848198,13,8.254848927,8.254728922,195,102.2650471,10,8,18,13,9,22,5,0.366279,0.379949,0.000001,No
17307,asset,16,12.32394346,12,8.334891634,8.334781631,192,102.7187332,10,8,18,15,14,29,5,0.403111,0.420668,0.000001,No
969,vague,14,12.45747485,13,8.254848927,8.254728922,182,102.8345729,10,8,18,14,9,23,4,0.425877,0.442388,0.000001,No
7809,melon,17,12.26331883,11,8.421903011,8.421803008,187,103.2804818,10,8,18,14,11,25,4,0.417838,0.434914,0.000001,No
602,walnut,16,12.32394346,11,8.421903011,8.421803008,176,103.7910565,10,8,18,13,15,28,5,0.386867,0.403411,0.000001,No
5384,poultry,14,12.45747485,10,8.517213191,8.517123189,140,106.1029691,10,8,18,11,11,22,4,0.42883,0.445069,0.000001,No
2190,sweeney,16,12.32394346,7,8.873888135,8.873828135,112,109.3612956,10,8,18,14,16,30,4,0.404378,0.421939,0.000001,No
6261,parallax,14,12.45747485,5,9.210360372,9.210320372,70,114.7378327,10,8,18,12,11,23,5,0.37417,0.389404,0.000001,No
17941,alfredo,21,12.05200974,21,7.775275846,7.77507583,441,93.70770023,11,7,18,17,7,24,5,0.36245,0.375581,0.000001,No
4039,saltwater,21,12.05200974,18,7.929426526,7.929256515,378,95.56552572,11,7,18,17,11,28,4,0.390922,0.407827,0.000001,No
8098,marguerite,17,12.26331883,16,8.047209562,8.047059554,272,98.68549658,11,7,18,13,13,26,5,0.380408,0.396425,0.000001,No
2587,stephanie,17,12.26331883,15,8.111748083,8.111608076,255,99.47695304,11,7,18,14,11,25,5,0.410703,0.428349,0.000001,No
7321,motive,14,12.45747485,14,8.180740955,8.180610949,196,101.9113747,11,7,18,14,13,27,4,0.4057,0.423239,0.000001,No
9676,intervention,14,12.45747485,13,8.254848927,8.254728922,182,102.8345729,11,7,18,11,13,24,4,0.382342,0.398522,0.000001,No
322,williamsburg,17,12.26331883,11,8.421903011,8.421803008,187,103.2804818,11,7,18,15,16,31,4,0.391448,0.408404,0.000001,No
11187,grady,14,12.45747485,11,8.421903011,8.421803008,154,104.9156449,11,7,18,13,10,23,4,0.423227,0.439938,0.000001,No
5462,porch,5,13.48709426,5,9.210360372,9.210320372,25,124.2209985,4,2,6,4,3,7,5,0.378623,0.394434,0.000003,No
7622,militant,23,11.96103796,21,7.775275846,7.77507583,483,93.00036956,12,6,18,19,11,30,5,0.330165,0.334617,0.000001,No
18101,aerospace,26,11.83843564,18,7.929426526,7.929256515,468,93.87200559,12,6,18,20,8,28,5,0.385054,0.401383,0.000001,No
10732,hawthorne,24,11.91847835,18,7.929426526,7.929256515,432,94.50669836,12,6,18,21,7,28,4,0.392678,0.409686,0.000001,No
7117,nathaniel,18,12.20616042,17,7.98658494,7.986424931,306,97.48553698,12,6,18,14,12,26,5,0.339401,0.346173,0.000001,No
4181,rubidium,17,12.26331883,3,9.721185996,9.721165996,51,119.2140033,12,6,18,14,9,23,5,0.358056,0.370004,0.000001,No
8058,marquis,30,11.6953348,28,7.487593774,7.487323743,840,87.569916,13,5,18,23,29,52,5,0.38311,0.399485,0.000001,No
17661,annette,11,12.6986369,8,8.740356743,8.740286741,88,110.9906167,7,2,9,8,3,11,5,0.384246,0.40043,0.000002,No
4737,raster,24,11.91847835,9,8.622573707,8.622493705,216,102.767958,14,4,18,18,12,30,4,0.419437,0.436548,0.000001,No
848,verne,16,12.32394346,10,8.517213191,8.517123189,160,104.9656538,5,12,17,12,13,25,4,0.412968,0.430431,0.000001,No
11371,ginsberg,16,12.32394346,8,8.740356743,8.740286741,128,107.7156623,5,12,17,13,14,27,4,0.424685,0.441374,0.000001,No
5875,peugeot,25,11.87765635,12,8.334891634,8.334781631,300,98.99897857,6,11,17,18,22,40,4,0.434371,0.450045,0.000001,No
14406,cosmopolitan,15,12.38848198,11,8.421903011,8.421803008,165,104.3345937,6,11,17,9,12,21,4,0.435789,0.451421,0.000001,No
4108,sachs,16,12.32394346,10,8.517213191,8.517123189,160,104.9656538,6,11,17,14,13,27,4,0.404932,0.422455,0.000001,No
12734,epstein,22,12.00548972,11,8.421903011,8.421803008,242,101.1090701,7,10,17,18,14,32,4,0.431111,0.447144,0.000001,No
3585,serum,17,12.26331883,13,8.254848927,8.254728922,221,101.2318443,7,10,17,15,15,30,4,0.445568,0.459622,0.000001,No
6090,peacock,15,12.38848198,13,8.254848927,8.254728922,195,102.2650471,7,10,17,11,12,23,4,0.43312,0.448923,0.000001,No
6744,oar,16,12.32394346,12,8.334891634,8.334781631,192,102.7187332,7,10,17,12,12,24,4,0.440439,0.45528,0.000001,No
12500,exhaustion,13,12.53158282,11,8.421903011,8.421803008,143,105.5397751,7,10,17,11,11,22,5,0.415851,0.433273,0.000001,No
6947,nietzsche,15,12.38848198,8,8.740356743,8.740286741,120,108.279752,7,10,17,13,11,24,5,0.35244,0.362974,0.000001,No
6196,partridge,17,12.26331883,7,8.873888135,8.873828135,119,108.8233195,7,10,17,15,13,28,4,0.429162,0.445383,0.000001,No
12709,eratosthenes,14,12.45747485,8,8.740356743,8.740286741,112,108.8827743,7,10,17,10,11,21,5,0.389276,0.406218,0.000001,No
2139,symptom,33,11.60002462,29,7.452502454,7.452222421,957,86.44921192,8,9,17,31,31,62,4,0.412881,0.430257,0.000001,No
7384,moorish,23,11.96103796,20,7.824066011,7.823875996,460,93.58395057,8,9,17,21,14,35,5,0.329662,0.333808,0.000001,No
6160,paternal,22,12.00548972,20,7.824066011,7.823875996,440,93.93174409,8,9,17,20,15,35,5,0.329601,0.334007,0.000001,No
12660,essence,20,12.1007999,19,7.875359305,7.875179292,380,95.29814712,8,9,17,18,18,36,4,0.42068,0.437802,0.000001,No
14950,cocktail,16,12.32394346,11,8.421903011,8.421803008,176,103.7910565,8,9,17,12,14,26,4,0.422663,0.439703,0.000001,No
2149,symbiosis,13,12.53158282,11,8.421903011,8.421803008,143,105.5397751,8,9,17,13,13,26,4,0.420152,0.437196,0.000001,No
4297,robotics,13,12.53158282,10,8.517213191,8.517123189,130,106.7341625,8,9,17,11,9,20,5,0.40367,0.421142,0.000001,No
11784,fraternity,11,12.6986369,10,8.517213191,8.517123189,110,108.1569978,8,9,17,9,10,19,5,0.375214,0.390543,0.000001,No
15317,cheer,13,12.53158282,8,8.740356743,8.740286741,104,109.5305044,8,9,17,12,12,24,4,0.427776,0.444121,0.000001,No
7398,montmartre,12,12.61162553,8,8.740356743,8.740286741,96,110.2301062,8,9,17,11,10,21,4,0.376128,0.391631,0.000001,No
6115,pause,11,12.6986369,8,8.740356743,8.740286741,88,110.9906167,8,9,17,10,10,20,4,0.441041,0.455787,0.000001,No
11577,galway,9,12.8993076,7,8.873888135,8.873828135,63,114.4670127,8,9,17,8,9,17,4,0.407311,0.424948,0.000001,No
11202,gout,12,12.61162553,4,9.433503923,9.433473923,48,118.9718189,8,9,17,9,9,18,4,0.409575,0.427084,0.000001,No
12198,feud,25,11.87765635,19,7.875359305,7.875179292,475,93.54081148,9,8,17,23,18,41,5,0.390965,0.407998,0.000001,No
12863,emit,19,12.1520932,19,7.875359305,7.875179292,361,95.70210024,9,8,17,14,11,25,5,0.414423,0.432193,0.000001,No
1842,tertiary,17,12.26331883,14,8.180740955,8.180610949,238,100.3230346,9,8,17,14,12,26,5,0.332796,0.338037,0.000001,No
15829,cal,11,12.6986369,10,8.517213191,8.517123189,110,108.1569978,9,8,17,10,8,18,5,0.384804,0.401153,0.000001,No
7420,monotreme,12,12.61162553,9,8.622573707,8.622493705,108,108.7446707,9,8,17,11,11,22,4,0.400032,0.417427,0.000001,No
17813,ambiguous,11,12.6986369,9,8.622573707,8.622493705,99,109.4949327,9,8,17,11,8,19,4,0.410646,0.428173,0.000001,No
15972,bullseye,14,12.45747485,3,9.721185996,9.721165996,42,121.10143,9,8,17,12,9,21,4,0.417956,0.435022,0.000001,No
16590,bigelow,9,12.8993076,3,9.721185996,9.721165996,27,125.3965684,9,8,17,9,9,18,5,0.353824,0.364817,0.000001,No
4624,refugee,21,12.05200974,16,8.047209562,8.047059554,336,96.98504802,10,7,17,18,14,32,4,0.386538,0.40324,0.000001,No
15915,burt,18,12.20616042,16,8.047209562,8.047059554,288,98.22553084,10,7,17,11,11,22,5,0.34956,0.359523,0.000001,No
9339,jude,13,12.53158282,9,8.622573707,8.622493705,117,108.0544965,10,7,17,11,8,19,4,0.429183,0.445365,0.000001,No
1670,thy,15,12.38848198,8,8.740356743,8.740286741,120,108.279752,10,7,17,13,9,22,5,0.338359,0.344823,0.000001,No
6663,oedipus,13,12.53158282,7,8.873888135,8.873828135,91,111.2038641,10,7,17,12,8,20,4,0.432003,0.447881,0.000001,No
4569,remembrance,18,12.20616042,11,8.421903011,8.421803008,198,102.7990992,11,6,17,13,17,30,4,0.427725,0.44405,0.000001,No
9362,josiah,18,12.20616042,10,8.517213191,8.517123189,180,103.9624705,11,6,17,13,10,23,5,0.339544,0.346436,0.000001,No
17133,aviv,23,11.96103796,12,8.334891634,8.334781631,276,99.69395524,1,15,16,23,22,45,4,0.413295,0.430793,0.000001,No
15021,clitoris,26,11.83843564,14,8.180740955,8.180610949,364,96.84717527,5,11,16,26,21,47,4,0.410922,0.428403,0.000001,No
2612,steamboat,17,12.26331883,12,8.334891634,8.334781631,204,102.2134336,5,11,16,14,15,29,4,0.425888,0.442595,0.000001,No
2131,syndicate,11,12.6986369,9,8.622573707,8.622493705,99,109.4949327,5,11,16,7,11,18,4,0.452151,0.465058,0.000001,No
12405,eyebrow,7,13.15062203,5,9.210360372,9.210320372,35,121.121968,3,5,8,4,6,10,4,0.391707,0.408644,0.000002,No
1716,thoughtful,5,13.48709426,5,9.210360372,9.210320372,25,124.2209985,3,5,8,4,5,9,5,0.384604,0.400885,0.000002,No
8360,luzon,5,13.48709426,5,9.210360372,9.210320372,25,124.2209985,3,5,8,3,5,8,5,0.360624,0.37333,0.000002,No
8698,libretto,26,11.83843564,20,7.824066011,7.823875996,520,92.62470191,6,10,16,23,22,45,4,0.425296,0.441938,0.000001,No
17459,archibald,15,12.38848198,14,8.180740955,8.180610949,210,101.3469619,6,10,16,6,12,18,5,0.379627,0.395688,0.000001,No
9501,jacobite,15,12.38848198,13,8.254848927,8.254728922,195,102.2650471,6,10,16,15,10,25,4,0.380629,0.397255,0.000001,No
15807,caliber,14,12.45747485,11,8.421903011,8.421803008,154,104.9156449,6,10,16,8,11,19,4,0.420202,0.43736,0.000001,No
4178,rudder,13,12.53158282,10,8.517213191,8.517123189,130,106.7341625,6,10,16,13,11,24,4,0.424219,0.441041,0.000001,No
8412,ludlow,13,12.53158282,9,8.622573707,8.622493705,117,108.0544965,6,10,16,9,13,22,4,0.4272,0.443614,0.000001,No
3806,scope,11,12.6986369,10,8.517213191,8.517123189,110,108.1569978,6,10,16,7,11,18,4,0.441216,0.455965,0.000001,No
14087,cuvier,15,12.38848198,6,9.028038815,9.027988815,90,111.8436961,6,10,16,6,13,19,4,0.381209,0.397292,0.000001,No
9537,isthmus,23,11.96103796,18,7.929426526,7.929256515,414,94.84417169,7,9,16,21,19,40,4,0.43235,0.448332,0.000001,No
7740,merry,21,12.05200974,19,7.875359305,7.875179292,399,94.91390705,7,9,16,13,13,26,5,0.339381,0.346225,0.000001,No
5086,proxy,24,11.91847835,12,8.334891634,8.334781631,288,99.33922547,7,9,16,20,9,29,4,0.411474,0.429027,0.000001,No
2086,tackle,17,12.26331883,13,8.254848927,8.254728922,221,101.2318443,7,9,16,16,12,28,4,0.432224,0.448252,0.000001,No
7070,necessity,14,12.45747485,14,8.180740955,8.180610949,196,101.9113747,7,9,16,13,12,25,4,0.433036,0.448942,0.000001,No
16925,baronet,15,12.38848198,12,8.334891634,8.334781631,180,103.2566548,7,9,16,11,9,20,5,0.378003,0.393689,0.000001,No
9060,kramer,14,12.45747485,10,8.517213191,8.517123189,140,106.1029691,7,9,16,10,10,20,4,0.419526,0.43652,0.000001,No
10715,headland,13,12.53158282,10,8.517213191,8.517123189,130,106.7341625,7,9,16,12,12,24,5,0.383134,0.399582,0.000001,No
6226,parkway,12,12.61162553,9,8.622573707,8.622493705,108,108.7446707,7,9,16,8,12,20,4,0.423227,0.439994,0.000001,No
2580,sterile,11,12.6986369,9,8.622573707,8.622493705,99,109.4949327,7,9,16,9,11,20,4,0.425163,0.441759,0.000001,No
15186,chrome,12,12.61162553,8,8.740356743,8.740286741,96,110.2301062,7,9,16,7,11,18,4,0.448303,0.461871,0.000001,No
9175,khartoum,11,12.6986369,8,8.740356743,8.740286741,88,110.9906167,7,9,16,10,11,21,4,0.414114,0.431591,0.000001,No
7025,nereid,12,12.61162553,7,8.873888135,8.873828135,84,111.9141541,7,9,16,11,11,22,4,0.410969,0.428516,0.000001,No
9472,jaundice,12,12.61162553,6,9.028038815,9.027988815,72,113.8582448,7,9,16,9,10,19,4,0.393479,0.410587,0.000001,No
9047,krypton,10,12.79394708,4,9.433503923,9.433473923,40,120.69175,7,9,16,9,10,19,4,0.427704,0.444074,0.000001,No
5784,pickle,3,13.99791989,3,9.721185996,9.721165996,9,136.0763828,1,1,2,1,1,2,7,0.207942,0.210135,0.000008,No
12625,ethyl,4,13.71023782,3,9.721185996,9.721165996,12,133.2797719,2,2,4,4,4,8,5,0.317691,0.321437,0.000004,No
685,volley,2,14.403385,2,10.1266511,10.1266411,4,145.8580546,2,2,4,2,2,4,5,0.378947,0.394753,0.000004,No
10521,hick,2,14.403385,1,10.81979828,10.81979828,2,155.8417203,2,2,4,2,2,4,4,0.389755,0.406475,0.000004,No
11343,glare,6,13.30477271,5,9.210360372,9.210320372,30,122.5417513,4,4,8,6,6,12,5,0.405459,0.422856,0.000002,No
6270,paradigm,5,13.48709426,4,9.433503923,9.433473923,20,127.2305567,4,4,8,4,4,8,4,0.41058,0.428074,0.000002,No
16960,barb,5,13.48709426,3,9.721185996,9.721165996,15,131.1105519,4,4,8,5,5,10,4,0.418814,0.435952,0.000002,No
11137,gravestone,4,13.71023782,3,9.721185996,9.721165996,12,133.2797719,4,4,8,4,4,8,5,0.365834,0.379662,0.000002,No
13830,defunct,22,12.00548972,19,7.875359305,7.875179292,418,94.54754521,8,8,16,18,11,29,5,0.397799,0.415101,0.000001,No
10801,harlan,21,12.05200974,17,7.98658494,7.986424931,357,96.25439949,8,8,16,16,21,37,5,0.351018,0.361359,0.000001,No
4354,rim,18,12.20616042,14,8.180740955,8.180610949,252,99.85543644,8,8,16,16,17,33,4,0.434042,0.449721,0.000001,No
1119,tyrannosaurus,20,12.1007999,13,8.254848927,8.254728922,260,99.8902751,8,8,16,15,18,33,4,0.398953,0.416291,0.000001,No
4571,rembrandt,20,12.1007999,13,8.254848927,8.254728922,260,99.8902751,8,8,16,12,12,24,4,0.432529,0.448369,0.000001,No
7519,mitochondria,13,12.53158282,12,8.334891634,8.334781631,156,104.4493848,8,8,16,12,11,23,4,0.430098,0.446214,0.000001,No
8753,leroy,13,12.53158282,10,8.517213191,8.517123189,130,106.7341625,8,8,16,9,11,20,5,0.336219,0.342122,0.000001,No
5792,piccadilly,12,12.61162553,10,8.517213191,8.517123189,120,107.4159033,8,8,16,12,12,24,4,0.429214,0.445407,0.000001,No
13276,dragonfly,12,12.61162553,10,8.517213191,8.517123189,120,107.4159033,8,8,16,10,9,19,4,0.412076,0.429581,0.000001,No
4858,quito,16,12.32394346,8,8.740356743,8.740286741,128,107.7156623,8,8,16,13,15,28,4,0.417936,0.435107,0.000001,No
5168,propane,13,12.53158282,9,8.622573707,8.622493705,117,108.0544965,8,8,16,8,12,20,4,0.403459,0.420943,0.000001,No
11047,grouse,12,12.61162553,9,8.622573707,8.622493705,108,108.7446707,8,8,16,10,9,19,4,0.388255,0.404926,0.000001,No
12163,figaro,14,12.45747485,8,8.740356743,8.740286741,112,108.8827743,8,8,16,11,12,23,5,0.393235,0.410392,0.000001,No
14949,coco,13,12.53158282,8,8.740356743,8.740286741,104,109.5305044,8,8,16,9,11,20,4,0.426317,0.442792,0.000001,No
15781,calypso,15,12.38848198,7,8.873888135,8.873828135,105,109.9340032,8,8,16,9,11,20,4,0.405904,0.423488,0.000001,No
5459,pore,12,12.61162553,8,8.740356743,8.740286741,96,110.2301062,8,8,16,10,8,18,5,0.3755,0.390867,0.000001,No
10833,hanoi,12,12.61162553,8,8.740356743,8.740286741,96,110.2301062,8,8,16,10,10,20,4,0.40949,0.427009,0.000001,No
15001,cloudy,11,12.6986369,8,8.740356743,8.740286741,88,110.9906167,8,8,16,8,9,17,4,0.387805,0.404428,0.000001,No
17801,americium,13,12.53158282,5,9.210360372,9.210320372,65,115.4203938,8,8,16,8,13,21,4,0.396529,0.413789,0.000001,No
7082,neapolitan,11,12.6986369,4,9.433503923,9.433473923,44,119.7926411,8,8,16,8,8,16,5,0.335678,0.341746,0.000001,No
18303,absorption,16,12.32394346,16,8.047209562,8.047059554,256,99.17335561,9,7,16,15,8,23,5,0.390578,0.407572,0.000001,No
16127,bridget,17,12.26331883,15,8.111748083,8.111608076,255,99.47695304,9,7,16,10,10,20,4,0.42348,0.440158,0.000001,No
6290,papa,15,12.38848198,14,8.180740955,8.180610949,210,101.3469619,9,7,16,10,7,17,4,0.391604,0.408569,0.000001,No
6818,noticeable,15,12.38848198,14,8.180740955,8.180610949,210,101.3469619,9,7,16,13,9,22,5,0.386783,0.403322,0.000001,No
17809,ambrose,12,12.61162553,10,8.517213191,8.517123189,120,107.4159033,9,7,16,11,10,21,5,0.381185,0.39734,0.000001,No
5355,pratt,10,12.79394708,10,8.517213191,8.517123189,100,108.9687749,9,7,16,10,9,19,5,0.3899,0.406716,0.000001,No
15539,catawba,14,12.45747485,7,8.873888135,8.873828135,98,110.5462382,9,7,16,10,14,24,5,0.334048,0.339582,0.000001,No
6254,paranoia,10,12.79394708,6,9.028038815,9.027988815,60,115.5042509,9,7,16,10,10,20,4,0.407966,0.425417,0.000001,No
11236,goodwill,7,13.15062203,7,8.873888135,8.873828135,49,116.6971488,5,3,8,5,3,8,5,0.318215,0.321758,0.000002,No
8333,macadamia,5,13.48709426,4,9.433503923,9.433473923,20,127.2305567,5,3,8,5,4,9,5,0.322558,0.325805,0.000002,No
12610,eukaryote,22,12.00548972,19,7.875359305,7.875179292,418,94.54754521,10,6,16,17,12,29,5,0.347317,0.356632,0.000001,No
12950,elena,21,12.05200974,17,7.98658494,7.986424931,357,96.25439949,10,6,16,11,7,18,4,0.389995,0.406813,0.000001,No
12944,eli,13,12.53158282,13,8.254848927,8.254728922,169,103.446323,10,6,16,10,7,17,4,0.423702,0.440365,0.000001,No
8846,leafy,12,12.61162553,11,8.421903011,8.421803008,132,106.213887,10,6,16,11,6,17,5,0.325832,0.329588,0.000001,No
10268,huck,11,12.6986369,4,9.433503923,9.433473923,44,119.7926411,10,6,16,10,8,18,5,0.365142,0.378614,0.000001,No
2163,sworn,25,11.87765635,24,7.641744454,7.641514432,600,90.76601456,11,5,16,24,22,46,4,0.409169,0.426572,0.000001,No
7124,nasty,13,12.53158282,13,8.254848927,8.254728922,169,103.446323,11,5,16,13,6,19,5,0.355796,0.367668,0.000001,No
7,zooplankton,4,13.71023782,4,9.433503923,9.433473923,16,129.3355822,2,3,5,2,4,6,5,0.385464,0.401782,0.000003,No
11390,gigantic,15,12.38848198,14,8.180740955,8.180610949,210,101.3469619,3,12,15,13,13,26,5,0.384971,0.401416,0.000001,No
14703,condiment,17,12.26331883,14,8.180740955,8.180610949,238,100.3230346,4,11,15,15,12,27,4,0.414211,0.431595,0.000001,No
6208,parthenon,16,12.32394346,12,8.334891634,8.334781631,192,102.7187332,4,11,15,16,14,30,4,0.407282,0.424788,0.000001,No
1438,trajectory,11,12.6986369,3,9.721185996,9.721165996,33,123.4458112,4,11,15,9,11,20,4,0.440745,0.455683,0.000001,No
3466,sheppard,89,10.60789581,82,6.413079037,6.412268725,7298,68.02927423,5,10,15,89,67,156,4,0.401979,0.419446,0.000001,No
12999,eighteenth,34,11.57017165,31,7.38581108,7.385511041,1054,85.45510199,5,10,15,32,28,60,4,0.39629,0.413587,0.000001,No
12941,eliminate,16,12.32394346,16,8.047209562,8.047059554,256,99.17335561,5,10,15,14,15,29,4,0.400005,0.417723,0.000001,No
16733,bellini,18,12.20616042,12,8.334891634,8.334781631,216,101.7370244,5,10,15,6,13,19,5,0.389054,0.405852,0.000001,No
6119,paulsen,15,12.38848198,10,8.517213191,8.517123189,150,105.5153421,5,10,15,12,14,26,4,0.437875,0.453195,0.000001,No
3392,shrew,16,12.32394346,7,8.873888135,8.873828135,112,109.3612956,5,10,15,16,12,28,4,0.40312,0.420634,0.000001,No
11892,fore,11,12.6986369,9,8.622573707,8.622493705,99,109.4949327,5,10,15,10,11,21,5,0.386673,0.403242,0.000001,No
5808,phylogeny,17,12.26331883,14,8.180740955,8.180610949,238,100.3230346,6,9,15,13,14,27,4,0.406974,0.424441,0.000001,No
6509,orchid,12,12.61162553,10,8.517213191,8.517123189,120,107.4159033,6,9,15,10,10,20,5,0.35154,0.361658,0.000001,No
7388,moonlight,12,12.61162553,9,8.622573707,8.622493705,108,108.7446707,6,9,15,10,10,20,4,0.417013,0.434159,0.000001,No
6755,nw,11,12.6986369,9,8.622573707,8.622493705,99,109.4949327,6,9,15,8,10,18,4,0.430317,0.446426,0.000001,No
12720,equity,11,12.6986369,9,8.622573707,8.622493705,99,109.4949327,6,9,15,9,9,18,4,0.392114,0.409118,0.000001,No
8315,mack,10,12.79394708,9,8.622573707,8.622493705,90,110.3167517,6,9,15,7,10,17,4,0.406099,0.423709,0.000001,No
9346,joystick,12,12.61162553,7,8.873888135,8.873828135,84,111.9141541,6,9,15,12,9,21,4,0.441238,0.455956,0.000001,No
1354,treatise,18,12.20616042,18,7.929426526,7.929256515,324,96.78785221,7,8,15,11,18,29,5,0.393767,0.410934,0.000001,No
15010,closet,12,12.61162553,12,8.334891634,8.334781631,144,105.1165321,7,8,15,10,8,18,4,0.409878,0.427384,0.000001,No
3554,seward,13,12.53158282,10,8.517213191,8.517123189,130,106.7341625,7,8,15,13,13,26,4,0.390819,0.407719,0.000001,No
13690,desmond,13,12.53158282,10,8.517213191,8.517123189,130,106.7341625,7,8,15,8,9,17,5,0.349773,0.359835,0.000001,No
8649,limerick,14,12.45747485,8,8.740356743,8.740286741,112,108.8827743,7,8,15,13,14,27,4,0.401961,0.419385,0.000001,No
16492,blanchard,11,12.6986369,9,8.622573707,8.622493705,99,109.4949327,7,8,15,7,9,16,4,0.394239,0.411404,0.000001,No
4477,resume,10,12.79394708,9,8.622573707,8.622493705,90,110.3167517,7,8,15,9,8,17,5,0.402462,0.419889,0.000001,No
693,volatile,11,12.6986369,8,8.740356743,8.740286741,88,110.9906167,7,8,15,8,9,17,5,0.398353,0.415678,0.000001,No
14059,cytosine,11,12.6986369,7,8.873888135,8.873828135,77,112.6862834,7,8,15,10,10,20,4,0.415316,0.432666,0.000001,No
14736,conakry,13,12.53158282,4,9.433503923,9.433473923,52,118.2167357,7,8,15,11,11,22,4,0.415627,0.432924,0.000001,No
6969,nh,9,12.8993076,5,9.210360372,9.210320372,45,118.8072715,7,8,15,8,9,17,4,0.40259,0.420263,0.000001,No
7959,mauve,12,12.61162553,4,9.433503923,9.433473923,48,118.9718189,7,8,15,10,11,21,5,0.346084,0.355084,0.000001,No
9705,intention,21,12.05200974,21,7.775275846,7.77507583,441,93.70770023,8,7,15,18,21,39,4,0.407806,0.425333,0.000001,No
11998,floral,15,12.38848198,13,8.254848927,8.254728922,195,102.2650471,8,7,15,13,11,24,5,0.325886,0.329498,0.000001,No
17670,ankara,14,12.45747485,12,8.334891634,8.334781631,168,103.8317029,8,7,15,11,8,19,4,0.396901,0.414399,0.000001,No
16116,briggs,13,12.53158282,10,8.517213191,8.517123189,130,106.7341625,8,7,15,11,9,20,4,0.422794,0.439539,0.000001,No
12626,ethology,12,12.61162553,8,8.740356743,8.740286741,96,110.2301062,8,7,15,8,8,16,4,0.378011,0.393771,0.000001,No
13449,distributor,10,12.79394708,9,8.622573707,8.622493705,90,110.3167517,8,7,15,9,10,19,4,0.445557,0.45957,0.000001,No
16136,bribery,13,12.53158282,7,8.873888135,8.873828135,91,111.2038641,8,7,15,9,9,18,4,0.426963,0.443332,0.000001,No
7352,morrow,16,12.32394346,6,9.028038815,9.027988815,96,111.2610399,8,7,15,8,9,17,4,0.424807,0.441388,0.000001,No
16120,brig,20,12.1007999,14,8.180740955,8.180610949,280,98.99350936,9,6,15,18,18,36,5,0.370152,0.384661,0.000001,No
3478,shelby,17,12.26331883,12,8.334891634,8.334781631,204,102.2134336,9,6,15,16,14,30,5,0.349939,0.359999,0.000001,No
7912,mcdonnell,14,12.45747485,11,8.421903011,8.421803008,154,104.9156449,9,6,15,12,13,25,5,0.373784,0.388808,0.000001,No
14349,courtroom,10,12.79394708,10,8.517213191,8.517123189,100,108.9687749,9,6,15,10,7,17,5,0.400998,0.418359,0.000001,No
6089,peafowl,16,12.32394346,4,9.433503923,9.433473923,64,116.2579689,9,6,15,13,10,23,4,0.415199,0.432586,0.000001,No
15430,cerulean,11,12.6986369,4,9.433503923,9.433473923,44,119.7926411,9,6,15,11,6,17,5,0.362702,0.375593,0.000001,No
2819,spinal,48,11.22533117,30,7.418600903,7.418310866,1440,83.27625192,10,5,15,43,45,88,5,0.320838,0.324244,0.000001,No
15192,christoph,18,12.20616042,17,7.98658494,7.986424931,306,97.48553698,10,5,15,15,7,22,5,0.321757,0.325918,0.000001,No
793,victorious,15,12.38848198,15,8.111748083,8.111608076,225,100.4922449,10,5,15,14,7,21,5,0.334798,0.340023,0.000001,No
9914,indira,15,12.38848198,10,8.517213191,8.517123189,150,105.5153421,10,5,15,12,14,26,5,0.324931,0.328194,0.000001,No
640,wadi,15,12.38848198,8,8.740356743,8.740286741,120,108.279752,10,5,15,14,6,20,5,0.353803,0.364791,0.000001,No
7754,meredith,10,12.79394708,8,8.740356743,8.740286741,80,111.8236617,10,5,15,10,5,15,5,0.361756,0.374684,0.000001,No
16551,bipolar,26,11.83843564,22,7.728755831,7.728545813,572,91.49637848,12,3,15,23,3,26,5,0.39863,0.416373,0.000001,No
10288,housewives,17,12.26331883,15,8.111748083,8.111608076,255,99.47695304,2,12,14,17,13,30,4,0.413083,0.430628,0.000001,No
12750,episcopalian,6,13.30477271,6,9.028038815,9.027988815,36,120.1160044,2,5,7,2,6,8,5,0.384854,0.401172,0.000002,No
11805,franca,5,13.48709426,5,9.210360372,9.210320372,25,124.2209985,2,5,7,4,5,9,4,0.446398,0.460237,0.000002,No
11296,glycol,7,13.15062203,3,9.721185996,9.721165996,21,127.8396427,2,5,7,7,7,14,4,0.398621,0.415897,0.000002,No
8891,lauderdale,20,12.1007999,15,8.111748083,8.111608076,300,98.15864042,5,9,14,19,15,34,4,0.392175,0.409193,0.000001,No
17926,alhambra,15,12.38848198,8,8.740356743,8.740286741,120,108.279752,5,9,14,15,12,27,4,0.415958,0.433276,0.000001,No
1669,thyme,13,12.53158282,7,8.873888135,8.873828135,91,111.2038641,5,9,14,10,10,20,4,0.403928,0.42138,0.000001,No
1532,toothbrush,10,12.79394708,5,9.210360372,9.210320372,50,117.8368632,5,9,14,10,9,19,5,0.397461,0.414936,0.000001,No
3012,solenoid,6,13.30477271,4,9.433503923,9.433473923,24,125.5106255,3,4,7,6,4,10,4,0.405283,0.422868,0.000002,No
5170,propagandist,4,13.71023782,4,9.433503923,9.433473923,16,129.3355822,3,4,7,3,4,7,5,0.411322,0.42864,0.000002,No
7907,mcgee,4,13.71023782,4,9.433503923,9.433473923,16,129.3355822,3,4,7,3,4,7,5,0.395821,0.41296,0.000002,No
9809,inhibition,4,13.71023782,4,9.433503923,9.433473923,16,129.3355822,3,4,7,3,4,7,5,0.393531,0.410678,0.000002,No
15580,casanova,6,13.30477271,3,9.721185996,9.721165996,18,129.3381701,3,4,7,4,5,9,5,0.410589,0.428208,0.000002,No
17642,anomaly,6,13.30477271,3,9.721185996,9.721165996,18,129.3381701,3,4,7,5,4,9,4,0.419338,0.436478,0.000002,No
665,vortices,4,13.71023782,2,10.1266511,10.1266411,8,138.8387949,3,4,7,3,4,7,4,0.421889,0.438792,0.000002,No
17558,aphid,4,13.71023782,2,10.1266511,10.1266411,8,138.8387949,3,4,7,4,4,8,5,0.357955,0.370201,0.000002,No
5635,playful,13,12.53158282,13,8.254848927,8.254728922,169,103.446323,6,8,14,7,11,18,4,0.39723,0.414512,0.000001,No
1833,testimony,12,12.61162553,11,8.421903011,8.421803008,132,106.213887,6,8,14,12,12,24,4,0.434626,0.450331,0.000001,No
15831,cajun,12,12.61162553,9,8.622573707,8.622493705,108,108.7446707,6,8,14,9,9,18,5,0.385657,0.402068,0.000001,No
5469,poppy,15,12.38848198,7,8.873888135,8.873828135,105,109.9340032,6,8,14,14,13,27,4,0.419209,0.436304,0.000001,No
12885,embroidery,12,12.61162553,8,8.740356743,8.740286741,96,110.2301062,6,8,14,9,9,18,4,0.431835,0.447768,0.000001,No
17777,amoeba,11,12.6986369,6,9.028038815,9.027988815,66,114.6437869,6,8,14,9,8,17,4,0.395187,0.412381,0.000001,No
14599,constitute,16,12.32394346,15,8.111748083,8.111608076,240,99.9687247,7,7,14,11,15,26,4,0.432255,0.448294,0.000001,No
16926,baroness,13,12.53158282,11,8.421903011,8.421803008,143,105.5397751,7,7,14,8,7,15,4,0.418636,0.435853,0.000001,No
14988,clutch,10,12.79394708,10,8.517213191,8.517123189,100,108.9687749,7,7,14,10,8,18,4,0.445512,0.459533,0.000001,No
4962,pygmalion,15,12.32394346,7,8.873888135,8.873828135,105,109.3612956,7,7,14,14,13,27,5,0.398031,0.415326,0.000001,No
5470,poplar,11,12.6986369,9,8.622573707,8.622493705,99,109.4949327,7,7,14,8,8,16,4,0.401916,0.419526,0.000001,No
1324,triceratops,11,12.6986369,8,8.740356743,8.740286741,88,110.9906167,7,7,14,8,8,16,5,0.343918,0.352041,0.000001,No
14124,curiosity,9,12.8993076,9,8.622573707,8.622493705,81,111.2252305,7,7,14,9,8,17,5,0.397871,0.415316,0.000001,No
17323,asphalt,9,12.8993076,9,8.622573707,8.622493705,81,111.2252305,7,7,14,9,8,17,4,0.440723,0.455467,0.000001,No
14363,coupe,10,12.79394708,8,8.740356743,8.740286741,80,111.8236617,7,7,14,9,10,19,5,0.389695,0.406528,0.000001,No
1721,thorpe,12,12.61162553,7,8.873888135,8.873828135,84,111.9141541,7,7,14,12,9,21,4,0.401952,0.419615,0.000001,No
9557,isfahan,12,12.61162553,7,8.873888135,8.873828135,84,111.9141541,7,7,14,11,8,19,4,0.374921,0.390138,0.000001,No
112,yates,10,12.79394708,7,8.873888135,8.873828135,70,113.5320552,7,7,14,10,7,17,5,0.390123,0.406979,0.000001,No
5236,proclaim,8,13.01709064,8,8.740356743,8.740286741,64,113.7740159,7,7,14,7,7,14,4,0.425082,0.441834,0.000001,No
15750,canaan,8,13.01709064,8,8.740356743,8.740286741,64,113.7740159,7,7,14,7,7,14,4,0.410865,0.428384,0.000001,No
16108,brindle,8,13.01709064,7,8.873888135,8.873828135,56,115.5122061,7,7,14,8,7,15,5,0.386656,0.403425,0.000001,No
1728,thorium,10,12.79394708,5,9.210360372,9.210320372,50,117.8368632,7,7,14,7,8,15,4,0.406788,0.424408,0.000001,No
17960,alder,10,12.79394708,5,9.210360372,9.210320372,50,117.8368632,7,7,14,8,7,15,5,0.386505,0.403237,0.000001,No
4809,radon,11,12.6986369,4,9.433503923,9.433473923,44,119.7926411,7,7,14,8,11,19,4,0.426399,0.442844,0.000001,No
15961,bundle,11,12.6986369,11,8.421903011,8.421803008,121,106.9466884,4,3,7,9,10,19,4,0.417946,0.435135,0.000002,No
13971,dash,9,12.8993076,6,9.028038815,9.027988815,54,116.4554497,4,3,7,8,4,12,5,0.336423,0.342497,0.000002,No
2808,spiro,7,13.15062203,4,9.433503923,9.433473923,28,124.0564445,4,3,7,4,4,8,5,0.331559,0.33611,0.000002,No
16000,buena,26,11.83843564,19,7.875359305,7.875179292,494,93.23193427,8,6,14,17,25,42,5,0.365367,0.379079,0.000001,No
2953,sophocles,14,12.45747485,10,8.517213191,8.517123189,140,106.1029691,8,6,14,11,10,21,4,0.424432,0.441022,0.000001,No
6366,padre,12,12.61162553,11,8.421903011,8.421803008,132,106.213887,8,6,14,9,6,15,5,0.386513,0.402998,0.000001,No
16851,bauxite,13,12.53158282,7,8.873888135,8.873828135,91,111.2038641,8,6,14,10,10,20,4,0.445736,0.459678,0.000001,No
5336,predicate,10,12.79394708,7,8.873888135,8.873828135,70,113.5320552,8,6,14,9,9,18,5,0.384271,0.400777,0.000001,No
13660,deuterium,10,12.79394708,6,9.028038815,9.027988815,60,115.5042509,8,6,14,8,9,17,4,0.392721,0.4097,0.000001,No
1905,tempera,10,12.79394708,5,9.210360372,9.210320372,50,117.8368632,8,6,14,9,6,15,5,0.372396,0.387248,0.000001,No
6490,origami,13,12.53158282,4,9.433503923,9.433473923,52,118.2167357,8,6,14,11,8,19,4,0.410504,0.428042,0.000001,No
50,yule,9,12.8993076,4,9.433503923,9.433473923,36,121.6856688,8,6,14,9,7,16,5,0.347827,0.357293,0.000001,No
11884,forge,14,12.45747485,12,8.334891634,8.334781631,168,103.8317029,9,5,14,13,8,21,4,0.390218,0.407038,0.000001,No
16220,bradshaw,14,12.45747485,12,8.334891634,8.334781631,168,103.8317029,9,5,14,14,8,22,4,0.401561,0.41892,0.000001,No
49,yves,15,12.38848198,11,8.421903011,8.421803008,165,104.3345937,9,5,14,10,7,17,5,0.323941,0.327944,0.000001,No
4334,ritchie,11,12.6986369,11,8.421903011,8.421803008,121,106.9466884,9,5,14,10,5,15,5,0.385942,0.40235,0.000001,No
4032,salvatore,12,12.61162553,10,8.517213191,8.517123189,120,107.4159033,9,5,14,9,6,15,4,0.425826,0.442285,0.000001,No
5574,pod,10,12.79394708,10,8.517213191,8.517123189,100,108.9687749,9,5,14,10,7,17,5,0.394598,0.411779,0.000001,No
4963,pvc,15,12.38848198,7,8.873888135,8.873828135,105,109.9340032,9,5,14,11,9,20,5,0.386799,0.403528,0.000001,No
17980,alberich,11,12.6986369,5,9.210360372,9.210320372,55,116.9590221,9,5,14,9,5,14,5,0.392435,0.409561,0.000001,No
6239,parental,16,12.32394346,14,8.180740955,8.180610949,224,100.8189889,10,4,14,12,10,22,5,0.324278,0.327839,0.000001,No
6436,otis,14,12.45747485,13,8.254848927,8.254728922,182,102.8345729,10,4,14,11,5,16,5,0.323723,0.32756,0.000001,No
3462,sherlock,18,12.20616042,10,8.517213191,8.517123189,180,103.9624705,12,2,14,15,18,33,5,0.312424,0.316963,0.000001,No
6190,paso,24,11.91847835,16,8.047209562,8.047059554,384,95.91049292,1,12,13,23,23,46,4,0.429588,0.445825,0.000001,No
11833,foundry,14,12.45747485,13,8.254848927,8.254728922,182,102.8345729,4,9,13,12,11,23,4,0.414753,0.432055,0.000001,No
1165,tutorial,14,12.45747485,14,8.180740955,8.180610949,196,101.9113747,5,8,13,5,10,15,4,0.412833,0.430201,0.000001,No
11594,gallagher,16,12.32394346,12,8.334891634,8.334781631,192,102.7187332,5,8,13,9,11,20,4,0.41837,0.435558,0.000001,No
6219,parr,10,12.79394708,10,8.517213191,8.517123189,100,108.9687749,5,8,13,10,8,18,5,0.360119,0.372419,0.000001,No
11689,fuchs,13,12.53158282,8,8.740356743,8.740286741,104,109.5305044,5,8,13,8,8,16,4,0.379944,0.395856,0.000001,No
14776,complaint,9,12.8993076,7,8.873888135,8.873828135,63,114.4670127,5,8,13,9,9,18,4,0.432392,0.448242,0.000001,No
15337,chateau,9,12.8993076,7,8.873888135,8.873828135,63,114.4670127,5,8,13,7,8,15,4,0.433692,0.44958,0.000001,No
16877,bastard,9,12.8993076,7,8.873888135,8.873828135,63,114.4670127,5,8,13,7,9,16,4,0.398971,0.41639,0.000001,No
3483,sheer,8,13.01709064,6,9.028038815,9.027988815,48,117.5187995,5,8,13,5,8,13,5,0.384604,0.400914,0.000001,No
11807,fran,17,12.26331883,12,8.334891634,8.334781631,204,102.2134336,6,7,13,8,10,18,4,0.390398,0.407273,0.000001,No
3211,skinny,15,12.38848198,13,8.254848927,8.254728922,195,102.2650471,6,7,13,11,7,18,4,0.419566,0.436689,0.000001,No
11060,groom,12,12.61162553,11,8.421903011,8.421803008,132,106.213887,6,7,13,12,8,20,4,0.405181,0.422807,0.000001,No
11473,generous,11,12.6986369,11,8.421903011,8.421803008,121,106.9466884,6,7,13,9,7,16,5,0.361108,0.373962,0.000001,No
9120,kitten,12,12.61162553,9,8.622573707,8.622493705,108,108.7446707,6,7,13,12,7,19,5,0.364602,0.378224,0.000001,No
11641,fuse,11,12.6986369,9,8.622573707,8.622493705,99,109.4949327,6,7,13,10,11,21,4,0.417631,0.434792,0.000001,No
10970,gus,10,12.79394708,9,8.622573707,8.622493705,90,110.3167517,6,7,13,8,7,15,4,0.422925,0.439656,0.000001,No
12929,ella,11,12.6986369,8,8.740356743,8.740286741,88,110.9906167,6,7,13,8,8,16,5,0.404849,0.422532,0.000001,No
2597,steiner,9,12.8993076,9,8.622573707,8.622493705,81,111.2252305,6,7,13,8,7,15,5,0.410931,0.428551,0.000001,No
8349,lynch,12,12.61162553,7,8.873888135,8.873828135,84,111.9141541,6,7,13,10,10,20,4,0.407376,0.424924,0.000001,No
5410,postman,10,12.79394708,7,8.873888135,8.873828135,70,113.5320552,6,7,13,9,10,19,4,0.400745,0.418117,0.000001,No
16514,blackberry,10,12.79394708,7,8.873888135,8.873828135,70,113.5320552,6,7,13,8,7,15,4,0.39063,0.407503,0.000001,No
8887,laughter,8,13.01709064,8,8.740356743,8.740286741,64,113.7740159,6,7,13,6,8,14,4,0.430839,0.446853,0.000001,No
14711,concubine,8,13.01709064,7,8.873888135,8.873828135,56,115.5122061,6,7,13,8,7,15,4,0.43565,0.451106,0.000001,No
9407,joanna,14,12.45747485,14,8.180740955,8.180610949,196,101.9113747,7,6,13,8,12,20,4,0.418606,0.435806,0.000001,No
14154,culinary,13,12.53158282,12,8.334891634,8.334781631,156,104.4493848,7,6,13,8,8,16,5,0.324688,0.328904,0.000001,No
6715,obsession,12,12.61162553,12,8.334891634,8.334781631,144,105.1165321,7,6,13,9,11,20,4,0.416416,0.433652,0.000001,No
15588,cartographer,12,12.61162553,12,8.334891634,8.334781631,144,105.1165321,7,6,13,10,8,18,4,0.424421,0.441017,0.000001,No
6972,newtonian,11,12.6986369,11,8.421903011,8.421803008,121,106.9466884,7,6,13,9,7,16,5,0.324397,0.327916,0.000001,No
4314,roadside,11,12.6986369,10,8.517213191,8.517123189,110,108.1569978,7,6,13,9,8,17,5,0.325796,0.329654,0.000001,No
9800,inject,11,12.6986369,10,8.517213191,8.517123189,110,108.1569978,7,6,13,9,10,19,5,0.414549,0.432311,0.000001,No
7286,mu,14,12.45747485,8,8.740356743,8.740286741,112,108.8827743,7,6,13,8,8,16,4,0.42682,0.443186,0.000001,No
9756,insoluble,11,12.6986369,9,8.622573707,8.622493705,99,109.4949327,7,6,13,10,10,20,5,0.381152,0.397362,0.000001,No
9011,lactose,13,12.53158282,8,8.740356743,8.740286741,104,109.5305044,7,6,13,9,8,17,4,0.409982,0.427356,0.000001,No
855,vermilion,9,12.8993076,7,8.873888135,8.873828135,63,114.4670127,7,6,13,9,9,18,4,0.404969,0.422643,0.000001,No
16412,blythe,9,12.8993076,7,8.873888135,8.873828135,63,114.4670127,7,6,13,9,7,16,5,0.354177,0.364977,0.000001,No
1637,tile,8,13.01709064,7,8.873888135,8.873828135,56,115.5122061,7,6,13,7,7,14,4,0.415568,0.432915,0.000001,No
8714,leyden,8,13.01709064,7,8.873888135,8.873828135,56,115.5122061,7,6,13,8,7,15,5,0.331114,0.335744,0.000001,No
12109,fireproof,8,13.01709064,6,9.028038815,9.027988815,48,117.5187995,7,6,13,8,7,15,5,0.351784,0.362267,0.000001,No
8626,lineman,7,13.15062203,6,9.028038815,9.027988815,42,118.7243261,7,6,13,7,6,13,5,0.387847,0.404477,0.000001,No
15139,circe,9,12.8993076,5,9.210360372,9.210320372,45,118.8072715,7,6,13,7,6,13,4,0.40868,0.426201,0.000001,No
390,whit,11,12.6986369,4,9.433503923,9.433473923,44,119.7926411,7,6,13,9,10,19,5,0.338172,0.344633,0.000001,No
12943,eligible,15,12.38848198,15,8.111748083,8.111608076,225,100.4922449,8,5,13,13,13,26,5,0.367698,0.381858,0.000001,No
10560,herpes,11,12.6986369,11,8.421903011,8.421803008,121,106.9466884,8,5,13,10,10,20,5,0.384529,0.400806,0.000001,No
2524,stonehenge,9,12.8993076,8,8.740356743,8.740286741,72,112.7445502,8,5,13,9,6,15,5,0.370183,0.384785,0.000001,No
8470,lopez,8,13.01709064,7,8.873888135,8.873828135,56,115.5122061,8,5,13,8,6,14,5,0.382252,0.399026,0.000001,No
10607,henrietta,18,12.20616042,16,8.047209562,8.047059554,288,98.22553084,9,4,13,14,17,31,5,0.379052,0.394955,0.000001,No
5087,proximity,13,12.53158282,12,8.334891634,8.334781631,156,104.4493848,9,4,13,11,11,22,4,0.429006,0.44528,0.000001,No
10163,hyperbolic,11,12.6986369,5,9.210360372,9.210320372,55,116.9590221,9,4,13,10,4,14,5,0.327207,0.331156,0.000001,No
17736,analytic,13,12.53158282,11,8.421903011,8.421803008,143,105.5397751,10,3,13,11,4,15,5,0.323817,0.327092,0.000001,No
843,versa,18,12.20616042,18,7.929426526,7.929256515,324,96.78785221,1,11,12,18,14,32,4,0.421629,0.438802,0.000001,No
1376,trapezoid,10,12.79394708,3,9.721185996,9.721165996,30,124.3723392,3,9,12,7,9,16,5,0.375071,0.390254,0.000001,No
16775,beg,12,12.61162553,10,8.517213191,8.517123189,120,107.4159033,4,8,12,4,11,15,4,0.427859,0.444383,0.000001,No
15709,canto,15,12.38848198,7,8.873888135,8.873828135,105,109.9340032,4,8,12,15,9,24,4,0.395495,0.412789,0.000001,No
7182,myra,12,12.61162553,7,8.873888135,8.873828135,84,111.9141541,4,8,12,9,11,20,4,0.375016,0.390302,0.000001,No
7900,mcguire,16,12.32394346,5,9.210360372,9.210320372,80,113.5079604,4,8,12,13,10,23,4,0.392643,0.409672,0.000001,No
15982,bulge,11,12.6986369,6,9.028038815,9.027988815,66,114.6437869,4,8,12,11,11,22,4,0.42065,0.437628,0.000001,No
3612,septum,13,12.53158282,4,9.433503923,9.433473923,52,118.2167357,4,8,12,12,11,23,4,0.430119,0.446214,0.000001,No
8537,locate,14,12.45747485,14,8.180740955,8.180610949,196,101.9113747,5,7,12,12,14,26,4,0.415812,0.433135,0.000001,No
759,vintage,13,12.53158282,13,8.254848927,8.254728922,169,103.446323,5,7,12,7,7,14,5,0.346977,0.356216,0.000001,No
11806,franc,21,12.05200974,8,8.740356743,8.740286741,168,105.3388646,5,7,12,14,17,31,4,0.439621,0.454524,0.000001,No
2433,stubborn,11,12.6986369,10,8.517213191,8.517123189,110,108.1569978,5,7,12,9,8,17,5,0.388578,0.405289,0.000001,No
16692,bentham,12,12.61162553,8,8.740356743,8.740286741,96,110.2301062,5,7,12,9,9,18,4,0.434839,0.450392,0.000001,No
8331,macarthur,10,12.79394708,7,8.873888135,8.873828135,70,113.5320552,5,7,12,9,7,16,4,0.423884,0.440539,0.000001,No
1760,thessaly,9,12.8993076,7,8.873888135,8.873828135,63,114.4670127,5,7,12,8,9,17,5,0.38931,0.406078,0.000001,No
14453,cornet,8,13.01709064,6,9.028038815,9.027988815,48,117.5187995,5,7,12,8,8,16,4,0.426205,0.442783,0.000001,No
18176,adenoma,1,15.09653218,1,10.81979828,10.81979828,1,163.341433,1,1,2,1,1,2,5,0.384237,0.400402,0.000006,No
8399,lumbar,4,13.71023782,4,9.433503923,9.433473923,16,129.3355822,3,3,6,4,4,8,5,0.321704,0.32482,0.000002,No
9845,inflammatory,4,13.71023782,4,9.433503923,9.433473923,16,129.3355822,3,3,6,3,3,6,5,0.303488,0.309015,0.000002,No
9696,interferometer,4,13.71023782,3,9.721185996,9.721165996,12,133.2797719,3,3,6,3,4,7,4,0.405904,0.423464,0.000002,No
1612,tipperary,3,13.99791989,3,9.721185996,9.721165996,9,136.0763828,3,3,6,3,3,6,5,0.332123,0.336769,0.000002,No
1949,teaspoon,3,13.99791989,3,9.721185996,9.721165996,9,136.0763828,3,3,6,3,3,6,5,0.385054,0.401563,0.000002,No
10866,handbag,3,13.99791989,3,9.721185996,9.721165996,9,136.0763828,3,3,6,3,3,6,5,0.356998,0.369101,0.000002,No
11495,gee,3,13.99791989,3,9.721185996,9.721165996,9,136.0763828,3,3,6,3,3,6,5,0.322037,0.325477,0.000002,No
18045,agouti,3,13.99791989,3,9.721185996,9.721165996,9,136.0763828,3,3,6,3,3,6,5,0.384487,0.400707,0.000002,No
4170,rue,14,12.45747485,11,8.421903011,8.421803008,154,104.9156449,6,6,12,14,10,24,5,0.39561,0.41281,0.000001,No
14038,dahl,13,12.53158282,11,8.421903011,8.421803008,143,105.5397751,6,6,12,6,8,14,4,0.387975,0.40455,0.000001,No
11114,greenish,11,12.6986369,11,8.421903011,8.421803008,121,106.9466884,6,6,12,8,9,17,5,0.378922,0.394839,0.000001,No
5287,priam,12,12.61162553,10,8.517213191,8.517123189,120,107.4159033,6,6,12,12,11,23,5,0.407844,0.425269,0.000001,No
17088,babe,12,12.61162553,9,8.622573707,8.622493705,108,108.7446707,6,6,12,7,11,18,5,0.384512,0.400806,0.000001,No
7150,nan,12,12.61162553,8,8.740356743,8.740286741,96,110.2301062,6,6,12,7,6,13,4,0.417415,0.434628,0.000001,No
2543,stir,10,12.79394708,9,8.622573707,8.622493705,90,110.3167517,6,6,12,7,7,14,5,0.383623,0.40003,0.000001,No
14247,crises,8,13.01709064,8,8.740356743,8.740286741,64,113.7740159,6,6,12,6,7,13,5,0.378156,0.393848,0.000001,No
13170,dungeon,7,13.15062203,7,8.873888135,8.873828135,49,116.6971488,6,6,12,6,6,12,4,0.405385,0.422915,0.000001,No
11735,friedman,8,13.01709064,6,9.028038815,9.027988815,48,117.5187995,6,6,12,7,6,13,4,0.389387,0.406479,0.000001,No
17326,asparagus,10,12.79394708,4,9.433503923,9.433473923,40,120.69175,6,6,12,8,6,14,5,0.357041,0.368826,0.000001,No
10161,hypnosis,7,13.15062203,5,9.210360372,9.210320372,35,121.121968,6,6,12,6,7,13,5,0.369766,0.384201,0.000001,No
16204,bran,7,13.15062203,5,9.210360372,9.210320372,35,121.121968,6,6,12,6,6,12,5,0.410266,0.427931,0.000001,No
17769,amos,17,12.26331883,16,8.047209562,8.047059554,272,98.68549658,7,5,12,10,7,17,5,0.347269,0.356549,0.000001,No
9704,inter,13,12.53158282,12,8.334891634,8.334781631,156,104.4493848,7,5,12,10,10,20,5,0.3484,0.357887,0.000001,No
5165,propelled,12,12.61162553,10,8.517213191,8.517123189,120,107.4159033,7,5,12,11,11,22,5,0.348955,0.35844,0.000001,No
5791,piccolo,12,12.61162553,10,8.517213191,8.517123189,120,107.4159033,7,5,12,12,7,19,4,0.406629,0.42422,0.000001,No
5535,polka,13,12.53158282,9,8.622573707,8.622493705,117,108.0544965,7,5,12,9,10,19,5,0.338237,0.345356,0.000001,No
1995,tart,10,12.79394708,10,8.517213191,8.517123189,100,108.9687749,7,5,12,8,8,16,4,0.432213,0.448031,0.000001,No
6935,nightingale,14,12.45747485,7,8.873888135,8.873828135,98,110.5462382,7,5,12,12,9,21,4,0.417376,0.43453,0.000001,No
17742,analogous,9,12.8993076,8,8.740356743,8.740286741,72,112.7445502,7,5,12,9,8,17,5,0.361373,0.374213,0.000001,No
9653,intrusive,9,12.8993076,6,9.028038815,9.027988815,54,116.4554497,7,5,12,8,7,15,4,0.422532,0.439257,0.000001,No
17872,almanac,7,13.15062203,7,8.873888135,8.873828135,49,116.6971488,7,5,12,7,6,13,5,0.375675,0.391036,0.000001,No
6329,palmyra,14,12.45747485,4,9.433503923,9.433473923,56,117.5176378,7,5,12,13,14,27,5,0.333415,0.338872,0.000001,No
1206,tunic,8,13.01709064,6,9.028038815,9.027988815,48,117.5187995,7,5,12,7,7,14,4,0.40323,0.420934,0.000001,No
11026,guaranteeing,4,13.71023782,4,9.433503923,9.433473923,16,129.3355822,4,2,6,4,3,7,4,0.402681,0.420319,0.000002,No
5679,plagioclase,4,13.71023782,3,9.721185996,9.721165996,12,133.2797719,4,2,6,4,2,6,5,0.294598,0.300679,0.000002,No
2733,squadron,16,12.32394346,13,8.254848927,8.254728922,208,101.7322914,8,4,12,10,9,19,4,0.426799,0.443266,0.000001,No
15907,bushy,13,12.53158282,11,8.421903011,8.421803008,143,105.5397751,8,4,12,11,9,20,5,0.355781,0.367646,0.000001,No
1825,tex,12,12.61162553,11,8.421903011,8.421803008,132,106.213887,8,4,12,10,8,18,5,0.321529,0.324703,0.000001,No
12839,encephalitis,9,12.8993076,4,9.433503923,9.433473923,36,121.6856688,8,4,12,9,6,15,5,0.369797,0.384344,0.000001,No
16518,bizarre,9,12.8993076,8,8.740356743,8.740286741,72,112.7445502,5,1,6,6,2,8,5,0.284594,0.290879,0.000002,No
11863,formulae,11,12.6986369,9,8.622573707,8.622493705,99,109.4949327,3,8,11,4,10,14,5,0.401634,0.419218,0.000001,No
14389,cougar,8,13.01709064,6,9.028038815,9.027988815,48,117.5187995,3,8,11,5,8,13,5,0.353254,0.363872,0.000001,No
18282,acadia,9,12.8993076,9,8.622573707,8.622493705,81,111.2252305,4,7,11,6,7,13,4,0.400293,0.417634,0.000001,No
8350,lymphoma,9,12.8993076,6,9.028038815,9.027988815,54,116.4554497,4,7,11,9,8,17,5,0.366847,0.380724,0.000001,No
1799,theism,9,12.8993076,5,9.210360372,9.210320372,45,118.8072715,4,7,11,7,8,15,5,0.363653,0.376957,0.000001,No
913,veal,8,13.01709064,5,9.210360372,9.210320372,40,119.8920957,4,7,11,7,7,14,4,0.43015,0.446228,0.000001,No
6476,ornithology,7,13.15062203,5,9.210360372,9.210320372,35,121.121968,4,7,11,6,7,13,4,0.407385,0.424971,0.000001,No
13419,dobbs,7,13.15062203,4,9.433503923,9.433473923,28,124.0564445,4,7,11,7,7,14,4,0.404185,0.421798,0.000001,No
13340,dora,11,12.6986369,9,8.622573707,8.622493705,99,109.4949327,5,6,11,7,7,14,4,0.390552,0.407404,0.000001,No
10314,horticulture,9,12.8993076,9,8.622573707,8.622493705,81,111.2252305,5,6,11,7,7,14,5,0.414646,0.432381,0.000001,No
10549,hess,9,12.8993076,8,8.740356743,8.740286741,72,112.7445502,5,6,11,9,6,15,5,0.387095,0.403665,0.000001,No
11006,guilford,9,12.8993076,8,8.740356743,8.740286741,72,112.7445502,5,6,11,9,7,16,5,0.340299,0.347351,0.000001,No
691,volcanism,8,13.01709064,7,8.873888135,8.873828135,56,115.5122061,5,6,11,6,6,12,4,0.409453,0.426882,0.000001,No
1762,theseus,8,13.01709064,7,8.873888135,8.873828135,56,115.5122061,5,6,11,6,6,12,4,0.430296,0.44635,0.000001,No
4481,restraint,7,13.15062203,7,8.873888135,8.873828135,49,116.6971488,5,6,11,6,6,12,5,0.412507,0.429842,0.000001,No
5047,puccini,8,13.01709064,6,9.028038815,9.027988815,48,117.5187995,5,6,11,8,8,16,4,0.403992,0.421582,0.000001,No
11854,forthcoming,7,13.15062203,6,9.028038815,9.027988815,42,118.7243261,5,6,11,6,7,13,5,0.414627,0.432348,0.000001,No
56,yucca,7,13.15062203,5,9.210360372,9.210320372,35,121.121968,5,6,11,5,6,11,4,0.390595,0.407451,0.000001,No
1898,templeton,7,13.15062203,5,9.210360372,9.210320372,35,121.121968,5,6,11,7,6,13,4,0.42642,0.442839,0.000001,No
1797,thelma,6,13.30477271,5,9.210360372,9.210320372,30,122.5417513,5,6,11,5,6,11,5,0.321111,0.324734,0.000001,No
10685,heater,11,12.6986369,3,9.721185996,9.721165996,33,123.4458112,5,6,11,7,11,18,4,0.427714,0.444294,0.000001,No
9240,katowice,6,13.30477271,3,9.721185996,9.721165996,18,129.3381701,5,6,11,5,6,11,4,0.401062,0.418718,0.000001,No
10328,horny,14,12.45747485,14,8.180740955,8.180610949,196,101.9113747,6,5,11,10,7,17,5,0.321175,0.324525,0.000001,No
12869,emilio,11,12.6986369,10,8.517213191,8.517123189,110,108.1569978,6,5,11,6,5,11,5,0.346841,0.355679,0.000001,No
3896,scan,10,12.79394708,10,8.517213191,8.517123189,100,108.9687749,6,5,11,8,7,15,4,0.418754,0.435919,0.000001,No
11927,fontaine,9,12.8993076,7,8.873888135,8.873828135,63,114.4670127,6,5,11,8,5,13,4,0.405071,0.422643,0.000001,No
1023,urgent,8,13.01709064,7,8.873888135,8.873828135,56,115.5122061,6,5,11,7,5,12,5,0.384321,0.400571,0.000001,No
11656,funky,7,13.15062203,7,8.873888135,8.873828135,49,116.6971488,6,5,11,6,5,11,5,0.362132,0.375116,0.000001,No
8356,lye,8,13.01709064,2,10.1266511,10.1266411,16,131.8195353,6,5,11,6,8,14,5,0.383499,0.399897,0.000001,No
18309,absinthe,7,13.15062203,2,10.1266511,10.1266411,14,133.1717611,6,5,11,6,6,12,4,0.388901,0.40608,0.000001,No
3748,se,17,12.26331883,12,8.334891634,8.334781631,204,102.2134336,7,4,11,8,5,13,4,0.412929,0.430154,0.000001,No
16179,breach,11,12.6986369,11,8.421903011,8.421803008,121,106.9466884,7,4,11,8,11,19,4,0.420003,0.437022,0.000001,No
3321,silas,8,13.01709064,7,8.873888135,8.873828135,56,115.5122061,7,4,11,7,5,12,5,0.327002,0.3306,0.000001,No
675,volumetric,9,12.8993076,6,9.028038815,9.027988815,54,116.4554497,7,4,11,9,7,16,5,0.398138,0.415936,0.000001,No
7863,mechanic,7,13.15062203,7,8.873888135,8.873828135,49,116.6971488,7,4,11,7,4,11,5,0.398505,0.415753,0.000001,No
14561,continuation,18,12.20616042,18,7.929426526,7.929256515,324,96.78785221,8,3,11,17,18,35,5,0.392747,0.409873,0.000001,No
4833,rachmaninoff,10,12.79394708,6,9.028038815,9.027988815,60,115.5042509,3,7,10,6,7,13,4,0.394274,0.411376,0.000001,No
1162,tuxedo,9,12.8993076,6,9.028038815,9.027988815,54,116.4554497,3,7,10,9,8,17,4,0.39977,0.41716,0.000001,No
16383,bog,9,12.8993076,5,9.210360372,9.210320372,45,118.8072715,3,7,10,5,9,14,4,0.428499,0.444759,0.000001,No
8966,landau,4,13.71023782,4,9.433503923,9.433473923,16,129.3355822,2,3,5,3,3,6,4,0.412929,0.430131,0.000002,No
7061,nectarine,3,13.99791989,3,9.721185996,9.721165996,9,136.0763828,2,3,5,2,3,5,4,0.422442,0.439135,0.000002,No
7941,maynard,14,12.45747485,8,8.740356743,8.740286741,112,108.8827743,4,6,10,10,14,24,5,0.350022,0.36014,0.000001,No
14728,conceptual,10,12.79394708,8,8.740356743,8.740286741,80,111.8236617,4,6,10,9,9,18,5,0.325623,0.329247,0.000001,No
16392,bodhisattva,10,12.79394708,8,8.740356743,8.740286741,80,111.8236617,4,6,10,8,8,16,4,0.426,0.44259,0.000001,No
4184,rubble,9,12.8993076,8,8.740356743,8.740286741,72,112.7445502,4,6,10,8,9,17,5,0.366234,0.379943,0.000001,No
2773,sportsman,8,13.01709064,8,8.740356743,8.740286741,64,113.7740159,4,6,10,5,7,12,5,0.383374,0.399753,0.000001,No
5520,polygamy,10,12.79394708,6,9.028038815,9.027988815,60,115.5042509,4,6,10,4,8,12,4,0.399455,0.416934,0.000001,No
13917,debbie,7,13.15062203,7,8.873888135,8.873828135,49,116.6971488,4,6,10,4,6,10,5,0.387238,0.403801,0.000001,No
10311,hose,11,12.6986369,5,9.210360372,9.210320372,55,116.9590221,4,6,10,10,8,18,5,0.358555,0.370795,0.000001,No
10979,gunmen,7,13.15062203,6,9.028038815,9.027988815,42,118.7243261,4,6,10,5,6,11,5,0.387323,0.403899,0.000001,No
3301,silverman,8,13.01709064,5,9.210360372,9.210320372,40,119.8920957,4,6,10,8,7,15,5,0.385606,0.402017,0.000001,No
12232,fennel,8,13.01709064,5,9.210360372,9.210320372,40,119.8920957,4,6,10,4,6,10,4,0.391207,0.408118,0.000001,No
1389,transpiration,7,13.15062203,5,9.210360372,9.210320372,35,121.121968,4,6,10,4,6,10,4,0.422542,0.439543,0.000001,No
15467,celt,6,13.30477271,5,9.210360372,9.210320372,30,122.5417513,4,6,10,4,6,10,4,0.437885,0.453021,0.000001,No
8391,lump,12,12.61162553,12,8.334891634,8.334781631,144,105.1165321,5,5,10,11,12,23,5,0.406397,0.423917,0.000001,No
10183,hydrology,10,12.79394708,8,8.740356743,8.740286741,80,111.8236617,5,5,10,7,9,16,4,0.425939,0.442388,0.000001,No
5072,psychic,9,12.8993076,8,8.740356743,8.740286741,72,112.7445502,5,5,10,7,6,13,5,0.38472,0.401022,0.000001,No
13472,dispersion,9,12.8993076,8,8.740356743,8.740286741,72,112.7445502,5,5,10,5,6,11,4,0.41552,0.432727,0.000001,No
5253,privilege,8,13.01709064,8,8.740356743,8.740286741,64,113.7740159,5,5,10,7,7,14,5,0.407479,0.424889,0.000001,No
9218,kemp,8,13.01709064,8,8.740356743,8.740286741,64,113.7740159,5,5,10,7,5,12,4,0.428499,0.444736,0.000001,No
3309,silky,8,13.01709064,7,8.873888135,8.873828135,56,115.5122061,5,5,10,7,7,14,5,0.327057,0.331017,0.000001,No
15980,bulky,8,13.01709064,7,8.873888135,8.873828135,56,115.5122061,5,5,10,5,7,12,5,0.394703,0.411833,0.000001,No
12394,faber,9,12.8993076,6,9.028038815,9.027988815,54,116.4554497,5,5,10,7,7,14,5,0.396502,0.413683,0.000001,No
10661,heidegger,8,13.01709064,6,9.028038815,9.027988815,48,117.5187995,5,5,10,7,5,12,4,0.380898,0.397405,0.000001,No
9076,kodak,7,13.15062203,6,9.028038815,9.027988815,42,118.7243261,5,5,10,6,5,11,4,0.42494,0.441473,0.000001,No
16908,bartender,6,13.30477271,6,9.028038815,9.027988815,36,120.1160044,5,5,10,6,5,11,5,0.38089,0.396983,0.000001,No
17008,ballerina,7,13.15062203,5,9.210360372,9.210320372,35,121.121968,5,5,10,6,7,13,5,0.352153,0.362849,0.000001,No
11977,fluff,8,13.01709064,4,9.433503923,9.433473923,32,122.7967756,5,5,10,8,8,16,5,0.371756,0.386644,0.000001,No
18161,adkins,8,13.01709064,4,9.433503923,9.433473923,32,122.7967756,5,5,10,5,5,10,5,0.343812,0.351941,0.000001,No
7823,melanoma,10,12.79394708,2,10.1266511,10.1266411,20,129.5598384,5,5,10,5,7,12,5,0.365864,0.379377,0.000001,No
3025,softwood,5,13.48709426,3,9.721185996,9.721165996,15,131.1105519,5,5,10,5,5,10,5,0.391327,0.408228,0.000001,No
17683,angstrom,5,13.48709426,4,9.433503923,9.433473923,20,127.2305567,3,2,5,3,2,5,5,0.357235,0.369491,0.000002,No
6068,pedestal,4,13.71023782,4,9.433503923,9.433473923,16,129.3355822,3,2,5,3,2,5,4,0.402161,0.41969,0.000002,No
15643,caress,3,13.99791989,3,9.721185996,9.721165996,9,136.0763828,3,2,5,3,2,5,4,0.417798,0.43498,0.000002,No
871,vera,11,12.6986369,11,8.421903011,8.421803008,121,106.9466884,6,4,10,7,6,13,5,0.309052,0.314111,0.000001,No
2654,stare,11,12.6986369,8,8.740356743,8.740286741,88,110.9906167,6,4,10,8,5,13,5,0.388782,0.405603,0.000001,No
16637,bessie,10,12.79394708,8,8.740356743,8.740286741,80,111.8236617,6,4,10,8,5,13,5,0.326792,0.330359,0.000001,No
6348,palate,9,12.8993076,8,8.740356743,8.740286741,72,112.7445502,6,4,10,9,6,15,5,0.392991,0.410145,0.000001,No
3898,scaly,8,13.01709064,8,8.740356743,8.740286741,64,113.7740159,6,4,10,8,4,12,5,0.398362,0.416115,0.000001,No
10425,hog,10,12.79394708,6,9.028038815,9.027988815,60,115.5042509,6,4,10,8,6,14,5,0.384479,0.400726,0.000001,No
8658,lillian,8,13.01709064,7,8.873888135,8.873828135,56,115.5122061,6,4,10,7,4,11,4,0.412411,0.429652,0.000001,No
9531,itchy,7,13.15062203,7,8.873888135,8.873828135,49,116.6971488,6,4,10,7,6,13,5,0.384321,0.400552,0.000001,No
17381,arrogant,7,13.15062203,7,8.873888135,8.873828135,49,116.6971488,6,4,10,6,6,12,4,0.422482,0.439187,0.000001,No
11676,fullerton,6,13.30477271,6,9.028038815,9.027988815,36,120.1160044,6,4,10,6,5,11,5,0.395839,0.412979,0.000001,No
15672,caraway,7,13.15062203,5,9.210360372,9.210320372,35,121.121968,6,4,10,6,4,10,5,0.361233,0.37405,0.000001,No
14021,daly,6,13.30477271,5,9.210360372,9.210320372,30,122.5417513,6,4,10,6,6,12,5,0.38067,0.396673,0.000001,No
16140,brewster,9,12.8993076,9,8.622573707,8.622493705,81,111.2252305,7,3,10,8,3,11,5,0.361675,0.37451,0.000001,No
13793,dell,10,12.79394708,6,9.028038815,9.027988815,60,115.5042509,7,3,10,7,3,10,4,0.405172,0.422741,0.000001,No
18186,addis,15,12.38848198,5,9.210360372,9.210320372,75,114.1023835,8,2,10,9,14,23,5,0.320751,0.324735,0.000001,No
16879,basso,8,13.01709064,7,8.873888135,8.873828135,56,115.5122061,8,2,10,8,7,15,5,0.31909,0.322806,0.000001,No
17684,angst,2,14.403385,2,10.1266511,10.1266411,4,145.8580546,1,2,3,1,2,3,5,0.388391,0.405141,0.000003,No
15559,castillo,9,12.8993076,8,8.740356743,8.740286741,72,112.7445502,3,6,9,4,6,10,4,0.392834,0.410202,0.000001,No
13708,derrick,8,13.01709064,8,8.740356743,8.740286741,64,113.7740159,3,6,9,3,7,10,5,0.340612,0.347861,0.000001,No
18109,aeneid,8,13.01709064,7,8.873888135,8.873828135,56,115.5122061,3,6,9,8,7,15,4,0.402426,0.420178,0.000001,No
13503,disaccharide,7,13.15062203,7,8.873888135,8.873828135,49,116.6971488,3,6,9,6,6,12,4,0.392556,0.409559,0.000001,No
8627,linebacker,7,13.15062203,6,9.028038815,9.027988815,42,118.7243261,3,6,9,4,7,11,4,0.386951,0.403696,0.000001,No
3821,schweitzer,9,12.8993076,5,9.210360372,9.210320372,45,118.8072715,3,6,9,8,7,15,5,0.386404,0.402895,0.000001,No
4794,raincoat,6,13.30477271,6,9.028038815,9.027988815,36,120.1160044,3,6,9,5,6,11,4,0.418656,0.43583,0.000001,No
7523,misty,8,13.01709064,7,8.873888135,8.873828135,56,115.5122061,4,5,9,6,5,11,5,0.334118,0.339258,0.000001,No
2705,stadia,7,13.15062203,7,8.873888135,8.873828135,49,116.6971488,4,5,9,4,6,10,4,0.403872,0.421507,0.000001,No
3704,secrete,7,13.15062203,6,9.028038815,9.027988815,42,118.7243261,4,5,9,4,5,9,5,0.401171,0.419072,0.000001,No
1656,tickle,9,12.8993076,5,9.210360372,9.210320372,45,118.8072715,4,5,9,7,7,14,5,0.384787,0.401092,0.000001,No
4507,residual,6,13.30477271,6,9.028038815,9.027988815,36,120.1160044,4,5,9,5,5,10,5,0.3282,0.332762,0.000001,No
473,weinstein,6,13.30477271,5,9.210360372,9.210320372,30,122.5417513,4,5,9,4,5,9,4,0.42911,0.445261,0.000001,No
6980,newscast,6,13.30477271,5,9.210360372,9.210320372,30,122.5417513,4,5,9,4,5,9,4,0.403249,0.42084,0.000001,No
9074,koenig,6,13.30477271,4,9.433503923,9.433473923,24,125.5106255,4,5,9,6,5,11,4,0.412852,0.430093,0.000001,No
548,watchdog,5,13.48709426,4,9.433503923,9.433473923,20,127.2305567,4,5,9,5,5,10,4,0.399806,0.417399,0.000001,No
1541,tonsillitis,7,13.15062203,3,9.721185996,9.721165996,21,127.8396427,4,5,9,4,7,11,5,0.373069,0.388113,0.000001,No
14028,dal,11,12.6986369,10,8.517213191,8.517123189,110,108.1569978,5,4,9,5,7,12,4,0.388433,0.405522,0.000001,No
18102,aerosol,10,12.79394708,9,8.622573707,8.622493705,90,110.3167517,5,4,9,9,6,15,5,0.378139,0.393916,0.000001,No
15623,carmichael,9,12.8993076,7,8.873888135,8.873828135,63,114.4670127,5,4,9,7,5,12,4,0.391569,0.408475,0.000001,No
6472,orpheus,8,13.01709064,7,8.873888135,8.873828135,56,115.5122061,5,4,9,7,7,14,5,0.395742,0.412871,0.000001,No
3080,sneak,7,13.15062203,7,8.873888135,8.873828135,49,116.6971488,5,4,9,6,6,12,5,0.328881,0.332898,0.000001,No
8202,mallard,8,13.01709064,6,9.028038815,9.027988815,48,117.5187995,5,4,9,6,6,12,4,0.406965,0.424535,0.000001,No
11097,gretchen,6,13.30477271,6,9.028038815,9.027988815,36,120.1160044,5,4,9,5,4,9,4,0.422522,0.439229,0.000001,No
11868,formatting,6,13.30477271,6,9.028038815,9.027988815,36,120.1160044,5,4,9,5,4,9,5,0.378963,0.394824,0.000001,No
13314,doubtful,6,13.30477271,6,9.028038815,9.027988815,36,120.1160044,5,4,9,6,4,10,5,0.392513,0.409657,0.000001,No
17116,awkward,6,13.30477271,6,9.028038815,9.027988815,36,120.1160044,5,4,9,5,4,9,4,0.430515,0.446501,0.000001,No
4691,receipt,5,13.48709426,5,9.210360372,9.210320372,25,124.2209985,5,4,9,5,5,10,4,0.413362,0.43076,0.000001,No
1138,tx,5,13.48709426,4,9.433503923,9.433473923,20,127.2305567,5,4,9,5,4,9,5,0.379303,0.395773,0.000001,No
5123,protactinium,6,13.30477271,2,10.1266511,10.1266411,12,134.7327912,5,4,9,5,5,10,4,0.400799,0.418127,0.000001,No
3832,schroeder,2,14.403385,2,10.1266511,10.1266411,4,145.8580546,2,1,3,2,2,4,5,0.398076,0.415824,0.000003,No
6022,penitent,2,14.403385,2,10.1266511,10.1266411,4,145.8580546,2,1,3,2,1,3,6,0.27832,0.284369,0.000003,No
2381,subtrahend,2,14.403385,1,10.81979828,10.81979828,2,155.8417203,2,1,3,2,1,3,5,0.398067,0.415814,0.000003,No
1896,temporal,11,12.6986369,11,8.421903011,8.421803008,121,106.9466884,6,3,9,7,3,10,5,0.325468,0.329078,0.000001,No
8149,manifestation,7,13.15062203,7,8.873888135,8.873828135,49,116.6971488,6,3,9,6,7,13,5,0.390871,0.407819,0.000001,No
2532,stocky,6,13.30477271,6,9.028038815,9.027988815,36,120.1160044,6,3,9,6,3,9,4,0.422572,0.439257,0.000001,No
8204,malignant,9,12.8993076,4,9.433503923,9.433473923,36,121.6856688,6,3,9,8,4,12,5,0.345646,0.354582,0.000001,No
5067,psychopath,3,13.99791989,3,9.721185996,9.721165996,9,136.0763828,1,3,4,3,3,6,4,0.377874,0.394363,0.000002,No
16286,boson,11,12.6986369,5,9.210360372,9.210320372,55,116.9590221,2,6,8,6,7,13,4,0.404305,0.421737,0.000001,No
11271,godmother,9,12.8993076,5,9.210360372,9.210320372,45,118.8072715,2,6,8,9,6,15,5,0.389969,0.406786,0.000001,No
582,wardrobe,8,13.01709064,4,9.433503923,9.433473923,32,122.7967756,2,6,8,8,7,15,5,0.396555,0.413753,0.000001,No
10953,gymnast,13,12.53158282,11,8.421903011,8.421803008,143,105.5397751,3,5,8,7,11,18,4,0.422744,0.439454,0.000001,No
1072,unitarian,12,12.61162553,11,8.421903011,8.421803008,132,106.213887,3,5,8,9,5,14,5,0.382392,0.399172,0.000001,No
7178,myrtle,9,12.8993076,7,8.873888135,8.873828135,63,114.4670127,3,5,8,4,8,12,5,0.347228,0.356493,0.000001,No
7545,miriam,7,13.15062203,7,8.873888135,8.873828135,49,116.6971488,3,5,8,4,5,9,5,0.398389,0.416208,0.000001,No
4936,quadratic,8,13.01709064,5,9.210360372,9.210320372,40,119.8920957,3,5,8,8,6,14,5,0.355333,0.36713,0.000001,No
17465,archangel,6,13.30477271,6,9.028038815,9.027988815,36,120.1160044,3,5,8,6,5,11,5,0.38868,0.405507,0.000001,No
8427,lubricant,6,13.30477271,5,9.210360372,9.210320372,30,122.5417513,3,5,8,5,5,10,4,0.436025,0.451397,0.000001,No
8435,lowry,6,13.30477271,5,9.210360372,9.210320372,30,122.5417513,3,5,8,3,5,8,5,0.387019,0.403543,0.000001,No
5898,pessimist,5,13.48709426,5,9.210360372,9.210320372,25,124.2209985,3,5,8,5,5,10,5,0.358186,0.370286,0.000001,No
10441,hoax,5,13.48709426,5,9.210360372,9.210320372,25,124.2209985,3,5,8,4,5,9,5,0.410941,0.428551,0.000001,No
6249,parapsychology,6,13.30477271,4,9.433503923,9.433473923,24,125.5106255,3,5,8,5,5,10,5,0.390613,0.407434,0.000001,No
18061,agate,6,13.30477271,4,9.433503923,9.433473923,24,125.5106255,3,5,8,3,5,8,4,0.391707,0.409024,0.000001,No
8186,mambo,2,14.403385,2,10.1266511,10.1266411,4,145.8580546,1,1,2,1,1,2,6,0.246104,0.247697,0.000004,No
16805,beckman,2,14.403385,2,10.1266511,10.1266411,4,145.8580546,1,1,2,1,1,2,5,0.345599,0.354479,0.000004,No
10497,hillbilly,3,13.99791989,3,9.721185996,9.721165996,9,136.0763828,2,2,4,2,2,4,5,0.384262,0.400449,0.000002,No
14170,crystallography,3,13.99791989,3,9.721185996,9.721165996,9,136.0763828,2,2,4,2,2,4,5,0.322329,0.326635,0.000002,No
18227,acm,3,13.99791989,3,9.721185996,9.721165996,9,136.0763828,2,2,4,2,2,4,5,0.301334,0.307064,0.000002,No
1134,tyke,3,13.99791989,2,10.1266511,10.1266411,6,141.7520509,2,2,4,3,2,5,5,0.402398,0.420143,0.000002,No
488,wedlock,2,14.403385,2,10.1266511,10.1266411,4,145.8580546,2,2,4,2,2,4,5,0.398621,0.416363,0.000002,No
2093,tabu,2,14.403385,2,10.1266511,10.1266411,4,145.8580546,2,2,4,2,2,4,5,0.398496,0.41626,0.000002,No
2588,stepchild,3,13.99791989,1,10.81979828,10.81979828,3,151.4546696,2,2,4,2,3,5,5,0.376991,0.393548,0.000002,No
78,yokel,2,14.403385,1,10.81979828,10.81979828,2,155.8417203,2,2,4,2,2,4,5,0.350001,0.359755,0.000002,No
12390,fabulous,10,12.79394708,9,8.622573707,8.622493705,90,110.3167517,4,4,8,9,5,14,5,0.398156,0.41596,0.000001,No
335,wiley,8,13.01709064,7,8.873888135,8.873828135,56,115.5122061,4,4,8,6,4,10,5,0.386328,0.402777,0.000001,No
9607,ir,10,12.79394708,5,9.210360372,9.210320372,50,117.8368632,4,4,8,4,4,8,5,0.315377,0.319429,0.000001,No
15213,chorale,9,12.8993076,5,9.210360372,9.210320372,45,118.8072715,4,4,8,8,4,12,5,0.330214,0.33509,0.000001,No
1463,trachea,6,13.30477271,6,9.028038815,9.027988815,36,120.1160044,4,4,8,5,4,9,5,0.412344,0.429677,0.000001,No
14627,conscription,6,13.30477271,6,9.028038815,9.027988815,36,120.1160044,4,4,8,4,4,8,4,0.409141,0.426746,0.000001,No
2517,stool,7,13.15062203,5,9.210360372,9.210320372,35,121.121968,4,4,8,6,5,11,5,0.38538,0.401939,0.000001,No
14662,congestion,6,13.30477271,5,9.210360372,9.210320372,30,122.5417513,4,4,8,5,4,9,4,0.418992,0.436135,0.000001,No
9674,intestinal,5,13.48709426,5,9.210360372,9.210320372,25,124.2209985,4,4,8,5,4,9,5,0.326858,0.33062,0.000001,No
6077,pecan,6,13.30477271,4,9.433503923,9.433473923,24,125.5106255,4,4,8,4,4,8,5,0.346172,0.355206,0.000001,No
7210,mussel,6,13.30477271,4,9.433503923,9.433473923,24,125.5106255,4,4,8,4,4,8,4,0.405237,0.422821,0.000001,No
11215,gosling,5,13.48709426,4,9.433503923,9.433473923,20,127.2305567,4,4,8,5,4,9,4,0.39306,0.410352,0.000001,No
11374,ginkgo,7,13.15062203,3,9.721185996,9.721165996,21,127.8396427,4,4,8,4,4,8,4,0.438535,0.453543,0.000001,No
4215,rotunda,4,13.71023782,4,9.433503923,9.433473923,16,129.3355822,4,4,8,4,4,8,5,0.346483,0.355225,0.000001,No
13099,earthy,4,13.71023782,4,9.433503923,9.433473923,16,129.3355822,4,4,8,4,4,8,5,0.356188,0.368186,0.000001,No
1596,tn,4,13.71023782,3,9.721185996,9.721165996,12,133.2797719,4,4,8,4,4,8,4,0.378728,0.395203,0.000001,No
9005,ladybird,4,13.71023782,3,9.721185996,9.721165996,12,133.2797719,4,4,8,4,4,8,5,0.340246,0.347301,0.000001,No
16326,bookworm,4,13.71023782,3,9.721185996,9.721165996,12,133.2797719,4,4,8,4,4,8,4,0.38908,0.406263,0.000001,No
9909,indium,7,13.15062203,1,10.81979828,10.81979828,7,142.2870777,4,4,8,7,6,13,4,0.407526,0.425103,0.000001,No
3654,semantic,9,12.8993076,7,8.873888135,8.873828135,63,114.4670127,5,3,8,8,7,15,5,0.322224,0.3254,0.000001,No
10509,hieronymus,7,13.15062203,7,8.873888135,8.873828135,49,116.6971488,5,3,8,5,5,10,5,0.326894,0.330544,0.000001,No
3275,simultaneous,6,13.30477271,6,9.028038815,9.027988815,36,120.1160044,5,3,8,5,3,8,5,0.334055,0.339985,0.000001,No
12567,everlasting,6,13.30477271,6,9.028038815,9.027988815,36,120.1160044,5,3,8,6,3,9,5,0.324937,0.328367,0.000001,No
18023,airborne,6,13.30477271,6,9.028038815,9.027988815,36,120.1160044,5,3,8,5,3,8,4,0.414753,0.432314,0.000001,No
551,wasting,5,13.48709426,5,9.210360372,9.210320372,25,124.2209985,5,3,8,5,4,9,5,0.38089,0.396887,0.000001,No
3785,scrap,5,13.48709426,5,9.210360372,9.210320372,25,124.2209985,5,3,8,5,4,9,5,0.400899,0.418631,0.000001,No
5505,polyphony,6,13.30477271,4,9.433503923,9.433473923,24,125.5106255,5,3,8,5,3,8,5,0.330319,0.335258,0.000001,No
1836,testicular,8,13.01709064,3,9.721185996,9.721165996,24,126.5415592,5,3,8,5,7,12,5,0.32139,0.324676,0.000001,No
12251,feldman,5,13.48709426,4,9.433503923,9.433473923,20,127.2305567,5,3,8,5,4,9,4,0.411379,0.428755,0.000001,No
13850,defecate,5,13.48709426,3,9.721185996,9.721165996,15,131.1105519,5,3,8,5,3,8,4,0.387686,0.404217,0.000001,No
13388,dolce,4,13.71023782,4,9.433503923,9.433473923,16,129.3355822,3,1,4,3,1,4,6,0.275722,0.281594,0.000002,No
13163,duodenal,4,13.71023782,2,10.1266511,10.1266411,8,138.8387949,3,1,4,3,2,5,5,0.303213,0.308646,0.000002,No
18175,adenosine,9,12.8993076,6,9.028038815,9.027988815,54,116.4554497,6,2,8,6,2,8,5,0.400962,0.418762,0.000001,No
14226,crook,6,13.30477271,5,9.210360372,9.210320372,30,122.5417513,6,2,8,6,3,9,5,0.390871,0.407912,0.000001,No
8986,lam,9,12.8993076,6,9.028038815,9.027988815,54,116.4554497,2,5,7,2,6,8,5,0.399977,0.417753,0.000001,No
9588,ironside,7,13.15062203,7,8.873888135,8.873828135,49,116.6971488,2,5,7,7,5,12,5,0.356353,0.368362,0.000001,No
12235,femur,6,13.30477271,6,9.028038815,9.027988815,36,120.1160044,2,5,7,6,6,12,5,0.359376,0.372113,0.000001,No
4430,rhapsody,5,13.48709426,5,9.210360372,9.210320372,25,124.2209985,2,5,7,2,5,7,5,0.370399,0.384924,0.000001,No
13543,diminutive,10,12.79394708,9,8.622573707,8.622493705,90,110.3167517,3,4,7,10,7,17,5,0.385272,0.401817,0.000001,No
13383,dolomite,7,13.15062203,7,8.873888135,8.873828135,49,116.6971488,3,4,7,7,5,12,5,0.333171,0.338114,0.000001,No
14551,contraceptive,10,12.79394708,4,9.433503923,9.433473923,40,120.69175,3,4,7,9,8,17,5,0.35931,0.371502,0.000001,No
1974,tawny,6,13.30477271,5,9.210360372,9.210320372,30,122.5417513,3,4,7,3,4,7,5,0.323711,0.327004,0.000001,No
15802,californium,7,13.15062203,4,9.433503923,9.433473923,28,124.0564445,3,4,7,3,6,9,4,0.405292,0.422878,0.000001,No
854,vermin,5,13.48709426,5,9.210360372,9.210320372,25,124.2209985,3,4,7,4,4,8,5,0.355817,0.367693,0.000001,No
1557,tome,5,13.48709426,5,9.210360372,9.210320372,25,124.2209985,3,4,7,4,4,8,5,0.388799,0.405624,0.000001,No
2547,stink,5,13.48709426,5,9.210360372,9.210320372,25,124.2209985,3,4,7,4,4,8,5,0.34041,0.347824,0.000001,No
9662,intrigue,5,13.48709426,5,9.210360372,9.210320372,25,124.2209985,3,4,7,3,4,7,5,0.384354,0.400585,0.000001,No
14718,conclave,5,13.48709426,5,9.210360372,9.210320372,25,124.2209985,3,4,7,5,4,9,4,0.41342,0.430825,0.000001,No
16454,blockage,5,13.48709426,5,9.210360372,9.210320372,25,124.2209985,3,4,7,4,5,9,5,0.38058,0.396636,0.000001,No
4151,runic,6,13.30477271,4,9.433503923,9.433473923,24,125.5106255,3,4,7,4,5,9,5,0.350402,0.360262,0.000001,No
11035,grumman,6,13.30477271,4,9.433503923,9.433473923,24,125.5106255,3,4,7,6,5,11,5,0.349223,0.358649,0.000001,No
10435,hobo,5,13.48709426,4,9.433503923,9.433473923,20,127.2305567,3,4,7,4,4,8,5,0.353754,0.364764,0.000001,No
14902,colette,7,13.15062203,3,9.721185996,9.721165996,21,127.8396427,3,4,7,4,4,8,4,0.395152,0.412273,0.000001,No
617,waldorf,4,13.71023782,4,9.433503923,9.433473923,16,129.3355822,3,4,7,3,4,7,5,0.375866,0.392442,0.000001,No
859,verify,4,13.71023782,4,9.433503923,9.433473923,16,129.3355822,3,4,7,3,4,7,4,0.399078,0.416732,0.000001,No
1619,tinge,4,13.71023782,4,9.433503923,9.433473923,16,129.3355822,3,4,7,3,4,7,4,0.415559,0.432849,0.000001,No
3086,snapdragon,4,13.71023782,4,9.433503923,9.433473923,16,129.3355822,3,4,7,3,4,7,4,0.412373,0.429614,0.000001,No
6621,okra,4,13.71023782,4,9.433503923,9.433473923,16,129.3355822,3,4,7,3,4,7,5,0.340384,0.347763,0.000001,No
8090,marimba,5,13.48709426,3,9.721185996,9.721165996,15,131.1105519,3,4,7,5,4,9,5,0.360127,0.372802,0.000001,No
570,warranty,7,13.15062203,2,10.1266511,10.1266411,14,133.1717611,3,4,7,7,6,13,5,0.351491,0.361934,0.000001,No
58,yttrium,4,13.71023782,3,9.721185996,9.721165996,12,133.2797719,3,4,7,3,4,7,5,0.3755,0.390825,0.000001,No
14769,complexion,4,13.71023782,2,10.1266511,10.1266411,8,138.8387949,3,4,7,3,4,7,5,0.352314,0.362652,0.000001,No
7527,missy,12,12.53158282,10,8.421903011,8.421803008,120,105.5397751,4,3,7,4,10,14,5,0.308327,0.313362,0.000001,No
17692,angiosperm,11,12.6986369,9,8.622573707,8.622493705,99,109.4949327,4,3,7,10,8,18,5,0.384979,0.401252,0.000001,No
8481,lookup,9,12.8993076,5,9.210360372,9.210320372,45,118.8072715,4,3,7,6,7,13,4,0.389841,0.406587,0.000001,No
14803,compagnie,6,13.30477271,5,9.210360372,9.210320372,30,122.5417513,4,3,7,4,3,7,5,0.355739,0.367604,0.000001,No
652,vulture,5,13.48709426,5,9.210360372,9.210320372,25,124.2209985,4,3,7,4,3,7,5,0.410134,0.427734,0.000001,No
1515,tori,5,13.48709426,5,9.210360372,9.210320372,25,124.2209985,4,3,7,4,4,8,5,0.318352,0.322297,0.000001,No
5672,planar,5,13.48709426,5,9.210360372,9.210320372,25,124.2209985,4,3,7,4,3,7,5,0.33413,0.339753,0.000001,No
12095,fishery,5,13.48709426,5,9.210360372,9.210320372,25,124.2209985,4,3,7,4,3,7,5,0.385213,0.401505,0.000001,No
15524,cation,6,13.30477271,4,9.433503923,9.433473923,24,125.5106255,4,3,7,5,5,10,4,0.389772,0.406512,0.000001,No
7856,medial,5,13.48709426,4,9.433503923,9.433473923,20,127.2305567,4,3,7,5,4,9,5,0.31381,0.318637,0.000001,No
13317,doubleday,5,13.48709426,4,9.433503923,9.433473923,20,127.2305567,4,3,7,5,3,8,5,0.384695,0.400956,0.000001,No
17931,algol,5,13.48709426,4,9.433503923,9.433473923,20,127.2305567,4,3,7,4,3,7,5,0.353641,0.364584,0.000001,No
2412,sturm,4,13.71023782,4,9.433503923,9.433473923,16,129.3355822,4,3,7,4,3,7,4,0.408567,0.426131,0.000001,No
3799,scot,4,13.71023782,4,9.433503923,9.433473923,16,129.3355822,4,3,7,4,3,7,5,0.398433,0.416199,0.000001,No
7709,metcalf,5,13.48709426,3,9.721185996,9.721165996,15,131.1105519,4,3,7,5,3,8,5,0.399401,0.417133,0.000001,No
14562,continual,5,13.48709426,3,9.721185996,9.721165996,15,131.1105519,4,3,7,5,4,9,5,0.314829,0.319112,0.000001,No
10914,hailstone,7,13.15062203,2,10.1266511,10.1266411,14,133.1717611,4,3,7,7,4,11,4,0.425796,0.442219,0.000001,No
9137,kinsman,4,13.71023782,3,9.721185996,9.721165996,12,133.2797719,4,3,7,4,4,8,4,0.389986,0.406747,0.000001,No
11505,gavin,13,12.53158282,11,8.421903011,8.421803008,143,105.5397751,5,2,7,8,2,10,5,0.311716,0.31632,0.000001,No
2016,tanya,8,13.01709064,8,8.740356743,8.740286741,64,113.7740159,5,2,7,6,2,8,5,0.31618,0.320217,0.000001,No
18349,abdominal,6,13.30477271,6,9.028038815,9.027988815,36,120.1160044,5,2,7,5,3,8,5,0.31936,0.322752,0.000001,No
3613,septic,5,13.48709426,5,9.210360372,9.210320372,25,124.2209985,5,2,7,5,4,9,5,0.318078,0.321644,0.000001,No
13873,declination,5,13.48709426,5,9.210360372,9.210320372,25,124.2209985,5,2,7,5,2,7,5,0.40425,0.421833,0.000001,No
6714,obsessive,6,13.30477271,6,9.028038815,9.027988815,36,120.1160044,6,1,7,6,3,9,1,1,1,0.000001,No
7447,monad,2,14.403385,2,10.1266511,10.1266411,4,145.8580546,1,2,3,1,2,3,5,0.360866,0.373548,0.000002,No
9391,johansen,2,14.403385,2,10.1266511,10.1266411,4,145.8580546,1,2,3,1,2,3,5,0.384329,0.400524,0.000002,No
18209,actinide,7,13.15062203,5,9.210360372,9.210320372,35,121.121968,2,4,6,7,7,14,5,0.329558,0.333683,0.000001,No
11033,grunt,6,13.30477271,5,9.210360372,9.210320372,30,122.5417513,2,4,6,4,5,9,5,0.350098,0.36015,0.000001,No
13738,deoxyribose,4,13.71023782,4,9.433503923,9.433473923,16,129.3355822,2,4,6,2,4,6,5,0.369897,0.384318,0.000001,No
14159,cud,4,13.71023782,3,9.721185996,9.721165996,12,133.2797719,2,4,6,4,4,8,5,0.395169,0.412289,0.000001,No
8285,maelstrom,1,15.09653218,1,10.81979828,10.81979828,1,163.341433,1,1,2,1,1,2,6,0.274894,0.280708,0.000003,No
1096,umbilical,8,13.01709064,8,8.740356743,8.740286741,64,113.7740159,3,3,6,7,7,14,5,0.321,0.324301,0.000001,No
9661,intrinsic,6,13.30477271,5,9.210360372,9.210320372,30,122.5417513,3,3,6,3,3,6,5,0.315865,0.31987,0.000001,No
10261,hug,6,13.30477271,5,9.210360372,9.210320372,30,122.5417513,3,3,6,5,4,9,4,0.392713,0.409686,0.000001,No
12683,errol,6,13.30477271,5,9.210360372,9.210320372,30,122.5417513,3,3,6,3,6,9,5,0.319366,0.322987,0.000001,No
9027,labia,7,13.15062203,4,9.433503923,9.433473923,28,124.0564445,3,3,6,6,3,9,4,0.405172,0.422741,0.000001,No
7788,mendelevium,5,13.48709426,4,9.433503923,9.433473923,20,127.2305567,3,3,6,3,4,7,5,0.357249,0.369037,0.000001,No
1875,tensor,4,13.71023782,4,9.433503923,9.433473923,16,129.3355822,3,3,6,3,3,6,5,0.360917,0.373632,0.000001,No
6021,penitentiary,4,13.71023782,4,9.433503923,9.433473923,16,129.3355822,3,3,6,4,3,7,5,0.375635,0.392198,0.000001,No
6061,pee,4,13.71023782,4,9.433503923,9.433473923,16,129.3355822,3,3,6,3,4,7,5,0.398094,0.41588,0.000001,No
10469,hippodrome,4,13.71023782,4,9.433503923,9.433473923,16,129.3355822,3,3,6,4,3,7,5,0.360939,0.373651,0.000001,No
14299,crap,4,13.71023782,4,9.433503923,9.433473923,16,129.3355822,3,3,6,3,3,6,5,0.330331,0.334777,0.000001,No
7812,melodrama,6,13.30477271,3,9.721185996,9.721165996,18,129.3381701,3,3,6,4,6,10,5,0.345855,0.354831,0.000001,No
1606,tit,4,13.71023782,3,9.721185996,9.721165996,12,133.2797719,3,3,6,3,3,6,5,0.345075,0.353784,0.000001,No
3451,shinbone,4,13.71023782,3,9.721185996,9.721165996,12,133.2797719,3,3,6,4,4,8,5,0.390948,0.408016,0.000001,No
8386,lunate,4,13.71023782,3,9.721185996,9.721165996,12,133.2797719,3,3,6,3,3,6,5,0.39829,0.416054,0.000001,No
12273,fearsome,4,13.71023782,3,9.721185996,9.721165996,12,133.2797719,3,3,6,3,3,6,5,0.319194,0.322571,0.000001,No
2739,spurious,3,13.99791989,3,9.721185996,9.721165996,9,136.0763828,3,3,6,3,3,6,5,0.398255,0.41603,0.000001,No
16944,bargain,3,13.99791989,3,9.721185996,9.721165996,9,136.0763828,3,3,6,3,3,6,4,0.391828,0.408705,0.000001,No
17313,assemblage,3,13.99791989,3,9.721185996,9.721165996,9,136.0763828,3,3,6,3,3,6,4,0.387746,0.404818,0.000001,No
3892,scandium,5,13.48709426,2,10.1266511,10.1266411,10,136.579098,3,3,6,3,5,8,4,0.389875,0.406625,0.000001,No
6060,peek,3,13.99791989,2,10.1266511,10.1266411,6,141.7520509,3,3,6,3,3,6,5,0.382953,0.399223,0.000001,No
3443,shipman,3,13.99791989,1,10.81979828,10.81979828,3,151.4546696,3,3,6,3,3,6,4,0.383822,0.400438,0.000001,No
7416,monsanto,3,13.99791989,3,9.721185996,9.721165996,9,136.0763828,2,1,3,2,1,3,6,0.261205,0.265117,0.000002,No
3186,slant,2,14.403385,2,10.1266511,10.1266411,4,145.8580546,2,1,3,2,1,3,5,0.378607,0.394397,0.000002,No
6815,notoriety,2,14.403385,2,10.1266511,10.1266411,4,145.8580546,2,1,3,2,2,4,5,0.360829,0.373487,0.000002,No
16607,bib,2,14.403385,2,10.1266511,10.1266411,4,145.8580546,2,1,3,2,1,3,5,0.286113,0.292352,0.000002,No
1213,tun,8,13.01709064,7,8.873888135,8.873828135,56,115.5122061,4,2,6,5,5,10,5,0.376049,0.392583,0.000001,No
1408,transient,4,13.71023782,4,9.433503923,9.433473923,16,129.3355822,4,2,6,4,2,6,5,0.359216,0.371588,0.000001,No
10043,impartial,4,13.71023782,4,9.433503923,9.433473923,16,129.3355822,4,2,6,4,2,6,5,0.33604,0.342244,0.000001,No
13165,dunlop,4,13.71023782,3,9.721185996,9.721165996,12,133.2797719,4,2,6,4,2,6,5,0.384246,0.40043,0.000001,No
15866,byway,5,13.48709426,5,9.210360372,9.210320372,25,124.2209985,1,4,5,4,4,8,4,0.407741,0.425328,0.000001,No
6151,pathway,4,13.71023782,3,9.721185996,9.721165996,12,133.2797719,1,4,5,2,4,6,5,0.363556,0.376682,0.000001,No
2602,steeplechase,5,13.48709426,4,9.433503923,9.433473923,20,127.2305567,2,3,5,3,4,7,4,0.405265,0.422826,0.000001,No
12304,fasten,5,13.48709426,4,9.433503923,9.433473923,20,127.2305567,2,3,5,5,3,8,5,0.376248,0.392761,0.000001,No
8721,lew,4,13.71023782,4,9.433503923,9.433473923,16,129.3355822,2,3,5,2,3,5,5,0.310941,0.315673,0.000001,No
16609,bianco,4,13.71023782,4,9.433503923,9.433473923,16,129.3355822,2,3,5,3,4,7,5,0.369097,0.383299,0.000001,No
3545,shack,4,13.71023782,3,9.721185996,9.721165996,12,133.2797719,2,3,5,2,3,5,4,0.405015,0.422572,0.000001,No
8541,lobo,4,13.71023782,3,9.721185996,9.721165996,12,133.2797719,2,3,5,3,3,6,5,0.425123,0.441944,0.000001,No
10462,hirsch,4,13.71023782,3,9.721185996,9.721165996,12,133.2797719,2,3,5,3,3,6,5,0.351011,0.361023,0.000001,No
4423,rhetorician,3,13.99791989,3,9.721185996,9.721165996,9,136.0763828,2,3,5,3,3,6,5,0.336117,0.342187,0.000001,No
15780,calyx,3,13.99791989,3,9.721185996,9.721165996,9,136.0763828,2,3,5,2,3,5,5,0.388382,0.404998,0.000001,No
397,whipple,3,13.99791989,2,10.1266511,10.1266411,6,141.7520509,2,3,5,3,3,6,4,0.412363,0.429586,0.000001,No
6966,niamey,3,13.99791989,2,10.1266511,10.1266411,6,141.7520509,2,3,5,2,3,5,4,0.391146,0.407996,0.000001,No
10862,handful,14,12.45747485,14,8.180740955,8.180610949,196,101.9113747,3,2,5,14,13,27,4,0.408351,0.425896,0.000001,No
5069,psychoanalyst,5,13.48709426,5,9.210360372,9.210320372,25,124.2209985,3,2,5,3,3,6,5,0.404821,0.422175,0.000001,No
5632,playmate,5,13.48709426,5,9.210360372,9.210320372,25,124.2209985,3,2,5,4,5,9,5,0.378623,0.394434,0.000001,No
1506,torr,4,13.71023782,4,9.433503923,9.433473923,16,129.3355822,3,2,5,4,2,6,5,0.34024,0.347528,0.000001,No
9571,irritable,4,13.71023782,4,9.433503923,9.433473923,16,129.3355822,3,2,5,4,3,7,5,0.321047,0.327244,0.000001,No
11687,fudge,4,13.71023782,4,9.433503923,9.433473923,16,129.3355822,3,2,5,3,2,5,4,0.405163,0.422713,0.000001,No
13191,dugan,4,13.71023782,4,9.433503923,9.433473923,16,129.3355822,3,2,5,4,3,7,4,0.412334,0.429539,0.000001,No
1320,trickster,3,13.99791989,3,9.721185996,9.721165996,9,136.0763828,3,2,5,3,2,5,5,0.36795,0.38217,0.000001,No
2522,stoneware,3,13.99791989,3,9.721185996,9.721165996,9,136.0763828,3,2,5,3,3,6,5,0.385188,0.401458,0.000001,No
5563,poinsettia,3,13.99791989,3,9.721185996,9.721165996,9,136.0763828,3,2,5,3,2,5,5,0.384562,0.400787,0.000001,No
6893,nobelium,3,13.99791989,3,9.721185996,9.721165996,9,136.0763828,3,2,5,3,3,6,4,0.389755,0.406475,0.000001,No
7999,mastiff,3,13.99791989,3,9.721185996,9.721165996,9,136.0763828,3,2,5,3,2,5,5,0.375889,0.392348,0.000001,No
9348,joyous,3,13.99791989,3,9.721185996,9.721165996,9,136.0763828,3,2,5,3,2,5,5,0.325665,0.329001,0.000001,No
10164,hyperbola,3,13.99791989,3,9.721185996,9.721165996,9,136.0763828,3,2,5,3,3,6,4,0.405163,0.422713,0.000001,No
16924,barony,3,13.99791989,3,9.721185996,9.721165996,9,136.0763828,3,2,5,3,2,5,4,0.417789,0.434971,0.000001,No
17478,arapaho,3,13.99791989,3,9.721185996,9.721165996,9,136.0763828,3,2,5,3,2,5,5,0.398532,0.41626,0.000001,No
8643,limpet,3,13.99791989,2,10.1266511,10.1266411,6,141.7520509,3,2,5,3,2,5,4,0.389755,0.406475,0.000001,No
12591,euterpe,3,13.99791989,2,10.1266511,10.1266411,6,141.7520509,3,2,5,3,3,6,5,0.398953,0.416701,0.000001,No
2701,stag,3,13.99791989,3,9.721185996,9.721165996,9,136.0763828,1,3,4,1,3,4,5,0.355475,0.367195,0.000001,No
1269,trot,3,13.99791989,2,10.1266511,10.1266411,6,141.7520509,1,3,4,2,3,5,4,0.399644,0.417305,0.000001,No
13289,downy,3,13.99791989,2,10.1266511,10.1266411,6,141.7520509,1,1,2,1,1,2,6,0.265602,0.270417,0.000002,No
14312,crafty,2,14.403385,2,10.1266511,10.1266411,4,145.8580546,1,1,2,1,1,2,6,0.26517,0.269914,0.000002,No
2691,stairwell,1,15.09653218,1,10.81979828,10.81979828,1,163.341433,1,1,2,1,1,2,5,0.384246,0.400407,0.000002,No
3579,serviette,1,15.09653218,1,10.81979828,10.81979828,1,163.341433,1,1,2,1,1,2,5,0.375317,0.391855,0.000002,No
3603,seraphim,1,15.09653218,1,10.81979828,10.81979828,1,163.341433,1,1,2,1,1,2,6,0.256351,0.259665,0.000002,No
4928,quagmire,1,15.09653218,1,10.81979828,10.81979828,1,163.341433,1,1,2,1,1,2,5,0.398076,0.415824,0.000002,No
14965,cobble,1,15.09653218,1,10.81979828,10.81979828,1,163.341433,1,1,2,1,1,2,5,0.384246,0.400407,0.000002,No
18139,adrenal,12,12.61162553,7,8.873888135,8.873828135,84,111.9141541,2,2,4,12,6,18,5,0.313921,0.318133,0.000001,No
6700,occipital,4,13.71023782,4,9.433503923,9.433473923,16,129.3355822,2,2,4,3,4,7,5,0.320017,0.323385,0.000001,No
7917,mccracken,4,13.71023782,4,9.433503923,9.433473923,16,129.3355822,2,2,4,4,2,6,5,0.384604,0.400834,0.000001,No
12904,elusive,5,13.48709426,3,9.721185996,9.721165996,15,131.1105519,2,2,4,5,2,7,5,0.326497,0.330015,0.000001,No
4096,sadie,4,13.71023782,3,9.721185996,9.721165996,12,133.2797719,2,2,4,2,3,5,5,0.395565,0.41265,0.000001,No
3127,sluggish,3,13.99791989,3,9.721185996,9.721165996,9,136.0763828,2,2,4,2,2,4,5,0.317158,0.320907,0.000001,No
5446,portico,3,13.99791989,3,9.721185996,9.721165996,9,136.0763828,2,2,4,3,3,6,5,0.363303,0.376463,0.000001,No
7283,mucosa,3,13.99791989,3,9.721185996,9.721165996,9,136.0763828,2,2,4,2,2,4,5,0.333102,0.338126,0.000001,No
13732,depletion,3,13.99791989,3,9.721185996,9.721165996,9,136.0763828,2,2,4,3,2,5,5,0.398094,0.415861,0.000001,No
292,winkle,2,14.403385,2,10.1266511,10.1266411,4,145.8580546,2,2,4,2,2,4,5,0.385623,0.401942,0.000001,No
3049,sobriety,2,14.403385,2,10.1266511,10.1266411,4,145.8580546,2,2,4,2,2,4,5,0.384279,0.400463,0.000001,No
3323,sikorsky,2,14.403385,2,10.1266511,10.1266411,4,145.8580546,2,2,4,2,2,4,5,0.398308,0.416054,0.000001,No
3754,scum,2,14.403385,2,10.1266511,10.1266411,4,145.8580546,2,2,4,2,2,4,5,0.338947,0.345763,0.000001,No
5363,pragmatic,2,14.403385,2,10.1266511,10.1266411,4,145.8580546,2,2,4,2,2,4,5,0.321582,0.324787,0.000001,No
5711,pistachio,2,14.403385,2,10.1266511,10.1266411,4,145.8580546,2,2,4,2,2,4,5,0.322564,0.328211,0.000001,No
9871,infantryman,2,14.403385,2,10.1266511,10.1266411,4,145.8580546,2,2,4,2,2,4,5,0.297312,0.303304,0.000001,No
10546,hester,2,14.403385,2,10.1266511,10.1266411,4,145.8580546,2,2,4,2,2,4,5,0.384287,0.400477,0.000001,No
14784,competent,2,14.403385,2,10.1266511,10.1266411,4,145.8580546,2,2,4,2,2,4,5,0.325886,0.329733,0.000001,No
14987,clutter,2,14.403385,2,10.1266511,10.1266411,4,145.8580546,2,2,4,2,2,4,5,0.398094,0.415856,0.000001,No
17868,aloe,2,14.403385,2,10.1266511,10.1266411,4,145.8580546,2,2,4,2,2,4,5,0.384254,0.400439,0.000001,No
12489,exorcism,2,14.403385,1,10.81979828,10.81979828,2,155.8417203,2,2,4,2,2,4,5,0.386589,0.403026,0.000001,No
14883,collie,5,13.48709426,4,9.433503923,9.433473923,20,127.2305567,3,1,4,4,3,7,5,0.384237,0.400402,0.000001,No
7592,mimosa,2,14.403385,2,10.1266511,10.1266411,4,145.8580546,1,2,3,1,2,3,5,0.360917,0.373609,0.000001,No
7984,mathewson,2,14.403385,2,10.1266511,10.1266411,4,145.8580546,1,2,3,2,2,4,5,0.384379,0.400576,0.000001,No
285,wintergreen,2,14.403385,1,10.81979828,10.81979828,2,155.8417203,1,2,3,2,2,4,5,0.303073,0.308638,0.000001,No
18234,aching,3,13.99791989,3,9.721185996,9.721165996,9,136.0763828,2,1,3,2,1,3,5,0.375325,0.39186,0.000001,No
10610,hendrickson,3,13.99791989,2,10.1266511,10.1266411,6,141.7520509,2,1,3,3,1,4,5,0.375325,0.39186,0.000001,No
1529,toothy,2,14.403385,2,10.1266511,10.1266411,4,145.8580546,2,1,3,2,1,3,6,0.278312,0.284255,0.000001,No
7002,neurotic,2,14.403385,2,10.1266511,10.1266411,4,145.8580546,2,1,3,2,1,3,5,0.384237,0.400402,0.000001,No
13039,edmondson,2,14.403385,2,10.1266511,10.1266411,4,145.8580546,2,1,3,2,1,3,5,0.398085,0.415828,0.000001,No
17935,alger,2,14.403385,2,10.1266511,10.1266411,4,145.8580546,2,1,3,2,1,3,5,0.378607,0.394397,0.000001,No
18009,airspeed,2,14.403385,2,10.1266511,10.1266411,4,145.8580546,2,1,3,2,1,3,5,0.359179,0.371527,0.000001,No
3591,serif,2,14.403385,2,10.1266511,10.1266411,4,145.8580546,1,1,2,2,1,3,5,0.304634,0.309909,0.000001,No
4779,raman,2,14.403385,2,10.1266511,10.1266411,4,145.8580546,1,1,2,1,1,2,5,0.398076,0.415824,0.000001,No
12712,erastus,2,14.403385,2,10.1266511,10.1266411,4,145.8580546,1,1,2,1,1,2,6,0.260309,0.264307,0.000001,No
15735,candide,2,14.403385,2,10.1266511,10.1266411,4,145.8580546,1,1,2,1,1,2,5,0.302521,0.308032,0.000001,No
7357,morrill,2,14.403385,1,10.81979828,10.81979828,2,155.8417203,1,1,2,2,1,3,5,0.398085,0.415828,0.000001,No
6,zorn,1,15.09653218,1,10.81979828,10.81979828,1,163.341433,1,1,2,1,1,2,5,0.294618,0.300697,0.000001,No
1097,umber,1,15.09653218,1,10.81979828,10.81979828,1,163.341433,1,1,2,1,1,2,5,0.281347,0.287457,0.000001,No
2415,stupor,1,15.09653218,1,10.81979828,10.81979828,1,163.341433,1,1,2,1,1,2,5,0.384237,0.400402,0.000001,No
3838,schoolmate,1,15.09653218,1,10.81979828,10.81979828,1,163.341433,1,1,2,1,1,2,5,0.384237,0.400402,0.000001,No
4642,reek,1,15.09653218,1,10.81979828,10.81979828,1,163.341433,1,1,2,1,1,2,5,0.384234,0.400398,0.000001,No
6396,oxcart,1,15.09653218,1,10.81979828,10.81979828,1,163.341433,1,1,2,1,1,2,5,0.375317,0.391855,0.000001,No
7161,nagging,1,15.09653218,1,10.81979828,10.81979828,1,163.341433,1,1,2,1,1,2,5,0.384246,0.400407,0.000001,No
7453,momenta,1,15.09653218,1,10.81979828,10.81979828,1,163.341433,1,1,2,1,1,2,5,0.378607,0.394397,0.000001,No
8549,loamy,1,15.09653218,1,10.81979828,10.81979828,1,163.341433,1,1,2,1,1,2,5,0.384237,0.400402,0.000001,No
9086,knowlton,1,15.09653218,1,10.81979828,10.81979828,1,163.341433,1,1,2,1,1,2,5,0.398085,0.415828,0.000001,No
9372,jonquil,1,15.09653218,1,10.81979828,10.81979828,1,163.341433,1,1,2,1,1,2,5,0.384246,0.400407,0.000001,No
10348,hookworm,1,15.09653218,1,10.81979828,10.81979828,1,163.341433,1,1,2,1,1,2,6,0.274822,0.280624,0.000001,No
13963,daugherty,1,15.09653218,1,10.81979828,10.81979828,1,163.341433,1,1,2,1,1,2,5,0.384237,0.400402,0.000001,No
14981,coachwork,1,15.09653218,1,10.81979828,10.81979828,1,163.341433,1,1,2,1,1,2,5,0.375325,0.39186,0.000001,No
18339,abhorrent,1,15.09653218,1,10.81979828,10.81979828,1,163.341433,1,1,2,1,1,2,5,0.35519,0.366885,0.000001,No
4639,refer,643,8.630387453,614,4.399803356,4.393654614,394802,37.97200768,35,11,46,607,641,1248,4,0.420142,0.437285,0,No
4489,responsible,240,9.615893254,221,5.421635583,5.419433203,53040,52.13386903,44,9,53,207,230,437,4,0.417415,0.434656,0,No
14785,compete,124,10.27625061,116,6.066208093,6.065057454,14384,62.33787463,19,23,42,99,120,219,4,0.437055,0.452646,0,No
8041,martial,145,10.11979843,89,6.331161914,6.330281545,12905,64.07008243,41,6,47,88,31,119,5,0.369343,0.383562,0,No
14807,communicate,111,10.38700198,102,6.194825471,6.193814981,11322,64.34566441,13,30,43,99,101,200,4,0.457488,0.469692,0,No
13110,earn,98,10.5115647,90,6.319988614,6.319098235,8820,66.43296921,19,30,49,92,85,177,4,0.438849,0.454383,0,No
17000,baltic,114,10.36033373,81,6.42534913,6.424548825,9234,66.56876131,19,13,32,107,81,188,4,0.424219,0.440956,0,No
4380,rid,88,10.61919536,77,6.475992862,6.475232589,6776,68.76983337,5,2,7,63,88,151,5,0.380213,0.396148,0,No
8896,latter,82,10.68981293,79,6.450350432,6.449570143,6478,68.95303945,7,38,45,77,66,143,4,0.463412,0.47448,0,No
1673,thursday,81,10.70208302,71,6.557118407,6.556418176,5751,70.17482558,18,28,46,78,68,146,4,0.450156,0.463758,0,No
14616,consist,73,10.80607274,71,6.557118407,6.556418176,5183,70.85669845,23,4,27,45,70,115,5,0.384221,0.40069,0,No
1349,trek,109,10.4051843,53,6.849506371,6.848986246,5777,71.27037612,5,35,40,109,90,199,4,0.4565,0.469006,0,No
12533,exception,71,10.8338523,69,6.58569178,6.585011562,4899,71.34841204,15,18,33,67,70,137,4,0.44921,0.462796,0,No
12977,eldest,71,10.8338523,66,6.630143542,6.629493344,4686,71.82999587,16,12,28,66,68,134,4,0.413179,0.430577,0,No
11631,ga,73,10.80607274,63,6.676663558,6.676043378,4599,72.14851204,8,11,19,57,12,69,5,0.37314,0.388219,0,No
3797,scotia,78,10.73982335,59,6.74226084,6.741680684,4602,72.41069041,3,33,36,78,62,140,4,0.444453,0.459143,0,No
12260,fed,66,10.90687744,63,6.676663558,6.676043378,4158,72.8215511,18,23,41,57,61,118,4,0.444164,0.458669,0,No
13735,depend,64,10.93764909,59,6.74226084,6.741680684,3776,73.74448317,22,4,26,40,62,102,5,0.346943,0.355929,0,No
13841,define,62,10.96939779,60,6.725453722,6.72486356,3720,73.77417721,13,24,37,54,52,106,4,0.420311,0.437834,0,No
14568,contestant,81,10.70208302,50,6.907775279,6.907285168,4050,73.92758454,11,19,30,70,62,132,4,0.452832,0.465772,0,No
8995,lahore,79,10.72708432,50,6.907775279,6.907285168,3950,74.10028791,20,29,49,68,58,126,4,0.456289,0.468706,0,No
2542,stirling,69,10.86242567,53,6.849506371,6.848986246,3657,74.40225385,14,23,37,52,57,109,4,0.436303,0.451951,0,No
3963,sardinia,65,10.92214491,53,6.849506371,6.848986246,3445,74.81130112,8,28,36,61,55,116,4,0.438654,0.454092,0,No
6919,nineteenth,57,11.05348091,57,6.776747016,6.776186871,3249,74.90664377,6,8,14,52,52,104,5,0.386522,0.40305,0,No
17592,antiquity,59,11.01899473,55,6.812465099,6.811924964,3245,75.06651705,13,29,42,42,46,88,4,0.464273,0.474983,0,No
17052,baden,70,10.84803694,49,6.927977986,6.92749788,3430,75.15496108,15,18,33,58,60,118,4,0.438654,0.453876,0,No
13991,danube,82,10.68981293,44,7.03560865,7.035178566,3608,75.20934032,7,22,29,76,60,136,4,0.456347,0.46864,0,No
2348,suggest,56,11.07118049,56,6.794446593,6.793896453,3136,75.22254454,21,13,34,28,52,80,4,0.425694,0.442599,0,No
5311,prepare,59,11.01899473,54,6.830814238,6.830284108,3186,75.26870611,13,19,32,52,51,103,4,0.449256,0.462838,0,No
3893,scandinavia,58,11.03608917,54,6.830814238,6.830284108,3132,75.38547501,21,23,44,55,50,105,4,0.439588,0.454791,0,No
17383,arrival,56,11.07118049,55,6.812465099,6.811924964,3080,75.42203067,12,11,23,54,51,105,4,0.447027,0.460969,0,No
8498,lombardy,60,11.00218762,52,6.868554566,6.868044446,3120,75.56912598,12,12,24,56,50,106,4,0.409443,0.426962,0,No
7139,napoleonic,56,11.07118049,53,6.849506371,6.848986246,2968,75.83212127,13,2,15,46,2,48,5,0.331447,0.335901,0,No
6278,papua,70,10.84803694,46,6.991156888,6.990706795,3220,75.84032814,20,12,32,60,66,126,4,0.421289,0.438215,0,No
9920,indies,56,11.07118049,52,6.868554566,6.868044446,2912,76.04300728,7,29,36,55,46,101,4,0.443653,0.458378,0,No
12768,ephemeris,55,11.08919899,52,6.868554566,6.868044446,2860,76.16676837,7,14,21,41,20,61,4,0.399114,0.416667,0,No
12149,fill,54,11.10754813,51,6.887972651,6.887472536,2754,76.50848775,16,22,38,49,50,99,4,0.455107,0.467654,0,No
9484,janeiro,69,10.86242567,43,7.058598169,7.058178089,2967,76.67349796,1,29,30,69,59,128,4,0.454944,0.46765,0,No
1544,tonight,60,11.00218762,47,6.969650683,6.969190586,2820,76.68140442,23,29,52,51,57,108,4,0.415588,0.433206,0,No
11476,generate,54,11.10754813,50,6.907775279,6.907285168,2700,76.72844639,10,24,34,49,36,85,4,0.437486,0.453007,0,No
6747,oakland,66,10.90687744,44,7.03560865,7.035178566,2904,76.73652123,20,17,37,53,42,95,4,0.446813,0.460782,0,No
6691,oceania,64,10.93764909,44,7.03560865,7.035178566,2816,76.95301858,16,28,44,46,53,99,4,0.448258,0.462162,0,No
12484,expand,53,11.12624026,49,6.927977986,6.92749788,2597,77.08234762,15,22,37,46,45,91,4,0.454141,0.466884,0,No
15338,chat,70,10.84803694,40,7.13091883,7.130528762,2800,77.35647085,19,21,40,40,40,80,4,0.43754,0.452989,0,No
11899,forbidden,52,11.14528846,46,6.991156888,6.990706795,2392,77.91846017,13,18,31,42,47,89,5,0.407124,0.424851,0,No
1152,twentieth,50,11.18450917,47,6.969650683,6.969190586,2350,77.95212198,12,7,19,45,42,87,5,0.33403,0.339401,0,No
7089,ncaa,66,10.90687744,39,7.156236638,7.155856573,2574,78.05219591,14,21,35,56,63,119,4,0.402919,0.420601,0,No
13488,discuss,52,11.14528846,45,7.013135794,7.012695706,2340,78.16342143,7,27,34,48,38,86,4,0.441424,0.456453,0,No
13431,divisible,51,11.16470654,45,7.013135794,7.012695706,2295,78.2996031,5,1,6,48,51,99,5,0.347133,0.356191,0,No
18152,admitted,49,11.20471188,46,6.991156888,6.990706795,2254,78.33389863,20,12,32,46,46,92,5,0.382647,0.399073,0,No
17599,antilles,66,10.90687744,38,7.182212124,7.181842063,2508,78.33550736,6,31,37,39,60,99,4,0.444742,0.459322,0,No
12474,expelled,50,11.18450917,45,7.013135794,7.012695706,2250,78.43848162,16,15,31,43,46,89,4,0.44126,0.456092,0,No
15159,cia,63,10.95339745,38,7.182212124,7.181842063,2394,78.66962398,14,24,38,51,47,98,4,0.444041,0.458622,0,No
17542,apostle,55,11.08919899,41,7.106226218,7.105826145,2255,78.80235661,8,22,30,51,47,98,4,0.460909,0.472246,0,No
5048,publish,49,11.20471188,44,7.03560865,7.035178566,2156,78.83196782,13,19,32,43,35,78,4,0.45145,0.464622,0,No
1234,tuberculosis,52,11.14528846,42,7.082128666,7.08171859,2184,78.93236688,15,22,37,41,44,85,4,0.448847,0.462561,0,No
10335,horizon,62,10.96939779,37,7.208880372,7.208520314,2294,79.07707643,11,36,47,58,55,113,4,0.467833,0.477832,0,No
9923,indianapolis,59,11.01899473,38,7.182212124,7.181842063,2242,79.14075757,11,18,29,55,44,99,4,0.438459,0.453726,0,No
18136,adriatic,59,11.01899473,38,7.182212124,7.181842063,2242,79.14075757,3,4,7,59,58,117,5,0.325982,0.329656,0,No
12598,eurasia,51,11.16470654,41,7.106226218,7.105826145,2091,79.33893036,18,20,38,45,44,89,4,0.437098,0.452599,0,No
5464,populous,47,11.24638458,43,7.058598169,7.058178089,2021,79.38370957,2,19,21,47,38,85,5,0.412929,0.430475,0,No
14760,compose,45,11.28986969,44,7.03560865,7.035178566,1980,79.43110483,8,19,27,43,41,84,4,0.447749,0.461603,0,No
5421,postage,55,11.08919899,38,7.182212124,7.181842063,2090,79.64497945,23,5,28,41,28,69,5,0.361704,0.374659,0,No
5208,programmer,52,11.14528846,39,7.156236638,7.155856573,2028,79.75832161,9,24,33,37,34,71,4,0.421489,0.438694,0,No
17792,amino,64,10.93764909,34,7.29343776,7.293107712,2176,79.7730629,30,1,31,58,15,73,5,0.318238,0.321893,0,No
17330,aside,43,11.33533206,43,7.058598169,7.058178089,1849,80.01155413,17,14,31,29,42,71,4,0.447534,0.461429,0,No
6458,osaka,58,11.03608917,35,7.264450223,7.264110172,2030,80.17112041,20,24,44,34,45,79,4,0.456935,0.469124,0,No
4790,rainy,45,11.28986969,40,7.13091883,7.130528762,1800,80.50714434,17,18,35,41,38,79,4,0.436271,0.451848,0,No
15977,bullet,55,11.08919899,35,7.264450223,7.264110172,1925,80.55693409,14,26,40,48,42,90,4,0.455154,0.467762,0,No
530,watershed,46,11.26789078,39,7.156236638,7.155856573,1794,80.63569284,8,17,25,30,36,66,4,0.449233,0.462842,0,No
7614,milky,62,10.96939779,32,7.354062381,7.35375234,1984,80.66963565,9,4,13,59,61,120,5,0.376535,0.393027,0,No
7570,minneapolis,49,11.20471188,37,7.208880372,7.208520314,1813,80.77342754,19,19,38,47,41,88,4,0.435746,0.451397,0,No
12382,facto,45,11.28986969,39,7.156236638,7.155856573,1755,80.7929791,1,18,19,45,29,74,4,0.425428,0.442257,0,No
16822,beaten,45,11.28986969,39,7.156236638,7.155856573,1755,80.7929791,13,16,29,40,36,76,4,0.441842,0.456608,0,No
1711,thrash,48,11.22533117,37,7.208880372,7.208520314,1776,80.92206951,17,3,20,40,47,87,5,0.379287,0.395162,0,No
9747,install,48,11.22533117,36,7.236279346,7.235929291,1728,81.22963207,10,23,33,46,37,83,4,0.445994,0.460218,0,No
15432,certificate,52,11.14528846,34,7.29343776,7.293107712,1768,81.28746769,15,23,38,45,48,93,4,0.452128,0.465354,0,No
6708,obtain,41,11.38296011,39,7.156236638,7.155856573,1599,81.45915619,8,18,26,36,34,70,4,0.42685,0.443609,0,No
12437,extend,41,11.38296011,39,7.156236638,7.155856573,1599,81.45915619,14,17,31,33,38,71,4,0.429983,0.446374,0,No
12479,expect,41,11.38296011,39,7.156236638,7.155856573,1599,81.45915619,17,18,35,36,37,73,4,0.445043,0.459425,0,No
11009,guild,44,11.31234254,37,7.208880372,7.208520314,1628,81.54932412,6,15,21,12,28,40,4,0.413468,0.430919,0,No
6677,octave,52,11.14528846,33,7.323290723,7.322970678,1716,81.62018757,10,16,26,50,23,73,4,0.437616,0.452974,0,No
15256,chin,47,11.24638458,35,7.264450223,7.264110172,1645,81.69880094,9,21,30,33,41,74,4,0.460551,0.471945,0,No
15746,canary,47,11.24638458,35,7.264450223,7.264110172,1645,81.69880094,9,4,13,44,6,50,5,0.361697,0.374581,0,No
1640,tigris,41,11.38296011,38,7.182212124,7.181842063,1558,81.75483412,4,15,19,26,28,54,4,0.434328,0.450064,0,No
1047,upset,39,11.43297053,39,7.156236638,7.155856573,1521,81.8170426,18,21,39,31,36,67,4,0.452913,0.465889,0,No
16257,bourbon,44,11.31234254,36,7.236279346,7.235929291,1584,81.8592707,8,28,36,43,33,76,4,0.437131,0.452791,0,No
13286,dozen,45,11.28986969,35,7.264450223,7.264110172,1575,82.01469637,9,20,29,42,28,70,4,0.445423,0.459749,0,No
9147,kinetic,48,11.22533117,33,7.323290723,7.322970678,1584,82.20636359,19,5,24,35,46,81,5,0.325163,0.328792,0,No
6204,participate,38,11.45894602,38,7.182212124,7.181842063,1444,82.30058102,13,6,19,34,34,68,4,0.437702,0.452857,0,No
14114,curse,47,11.24638458,33,7.323290723,7.322970678,1551,82.36054383,11,22,33,42,40,82,4,0.462133,0.473199,0,No
2248,surround,39,11.43297053,37,7.208880372,7.208520314,1443,82.41891685,11,15,26,29,31,60,4,0.442282,0.456951,0,No
6813,notre,48,11.22533117,32,7.354062381,7.35375234,1536,82.55178565,12,1,13,40,48,88,5,0.312837,0.317219,0,No
764,vinci,41,11.38296011,35,7.264450223,7.264110172,1435,82.69094711,1,16,17,1,29,30,4,0.392209,0.409301,0,No
1071,unitary,44,11.31234254,33,7.323290723,7.322970678,1452,82.8435732,16,5,21,41,12,53,5,0.331534,0.336335,0,No
7814,melodic,43,11.33533206,33,7.323290723,7.322970678,1419,83.01193213,22,13,35,37,36,73,4,0.40401,0.421558,0,No
14510,convict,43,11.33533206,33,7.323290723,7.322970678,1419,83.01193213,8,17,25,41,31,72,4,0.429785,0.446196,0,No
9336,judicial,41,11.38296011,34,7.29343776,7.293107712,1394,83.02091109,21,13,34,37,25,62,4,0.423167,0.439999,0,No
18085,afford,37,11.48561426,36,7.236279346,7.235929291,1332,83.11311328,4,13,17,36,34,70,4,0.4361,0.451716,0,No
5122,protagonist,41,11.38296011,33,7.323290723,7.322970678,1353,83.36072618,6,15,21,39,34,73,4,0.442194,0.45696,0,No
17433,argue,39,11.43297053,34,7.29343776,7.293107712,1326,83.38565898,10,7,17,22,37,59,5,0.376104,0.391492,0,No
18112,aegean,40,11.40765272,33,7.323290723,7.322970678,1320,83.54155736,6,10,16,39,38,77,5,0.408275,0.425767,0,No
16900,basal,38,11.45894602,34,7.29343776,7.293107712,1292,83.57510957,17,17,34,31,24,55,5,0.403514,0.421285,0,No
659,vowel,51,11.16470654,28,7.487593774,7.487323743,1428,83.59678721,17,23,40,49,39,88,4,0.444531,0.458998,0,No
2377,succeed,36,11.51301324,35,7.264450223,7.264110172,1260,83.63571159,11,21,32,34,31,65,4,0.440046,0.455228,0,No
17455,architectural,36,11.51301324,35,7.264450223,7.264110172,1260,83.63571159,18,18,36,30,23,53,5,0.334836,0.340574,0,No
12512,execute,37,11.48561426,34,7.29343776,7.293107712,1258,83.76961277,9,21,30,33,27,60,4,0.439207,0.454547,0,No
7549,miracle,38,11.45894602,33,7.323290723,7.322970678,1254,83.91719306,6,23,29,27,29,56,4,0.440439,0.455556,0,No
8104,mare,44,11.31234254,30,7.418600903,7.418310866,1320,83.9217546,4,18,22,6,32,38,4,0.447918,0.46172,0,No
14018,damascus,44,11.31234254,30,7.418600903,7.418310866,1320,83.9217546,18,24,42,39,36,75,4,0.456747,0.469011,0,No
6734,obey,37,11.48561426,33,7.323290723,7.322970678,1221,84.11249239,12,17,29,33,33,66,4,0.422874,0.439919,0,No
13930,dealt,35,11.54118412,34,7.29343776,7.293107712,1190,84.17490802,17,8,25,31,32,63,4,0.390957,0.408127,0,No
17219,auckland,49,11.20471188,27,7.523961418,7.52370139,1323,84.30381988,18,18,36,41,44,85,4,0.393802,0.411221,0,No
2127,synonym,41,11.38296011,30,7.418600903,7.418310866,1230,84.44563815,9,14,23,36,40,76,4,0.43961,0.454754,0,No
12545,exam,43,11.33533206,29,7.452502454,7.452222421,1247,84.47659001,20,22,42,35,38,73,4,0.456711,0.468945,0,No
10844,hang,35,11.54118412,33,7.323290723,7.322970678,1155,84.51944657,17,17,34,24,27,51,4,0.44413,0.458599,0,No
6595,oman,45,11.28986969,28,7.487593774,7.487323743,1260,84.53395798,18,17,35,42,38,80,4,0.442271,0.456974,0,No
15180,chronicle,40,11.40765272,30,7.418600903,7.418310866,1200,84.62882279,11,18,29,29,29,58,4,0.439446,0.454716,0,No
6040,penal,42,11.35886256,29,7.452502454,7.452222421,1218,84.6519511,11,2,13,38,35,73,5,0.32288,0.326099,0,No
6862,nordic,44,11.31234254,28,7.487593774,7.487323743,1232,84.7022256,15,11,26,38,16,54,5,0.387162,0.403796,0,No
2528,stole,34,11.57017165,33,7.323290723,7.322970678,1122,84.73173073,13,15,28,27,26,53,4,0.439218,0.454345,0,No
14594,construct,34,11.57017165,33,7.323290723,7.322970678,1122,84.73173073,7,14,21,33,25,58,4,0.443387,0.457847,0,No
4446,revenue,37,11.48561426,31,7.38581108,7.385511041,1147,84.83057709,14,20,34,25,27,52,4,0.44828,0.462068,0,No
3859,schism,43,11.33533206,28,7.487593774,7.487323743,1204,84.87436177,13,26,39,35,37,72,4,0.443753,0.458397,0,No
1398,transmit,35,11.54118412,32,7.354062381,7.35375234,1120,84.87458794,8,17,25,32,29,61,4,0.434733,0.450604,0,No
17154,autonomy,38,11.45894602,30,7.418600903,7.418310866,1140,85.00934727,14,21,35,28,35,63,4,0.447388,0.46135,0,No
1966,taxonomic,36,11.51301324,31,7.38581108,7.385511041,1116,85.03294074,9,14,23,32,29,61,5,0.386901,0.40358,0,No
2326,summary,36,11.51301324,31,7.38581108,7.385511041,1116,85.03294074,13,11,24,33,33,66,5,0.407142,0.424785,0,No
8251,maharashtra,42,11.35886256,28,7.487593774,7.487323743,1176,85.05054858,11,16,27,34,37,71,4,0.437238,0.452641,0,No
13632,diabetes,42,11.35886256,28,7.487593774,7.487323743,1176,85.05054858,22,18,40,31,25,56,4,0.440767,0.455683,0,No
2999,solstice,56,11.07118049,23,7.684304068,7.684084048,1288,85.07431725,12,17,29,53,46,99,4,0.435447,0.451087,0,No
2068,taipei,59,11.01899473,22,7.728755831,7.728545813,1298,85.1631198,18,18,36,51,48,99,4,0.4358,0.451402,0,No
4295,rochester,46,11.26789078,26,7.561701746,7.56145172,1196,85.20442939,20,22,42,40,41,81,4,0.394038,0.411376,0,No
7691,metropolis,46,11.26789078,26,7.561701746,7.56145172,1196,85.20442939,17,21,38,27,36,63,4,0.457583,0.469607,0,No
4635,referendum,37,11.48561426,30,7.418600903,7.418310866,1110,85.20718835,6,17,23,34,36,70,4,0.453225,0.466096,0,No
12701,erich,41,11.38296011,28,7.487593774,7.487323743,1148,85.23098125,21,8,29,25,20,45,5,0.329546,0.334069,0,No
15041,click,35,11.54118412,31,7.38581108,7.385511041,1085,85.24100552,18,13,31,27,29,56,4,0.431048,0.447285,0,No
17013,balkan,35,11.54118412,31,7.38581108,7.385511041,1085,85.24100552,10,8,18,32,23,55,5,0.385063,0.401439,0,No
15548,catalonia,43,11.33533206,27,7.523961418,7.52370139,1161,85.28660109,14,21,35,32,35,67,4,0.448745,0.462458,0,No
4333,rite,38,11.45894602,29,7.452502454,7.452222421,1102,85.39782332,11,15,26,26,30,56,4,0.441677,0.456547,0,No
15082,clash,38,11.45894602,29,7.452502454,7.452222421,1102,85.39782332,8,19,27,34,36,70,4,0.435543,0.451256,0,No
5034,pulitzer,40,11.40765272,28,7.487593774,7.487323743,1120,85.41586951,11,10,21,38,34,72,4,0.406741,0.424258,0,No
15214,choral,40,11.40765272,28,7.487593774,7.487323743,1120,85.41586951,22,7,29,34,19,53,5,0.330984,0.335619,0,No
1811,thank,34,11.57017165,31,7.38581108,7.385511041,1054,85.45510199,19,9,28,27,32,59,4,0.404812,0.422563,0,No
8623,lineup,34,11.57017165,31,7.38581108,7.385511041,1054,85.45510199,14,23,37,31,28,59,4,0.426072,0.442881,0,No
18305,absorb,34,11.57017165,31,7.38581108,7.385511041,1054,85.45510199,10,19,29,26,31,57,4,0.424208,0.441233,0,No
12884,embryo,42,11.35886256,27,7.523961418,7.52370139,1134,85.46364365,10,19,29,37,34,71,4,0.456958,0.469072,0,No
1273,tropic,47,11.24638458,25,7.600922459,7.600682435,1175,85.48289711,17,8,25,40,42,82,5,0.389841,0.406835,0,No
1193,turin,39,11.43297053,28,7.487593774,7.487323743,1092,85.60543897,15,15,30,35,26,61,4,0.438329,0.453566,0,No
16344,boniface,39,11.43297053,28,7.487593774,7.487323743,1092,85.60543897,7,12,19,32,36,68,5,0.384013,0.400502,0,No
6474,orphan,35,11.54118412,30,7.418600903,7.418310866,1050,85.6194389,11,24,35,34,31,65,4,0.437983,0.453416,0,No
7395,monty,46,11.26789078,25,7.600922459,7.600682435,1150,85.64636411,21,4,25,38,44,82,5,0.328716,0.332563,0,No
1014,ursula,33,11.60002462,31,7.38581108,7.385511041,1023,85.67559033,9,3,12,27,3,30,5,0.382013,0.39819,0,No
13703,descendant,33,11.60002462,31,7.38581108,7.385511041,1023,85.67559033,10,7,17,30,32,62,5,0.394248,0.411579,0,No
6099,pbs,38,11.45894602,28,7.487593774,7.487323743,1064,85.79993286,17,20,37,30,23,53,4,0.436679,0.452228,0,No
2817,spine,36,11.51301324,29,7.452502454,7.452222421,1044,85.80075942,9,26,35,33,32,65,4,0.453781,0.466659,0,No
3233,sixteenth,32,11.63079627,31,7.38581108,7.385511041,992,85.90286399,3,7,10,31,26,57,5,0.385414,0.401824,0,No
10068,imagine,32,11.63079627,31,7.38581108,7.385511041,992,85.90286399,20,13,33,27,30,57,4,0.444475,0.458772,0,No
213,worcester,44,11.31234254,25,7.600922459,7.600682435,1100,85.98423851,11,25,36,39,40,79,4,0.429172,0.445735,0,No
18116,advisor,37,11.48561426,28,7.487593774,7.487323743,1036,85.99961386,11,19,30,19,35,54,4,0.415559,0.433032,0,No
4283,rodent,35,11.54118412,29,7.452502454,7.452222421,1015,86.01070295,7,15,22,28,28,56,4,0.446386,0.460472,0,No
7469,moldavia,35,11.54118412,29,7.452502454,7.452222421,1015,86.01070295,9,15,24,30,28,58,4,0.437368,0.45274,0,No
5227,prodigy,33,11.60002462,30,7.418600903,7.418310866,990,86.05595308,4,13,17,33,30,63,4,0.448847,0.462396,0,No
4512,resemble,31,11.66254497,31,7.38581108,7.385511041,961,86.13735388,9,14,23,20,25,45,4,0.417641,0.435177,0,No
16763,behalf,31,11.66254497,31,7.38581108,7.385511041,961,86.13735388,4,8,12,29,31,60,4,0.427045,0.44359,0,No
15476,celestial,36,11.51301324,28,7.487593774,7.487323743,1008,86.20476625,13,9,22,26,15,41,5,0.385113,0.401519,0,No
5508,polynesia,37,11.48561426,27,7.523961418,7.52370139,999,86.41731859,13,14,27,36,23,59,4,0.403918,0.42146,0,No
9775,inquisition,33,11.60002462,29,7.452502454,7.452222421,957,86.44921192,7,18,25,29,25,54,4,0.445311,0.459552,0,No
11201,govern,33,11.60002462,29,7.452502454,7.452222421,957,86.44921192,9,13,22,33,28,61,4,0.443387,0.457847,0,No
4923,qualify,39,11.43297053,26,7.561701746,7.56145172,1014,86.45271323,10,14,24,37,37,74,4,0.417435,0.43476,0,No
17572,anyway,31,11.66254497,30,7.418600903,7.418310866,930,86.51976666,21,25,46,23,28,51,4,0.436411,0.452106,0,No
1647,tier,34,11.57017165,28,7.487593774,7.487323743,952,86.63274523,8,10,18,30,33,63,4,0.437572,0.452829,0,No
12599,euphrates,34,11.57017165,28,7.487593774,7.487323743,952,86.63274523,4,13,17,29,28,57,4,0.4401,0.455054,0,No
16895,basel,34,11.57017165,28,7.487593774,7.487323743,952,86.63274523,12,15,27,28,28,56,4,0.432825,0.448763,0,No
6372,pact,38,11.45894602,26,7.561701746,7.56145172,988,86.64913211,7,20,27,32,30,62,4,0.452589,0.465598,0,No
7951,maximilian,38,11.45894602,26,7.561701746,7.56145172,988,86.64913211,20,12,32,32,26,58,4,0.397969,0.415437,0,No
8938,lap,35,11.54118412,27,7.523961418,7.52370139,945,86.83542401,12,14,26,14,28,42,5,0.421489,0.438526,0,No
954,valois,37,11.48561426,26,7.561701746,7.56145172,962,86.85078944,5,25,30,37,34,71,4,0.43726,0.452843,0,No
653,vulnerable,33,11.60002462,28,7.487593774,7.487323743,924,86.85627209,17,15,32,28,29,57,4,0.43726,0.45266,0,No
4667,rectangle,36,11.51301324,26,7.561701746,7.56145172,936,87.05797231,6,17,23,35,31,66,4,0.449723,0.463256,0,No
15928,burmese,38,11.45894602,25,7.600922459,7.600682435,950,87.09856015,15,17,32,30,21,51,4,0.401952,0.419521,0,No
4146,runway,40,11.40765272,24,7.641744454,7.641514432,960,87.17436693,15,20,35,38,35,73,4,0.44258,0.457298,0,No
13327,dorsal,40,11.40765272,24,7.641744454,7.641514432,960,87.17436693,16,9,25,38,31,69,5,0.353451,0.364448,0,No
7375,moravia,33,11.60002462,27,7.523961418,7.52370139,891,87.27813766,13,22,35,29,30,59,4,0.443675,0.458279,0,No
14600,constituent,33,11.60002462,27,7.523961418,7.52370139,891,87.27813766,12,10,22,28,19,47,4,0.423621,0.44051,0,No
8235,mainline,31,11.66254497,28,7.487593774,7.487323743,868,87.32439913,16,12,28,28,24,52,4,0.430087,0.446275,0,No
17909,alkali,39,11.43297053,24,7.641744454,7.641514432,936,87.36783915,9,11,20,37,24,61,4,0.42051,0.437506,0,No
296,wingspan,32,11.63079627,27,7.523961418,7.52370139,864,87.50966243,4,8,12,23,31,54,4,0.440887,0.455636,0,No
15731,cane,32,11.63079627,27,7.523961418,7.52370139,864,87.50966243,11,16,27,32,26,58,4,0.43961,0.454683,0,No
5118,protectorate,38,11.45894602,24,7.641744454,7.641514432,912,87.56633718,6,21,27,31,34,65,4,0.45873,0.470495,0,No
12996,eighty,30,11.6953348,28,7.487593774,7.487323743,840,87.569916,11,4,15,23,4,27,5,0.384779,0.401059,0,No
2401,sub,33,11.60002462,26,7.561701746,7.56145172,858,87.71592639,17,10,27,28,27,55,5,0.3706,0.38532,0,No
5150,proprietary,33,11.60002462,26,7.561701746,7.56145172,858,87.71592639,20,11,31,29,26,55,5,0.36017,0.37301,0,No
402,whig,31,11.66254497,27,7.523961418,7.52370139,837,87.74853841,11,6,17,30,27,57,4,0.395592,0.41278,0,No
5079,pseudonym,31,11.66254497,27,7.523961418,7.52370139,837,87.74853841,4,10,14,29,19,48,5,0.395046,0.412406,0,No
7126,nassau,31,11.66254497,27,7.523961418,7.52370139,837,87.74853841,12,15,27,28,23,51,4,0.411303,0.42883,0,No
11982,flown,31,11.66254497,27,7.523961418,7.52370139,837,87.74853841,15,19,34,29,27,56,4,0.442768,0.457439,0,No
2075,tahiti,37,11.48561426,24,7.641744454,7.641514432,888,87.77012911,13,21,34,31,29,60,4,0.441886,0.456735,0,No
12355,falkland,37,11.48561426,24,7.641744454,7.641514432,888,87.77012911,11,6,17,36,9,45,4,0.390716,0.407587,0,No
4162,rumble,42,11.35886256,22,7.728755831,7.728545813,924,87.78987524,9,14,23,40,38,78,4,0.434509,0.450219,0,No
5290,prevention,34,11.57017165,25,7.600922459,7.600682435,850,87.94397757,8,12,20,26,28,54,4,0.436196,0.451669,0,No
5457,pornography,34,11.57017165,25,7.600922459,7.600682435,850,87.94397757,13,20,33,28,26,54,4,0.445233,0.459537,0,No
12329,fantastic,34,11.57017165,25,7.600922459,7.600682435,850,87.94397757,16,13,29,26,28,54,4,0.410191,0.427736,0,No
12000,floppy,41,11.38296011,22,7.728755831,7.728545813,902,87.97611933,18,8,26,34,25,59,4,0.376847,0.392353,0,No
672,volunteer,30,11.6953348,27,7.523961418,7.52370139,810,87.99524778,13,12,25,22,17,39,4,0.407956,0.425488,0,No
13098,ease,30,11.6953348,27,7.523961418,7.52370139,810,87.99524778,14,13,27,24,26,50,4,0.44057,0.455453,0,No
13874,declare,28,11.76432767,28,7.487593774,7.487323743,784,88.0865066,16,10,26,22,22,44,4,0.426625,0.443261,0,No
1874,tent,33,11.60002462,25,7.600922459,7.600682435,825,88.17088763,11,20,31,28,29,57,4,0.436421,0.452017,0,No
18069,afterlife,32,11.60002462,25,7.600922459,7.600682435,800,88.17088763,7,20,27,31,29,60,4,0.450327,0.463739,0,No
2626,statute,31,11.66254497,26,7.561701746,7.56145172,806,88.18868669,14,12,26,29,30,59,5,0.406211,0.423795,0,No
7438,monetary,35,11.54118412,24,7.641744454,7.641514432,840,88.19477971,12,8,20,15,25,40,5,0.385113,0.4015,0,No
7421,monopoly,39,11.43297053,22,7.728755831,7.728545813,858,88.36263766,18,17,35,35,27,62,4,0.429785,0.446186,0,No
593,wan,32,11.63079627,25,7.600922459,7.600682435,800,88.40478062,9,6,15,27,6,33,5,0.355603,0.36688,0,No
6057,peer,30,11.6953348,26,7.561701746,7.56145172,780,88.43663355,15,13,28,23,22,45,4,0.418054,0.435299,0,No
13852,default,30,11.6953348,26,7.561701746,7.56145172,780,88.43663355,7,16,23,27,18,45,5,0.384587,0.401277,0,No
1518,torah,36,11.51301324,23,7.684304068,7.684084048,828,88.46949447,7,23,30,30,31,61,4,0.447839,0.461749,0,No
6406,ovum,36,11.51301324,23,7.684304068,7.684084048,828,88.46949447,10,12,22,34,33,67,4,0.439403,0.454434,0,No
2940,sorry,28,11.76432767,27,7.523961418,7.52370139,756,88.51434748,16,14,30,22,26,48,4,0.407142,0.424723,0,No
15016,clockwise,28,11.76432767,27,7.523961418,7.52370139,756,88.51434748,12,13,25,16,22,38,4,0.42432,0.441172,0,No
1826,teutonic,29,11.72923635,26,7.561701746,7.56145172,754,88.69298697,2,2,4,27,6,33,5,0.326503,0.32991,0,No
1940,tectonic,29,11.72923635,26,7.561701746,7.56145172,754,88.69298697,14,2,16,24,8,32,5,0.322423,0.325625,0,No
6042,pembroke,29,11.72923635,26,7.561701746,7.56145172,754,88.69298697,11,18,29,25,23,48,4,0.405867,0.423511,0,No
17428,aria,40,11.40765272,21,7.775275846,7.77507583,840,88.69764668,12,19,31,33,24,57,4,0.437702,0.453097,0,No
4588,reject,27,11.80069531,27,7.523961418,7.52370139,729,88.78797623,11,12,23,19,22,41,4,0.418153,0.435642,0,No
13879,decisive,27,11.80069531,27,7.523961418,7.52370139,729,88.78797623,5,7,12,26,22,48,5,0.384545,0.400853,0,No
9520,ivy,32,11.63079627,24,7.641744454,7.641514432,768,88.87957293,10,11,21,23,28,51,4,0.426738,0.443233,0,No
8431,loyalty,30,11.6953348,25,7.600922459,7.600682435,750,88.89533292,19,15,34,24,26,50,4,0.444464,0.458791,0,No
14060,cytoplasm,30,11.6953348,25,7.600922459,7.600682435,750,88.89533292,7,17,24,29,24,53,4,0.443487,0.458021,0,No
17327,asleep,30,11.6953348,25,7.600922459,7.600682435,750,88.89533292,11,16,27,24,25,49,4,0.430912,0.4472,0,No
541,waterfall,34,11.57017165,23,7.684304068,7.684084048,782,88.9087171,11,15,26,21,29,50,4,0.444831,0.459176,0,No
4070,sake,34,11.57017165,23,7.684304068,7.684084048,782,88.9087171,16,13,29,30,31,61,4,0.4361,0.451632,0,No
14016,damn,34,11.57017165,23,7.684304068,7.684084048,782,88.9087171,8,8,16,28,29,57,5,0.334162,0.339739,0,No
6080,peasant,28,11.76432767,26,7.561701746,7.56145172,728,88.95833706,12,17,29,23,21,44,4,0.41136,0.428948,0,No
12852,emphasis,28,11.76432767,26,7.561701746,7.56145172,728,88.95833706,11,6,17,21,26,47,5,0.373242,0.388285,0,No
14633,conquistador,28,11.76432767,26,7.561701746,7.56145172,728,88.95833706,7,13,20,25,17,42,5,0.407591,0.425152,0,No
16711,benedictine,28,11.76432767,26,7.561701746,7.56145172,728,88.95833706,6,7,13,26,26,52,5,0.35576,0.367622,0,No
77,yokohama,41,11.38296011,20,7.824066011,7.823875996,820,89.0610313,17,12,29,27,23,50,4,0.435362,0.450942,0,No
10087,iliad,33,11.60002462,23,7.684304068,7.684084048,759,89.13811635,4,16,20,25,26,51,4,0.437939,0.453247,0,No
17720,andalusia,33,11.60002462,23,7.684304068,7.684084048,759,89.13811635,12,18,30,27,29,56,4,0.435575,0.451219,0,No
14685,confessor,35,11.54118412,22,7.728755831,7.728545813,770,89.19899403,2,20,22,31,23,54,4,0.447726,0.461617,0,No
9431,jesuit,27,11.80069531,26,7.561701746,7.56145172,702,89.23333834,12,9,21,24,16,40,4,0.385104,0.401494,0,No
522,watt,37,11.48561426,21,7.775275846,7.77507583,777,89.30381917,12,22,34,33,28,61,4,0.453375,0.466251,0,No
10745,havana,30,11.6953348,24,7.641744454,7.641514432,720,89.37275981,13,12,25,23,23,46,4,0.43254,0.44844,0,No
11888,forestry,30,11.6953348,24,7.641744454,7.641514432,720,89.37275981,14,11,25,22,18,40,4,0.436357,0.451787,0,No
6046,peloponnese,32,11.63079627,23,7.684304068,7.684084048,736,89.37457513,3,12,15,30,30,60,4,0.433427,0.449233,0,No
6927,nikolai,32,11.63079627,23,7.684304068,7.684084048,736,89.37457513,19,9,28,21,10,31,4,0.417248,0.434487,0,No
10015,impression,28,11.76432767,25,7.600922459,7.600682435,700,89.41974238,11,11,22,22,26,48,5,0.40167,0.419227,0,No
2156,syllable,36,11.51301324,21,7.775275846,7.77507583,756,89.51685376,13,16,29,34,24,58,4,0.457559,0.469518,0,No
1741,thirteenth,26,11.83843564,26,7.561701746,7.56145172,676,89.51871945,4,9,13,23,17,40,5,0.334306,0.33954,0,No
14771,completion,26,11.83843564,26,7.561701746,7.56145172,676,89.51871945,9,6,15,21,26,47,4,0.414443,0.431685,0,No
10083,illegitimate,29,11.72923635,24,7.641744454,7.641514432,696,89.63182681,11,11,22,23,29,52,4,0.382845,0.399503,0,No
16475,blend,29,11.72923635,24,7.641744454,7.641514432,696,89.63182681,10,6,16,27,29,56,4,0.41626,0.433581,0,No
6238,parentheses,33,11.60002462,22,7.728755831,7.728545813,726,89.65375789,6,6,12,31,27,58,5,0.397675,0.414974,0,No
15729,canis,33,11.60002462,22,7.728755831,7.728545813,726,89.65375789,15,2,17,26,7,33,5,0.326245,0.330095,0,No
17908,alkaline,33,11.60002462,22,7.728755831,7.728545813,726,89.65375789,15,10,25,31,24,55,4,0.418163,0.435276,0,No
17948,alexandre,33,11.60002462,22,7.728755831,7.728545813,726,89.65375789,15,1,16,22,1,23,5,0.336021,0.342018,0,No
16275,botswana,40,11.40765272,19,7.875359305,7.875179292,760,89.83936402,16,14,30,26,26,52,4,0.412095,0.429586,0,No
1809,thanksgiving,30,11.6953348,23,7.684304068,7.684084048,690,89.87050875,14,16,30,19,26,45,4,0.443664,0.458134,0,No
1820,textbook,30,11.6953348,23,7.684304068,7.684084048,690,89.87050875,14,20,34,25,28,53,4,0.444119,0.45865,0,No
12528,exchequer,30,11.6953348,23,7.684304068,7.684084048,690,89.87050875,1,17,18,30,26,56,4,0.443586,0.458096,0,No
8325,macedon,43,11.33533206,18,7.929426526,7.929256515,774,89.88268273,5,17,22,41,18,59,4,0.450636,0.46395,0,No
199,workshop,32,11.63079627,22,7.728755831,7.728545813,704,89.89158452,16,17,33,25,26,51,4,0.447365,0.461228,0,No
13049,edict,32,11.63079627,22,7.728755831,7.728545813,704,89.89158452,7,7,14,32,29,61,5,0.403038,0.420481,0,No
574,warn,28,11.76432767,24,7.641744454,7.641514432,672,89.8999857,6,11,17,26,23,49,4,0.427828,0.444341,0,No
14824,commentator,28,11.76432767,24,7.641744454,7.641514432,672,89.8999857,11,12,23,16,27,43,4,0.396024,0.413305,0,No
16965,baptism,34,11.57017165,21,7.775275846,7.77507583,714,89.96127619,13,15,28,26,27,53,4,0.447907,0.461669,0,No
1901,tempest,26,11.83843564,25,7.600922459,7.600682435,650,89.98303133,3,11,14,24,19,43,4,0.44034,0.455237,0,No
9632,investigate,26,11.83843564,25,7.600922459,7.600682435,650,89.98303133,8,14,22,25,21,46,4,0.443742,0.458153,0,No
13094,easternmost,26,11.83843564,25,7.600922459,7.600682435,650,89.98303133,3,12,15,25,23,48,5,0.381438,0.397673,0,No
374,whoever,25,11.83843564,24,7.600922459,7.600682435,600,89.98303133,18,6,24,20,9,29,4,0.406229,0.423845,0,No
4367,rift,36,11.51301324,20,7.824066011,7.823875996,720,90.07857556,10,10,20,30,32,62,4,0.416329,0.433666,0,No
12088,fist,31,11.66254497,22,7.728755831,7.728545813,682,90.13696246,10,11,21,30,27,57,4,0.437918,0.453139,0,No
17318,assam,31,11.66254497,22,7.728755831,7.728545813,682,90.13696246,15,15,30,26,24,50,4,0.434456,0.450186,0,No
10887,halo,45,11.28986969,17,7.98658494,7.986424931,765,90.16750322,22,24,46,33,40,73,4,0.457323,0.469429,0,No
11063,grocery,33,11.60002462,21,7.775275846,7.77507583,693,90.19339121,14,6,20,26,23,49,4,0.389986,0.406799,0,No
9254,karate,41,11.38296011,18,7.929426526,7.929256515,738,90.26034585,12,19,31,30,28,58,4,0.438015,0.453359,0,No
5860,phd,25,11.87765635,25,7.600922459,7.600682435,625,90.28114493,6,10,16,23,21,44,5,0.401506,0.418974,0,No
8617,linguist,25,11.87765635,25,7.600922459,7.600682435,625,90.28114493,12,12,24,18,17,35,4,0.42938,0.445651,0,No
897,velvet,35,11.54118412,20,7.824066011,7.823875996,700,90.29898636,12,10,22,28,12,40,5,0.39644,0.413711,0,No
226,woodland,28,11.76432767,23,7.684304068,7.684084048,644,90.40067095,16,11,27,24,15,39,5,0.389217,0.40627,0,No
9427,jew,28,11.76432767,23,7.684304068,7.684084048,644,90.40067095,8,19,27,26,26,52,4,0.4333,0.449299,0,No
15130,circumference,28,11.76432767,23,7.684304068,7.684084048,644,90.40067095,9,15,24,24,25,49,4,0.443686,0.458148,0,No
3759,scuba,32,11.63079627,21,7.775275846,7.77507583,672,90.43264935,16,3,19,26,3,29,4,0.388374,0.405465,0,No
4191,royalty,26,11.83843564,24,7.641744454,7.641514432,624,90.46629989,11,10,21,19,18,37,4,0.4235,0.440252,0,No
5569,poetic,26,11.83843564,24,7.641744454,7.641514432,624,90.46629989,12,16,28,22,17,39,4,0.425377,0.442224,0,No
4343,ripe,29,11.72923635,22,7.728755831,7.728545813,638,90.65240381,13,15,28,23,24,47,4,0.439653,0.454707,0,No
9370,jorge,29,11.72923635,22,7.728755831,7.728545813,638,90.65240381,16,5,21,18,6,24,5,0.33334,0.338444,0,No
18189,adaptive,29,11.72923635,22,7.728755831,7.728545813,638,90.65240381,15,4,19,23,8,31,5,0.355596,0.367421,0,No
1094,umbrella,31,11.66254497,21,7.775275846,7.77507583,651,90.67950424,11,14,25,30,25,55,4,0.416231,0.433525,0,No
3645,semitic,31,11.66254497,21,7.775275846,7.77507583,651,90.67950424,13,11,24,31,19,50,5,0.383366,0.399895,0,No
5811,phyla,31,11.66254497,21,7.775275846,7.77507583,651,90.67950424,14,22,36,25,26,51,4,0.458647,0.470434,0,No
17283,astronaut,31,11.66254497,21,7.775275846,7.77507583,651,90.67950424,8,16,24,19,24,43,4,0.400989,0.418573,0,No
834,vertebrate,27,11.80069531,23,7.684304068,7.684084048,621,90.68013099,14,13,27,25,15,40,4,0.43292,0.448815,0,No
1260,truce,27,11.80069531,23,7.684304068,7.684084048,621,90.68013099,9,13,22,24,25,49,4,0.425153,0.441886,0,No
2355,suffix,27,11.80069531,23,7.684304068,7.684084048,621,90.68013099,8,16,24,25,19,44,4,0.432161,0.448294,0,No
12972,elector,27,11.80069531,23,7.684304068,7.684084048,621,90.68013099,15,7,22,24,27,51,4,0.415082,0.432398,0,No
447,wesleyan,42,11.35886256,17,7.98658494,7.986424931,714,90.71852065,23,8,31,36,15,51,5,0.353155,0.363913,0,No
2551,stimulus,33,11.60002462,20,7.824066011,7.823875996,660,90.75935832,11,18,29,27,29,56,4,0.409869,0.427488,0,No
8260,magnificent,25,11.87765635,24,7.641744454,7.641514432,600,90.76601456,7,13,20,22,17,39,5,0.397479,0.414889,0,No
16973,bankrupt,25,11.87765635,24,7.641744454,7.641514432,600,90.76601456,4,11,15,17,22,39,4,0.437788,0.45305,0,No
8270,magna,28,11.76432767,22,7.728755831,7.728545813,616,90.92361605,9,4,13,21,4,25,5,0.323569,0.327834,0,No
14202,crucifixion,28,11.76432767,22,7.728755831,7.728545813,616,90.92361605,8,12,20,23,25,48,4,0.442856,0.457378,0,No
4827,radcliffe,30,11.6953348,21,7.775275846,7.77507583,630,90.93445415,17,14,31,27,26,53,4,0.401952,0.419493,0,No
15141,circa,30,11.6953348,21,7.775275846,7.77507583,630,90.93445415,15,17,32,17,20,37,4,0.435907,0.451496,0,No
268,withdrawal,26,11.83843564,23,7.684304068,7.684084048,598,90.97013915,12,11,23,19,24,43,5,0.394985,0.412335,0,No
6289,papacy,26,11.83843564,23,7.684304068,7.684084048,598,90.97013915,3,14,17,23,19,42,4,0.442293,0.456955,0,No
13154,duration,26,11.83843564,23,7.684304068,7.684084048,598,90.97013915,9,7,16,21,24,45,4,0.409037,0.426441,0,No
845,verona,32,11.63079627,20,7.824066011,7.823875996,640,91.00011781,11,15,26,26,26,52,4,0.434573,0.450308,0,No
6228,parkinson,32,11.63079627,20,7.824066011,7.823875996,640,91.00011781,17,5,22,22,6,28,5,0.357285,0.369052,0,No
928,vascular,37,11.48561426,18,7.929426526,7.929256515,666,91.07433442,15,4,19,30,13,43,5,0.327153,0.331074,0,No
5936,permitted,24,11.91847835,24,7.641744454,7.641514432,576,91.07796581,8,11,19,20,23,43,4,0.43401,0.449777,0,No
13764,demonstrate,24,11.91847835,24,7.641744454,7.641514432,576,91.07796581,6,7,13,20,18,38,4,0.419685,0.436943,0,No
4115,sabbath,34,11.57017165,19,7.875359305,7.875179292,646,91.11925899,9,16,25,33,27,60,4,0.442216,0.456904,0,No
6620,olaf,30,11.66254497,19,7.824066011,7.823875996,570,91.24852172,9,15,24,21,22,43,5,0.377472,0.393261,0,No
6139,patriot,25,11.87765635,23,7.684304068,7.684084048,575,91.27152303,12,18,30,19,21,40,4,0.42821,0.444698,0,No
11996,florentine,25,11.87765635,23,7.684304068,7.684084048,575,91.27152303,9,12,21,19,14,33,5,0.336174,0.341961,0,No
17639,anonymous,33,11.60002462,19,7.875359305,7.875179292,627,91.3543618,14,15,29,23,19,42,4,0.40635,0.423915,0,No
15560,caste,28,11.76432767,21,7.775275846,7.77507583,588,91.47089276,11,11,22,21,25,46,4,0.404452,0.421981,0,No
914,vault,26,11.83843564,22,7.728755831,7.728545813,572,91.49637848,16,18,34,23,23,46,4,0.443598,0.458129,0,No
9208,kenton,26,11.83843564,22,7.728755831,7.728545813,572,91.49637848,5,5,10,24,26,50,4,0.405886,0.423488,0,No
12307,fascist,26,11.83843564,22,7.728755831,7.728545813,572,91.49637848,12,9,21,23,16,39,5,0.385021,0.40143,0,No
12818,engage,26,11.83843564,22,7.728755831,7.728545813,572,91.49637848,12,9,21,19,25,44,4,0.419725,0.436783,0,No
16663,berne,26,11.83843564,22,7.728755831,7.728545813,572,91.49637848,8,11,19,22,17,39,4,0.433215,0.449026,0,No
17861,aloud,26,11.83843564,22,7.728755831,7.728545813,572,91.49637848,7,18,25,9,26,35,4,0.438069,0.453392,0,No
1166,tutor,30,11.6953348,20,7.824066011,7.823875996,600,91.50507146,11,15,26,26,26,52,4,0.447174,0.461068,0,No
7419,monoxide,30,11.6953348,20,7.824066011,7.823875996,600,91.50507146,1,15,16,30,21,51,4,0.423692,0.440571,0,No
7891,mckinley,30,11.6953348,20,7.824066011,7.823875996,600,91.50507146,8,18,26,27,26,53,4,0.421389,0.438529,0,No
16294,borneo,30,11.6953348,20,7.824066011,7.823875996,600,91.50507146,16,16,32,24,27,51,4,0.439915,0.454965,0,No
15222,cholesterol,35,11.54118412,18,7.929426526,7.929256515,630,91.51497147,15,15,30,29,28,57,4,0.446802,0.460725,0,No
4979,pursue,24,11.91847835,23,7.684304068,7.684084048,552,91.58521165,9,9,18,24,21,45,4,0.420241,0.437534,0,No
10025,import,24,11.91847835,23,7.684304068,7.684084048,552,91.58521165,12,14,26,19,15,34,4,0.422613,0.439548,0,No
11027,guarantee,24,11.91847835,23,7.684304068,7.684084048,552,91.58521165,10,11,21,20,19,39,4,0.436368,0.451899,0,No
18272,accessible,24,11.91847835,23,7.684304068,7.684084048,552,91.58521165,10,15,25,16,21,37,4,0.412038,0.429553,0,No
14624,consent,34,11.57017165,18,7.929426526,7.929256515,612,91.74482602,13,17,30,32,30,62,4,0.427004,0.443628,0,No
15594,cart,27,11.80069531,21,7.775275846,7.77507583,567,91.75366123,11,18,29,24,21,45,4,0.405895,0.423511,0,No
3091,snack,25,11.87765635,22,7.728755831,7.728545813,550,91.79950579,9,15,24,21,19,40,4,0.429183,0.445524,0,No
14746,compromise,31,11.66254497,19,7.875359305,7.875179292,589,91.84673207,9,12,21,31,26,57,4,0.44193,0.456603,0,No
1776,thereby,23,11.96103796,23,7.684304068,7.684084048,529,91.91225267,15,6,21,16,7,23,5,0.35899,0.371182,0,No
4564,remnant,23,11.96103796,23,7.684304068,7.684084048,529,91.91225267,6,5,11,18,20,38,5,0.384163,0.400622,0,No
10486,himalaya,23,11.96103796,23,7.684304068,7.684084048,529,91.91225267,5,9,14,22,14,36,4,0.408972,0.426445,0,No
12167,fifteenth,23,11.96103796,23,7.684304068,7.684084048,529,91.91225267,6,9,15,21,16,37,5,0.391457,0.408535,0,No
17727,ancestral,23,11.96103796,23,7.684304068,7.684084048,529,91.91225267,12,8,20,19,15,34,5,0.377488,0.39324,0,No
18266,acclaim,23,11.96103796,23,7.684304068,7.684084048,529,91.91225267,4,11,15,5,22,27,4,0.419526,0.4366,0,No
3826,schumann,28,11.76432767,20,7.824066011,7.823875996,560,92.04487624,9,22,31,27,27,54,4,0.400194,0.417826,0,No
13498,disciple,28,11.76432767,20,7.824066011,7.823875996,560,92.04487624,8,10,18,22,25,47,4,0.4235,0.440393,0,No
629,waist,26,11.83843564,21,7.775275846,7.77507583,546,92.04710269,8,14,22,26,23,49,4,0.450282,0.463584,0,No
5013,punic,30,11.6953348,19,7.875359305,7.875179292,570,92.10496371,6,2,8,29,23,52,5,0.338546,0.345847,0,No
7642,midwestern,24,11.91847835,22,7.728755831,7.728545813,528,92.11500902,6,5,11,24,9,33,5,0.385113,0.401444,0,No
10460,hispanic,24,11.91847835,22,7.728755831,7.728545813,528,92.11500902,8,7,15,16,18,34,4,0.400429,0.417826,0,No
13196,duet,24,11.91847835,22,7.728755831,7.728545813,528,92.11500902,11,9,20,24,21,45,4,0.412497,0.429915,0,No
14884,collide,24,11.91847835,22,7.728755831,7.728545813,528,92.11500902,10,9,19,14,21,35,4,0.421349,0.438323,0,No
421,wheelchair,32,11.63079627,18,7.929426526,7.929256515,576,92.2255445,9,19,28,30,24,54,4,0.440997,0.455965,0,No
4580,relieve,25,11.87765635,21,7.775275846,7.77507583,525,92.35205455,4,6,10,24,21,45,4,0.398863,0.416587,0,No
14608,consortium,25,11.87765635,21,7.775275846,7.77507583,525,92.35205455,7,11,18,18,18,36,4,0.449745,0.463091,0,No
17846,altar,25,11.87765635,21,7.775275846,7.77507583,525,92.35205455,6,15,21,24,25,49,4,0.425276,0.442013,0,No
17093,azores,29,11.72923635,19,7.875359305,7.875179292,551,92.37195061,3,17,20,27,21,48,4,0.441446,0.456261,0,No
2356,sufficient,23,11.96103796,22,7.728755831,7.728545813,506,92.44394189,13,11,24,21,17,38,4,0.415948,0.433361,0,No
7487,modify,23,11.96103796,22,7.728755831,7.728545813,506,92.44394189,12,8,20,23,19,42,4,0.426389,0.442844,0,No
10186,hydroelectric,23,11.96103796,22,7.728755831,7.728545813,506,92.44394189,14,8,22,22,20,42,5,0.385464,0.401881,0,No
17304,assist,23,11.96103796,22,7.728755831,7.728545813,506,92.44394189,6,16,22,20,21,41,4,0.425908,0.442576,0,No
18329,aboard,23,11.96103796,22,7.728755831,7.728545813,506,92.44394189,11,5,16,12,19,31,4,0.41912,0.436393,0,No
11019,guernsey,31,11.66254497,18,7.929426526,7.929256515,558,92.47729347,13,14,27,30,25,55,4,0.434382,0.450125,0,No
2860,spectral,26,11.83843564,20,7.824066011,7.823875996,520,92.62470191,11,8,19,21,16,37,5,0.356296,0.368336,0,No
3241,sistine,26,11.83843564,20,7.824066011,7.823875996,520,92.62470191,1,1,2,26,26,52,5,0.317339,0.32101,0,No
8815,leeward,26,11.83843564,20,7.824066011,7.823875996,520,92.62470191,5,3,8,26,4,30,5,0.328984,0.332968,0,No
12894,embassy,26,11.83843564,20,7.824066011,7.823875996,520,92.62470191,10,13,23,21,21,42,4,0.425143,0.441853,0,No
1982,tattoo,33,11.60002462,17,7.98658494,7.986424931,561,92.6445819,12,19,31,31,26,57,4,0.441479,0.456439,0,No
12199,fetus,33,11.60002462,17,7.98658494,7.986424931,561,92.6445819,6,17,23,32,26,58,4,0.440089,0.455157,0,No
14814,commodore,30,11.6953348,18,7.929426526,7.929256515,540,92.73729796,18,11,29,28,20,48,4,0.402398,0.419845,0,No
2199,swear,22,12.00548972,22,7.728755831,7.728545813,484,92.78749871,14,9,23,18,15,33,4,0.429744,0.445961,0,No
3371,shy,22,12.00548972,22,7.728755831,7.728545813,484,92.78749871,9,14,23,19,21,40,4,0.431404,0.447472,0,No
7636,migrate,22,12.00548972,22,7.728755831,7.728545813,484,92.78749871,8,11,19,16,21,37,4,0.41058,0.428065,0,No
10014,impressive,22,12.00548972,22,7.728755831,7.728545813,484,92.78749871,8,10,18,19,10,29,4,0.412987,0.430323,0,No
11882,forget,22,12.00548972,22,7.728755831,7.728545813,484,92.78749871,9,13,22,21,17,38,4,0.437098,0.452538,0,No
0,zygote,35,11.54118412,16,8.047209562,8.047059554,560,92.87432717,8,16,24,35,25,60,4,0.455984,0.468232,0,No
7551,miocene,35,11.54118412,16,8.047209562,8.047059554,560,92.87432717,9,11,20,23,23,46,4,0.439828,0.454796,0,No
9361,joss,25,11.87765635,20,7.824066011,7.823875996,500,92.93156735,12,4,16,20,4,24,5,0.331114,0.335747,0,No
12767,ephesus,25,11.87765635,20,7.824066011,7.823875996,500,92.93156735,4,13,17,21,14,35,4,0.447884,0.461594,0,No
15808,calhoun,25,11.87765635,20,7.824066011,7.823875996,500,92.93156735,11,10,21,25,21,46,4,0.395707,0.412977,0,No
17317,assassin,25,11.87765635,20,7.824066011,7.823875996,500,92.93156735,9,17,26,18,22,40,5,0.403368,0.420973,0,No
5309,presbyterian,27,11.80069531,19,7.875359305,7.875179292,513,92.93471563,10,6,16,24,17,41,4,0.422613,0.439351,0,No
1070,unite,23,11.96103796,21,7.775275846,7.77507583,483,93.00036956,6,15,21,21,21,42,4,0.431132,0.447332,0,No
3927,savannah,23,11.96103796,21,7.775275846,7.77507583,483,93.00036956,9,8,17,20,17,37,4,0.402298,0.419704,0,No
17301,assume,23,11.96103796,21,7.775275846,7.77507583,483,93.00036956,8,12,20,13,23,36,4,0.423561,0.440623,0,No
11732,friesland,29,11.72923635,18,7.929426526,7.929256515,522,93.00611783,13,13,26,27,24,51,4,0.449222,0.462697,0,No
1310,trillion,26,11.83843564,19,7.875359305,7.875179292,494,93.23193427,16,8,24,25,11,36,4,0.401252,0.418892,0,No
5843,philippine,26,11.83843564,19,7.875359305,7.875179292,494,93.23193427,8,9,17,26,21,47,5,0.332086,0.337085,0,No
12066,flair,26,11.83843564,19,7.875359305,7.875179292,494,93.23193427,6,11,17,6,17,23,4,0.403294,0.420784,0,No
3886,scare,24,11.91847835,20,7.824066011,7.823875996,480,93.25096133,6,13,19,22,21,43,4,0.428654,0.445116,0,No
4754,ransom,24,11.91847835,20,7.824066011,7.823875996,480,93.25096133,11,14,25,22,18,40,4,0.44879,0.462378,0,No
7733,mesozoic,24,11.91847835,20,7.824066011,7.823875996,480,93.25096133,6,5,11,23,19,42,5,0.364063,0.377358,0,No
13371,dominic,24,11.91847835,20,7.824066011,7.823875996,480,93.25096133,10,12,22,17,18,35,4,0.409368,0.426887,0,No
14134,cupid,24,11.91847835,20,7.824066011,7.823875996,480,93.25096133,13,11,24,17,14,31,4,0.435372,0.450928,0,No
6787,nucleic,28,11.76432767,18,7.929426526,7.929256515,504,93.28437187,8,1,9,24,12,36,5,0.318238,0.321893,0,No
2373,successive,22,12.00548972,21,7.775275846,7.77507583,462,93.34599428,18,1,19,21,1,22,5,0.320473,0.324013,0,No
7763,merchandise,22,12.00548972,21,7.775275846,7.77507583,462,93.34599428,9,12,21,15,14,29,4,0.450693,0.46388,0,No
15357,charitable,22,12.00548972,21,7.775275846,7.77507583,462,93.34599428,13,7,20,19,8,27,5,0.397719,0.415007,0,No
2785,sponge,30,11.6953348,17,7.98658494,7.986424931,510,93.40578475,7,18,25,27,26,53,4,0.435244,0.451078,0,No
8852,lea,25,11.87765635,19,7.875359305,7.875179292,475,93.54081148,11,4,15,20,13,33,5,0.332715,0.337827,0,No
12334,fancy,25,11.87765635,19,7.875359305,7.875179292,475,93.54081148,15,16,31,21,18,39,4,0.433628,0.4495,0,No
12487,exoskeleton,25,11.87765635,19,7.875359305,7.875179292,475,93.54081148,7,14,21,22,19,41,4,0.443609,0.458059,0,No
12751,episcopal,25,11.87765635,19,7.875359305,7.875179292,475,93.54081148,11,10,21,20,22,42,5,0.366627,0.380485,0,No
12866,emirate,27,11.80069531,18,7.929426526,7.929256515,486,93.57274643,13,5,18,26,23,49,5,0.403505,0.421025,0,No
16862,battalion,27,11.80069531,18,7.929426526,7.929256515,486,93.57274643,11,15,26,22,21,43,4,0.449222,0.462828,0,No
139,xavier,23,11.96103796,20,7.824066011,7.823875996,460,93.58395057,9,11,20,18,13,31,4,0.416046,0.433436,0,No
7414,monsoon,23,11.96103796,20,7.824066011,7.823875996,460,93.58395057,9,10,19,17,18,35,4,0.440942,0.455721,0,No
14592,constructor,23,11.96103796,20,7.824066011,7.823875996,460,93.58395057,5,4,9,23,4,27,5,0.386681,0.403247,0,No
12661,essen,32,11.63079627,16,8.047209562,8.047059554,512,93.59545499,13,15,28,22,25,47,4,0.434754,0.450468,0,No
407,wherever,21,12.05200974,21,7.775275846,7.77507583,441,93.70770023,16,10,26,16,20,36,4,0.407694,0.425314,0,No
16036,brutal,21,12.05200974,21,7.775275846,7.77507583,441,93.70770023,12,11,23,19,15,34,4,0.413391,0.430722,0,No
14915,coil,31,11.66254497,16,8.047209562,8.047059554,496,93.85094342,6,14,20,24,28,52,4,0.456218,0.468382,0,No
15189,chromatic,31,11.66254497,16,8.047209562,8.047059554,496,93.85094342,12,11,23,29,22,51,4,0.411866,0.429422,0,No
10098,igneous,24,11.91847835,19,7.875359305,7.875179292,456,93.86229935,15,5,20,20,17,37,5,0.326065,0.329736,0,No
13517,diplomacy,24,11.91847835,19,7.875359305,7.875179292,456,93.86229935,11,15,26,20,19,39,4,0.405969,0.423605,0,No
16226,brackish,26,11.83843564,18,7.929426526,7.929256515,468,93.87200559,15,8,23,20,21,41,5,0.359288,0.371921,0,No
16679,bergen,26,11.83843564,18,7.929426526,7.929256515,468,93.87200559,15,10,25,21,22,43,4,0.403652,0.421169,0,No
10612,henderson,22,12.00548972,20,7.824066011,7.823875996,440,93.93174409,15,15,30,15,16,31,4,0.412699,0.430272,0,No
7475,moines,28,11.76432767,17,7.98658494,7.986424931,476,93.95680218,1,14,15,28,25,53,4,0.419338,0.436562,0,No
8525,locus,28,11.76432767,17,7.98658494,7.986424931,476,93.95680218,12,10,22,23,25,48,5,0.392417,0.409591,0,No
16362,bolt,28,11.76432767,17,7.98658494,7.986424931,476,93.95680218,12,16,28,26,16,42,4,0.417563,0.434858,0,No
5958,perihelion,25,11.87765635,18,7.929426526,7.929256515,450,94.18300335,12,11,23,20,16,36,4,0.433194,0.449008,0,No
7750,merit,25,11.87765635,18,7.929426526,7.929256515,450,94.18300335,6,17,23,25,23,48,4,0.462302,0.473232,0,No
8171,manchuria,25,11.87765635,18,7.929426526,7.929256515,450,94.18300335,13,15,28,22,22,44,4,0.428571,0.444947,0,No
10306,hostage,25,11.87765635,18,7.929426526,7.929256515,450,94.18300335,14,14,28,21,21,42,4,0.407863,0.425417,0,No
7478,mohammed,23,11.96103796,19,7.875359305,7.875179292,437,94.19747161,8,9,17,12,12,24,5,0.348284,0.35792,0,No
9639,inverness,23,11.96103796,19,7.875359305,7.875179292,437,94.19747161,15,9,24,20,15,35,4,0.433078,0.448876,0,No
11761,freeze,23,11.96103796,19,7.875359305,7.875179292,437,94.19747161,14,16,30,23,19,42,4,0.433258,0.449158,0,No
12905,elton,23,11.96103796,19,7.875359305,7.875179292,437,94.19747161,15,4,19,20,22,42,5,0.333158,0.338379,0,No
471,weird,21,12.05200974,20,7.824066011,7.823875996,420,94.29571976,14,9,23,19,18,37,4,0.39889,0.416244,0,No
9070,konrad,21,12.05200974,20,7.824066011,7.823875996,420,94.29571976,12,5,17,14,9,23,5,0.379425,0.395335,0,No
10029,implement,21,12.05200974,20,7.824066011,7.823875996,420,94.29571976,6,12,18,19,20,39,4,0.416397,0.43399,0,No
10325,horrible,21,12.05200974,20,7.824066011,7.823875996,420,94.29571976,13,10,23,18,10,28,5,0.392591,0.409774,0,No
12485,exotic,21,12.05200974,20,7.824066011,7.823875996,420,94.29571976,16,7,23,20,7,27,5,0.385514,0.401918,0,No
14431,correspond,21,12.05200974,20,7.824066011,7.823875996,420,94.29571976,8,3,11,14,20,34,5,0.369097,0.383297,0,No
4166,ruin,24,11.91847835,18,7.929426526,7.929256515,432,94.50669836,14,16,30,21,21,42,4,0.44433,0.458711,0,No
4724,ravel,24,11.91847835,18,7.929426526,7.929256515,432,94.50669836,7,14,21,22,19,41,4,0.432582,0.448519,0,No
8918,larval,24,11.91847835,18,7.929426526,7.929256515,432,94.50669836,12,5,17,23,15,38,5,0.328814,0.332874,0,No
9772,inscription,24,11.91847835,18,7.929426526,7.929256515,432,94.50669836,11,12,23,17,21,38,4,0.44819,0.461843,0,No
17781,amnesty,24,11.91847835,18,7.929426526,7.929256515,432,94.50669836,15,7,22,19,9,28,4,0.381668,0.397865,0,No
5757,pilgrim,22,12.00548972,19,7.875359305,7.875179292,418,94.54754521,8,7,15,19,15,34,4,0.416026,0.433356,0,No
10075,illustrate,22,12.00548972,19,7.875359305,7.875179292,418,94.54754521,7,11,18,21,20,41,4,0.439425,0.454434,0,No
18249,accuracy,22,12.00548972,19,7.875359305,7.875179292,418,94.54754521,5,10,15,15,19,34,4,0.441413,0.456129,0,No
13529,diocletian,26,11.83843564,17,7.98658494,7.986424931,442,94.54867179,13,11,24,23,13,36,5,0.399482,0.416884,0,No
15734,candle,31,11.66254497,15,8.111748083,8.111608076,465,94.60362683,13,15,28,27,23,50,4,0.423581,0.440501,0,No
5491,pompey,34,11.57017165,14,8.180740955,8.180610949,476,94.65257709,16,15,31,18,27,45,4,0.434392,0.45013,0,No
11440,georgetown,28,11.76432767,16,8.047209562,8.047059554,448,94.67001009,13,12,25,20,20,40,4,0.402901,0.420455,0,No
442,westernmost,20,12.1007999,20,7.824066011,7.823875996,400,94.67745723,2,7,9,17,14,31,5,0.379741,0.395711,0,No
3333,sigmund,20,12.1007999,20,7.824066011,7.823875996,400,94.67745723,12,3,15,16,18,34,5,0.327824,0.332763,0,No
5277,primate,20,12.1007999,20,7.824066011,7.823875996,400,94.67745723,10,13,23,15,17,32,4,0.408172,0.425708,0,No
13228,drown,20,12.1007999,20,7.824066011,7.823875996,400,94.67745723,10,16,26,18,18,36,4,0.422492,0.439576,0,No
18144,adopt,20,12.1007999,20,7.824066011,7.823875996,400,94.67745723,7,9,16,15,15,30,4,0.425449,0.442229,0,No
1,zurich,23,11.96103796,18,7.929426526,7.929256515,414,94.84417169,5,12,17,20,19,39,4,0.444408,0.458688,0,No
4463,retina,25,11.87765635,17,7.98658494,7.986424931,425,94.86191135,4,14,18,25,21,46,4,0.438686,0.453956,0,No
9219,kelvin,25,11.87765635,17,7.98658494,7.986424931,425,94.86191135,14,16,30,24,24,48,4,0.445133,0.459345,0,No
10676,hebrides,25,11.87765635,17,7.98658494,7.986424931,425,94.86191135,6,14,20,11,22,33,4,0.427323,0.443867,0,No
13197,duel,25,11.87765635,17,7.98658494,7.986424931,425,94.86191135,8,13,21,22,18,40,4,0.438968,0.454082,0,No
11245,gong,30,11.6953348,15,8.111748083,8.111608076,450,94.86960961,5,13,18,14,21,35,5,0.351519,0.361952,0,No
11575,gambia,30,11.6953348,15,8.111748083,8.111608076,450,94.86960961,10,18,28,27,25,52,4,0.448779,0.462425,0,No
11607,galactic,21,12.05200974,19,7.875359305,7.875179292,399,94.91390705,6,8,14,19,12,31,4,0.408746,0.426389,0,No
13866,decorate,21,12.05200974,19,7.875359305,7.875179292,399,94.91390705,5,8,13,20,14,34,4,0.418616,0.436032,0,No
15687,capricorn,21,12.05200974,19,7.875359305,7.875179292,399,94.91390705,3,14,17,18,18,36,4,0.438102,0.453359,0,No
2661,staple,29,11.72923635,15,8.111748083,8.111608076,435,95.14461046,12,16,28,28,24,52,4,0.449985,0.463406,0,No
11566,ganges,29,11.72923635,15,8.111748083,8.111608076,435,95.14461046,5,12,17,26,26,52,4,0.409151,0.426629,0,No
7664,micronesia,32,11.63079627,14,8.180740955,8.180610949,448,95.14853142,8,18,26,29,24,53,4,0.433808,0.449679,0,No
923,vassal,24,11.91847835,17,7.98658494,7.986424931,408,95.18793968,8,9,17,22,19,41,4,0.430087,0.446299,0,No
16188,bravery,24,11.91847835,17,7.98658494,7.986424931,408,95.18793968,6,13,19,22,22,44,4,0.445434,0.45958,0,No
16972,bankruptcy,24,11.91847835,17,7.98658494,7.986424931,408,95.18793968,9,14,23,23,20,43,4,0.435063,0.450693,0,No
4122,rutland,22,12.00548972,18,7.929426526,7.929256515,396,95.19664868,8,12,20,14,15,29,4,0.435875,0.451392,0,No
8568,liturgy,22,12.00548972,18,7.929426526,7.929256515,396,95.19664868,12,13,25,20,18,38,4,0.442227,0.456871,0,No
11402,giantess,22,12.00548972,18,7.929426526,7.929256515,396,95.19664868,4,7,11,22,12,34,5,0.397434,0.414683,0,No
51,yukon,26,11.83843564,16,8.047209562,8.047059554,416,95.26637248,7,15,22,26,26,52,5,0.387907,0.404937,0,No
1352,treble,26,11.83843564,16,8.047209562,8.047059554,416,95.26637248,9,7,16,24,20,44,4,0.406462,0.424032,0,No
1737,thistle,26,11.83843564,16,8.047209562,8.047059554,416,95.26637248,3,13,16,9,18,27,4,0.433914,0.449679,0,No
7943,mayflower,26,11.83843564,16,8.047209562,8.047059554,416,95.26637248,4,13,17,25,19,44,4,0.421099,0.43814,0,No
8298,madeira,26,11.83843564,16,8.047209562,8.047059554,416,95.26637248,13,16,29,22,20,42,4,0.414947,0.432361,0,No
1045,upside,20,12.1007999,19,7.875359305,7.875179292,380,95.29814712,9,5,14,15,19,34,4,0.400068,0.41738,0,No
1084,ungulate,20,12.1007999,19,7.875359305,7.875179292,380,95.29814712,6,7,13,18,11,29,5,0.349601,0.359406,0,No
8586,literacy,20,12.1007999,19,7.875359305,7.875179292,380,95.29814712,12,8,20,16,14,30,4,0.405098,0.422572,0,No
11316,glorious,20,12.1007999,19,7.875359305,7.875179292,380,95.29814712,6,7,13,17,19,36,5,0.386791,0.403327,0,No
11976,fluffy,20,12.1007999,19,7.875359305,7.875179292,380,95.29814712,12,12,24,17,13,30,4,0.413892,0.43121,0,No
15817,calcutta,20,12.1007999,19,7.875359305,7.875179292,380,95.29814712,9,14,23,15,18,33,4,0.434031,0.449801,0,No
18163,adjust,20,12.1007999,19,7.875359305,7.875179292,380,95.29814712,8,7,15,18,19,37,4,0.415189,0.432567,0,No
15336,chatham,38,11.45894602,12,8.334891634,8.334781631,456,95.5090733,20,15,35,30,31,61,4,0.418695,0.435872,0,No
12902,elves,23,11.96103796,17,7.98658494,7.986424931,391,95.52784565,8,12,20,17,19,36,4,0.425092,0.441745,0,No
930,varsity,21,12.05200974,18,7.929426526,7.929256515,378,95.56552572,7,4,11,20,6,26,5,0.32976,0.333999,0,No
4012,sancho,21,12.05200974,18,7.929426526,7.929256515,378,95.56552572,10,8,18,18,16,34,5,0.349636,0.359583,0,No
6191,pasha,21,12.05200974,18,7.929426526,7.929256515,378,95.56552572,3,12,15,8,14,22,4,0.42549,0.442219,0,No
15179,chronology,21,12.05200974,18,7.929426526,7.929256515,378,95.56552572,14,12,26,16,19,35,4,0.410608,0.428079,0,No
8795,leibniz,25,11.87765635,16,8.047209562,8.047059554,400,95.58198977,8,11,19,22,16,38,4,0.432392,0.448303,0,No
15352,charley,25,11.87765635,16,8.047209562,8.047059554,400,95.58198977,16,13,29,20,17,37,4,0.409528,0.427131,0,No
15859,cabaret,25,11.87765635,16,8.047209562,8.047059554,400,95.58198977,10,16,26,14,19,33,4,0.446982,0.460918,0,No
10245,humboldt,30,11.6953348,14,8.180740955,8.180610949,420,95.67650434,11,16,27,26,26,52,4,0.403459,0.421061,0,No
4451,rev,19,12.1520932,19,7.875359305,7.875179292,361,95.70210024,8,13,21,17,15,32,5,0.336423,0.342542,0,No
6138,patriotic,19,12.1520932,19,7.875359305,7.875179292,361,95.70210024,10,10,20,16,13,29,4,0.407142,0.424784,0,No
6840,northward,19,12.1520932,19,7.875359305,7.875179292,361,95.70210024,4,9,13,4,16,20,4,0.409207,0.426704,0,No
12793,entertain,19,12.1520932,19,7.875359305,7.875179292,361,95.70210024,9,10,19,19,15,34,4,0.426861,0.443313,0,No
13816,delegate,19,12.1520932,19,7.875359305,7.875179292,361,95.70210024,6,3,9,17,17,34,5,0.372373,0.387318,0,No
15079,classify,19,12.1520932,19,7.875359305,7.875179292,361,95.70210024,5,6,11,16,8,24,4,0.401943,0.419587,0,No
18260,accompany,19,12.1520932,19,7.875359305,7.875179292,361,95.70210024,7,11,18,18,15,33,4,0.427817,0.444388,0,No
220,woodwind,22,12.00548972,17,7.98658494,7.986424931,374,95.88286343,10,7,17,19,18,37,4,0.435736,0.451176,0,No
224,woodrow,22,12.00548972,17,7.98658494,7.986424931,374,95.88286343,13,1,14,21,22,43,5,0.310783,0.315618,0,No
1663,tiber,22,12.00548972,17,7.98658494,7.986424931,374,95.88286343,2,12,14,22,19,41,4,0.436271,0.451726,0,No
2142,symphonic,22,12.00548972,17,7.98658494,7.986424931,374,95.88286343,11,6,17,19,15,34,5,0.358526,0.370914,0,No
10955,gym,22,12.00548972,17,7.98658494,7.986424931,374,95.88286343,8,13,21,17,19,36,4,0.401397,0.418892,0,No
2390,substantial,20,12.1007999,18,7.929426526,7.929256515,360,95.95240375,8,10,18,18,11,29,5,0.327449,0.331609,0,No
2869,specify,20,12.1007999,18,7.929426526,7.929256515,360,95.95240375,7,8,15,13,19,32,4,0.429474,0.445815,0,No
7819,melee,20,12.1007999,18,7.929426526,7.929256515,360,95.95240375,3,11,14,20,16,36,4,0.434148,0.449853,0,No
9534,italic,20,12.1007999,18,7.929426526,7.929256515,360,95.95240375,8,8,16,10,12,22,4,0.420291,0.437234,0,No
10189,hydrocarbon,20,12.1007999,18,7.929426526,7.929256515,360,95.95240375,9,10,19,19,13,32,5,0.372498,0.387337,0,No
12400,eyesight,20,12.1007999,18,7.929426526,7.929256515,360,95.95240375,9,13,22,17,17,34,4,0.445177,0.459359,0,No
13092,eastward,20,12.1007999,18,7.929426526,7.929256515,360,95.95240375,6,12,18,6,19,25,4,0.446948,0.460819,0,No
14666,confuse,20,12.1007999,18,7.929426526,7.929256515,360,95.95240375,9,9,18,17,16,33,4,0.414636,0.431976,0,No
14678,confirm,20,12.1007999,18,7.929426526,7.929256515,360,95.95240375,3,9,12,15,19,34,4,0.417789,0.435051,0,No
15827,calais,20,12.1007999,18,7.929426526,7.929256515,360,95.95240375,9,10,19,18,17,35,4,0.445244,0.459345,0,No
16264,bounce,20,12.1007999,18,7.929426526,7.929256515,360,95.95240375,14,13,27,19,19,38,4,0.410039,0.427727,0,No
18326,abolition,20,12.1007999,18,7.929426526,7.929256515,360,95.95240375,8,6,14,19,20,39,5,0.381414,0.397533,0,No
1449,trafficking,29,11.72923635,14,8.180740955,8.180610949,406,95.95384415,9,14,23,23,23,46,4,0.410903,0.428436,0,No
9210,kensington,32,11.63079627,13,8.254848927,8.254728922,416,96.01046614,15,11,26,28,22,50,4,0.426553,0.443045,0,No
2570,stevenson,26,11.83843564,15,8.111748083,8.111608076,390,96.0304076,11,18,29,19,24,43,4,0.394712,0.412061,0,No
7961,mauritius,26,11.83843564,15,8.111748083,8.111608076,390,96.0304076,15,13,28,25,19,44,4,0.442315,0.456932,0,No
671,volvo,35,11.54118412,12,8.334891634,8.334781631,420,96.19451894,10,10,20,26,28,54,4,0.404397,0.421901,0,No
11307,glow,28,11.76432767,14,8.180740955,8.180610949,392,96.24091715,13,18,31,21,27,48,5,0.405858,0.423565,0,No
4787,raj,23,11.96103796,16,8.047209562,8.047059554,368,96.25297905,3,12,15,21,19,40,4,0.437454,0.452754,0,No
6363,pageant,23,11.96103796,16,8.047209562,8.047059554,368,96.25297905,10,14,24,23,18,41,4,0.442359,0.457007,0,No
8615,linnaeus,23,11.96103796,16,8.047209562,8.047059554,368,96.25297905,8,13,21,12,15,27,5,0.378906,0.394721,0,No
9003,lafayette,23,11.96103796,16,8.047209562,8.047059554,368,96.25297905,10,12,22,19,18,37,5,0.353683,0.364666,0,No
9868,infect,23,11.96103796,16,8.047209562,8.047059554,368,96.25297905,10,10,20,20,12,32,4,0.403423,0.421164,0,No
17630,ant,23,11.96103796,16,8.047209562,8.047059554,368,96.25297905,14,9,23,21,14,35,4,0.412968,0.430351,0,No
6459,orwell,21,12.05200974,17,7.98658494,7.986424931,357,96.25439949,5,14,19,20,19,39,4,0.405728,0.423291,0,No
6482,orkney,21,12.05200974,17,7.98658494,7.986424931,357,96.25439949,10,7,17,16,13,29,4,0.394721,0.411845,0,No
8201,malleable,21,12.05200974,17,7.98658494,7.986424931,357,96.25439949,9,7,16,17,15,32,4,0.420241,0.437168,0,No
8309,macmillan,21,12.05200974,17,7.98658494,7.986424931,357,96.25439949,9,15,24,18,16,34,4,0.434999,0.450674,0,No
8409,luftwaffe,21,12.05200974,17,7.98658494,7.986424931,357,96.25439949,6,13,19,20,16,36,4,0.417484,0.434811,0,No
15347,charon,39,11.43297053,11,8.421903011,8.421803008,429,96.28736895,19,22,41,24,32,56,4,0.454303,0.466974,0,No
1900,template,25,11.87765635,15,8.111748083,8.111608076,375,96.34855615,6,11,17,22,18,40,4,0.402462,0.420094,0,No
5252,privy,25,11.87765635,15,8.111748083,8.111608076,375,96.34855615,7,3,10,23,14,37,5,0.359543,0.371997,0,No
5671,planck,25,11.87765635,15,8.111748083,8.111608076,375,96.34855615,11,14,25,23,20,43,5,0.408689,0.42626,0,No
1441,trait,19,12.1520932,18,7.929426526,7.929256515,342,96.35913016,10,12,22,17,18,35,4,0.435234,0.450829,0,No
4693,rebellious,19,12.1520932,18,7.929426526,7.929256515,342,96.35913016,12,9,21,17,10,27,5,0.386404,0.402923,0,No
4783,rally,19,12.1520932,18,7.929426526,7.929256515,342,96.35913016,11,12,23,16,13,29,4,0.436421,0.451862,0,No
6540,oppose,19,12.1520932,18,7.929426526,7.929256515,342,96.35913016,7,12,19,15,18,33,4,0.424178,0.440909,0,No
14781,competitor,19,12.1520932,18,7.929426526,7.929256515,342,96.35913016,7,11,18,16,19,35,4,0.439686,0.454749,0,No
15904,businessmen,19,12.1520932,18,7.929426526,7.929256515,342,96.35913016,14,14,28,17,18,35,4,0.436572,0.452064,0,No
16628,beth,19,12.1520932,18,7.929426526,7.929256515,342,96.35913016,15,9,24,17,12,29,4,0.408304,0.426061,0,No
18311,absent,19,12.1520932,18,7.929426526,7.929256515,342,96.35913016,8,10,18,17,17,34,4,0.435607,0.451115,0,No
11655,funnel,34,11.57017165,12,8.334891634,8.334781631,408,96.43612692,8,12,20,19,26,45,4,0.439501,0.454519,0,No
13847,defendant,27,11.80069531,14,8.180740955,8.180610949,378,96.53843143,3,16,19,27,23,50,4,0.425408,0.442238,0,No
1730,thorax,22,12.00548972,16,8.047209562,8.047059554,352,96.6106917,6,13,19,21,21,42,4,0.432941,0.448815,0,No
3343,siemens,22,12.00548972,16,8.047209562,8.047059554,352,96.6106917,8,9,17,20,12,32,4,0.442635,0.457148,0,No
5813,photon,22,12.00548972,16,8.047209562,8.047059554,352,96.6106917,6,11,17,21,17,38,4,0.427921,0.44443,0,No
7109,naughty,22,12.00548972,16,8.047209562,8.047059554,352,96.6106917,12,7,19,19,21,40,5,0.385724,0.402148,0,No
7911,mcdowell,22,12.00548972,16,8.047209562,8.047059554,352,96.6106917,13,12,25,20,19,39,5,0.39487,0.412101,0,No
8456,lottery,22,12.00548972,16,8.047209562,8.047059554,352,96.6106917,9,17,26,18,18,36,4,0.430944,0.447167,0,No
13938,deacon,22,12.00548972,16,8.047209562,8.047059554,352,96.6106917,7,14,21,20,18,38,4,0.435415,0.451022,0,No
526,waterway,20,12.1007999,17,7.98658494,7.986424931,340,96.64406628,10,16,26,17,18,35,4,0.437713,0.453064,0,No
684,volleyball,20,12.1007999,17,7.98658494,7.986424931,340,96.64406628,14,15,29,16,17,33,4,0.434371,0.45012,0,No
2552,stimuli,20,12.1007999,17,7.98658494,7.986424931,340,96.64406628,14,10,24,18,17,35,4,0.407853,0.425375,0,No
13041,editorial,20,12.1007999,17,7.98658494,7.986424931,340,96.64406628,10,8,18,14,12,26,4,0.400591,0.418296,0,No
17030,bakery,20,12.1007999,17,7.98658494,7.986424931,340,96.64406628,10,13,23,17,15,32,4,0.44269,0.45727,0,No
17588,antoinette,20,12.1007999,17,7.98658494,7.986424931,340,96.64406628,4,11,15,18,14,32,4,0.393985,0.411151,0,No
10868,hancock,24,11.91847835,15,8.111748083,8.111608076,360,96.67969388,9,15,24,21,21,42,4,0.41396,0.431473,0,No
11263,gogh,24,11.91847835,15,8.111748083,8.111608076,360,96.67969388,1,13,14,24,16,40,4,0.388595,0.405381,0,No
15281,chiang,24,11.91847835,15,8.111748083,8.111608076,360,96.67969388,17,7,24,19,11,30,5,0.387949,0.404599,0,No
505,weaken,18,12.20616042,18,7.929426526,7.929256515,324,96.78785221,5,12,17,15,14,29,4,0.449518,0.462918,0,No
2744,spun,18,12.20616042,18,7.929426526,7.929256515,324,96.78785221,11,10,21,15,16,31,4,0.422955,0.440064,0,No
6816,notion,18,12.20616042,18,7.929426526,7.929256515,324,96.78785221,6,6,12,16,18,34,5,0.392895,0.409988,0,No
8485,longtime,18,12.20616042,18,7.929426526,7.929256515,324,96.78785221,6,6,12,13,10,23,5,0.329656,0.333878,0,No
11644,furthermore,18,12.20616042,18,7.929426526,7.929256515,324,96.78785221,11,13,24,12,15,27,4,0.407198,0.425,0,No
12543,examine,18,12.20616042,18,7.929426526,7.929256515,324,96.78785221,7,8,15,16,13,29,4,0.417484,0.434919,0,No
18191,adapt,18,12.20616042,18,7.929426526,7.929256515,324,96.78785221,6,5,11,16,17,33,4,0.443088,0.457448,0,No
9121,kite,29,11.72923635,13,8.254848927,8.254728922,377,96.82307407,7,14,21,25,19,44,4,0.439468,0.454542,0,No
9262,kant,26,11.83843564,14,8.180740955,8.180610949,364,96.84717527,9,13,22,11,17,28,5,0.401743,0.419255,0,No
12672,escort,26,11.83843564,14,8.180740955,8.180610949,364,96.84717527,9,16,25,25,22,47,4,0.402572,0.420249,0,No
13539,din,26,11.83843564,14,8.180740955,8.180610949,364,96.84717527,7,8,15,10,11,21,4,0.428996,0.445205,0,No
44,zagreb,32,11.63079627,12,8.334891634,8.334781631,384,96.94142657,11,14,25,24,27,51,4,0.432561,0.448491,0,No
9012,lacrosse,32,11.63079627,12,8.334891634,8.334781631,384,96.94142657,10,16,26,22,27,49,4,0.433279,0.449181,0,No
8864,lawson,21,12.05200974,16,8.047209562,8.047059554,336,96.98504802,8,12,20,11,18,29,4,0.429567,0.445782,0,No
9095,knockout,21,12.05200974,16,8.047209562,8.047059554,336,96.98504802,9,11,20,17,18,35,5,0.405265,0.422898,0,No
12615,euclidean,21,12.05200974,16,8.047209562,8.047059554,336,96.98504802,13,4,17,19,7,26,5,0.324148,0.327557,0,No
12746,epistle,21,12.05200974,16,8.047209562,8.047059554,336,96.98504802,6,4,10,17,20,37,5,0.403239,0.420769,0,No
14344,covalent,21,12.05200974,16,8.047209562,8.047059554,336,96.98504802,14,4,18,18,9,27,5,0.39473,0.411843,0,No
1104,ullman,23,11.96103796,15,8.111748083,8.111608076,345,97.02492676,3,6,9,3,17,20,5,0.358657,0.370532,0,No
3172,sled,23,11.96103796,15,8.111748083,8.111608076,345,97.02492676,10,9,19,21,16,37,5,0.375206,0.390752,0,No
7068,necklace,23,11.96103796,15,8.111748083,8.111608076,345,97.02492676,6,11,17,19,14,33,4,0.434148,0.449937,0,No
8370,lute,23,11.96103796,15,8.111748083,8.111608076,345,97.02492676,8,16,24,21,21,42,4,0.428685,0.445069,0,No
11132,graze,19,12.1520932,17,7.98658494,7.986424931,323,97.05372453,10,14,24,19,19,38,4,0.439969,0.454942,0,No
15613,carolingian,19,12.1520932,17,7.98658494,7.986424931,323,97.05372453,6,9,15,18,15,33,5,0.380621,0.397308,0,No
17387,arrange,19,12.1520932,17,7.98658494,7.986424931,323,97.05372453,3,13,16,16,17,33,4,0.428665,0.445228,0,No
17502,approve,19,12.1520932,17,7.98658494,7.986424931,323,97.05372453,6,8,14,16,16,32,4,0.438166,0.453449,0,No
6416,ovary,28,11.76432767,13,8.254848927,8.254728922,364,97.11274762,10,14,24,25,24,49,5,0.413873,0.431409,0,No
5151,proposition,25,11.87765635,14,8.180740955,8.180610949,350,97.16802977,15,17,32,22,24,46,4,0.451014,0.464246,0,No
17019,baleen,35,11.54118412,11,8.421903011,8.421803008,385,97.19873326,16,7,23,27,18,45,4,0.419516,0.43659,0,No
3149,slip,20,12.1007999,16,8.047209562,8.047059554,320,97.37767269,13,12,25,16,17,33,4,0.41768,0.434872,0,No
4586,relaxation,20,12.1007999,16,8.047209562,8.047059554,320,97.37767269,8,11,19,15,15,30,4,0.409481,0.426981,0,No
10585,heredity,20,12.1007999,16,8.047209562,8.047059554,320,97.37767269,11,12,23,17,16,33,4,0.436991,0.45235,0,No
12326,faraday,20,12.1007999,16,8.047209562,8.047059554,320,97.37767269,5,10,15,18,12,30,4,0.401134,0.418836,0,No
15015,clockwork,20,12.1007999,16,8.047209562,8.047059554,320,97.37767269,4,4,8,18,18,36,5,0.391405,0.408251,0,No
15237,chivalry,20,12.1007999,16,8.047209562,8.047059554,320,97.37767269,2,8,10,17,16,33,4,0.439033,0.454054,0,No
654,vulgar,22,12.00548972,15,8.111748083,8.111608076,330,97.38550826,14,5,19,17,17,34,5,0.371764,0.386501,0,No
1803,thebes,22,12.00548972,15,8.111748083,8.111608076,330,97.38550826,13,11,24,19,20,39,4,0.416974,0.434238,0,No
9280,kabul,22,12.00548972,15,8.111748083,8.111608076,330,97.38550826,10,12,22,20,19,39,4,0.434296,0.449993,0,No
10567,herodotus,22,12.00548972,15,8.111748083,8.111608076,330,97.38550826,12,10,22,14,14,28,4,0.424828,0.441571,0,No
10925,hadrian,22,12.00548972,15,8.111748083,8.111608076,330,97.38550826,13,7,20,20,15,35,5,0.352489,0.362677,0,No
16983,bandwidth,22,12.00548972,15,8.111748083,8.111608076,330,97.38550826,10,7,17,13,12,25,4,0.417229,0.434412,0,No
5753,pillar,27,11.80069531,13,8.254848927,8.254728922,351,97.41295703,12,15,27,23,23,46,5,0.416534,0.433973,0,No
11955,focal,27,11.80069531,13,8.254848927,8.254728922,351,97.41295703,12,5,17,19,21,40,5,0.325497,0.329011,0,No
17343,ascii,27,11.80069531,13,8.254848927,8.254728922,351,97.41295703,12,12,24,17,19,36,4,0.424584,0.441355,0,No
192,worry,18,12.20616042,17,7.98658494,7.986424931,306,97.48553698,8,8,16,16,16,32,4,0.395857,0.413066,0,No
5339,predatory,18,12.20616042,17,7.98658494,7.986424931,306,97.48553698,12,5,17,17,9,26,5,0.325211,0.328776,0,No
6342,paleolithic,18,12.20616042,17,7.98658494,7.986424931,306,97.48553698,6,12,18,13,14,27,5,0.388884,0.405702,0,No
7717,metallurgy,18,12.20616042,17,7.98658494,7.986424931,306,97.48553698,7,11,18,15,14,29,4,0.450464,0.463673,0,No
9584,irrational,18,12.20616042,17,7.98658494,7.986424931,306,97.48553698,8,5,13,13,7,20,5,0.395433,0.412603,0,No
13149,dusk,18,12.20616042,17,7.98658494,7.986424931,306,97.48553698,9,10,19,17,16,33,4,0.436733,0.452097,0,No
13741,deny,18,12.20616042,17,7.98658494,7.986424931,306,97.48553698,7,10,17,16,17,33,4,0.406239,0.423981,0,No
14493,cooperate,18,12.20616042,17,7.98658494,7.986424931,306,97.48553698,6,9,15,15,17,32,4,0.417867,0.435027,0,No
15663,carboniferous,18,12.20616042,17,7.98658494,7.986424931,306,97.48553698,4,7,11,17,17,34,4,0.425622,0.442144,0,No
16916,barren,18,12.20616042,17,7.98658494,7.986424931,306,97.48553698,11,12,23,17,16,33,4,0.426154,0.442712,0,No
9694,interim,24,11.91847835,14,8.180740955,8.180610949,336,97.50198393,6,15,21,22,17,39,5,0.386294,0.402918,0,No
10216,huron,24,11.91847835,14,8.180740955,8.180610949,336,97.50198393,7,16,23,23,21,44,4,0.404038,0.421624,0,No
11183,grail,24,11.91847835,14,8.180740955,8.180610949,336,97.50198393,1,18,19,5,24,29,4,0.443653,0.458162,0,No
8984,lamar,26,11.83843564,13,8.254848927,8.254728922,338,97.72449773,11,13,24,15,20,35,4,0.40805,0.425741,0,No
6623,okinawa,29,11.72923635,12,8.334891634,8.334781631,348,97.76191391,13,14,27,26,20,46,4,0.399042,0.416502,0,No
7960,mausoleum,21,12.05200974,15,8.111748083,8.111608076,315,97.7628669,6,10,16,17,18,35,4,0.441787,0.456439,0,No
12980,elba,21,12.05200974,15,8.111748083,8.111608076,315,97.7628669,10,12,22,19,20,39,4,0.428148,0.44451,0,No
16438,bloomington,21,12.05200974,15,8.111748083,8.111608076,315,97.7628669,9,11,20,16,20,36,5,0.373941,0.38913,0,No
16806,becket,21,12.05200974,15,8.111748083,8.111608076,315,97.7628669,6,11,17,17,15,32,4,0.427128,0.443707,0,No
1550,tonal,19,12.1520932,16,8.047209562,8.047059554,304,97.79044058,9,10,19,16,17,33,4,0.418666,0.435727,0,No
3782,scratch,19,12.1520932,16,8.047209562,8.047059554,304,97.79044058,9,11,20,14,17,31,4,0.440111,0.455012,0,No
11119,greene,19,12.1520932,16,8.047209562,8.047059554,304,97.79044058,10,7,17,15,16,31,5,0.381135,0.397238,0,No
12308,fascism,19,12.1520932,16,8.047209562,8.047059554,304,97.79044058,12,11,23,18,14,32,4,0.433046,0.448867,0,No
16148,brent,19,12.1520932,16,8.047209562,8.047059554,304,97.79044058,12,7,19,14,13,27,4,0.39057,0.407442,0,No
977,vaccine,23,11.96103796,14,8.180740955,8.180610949,322,97.85015311,8,12,20,23,19,42,4,0.41367,0.431088,0,No
8424,lucerne,23,11.96103796,14,8.180740955,8.180610949,322,97.85015311,7,13,20,16,16,32,4,0.432719,0.448623,0,No
11438,geothermal,23,11.96103796,14,8.180740955,8.180610949,322,97.85015311,10,5,15,17,17,34,5,0.327063,0.33094,0,No
12448,exponential,23,11.96103796,14,8.180740955,8.180610949,322,97.85015311,11,6,17,22,19,41,4,0.407385,0.425089,0,No
13942,daytona,23,11.96103796,14,8.180740955,8.180610949,322,97.85015311,8,9,17,18,21,39,4,0.41715,0.434403,0,No
17104,axle,23,11.96103796,14,8.180740955,8.180610949,322,97.85015311,10,14,24,22,18,40,4,0.451381,0.464486,0,No
2396,submitted,17,12.26331883,17,7.98658494,7.986424931,289,97.94203751,11,9,20,13,15,28,4,0.446173,0.460185,0,No
3563,seventeenth,17,12.26331883,17,7.98658494,7.986424931,289,97.94203751,2,5,7,16,12,28,5,0.38518,0.401519,0,No
6581,omnivorous,17,12.26331883,17,7.98658494,7.986424931,289,97.94203751,7,8,15,16,8,24,4,0.427138,0.443524,0,No
9723,intact,17,12.26331883,17,7.98658494,7.986424931,289,97.94203751,9,13,22,12,13,25,4,0.430025,0.446224,0,No
12540,exceed,17,12.26331883,17,7.98658494,7.986424931,289,97.94203751,7,9,16,16,13,29,4,0.428924,0.44535,0,No
13801,delimit,17,12.26331883,17,7.98658494,7.986424931,289,97.94203751,0,1,1,0,17,17,5,0.398072,0.415819,0,No
14831,commemorate,17,12.26331883,17,7.98658494,7.986424931,289,97.94203751,2,9,11,17,17,34,4,0.41589,0.433473,0,No
16495,blame,17,12.26331883,17,7.98658494,7.986424931,289,97.94203751,6,12,18,13,14,27,4,0.377874,0.393593,0,No
16873,batch,17,12.26331883,17,7.98658494,7.986424931,289,97.94203751,11,5,16,15,15,30,4,0.402718,0.420197,0,No
13641,dew,32,11.63079627,11,8.421903011,8.421803008,352,97.95343817,13,11,24,27,32,59,5,0.360522,0.373072,0,No
10543,heterosexual,25,11.87765635,13,8.254848927,8.254728922,325,98.04825879,13,20,33,21,23,44,4,0.458967,0.470682,0,No
3457,sherwood,20,12.1007999,15,8.111748083,8.111608076,300,98.15864042,12,9,21,17,14,31,4,0.392799,0.409888,0,No
8004,mast,20,12.1007999,15,8.111748083,8.111608076,300,98.15864042,8,9,17,14,15,29,4,0.421819,0.438797,0,No
11044,grover,20,12.1007999,15,8.111748083,8.111608076,300,98.15864042,12,1,13,15,18,33,5,0.314005,0.318273,0,No
11779,freak,20,12.1007999,15,8.111748083,8.111608076,300,98.15864042,11,10,21,16,18,34,4,0.434552,0.450205,0,No
12569,everett,20,12.1007999,15,8.111748083,8.111608076,300,98.15864042,14,10,24,17,12,29,5,0.356854,0.368434,0,No
12862,emitted,20,12.1007999,15,8.111748083,8.111608076,300,98.15864042,11,9,20,17,16,33,4,0.414588,0.431943,0,No
13287,doyle,20,12.1007999,15,8.111748083,8.111608076,300,98.15864042,8,10,18,8,12,20,5,0.372709,0.387727,0,No
13860,decryption,20,12.1007999,15,8.111748083,8.111608076,300,98.15864042,9,9,18,17,16,33,4,0.411646,0.42906,0,No
17297,assyria,20,12.1007999,15,8.111748083,8.111608076,300,98.15864042,6,12,18,18,13,31,4,0.424462,0.441294,0,No
1763,theses,22,12.00548972,14,8.180740955,8.180610949,308,98.21380147,6,10,16,20,18,38,4,0.405552,0.423211,0,No
5235,proclamation,22,12.00548972,14,8.180740955,8.180610949,308,98.21380147,6,15,21,17,18,35,4,0.445826,0.459932,0,No
5519,polygon,22,12.00548972,14,8.180740955,8.180610949,308,98.21380147,5,14,19,20,22,42,4,0.417808,0.435037,0,No
7249,mummy,22,12.00548972,14,8.180740955,8.180610949,308,98.21380147,6,10,16,22,15,37,4,0.452266,0.465129,0,No
8706,libertarian,22,12.00548972,14,8.180740955,8.180610949,308,98.21380147,10,6,16,16,11,27,5,0.394967,0.412134,0,No
9511,jacket,22,12.00548972,14,8.180740955,8.180610949,308,98.21380147,11,15,26,20,18,38,4,0.438231,0.4535,0,No
10894,halley,22,12.00548972,14,8.180740955,8.180610949,308,98.21380147,8,9,17,14,19,33,5,0.386681,0.403439,0,No
15369,chaplin,22,12.00548972,14,8.180740955,8.180610949,308,98.21380147,6,18,24,17,19,36,4,0.433438,0.449364,0,No
15867,byte,22,12.00548972,14,8.180740955,8.180610949,308,98.21380147,11,13,24,20,17,37,4,0.440778,0.455636,0,No
482,weekday,18,12.20616042,16,8.047209562,8.047059554,288,98.22553084,7,15,22,18,17,35,4,0.436335,0.451824,0,No
1460,tractor,18,12.20616042,16,8.047209562,8.047059554,288,98.22553084,8,9,17,17,11,28,4,0.41003,0.427483,0,No
2274,suppose,18,12.20616042,16,8.047209562,8.047059554,288,98.22553084,9,7,16,12,18,30,4,0.419874,0.437144,0,No
2305,sunk,18,12.20616042,16,8.047209562,8.047059554,288,98.22553084,11,11,22,16,16,32,4,0.4408,0.455608,0,No
2891,spark,18,12.20616042,16,8.047209562,8.047059554,288,98.22553084,7,12,19,16,15,31,4,0.432466,0.448486,0,No
4585,relevant,18,12.20616042,16,8.047209562,8.047059554,288,98.22553084,12,6,18,16,13,29,4,0.404038,0.421455,0,No
5428,possess,18,12.20616042,16,8.047209562,8.047059554,288,98.22553084,7,10,17,14,15,29,4,0.419289,0.436332,0,No
8161,manfred,18,12.20616042,16,8.047209562,8.047059554,288,98.22553084,11,5,16,17,14,31,5,0.385272,0.40184,0,No
8482,lookout,18,12.20616042,16,8.047209562,8.047059554,288,98.22553084,10,4,14,17,7,24,4,0.403221,0.42084,0,No
8800,legitimate,18,12.20616042,16,8.047209562,8.047059554,288,98.22553084,12,14,26,17,16,33,5,0.355696,0.366884,0,No
9727,insult,18,12.20616042,16,8.047209562,8.047059554,288,98.22553084,5,13,18,15,15,30,4,0.45207,0.465044,0,No
11196,grab,18,12.20616042,16,8.047209562,8.047059554,288,98.22553084,7,9,16,17,15,32,4,0.438892,0.453946,0,No
12619,etymology,18,12.20616042,16,8.047209562,8.047059554,288,98.22553084,5,9,14,10,15,25,4,0.42496,0.441675,0,No
15319,cheek,18,12.20616042,16,8.047209562,8.047059554,288,98.22553084,11,4,15,17,6,23,5,0.330159,0.334722,0,No
16169,breakthrough,18,12.20616042,16,8.047209562,8.047059554,288,98.22553084,11,9,20,14,12,26,5,0.387272,0.403895,0,No
16375,boil,18,12.20616042,16,8.047209562,8.047059554,288,98.22553084,9,10,19,16,14,30,4,0.438145,0.453317,0,No
17953,alert,18,12.20616042,16,8.047209562,8.047059554,288,98.22553084,10,11,21,13,15,28,4,0.42757,0.44398,0,No
377,whittier,35,11.54118412,10,8.517213191,8.517123189,350,98.29872559,18,15,33,27,31,58,4,0.432498,0.448566,0,No
2751,sprint,24,11.91847835,13,8.254848927,8.254728922,312,98.38523819,12,8,20,20,22,42,5,0.364707,0.378255,0,No
9683,interregnum,24,11.91847835,13,8.254848927,8.254728922,312,98.38523819,8,13,21,19,15,34,4,0.425745,0.44251,0,No
10584,hereford,24,11.91847835,13,8.254848927,8.254728922,312,98.38523819,12,13,25,21,18,39,4,0.442426,0.457045,0,No
13896,decatur,24,11.91847835,13,8.254848927,8.254728922,312,98.38523819,15,12,27,23,21,44,4,0.394353,0.411564,0,No
15814,caldwell,24,11.91847835,13,8.254848927,8.254728922,312,98.38523819,13,8,21,22,23,45,4,0.39156,0.408508,0,No
17402,armistice,24,11.91847835,13,8.254848927,8.254728922,312,98.38523819,9,11,20,23,22,45,4,0.444586,0.458824,0,No
8217,malawi,30,11.6953348,11,8.421903011,8.421803008,330,98.49697534,11,15,26,27,22,49,4,0.440461,0.455416,0,No
14644,conn,19,12.1520932,16,8.111748083,8.111608076,304,98.57471871,4,1,5,17,18,35,6,0.249249,0.25116,0,No
122,yang,19,12.1520932,15,8.111748083,8.111608076,285,98.57471871,7,8,15,8,10,18,4,0.392704,0.409756,0,No
571,warrant,19,12.1520932,15,8.111748083,8.111608076,285,98.57471871,11,7,18,18,11,29,4,0.430327,0.446402,0,No
821,vesuvius,19,12.1520932,15,8.111748083,8.111608076,285,98.57471871,4,9,13,19,10,29,4,0.377247,0.392875,0,No
1328,tribunal,19,12.1520932,15,8.111748083,8.111608076,285,98.57471871,9,14,23,17,15,32,4,0.405876,0.423436,0,No
5548,policemen,19,12.1520932,15,8.111748083,8.111608076,285,98.57471871,10,14,24,16,14,30,5,0.41095,0.428485,0,No
9707,intensive,19,12.1520932,15,8.111748083,8.111608076,285,98.57471871,13,8,21,16,11,27,4,0.388961,0.405695,0,No
11018,guerrilla,19,12.1520932,15,8.111748083,8.111608076,285,98.57471871,12,6,18,16,12,28,5,0.350568,0.360528,0,No
11417,gestation,19,12.1520932,15,8.111748083,8.111608076,285,98.57471871,6,6,12,15,18,33,5,0.393758,0.410882,0,No
12445,exposition,19,12.1520932,15,8.111748083,8.111608076,285,98.57471871,11,7,18,14,13,27,5,0.418656,0.435747,0,No
16442,bloodstream,19,12.1520932,15,8.111748083,8.111608076,285,98.57471871,2,13,15,19,18,37,4,0.438253,0.453453,0,No
17278,astrophysics,19,12.1520932,15,8.111748083,8.111608076,285,98.57471871,7,14,21,18,17,35,4,0.447681,0.461443,0,No
17853,alphonse,19,12.1520932,15,8.111748083,8.111608076,285,98.57471871,11,7,18,15,7,22,5,0.406099,0.423551,0,No
18131,adultery,19,12.1520932,15,8.111748083,8.111608076,285,98.57471871,11,10,21,17,14,31,4,0.405376,0.422864,0,No
3087,snap,21,12.05200974,14,8.180740955,8.180610949,294,98.59436966,13,14,27,20,16,36,4,0.437001,0.45251,0,No
8006,massif,21,12.05200974,14,8.180740955,8.180610949,294,98.59436966,2,6,8,19,20,39,4,0.426389,0.44282,0,No
10108,idiot,21,12.05200974,14,8.180740955,8.180610949,294,98.59436966,6,16,22,7,19,26,4,0.429827,0.446111,0,No
11367,giraffe,21,12.05200974,14,8.180740955,8.180610949,294,98.59436966,5,6,11,15,14,29,4,0.427323,0.443665,0,No
370,wholly,17,12.26331883,16,8.047209562,8.047059554,272,98.68549658,8,4,12,15,6,21,5,0.361594,0.374567,0,No
979,vacant,17,12.26331883,16,8.047209562,8.047059554,272,98.68549658,7,11,18,13,15,28,5,0.397523,0.414833,0,No
1573,token,17,12.26331883,16,8.047209562,8.047059554,272,98.68549658,11,7,18,15,16,31,5,0.390785,0.407737,0,No
2107,ta,17,12.26331883,16,8.047209562,8.047059554,272,98.68549658,5,9,14,16,14,30,5,0.341641,0.349361,0,No
3008,solidarity,17,12.26331883,16,8.047209562,8.047059554,272,98.68549658,11,15,26,12,16,28,4,0.461713,0.472734,0,No
3670,seize,17,12.26331883,16,8.047209562,8.047059554,272,98.68549658,5,9,14,12,16,28,5,0.399887,0.417701,0,No
4048,salle,17,12.26331883,16,8.047209562,8.047059554,272,98.68549658,2,7,9,17,8,25,5,0.351777,0.362206,0,No
7773,mentor,17,12.26331883,16,8.047209562,8.047059554,272,98.68549658,11,12,23,16,16,32,4,0.447568,0.461336,0,No
9463,jealousy,17,12.26331883,16,8.047209562,8.047059554,272,98.68549658,11,12,23,12,14,26,4,0.43684,0.452219,0,No
9644,invent,17,12.26331883,16,8.047209562,8.047059554,272,98.68549658,7,5,12,13,14,27,4,0.418281,0.4356,0,No
12438,extant,17,12.26331883,16,8.047209562,8.047059554,272,98.68549658,11,7,18,13,10,23,5,0.399518,0.416842,0,No
13412,doctoral,17,12.26331883,16,8.047209562,8.047059554,272,98.68549658,5,4,9,15,13,28,5,0.384362,0.400599,0,No
14656,congressional,17,12.26331883,16,8.047209562,8.047059554,272,98.68549658,10,7,17,13,11,24,5,0.327909,0.331886,0,No
15270,chieftain,17,12.26331883,16,8.047209562,8.047059554,272,98.68549658,8,9,17,9,13,22,4,0.442095,0.456683,0,No
16432,blown,17,12.26331883,16,8.047209562,8.047059554,272,98.68549658,8,9,17,14,17,31,5,0.372732,0.387686,0,No
17073,backbone,17,12.26331883,16,8.047209562,8.047059554,272,98.68549658,6,8,14,17,15,32,4,0.437993,0.453298,0,No
5691,pizarro,23,11.96103796,13,8.254848927,8.254728922,299,98.73656138,7,13,20,22,14,36,4,0.394686,0.411967,0,No
7160,nagoya,23,11.96103796,13,8.254848927,8.254728922,299,98.73656138,10,8,18,14,9,23,4,0.426276,0.442754,0,No
12009,flock,23,11.96103796,13,8.254848927,8.254728922,299,98.73656138,4,13,17,17,18,35,4,0.437972,0.453308,0,No
13526,dionysus,23,11.96103796,13,8.254848927,8.254728922,299,98.73656138,11,17,28,16,21,37,4,0.441776,0.456571,0,No
15306,chemotherapy,23,11.96103796,13,8.254848927,8.254728922,299,98.73656138,14,11,25,18,14,32,4,0.411169,0.428652,0,No
308,windmill,29,11.72923635,11,8.421903011,8.421803008,319,98.78249092,12,16,28,19,21,40,4,0.451346,0.464486,0,No
6207,parthia,20,12.1007999,14,8.180740955,8.180610949,280,98.99350936,5,12,17,19,13,32,4,0.439338,0.454383,0,No
8768,lent,20,12.1007999,14,8.180740955,8.180610949,280,98.99350936,13,14,27,15,15,30,4,0.450419,0.463786,0,No
13783,deluxe,20,12.1007999,14,8.180740955,8.180610949,280,98.99350936,10,4,14,13,19,32,5,0.347977,0.357572,0,No
14293,craven,20,12.1007999,14,8.180740955,8.180610949,280,98.99350936,5,11,16,5,17,22,4,0.42349,0.440262,0,No
15296,chesapeake,20,12.1007999,14,8.180740955,8.180610949,280,98.99350936,10,7,17,18,20,38,5,0.37077,0.385389,0,No
15380,chant,20,12.1007999,14,8.180740955,8.180610949,280,98.99350936,6,8,14,8,14,22,4,0.440253,0.455195,0,No
15599,carrion,20,12.1007999,14,8.180740955,8.180610949,280,98.99350936,9,9,18,18,16,34,5,0.397666,0.415171,0,No
1009,usable,18,12.20616042,15,8.111748083,8.111608076,270,99.01329838,16,10,26,16,13,29,5,0.38538,0.401904,0,No
1713,thrace,18,12.20616042,15,8.111748083,8.111608076,270,99.01329838,8,12,20,13,14,27,4,0.426102,0.44267,0,No
5316,premium,18,12.20616042,15,8.111748083,8.111608076,270,99.01329838,9,10,19,17,11,28,5,0.333841,0.339576,0,No
8691,lick,18,12.20616042,15,8.111748083,8.111608076,270,99.01329838,12,7,19,16,17,33,4,0.414675,0.432088,0,No
13333,doris,18,12.20616042,15,8.111748083,8.111608076,270,99.01329838,10,10,20,13,14,27,4,0.37793,0.393654,0,No
15132,circulatory,18,12.20616042,15,8.111748083,8.111608076,270,99.01329838,7,4,11,16,16,32,4,0.412641,0.429877,0,No
17719,andean,18,12.20616042,15,8.111748083,8.111608076,270,99.01329838,5,6,11,16,6,22,5,0.328084,0.331992,0,No
12107,firewall,28,11.76432767,11,8.421903011,8.421803008,308,99.07802661,9,16,25,18,22,40,4,0.441227,0.456073,0,No
17186,auschwitz,28,11.76432767,11,8.421903011,8.421803008,308,99.07802661,10,14,24,18,17,35,4,0.407068,0.424662,0,No
169,wren,22,12.00548972,13,8.254848927,8.254728922,286,99.10350396,8,14,22,20,16,36,4,0.441941,0.456641,0,No
1877,tensile,22,12.00548972,13,8.254848927,8.254728922,286,99.10350396,10,3,13,16,20,36,5,0.322693,0.325968,0,No
4066,salamander,22,12.00548972,13,8.254848927,8.254728922,286,99.10350396,9,8,17,18,13,31,5,0.381668,0.397967,0,No
6316,pancreas,22,12.00548972,13,8.254848927,8.254728922,286,99.10350396,2,11,13,19,14,33,4,0.441501,0.456209,0,No
7832,meiosis,22,12.00548972,13,8.254848927,8.254728922,286,99.10350396,14,12,26,18,19,37,4,0.440133,0.455059,0,No
11753,fresco,22,12.00548972,13,8.254848927,8.254728922,286,99.10350396,11,11,22,19,16,35,4,0.4355,0.451101,0,No
575,warmth,16,12.32394346,16,8.047209562,8.047059554,256,99.17335561,11,10,21,13,12,25,4,0.444497,0.45873,0,No
2369,suck,16,12.32394346,16,8.047209562,8.047059554,256,99.17335561,9,9,18,15,16,31,4,0.417769,0.434933,0,No
7871,meaningful,16,12.32394346,16,8.047209562,8.047059554,256,99.17335561,14,10,24,14,11,25,4,0.397835,0.41516,0,No
12322,farewell,16,12.32394346,16,8.047209562,8.047059554,256,99.17335561,10,11,21,16,14,30,4,0.395963,0.413254,0,No
12819,eng,16,12.32394346,16,8.047209562,8.047059554,256,99.17335561,4,4,8,13,11,24,5,0.331169,0.335805,0,No
16665,bernardino,16,12.32394346,16,8.047209562,8.047059554,256,99.17335561,3,4,7,14,12,26,5,0.330343,0.33488,0,No
18153,admit,16,12.32394346,16,8.047209562,8.047059554,256,99.17335561,8,7,15,14,16,30,4,0.416641,0.433938,0,No
8322,mach,24,11.91847835,12,8.334891634,8.334781631,288,99.33922547,13,11,24,22,12,34,4,0.430359,0.446491,0,No
16584,bikini,24,11.91847835,12,8.334891634,8.334781631,288,99.33922547,9,11,20,22,17,39,4,0.434637,0.450374,0,No
3874,scenario,27,11.80069531,11,8.421903011,8.421803008,297,99.38431138,6,15,21,14,21,35,4,0.452832,0.465762,0,No
5019,pun,19,12.1520932,14,8.180740955,8.180610949,266,99.41312651,3,9,12,19,16,35,5,0.386724,0.403369,0,No
5164,propeller,19,12.1520932,14,8.180740955,8.180610949,266,99.41312651,9,12,21,17,13,30,4,0.426,0.442585,0,No
5444,portmanteau,19,12.1520932,14,8.180740955,8.180610949,266,99.41312651,3,6,9,19,16,35,5,0.381816,0.398083,0,No
6949,nielsen,19,12.1520932,14,8.180740955,8.180610949,266,99.41312651,8,6,14,15,6,21,5,0.340292,0.347293,0,No
8381,lund,19,12.1520932,14,8.180740955,8.180610949,266,99.41312651,8,6,14,11,11,22,4,0.390218,0.407057,0,No
11293,gmt,19,12.1520932,14,8.180740955,8.180610949,266,99.41312651,9,13,22,18,15,33,4,0.43064,0.446759,0,No
12254,feedback,19,12.1520932,14,8.180740955,8.180610949,266,99.41312651,9,9,18,11,16,27,4,0.42059,0.437525,0,No
16664,bernardo,19,12.1520932,14,8.180740955,8.180610949,266,99.41312651,9,4,13,10,7,17,5,0.385272,0.401618,0,No
18336,abigail,19,12.1520932,14,8.180740955,8.180610949,266,99.41312651,14,5,19,15,7,22,5,0.347398,0.356746,0,No
1500,torso,17,12.26331883,15,8.111748083,8.111608076,255,99.47695304,8,11,19,17,12,29,4,0.438708,0.453946,0,No
2584,stepmother,17,12.26331883,15,8.111748083,8.111608076,255,99.47695304,8,10,18,14,11,25,4,0.436303,0.45174,0,No
2766,spouse,17,12.26331883,15,8.111748083,8.111608076,255,99.47695304,10,9,19,16,16,32,5,0.395275,0.412586,0,No
4055,saline,17,12.26331883,15,8.111748083,8.111608076,255,99.47695304,11,8,19,14,16,30,5,0.366521,0.380454,0,No
5073,psychiatry,17,12.26331883,15,8.111748083,8.111608076,255,99.47695304,9,8,17,14,12,26,4,0.404268,0.421713,0,No
10391,homecoming,17,12.26331883,15,8.111748083,8.111608076,255,99.47695304,4,7,11,16,15,31,5,0.378939,0.395416,0,No
12150,filipino,17,12.26331883,15,8.111748083,8.111608076,255,99.47695304,10,14,24,14,15,29,5,0.368806,0.383154,0,No
12979,elbow,17,12.26331883,15,8.111748083,8.111608076,255,99.47695304,7,12,19,15,14,29,4,0.450156,0.463462,0,No
14405,cosmos,17,12.26331883,15,8.111748083,8.111608076,255,99.47695304,10,12,22,16,14,30,4,0.439099,0.454181,0,No
16115,brigham,17,12.26331883,15,8.111748083,8.111608076,255,99.47695304,11,2,13,12,16,28,5,0.324521,0.328069,0,No
6322,pamphlet,21,12.05200974,13,8.254848927,8.254728922,273,99.48751966,7,13,20,19,18,37,4,0.438188,0.453406,0,No
6699,occult,21,12.05200974,13,8.254848927,8.254728922,273,99.48751966,16,11,27,21,13,34,5,0.372068,0.387048,0,No
10582,heretic,21,12.05200974,13,8.254848927,8.254728922,273,99.48751966,11,11,22,20,15,35,4,0.406648,0.424164,0,No
12694,ernestine,21,12.05200974,13,8.254848927,8.254728922,273,99.48751966,8,1,9,19,2,21,5,0.323569,0.326815,0,No
12,zombie,23,11.96103796,12,8.334891634,8.334781631,276,99.69395524,10,14,24,19,19,38,4,0.434946,0.450613,0,No
18205,acton,23,11.96103796,12,8.334891634,8.334781631,276,99.69395524,8,11,19,13,14,27,5,0.354121,0.365088,0,No
7226,muse,26,11.83843564,11,8.421903011,8.421803008,286,99.70215676,9,13,22,23,25,48,4,0.417789,0.43499,0,No
3159,slice,18,12.20616042,14,8.180740955,8.180610949,252,99.85543644,10,9,19,13,15,28,4,0.40949,0.426934,0,No
9018,lace,18,12.20616042,14,8.180740955,8.180610949,252,99.85543644,12,9,21,15,14,29,4,0.449347,0.462725,0,No
11528,gastrointestinal,18,12.20616042,14,8.180740955,8.180610949,252,99.85543644,3,2,5,18,16,34,5,0.325611,0.329245,0,No
15730,canine,18,12.20616042,14,8.180740955,8.180610949,252,99.85543644,6,7,13,13,16,29,5,0.33413,0.339771,0,No
1053,upland,20,12.1007999,13,8.254848927,8.254728922,260,99.8902751,9,7,16,15,9,24,5,0.369205,0.383635,0,No
6492,orient,20,12.1007999,13,8.254848927,8.254728922,260,99.8902751,6,9,15,13,12,25,4,0.394108,0.411235,0,No
14952,cockpit,20,12.1007999,13,8.254848927,8.254728922,260,99.8902751,4,11,15,17,18,35,4,0.414966,0.432257,0,No
10917,haifa,29,11.72923635,10,8.517213191,8.517123189,290,99.90040654,6,12,18,11,19,30,4,0.426123,0.442689,0,No
2805,spite,16,12.32394346,15,8.111748083,8.111608076,240,99.9687247,2,2,4,16,16,32,5,0.378656,0.394458,0,No
3278,simulate,16,12.32394346,15,8.111748083,8.111608076,240,99.9687247,3,7,10,15,14,29,4,0.417877,0.435337,0,No
4171,rudyard,16,12.32394346,15,8.111748083,8.111608076,240,99.9687247,7,2,9,14,16,30,5,0.326017,0.329359,0,No
5723,pious,16,12.32394346,15,8.111748083,8.111608076,240,99.9687247,4,10,14,16,13,29,5,0.408915,0.426391,0,No
5910,persuade,16,12.32394346,15,8.111748083,8.111608076,240,99.9687247,5,7,12,16,14,30,4,0.410618,0.428192,0,No
6487,originate,16,12.32394346,15,8.111748083,8.111608076,240,99.9687247,7,5,12,11,16,27,5,0.375802,0.391146,0,No
8679,lifespan,16,12.32394346,15,8.111748083,8.111608076,240,99.9687247,7,8,15,12,15,27,4,0.415053,0.432304,0,No
8680,lifelong,16,12.32394346,15,8.111748083,8.111608076,240,99.9687247,7,6,13,15,8,23,5,0.32803,0.331758,0,No
9671,intimate,16,12.32394346,15,8.111748083,8.111608076,240,99.9687247,10,6,16,12,6,18,5,0.333283,0.338256,0,No
9698,interfere,16,12.32394346,15,8.111748083,8.111608076,240,99.9687247,4,4,8,16,16,32,4,0.403478,0.42099,0,No
9837,inform,16,12.32394346,15,8.111748083,8.111608076,240,99.9687247,5,11,16,14,15,29,4,0.430046,0.446219,0,No
14429,corridor,16,12.32394346,15,8.111748083,8.111608076,240,99.9687247,5,9,14,5,16,21,4,0.443487,0.457941,0,No
14545,contralto,16,12.32394346,15,8.111748083,8.111608076,240,99.9687247,9,8,17,15,11,26,5,0.368921,0.383332,0,No
17039,bail,16,12.32394346,15,8.111748083,8.111608076,240,99.9687247,5,11,16,10,11,21,4,0.40761,0.42514,0,No
11190,gradient,25,11.87765635,11,8.421903011,8.421803008,275,100.0324698,12,14,26,22,23,45,4,0.451128,0.464293,0,No
14815,commodity,25,11.87765635,11,8.421903011,8.421803008,275,100.0324698,14,11,25,23,16,39,4,0.422713,0.439628,0,No
3409,shotgun,22,12.00548972,12,8.334891634,8.334781631,264,100.0644559,7,13,20,22,19,41,4,0.405394,0.422957,0,No
6043,pelvis,22,12.00548972,12,8.334891634,8.334781631,264,100.0644559,8,16,24,21,20,41,4,0.445882,0.460007,0,No
12449,exponent,22,12.00548972,12,8.334891634,8.334781631,264,100.0644559,8,15,23,20,19,39,5,0.416984,0.434419,0,No
14161,cuckoo,22,12.00548972,12,8.334891634,8.334781631,264,100.0644559,10,8,18,20,17,37,5,0.411675,0.429302,0,No
1115,tyson,19,12.1520932,13,8.254848927,8.254728922,247,100.3136935,7,9,16,14,11,25,5,0.397443,0.41473,0,No
1342,trenton,19,12.1520932,13,8.254848927,8.254728922,247,100.3136935,12,9,21,15,19,34,4,0.426953,0.443388,0,No
2644,starvation,19,12.1520932,13,8.254848927,8.254728922,247,100.3136935,12,12,24,17,15,32,4,0.428841,0.445149,0,No
6011,pension,19,12.1520932,13,8.254848927,8.254728922,247,100.3136935,10,9,19,18,13,31,5,0.393679,0.410915,0,No
6668,odessa,19,12.1520932,13,8.254848927,8.254728922,247,100.3136935,9,11,20,17,16,33,4,0.394388,0.41177,0,No
8609,linus,19,12.1520932,13,8.254848927,8.254728922,247,100.3136935,10,6,16,12,6,18,4,0.399806,0.417136,0,No
11597,galilee,19,12.1520932,13,8.254848927,8.254728922,247,100.3136935,6,16,22,16,17,33,4,0.442757,0.457359,0,No
13861,decrypt,19,12.1520932,13,8.254848927,8.254728922,247,100.3136935,5,11,16,18,16,34,4,0.422794,0.439769,0,No
15345,chartres,19,12.1520932,13,8.254848927,8.254728922,247,100.3136935,8,12,20,17,16,33,4,0.433184,0.449017,0,No
235,wonderland,17,12.26331883,14,8.180740955,8.180610949,238,100.3230346,4,12,16,17,14,31,4,0.436668,0.452073,0,No
4226,roster,17,12.26331883,14,8.180740955,8.180610949,238,100.3230346,7,14,21,11,15,26,4,0.397719,0.415235,0,No
6085,peanut,17,12.26331883,14,8.180740955,8.180610949,238,100.3230346,9,8,17,14,8,22,5,0.352713,0.363317,0,No
13443,diva,17,12.26331883,14,8.180740955,8.180610949,238,100.3230346,5,10,15,10,13,23,4,0.429172,0.44543,0,No
15418,cf,17,12.26331883,14,8.180740955,8.180610949,238,100.3230346,9,14,23,9,14,23,4,0.434211,0.449956,0,No
17300,assumption,17,12.26331883,14,8.180740955,8.180610949,238,100.3230346,7,6,13,14,15,29,4,0.398406,0.415756,0,No
17614,anthology,17,12.26331883,14,8.180740955,8.180610949,238,100.3230346,11,9,20,15,13,28,4,0.438871,0.453927,0,No
7083,neanderthal,24,11.91847835,11,8.421903011,8.421803008,264,100.3762687,8,12,20,18,17,35,4,0.418646,0.43606,0,No
8660,lilac,24,11.91847835,11,8.421903011,8.421803008,264,100.3762687,14,13,27,22,18,40,4,0.431887,0.447862,0,No
11513,gaunt,24,11.91847835,11,8.421903011,8.421803008,264,100.3762687,4,15,19,22,20,42,4,0.427879,0.444346,0,No
17707,andromeda,24,11.91847835,11,8.421903011,8.421803008,264,100.3762687,15,15,30,17,21,38,4,0.433163,0.449069,0,No
1599,tito,21,12.05200974,12,8.334891634,8.334781631,252,100.4521952,6,7,13,7,12,19,4,0.427704,0.444027,0,No
4410,rhodesia,21,12.05200974,12,8.334891634,8.334781631,252,100.4521952,9,13,22,20,18,38,4,0.426102,0.442684,0,No
7518,mitosis,21,12.05200974,12,8.334891634,8.334781631,252,100.4521952,9,10,19,16,19,35,4,0.440515,0.455341,0,No
8941,lao,21,12.05200974,12,8.334891634,8.334781631,252,100.4521952,13,6,19,17,9,26,4,0.413892,0.431117,0,No
13479,disneyland,21,12.05200974,12,8.334891634,8.334781631,252,100.4521952,13,12,25,18,19,37,4,0.437896,0.453134,0,No
183,worthy,15,12.38848198,15,8.111748083,8.111608076,225,100.4922449,11,7,18,12,14,26,4,0.440482,0.455284,0,No
1284,trivia,15,12.38848198,15,8.111748083,8.111608076,225,100.4922449,8,11,19,12,13,25,4,0.40746,0.425075,0,No
2126,synonymous,15,12.38848198,15,8.111748083,8.111608076,225,100.4922449,6,3,9,13,15,28,5,0.367447,0.381317,0,No
3887,scarce,15,12.38848198,15,8.111748083,8.111608076,225,100.4922449,8,10,18,13,12,25,4,0.428644,0.444919,0,No
3945,satisfy,15,12.38848198,15,8.111748083,8.111608076,225,100.4922449,5,7,12,14,11,25,4,0.422552,0.439642,0,No
6232,parisian,15,12.38848198,15,8.111748083,8.111608076,225,100.4922449,11,5,16,14,5,19,5,0.329626,0.334296,0,No
7371,moreover,15,12.38848198,15,8.111748083,8.111608076,225,100.4922449,10,13,23,10,13,23,4,0.417484,0.434769,0,No
11454,genuine,15,12.38848198,15,8.111748083,8.111608076,225,100.4922449,9,8,17,14,8,22,5,0.350243,0.360426,0,No
12498,exhibit,15,12.38848198,15,8.111748083,8.111608076,225,100.4922449,8,9,17,11,14,25,4,0.420281,0.437496,0,No
12552,evolve,15,12.38848198,15,8.111748083,8.111608076,225,100.4922449,10,10,20,12,15,27,4,0.418527,0.4356,0,No
12897,emanuel,15,12.38848198,15,8.111748083,8.111608076,225,100.4922449,7,5,12,8,9,17,5,0.329253,0.333253,0,No
13268,drank,15,12.38848198,15,8.111748083,8.111608076,225,100.4922449,10,12,22,12,15,27,4,0.417966,0.435196,0,No
13808,delicate,15,12.38848198,15,8.111748083,8.111608076,225,100.4922449,6,9,15,11,9,20,4,0.422925,0.439689,0,No
15694,capita,15,12.38848198,15,8.111748083,8.111608076,225,100.4922449,2,9,11,15,11,26,4,0.399716,0.417084,0,No
15743,cancel,15,12.38848198,15,8.111748083,8.111608076,225,100.4922449,4,5,9,12,14,26,4,0.402782,0.420497,0,No
16777,beforehand,15,12.38848198,15,8.111748083,8.111608076,225,100.4922449,5,11,16,6,15,21,4,0.440986,0.455777,0,No
17656,announce,15,12.38848198,15,8.111748083,8.111608076,225,100.4922449,8,9,17,14,14,28,4,0.421349,0.438515,0,No
2993,soma,27,11.80069531,10,8.517213191,8.517123189,270,100.5090378,11,13,24,21,18,39,4,0.446263,0.460251,0,No
712,viva,23,11.96103796,11,8.421903011,8.421803008,253,100.7347016,12,4,16,18,20,38,5,0.326485,0.330286,0,No
6498,orestes,23,11.96103796,11,8.421903011,8.421803008,253,100.7347016,12,12,24,14,17,31,4,0.41625,0.433525,0,No
13638,dexter,23,11.96103796,11,8.421903011,8.421803008,253,100.7347016,11,17,28,13,23,36,4,0.421229,0.438379,0,No
14745,compton,23,11.96103796,11,8.421903011,8.421803008,253,100.7347016,8,9,17,19,17,36,4,0.416827,0.43413,0,No
497,weasel,18,12.20616042,13,8.254848927,8.254728922,234,100.7600102,7,9,16,15,11,26,5,0.360404,0.372906,0,No
831,vertices,18,12.20616042,13,8.254848927,8.254728922,234,100.7600102,9,9,18,12,16,28,4,0.440668,0.455463,0,No
1158,twain,18,12.20616042,13,8.254848927,8.254728922,234,100.7600102,5,7,12,16,11,27,5,0.388544,0.405233,0,No
1860,terminus,18,12.20616042,13,8.254848927,8.254728922,234,100.7600102,10,11,21,15,15,30,4,0.450316,0.46357,0,No
6180,passport,18,12.20616042,13,8.254848927,8.254728922,234,100.7600102,11,10,21,16,12,28,4,0.439392,0.454416,0,No
6504,ordinance,18,12.20616042,13,8.254848927,8.254728922,234,100.7600102,8,9,17,14,10,24,4,0.421039,0.438069,0,No
8357,lydia,18,12.20616042,13,8.254848927,8.254728922,234,100.7600102,10,13,23,14,13,27,5,0.379936,0.395895,0,No
11588,gallon,18,12.20616042,13,8.254848927,8.254728922,234,100.7600102,10,8,18,18,14,32,5,0.401515,0.419091,0,No
13128,dyke,18,12.20616042,13,8.254848927,8.254728922,234,100.7600102,3,12,15,16,15,31,4,0.417121,0.434454,0,No
16912,barrow,18,12.20616042,13,8.254848927,8.254728922,234,100.7600102,14,8,22,14,13,27,4,0.391293,0.408245,0,No
18331,abnormal,18,12.20616042,13,8.254848927,8.254728922,234,100.7600102,15,8,23,16,11,27,5,0.371803,0.386583,0,No
4201,routine,16,12.32394346,14,8.180740955,8.180610949,224,100.8189889,9,12,21,13,13,26,4,0.429858,0.446186,0,No
4234,rosemary,16,12.32394346,14,8.180740955,8.180610949,224,100.8189889,7,6,13,10,8,18,4,0.389986,0.406803,0,No
6907,nitric,16,12.32394346,14,8.180740955,8.180610949,224,100.8189889,9,2,11,12,15,27,5,0.320618,0.323964,0,No
6911,nippon,16,12.32394346,14,8.180740955,8.180610949,224,100.8189889,7,3,10,11,3,14,5,0.348647,0.358281,0,No
8167,mandatory,16,12.32394346,14,8.180740955,8.180610949,224,100.8189889,9,12,21,13,13,26,5,0.367493,0.381794,0,No
8468,lore,16,12.32394346,14,8.180740955,8.180610949,224,100.8189889,11,7,18,15,14,29,4,0.435426,0.450918,0,No
9165,kidnapping,16,12.32394346,14,8.180740955,8.180610949,224,100.8189889,8,11,19,13,13,26,5,0.389046,0.406037,0,No
9444,jeremiah,16,12.32394346,14,8.180740955,8.180610949,224,100.8189889,9,8,17,14,9,23,5,0.385464,0.402155,0,No
10399,holstein,16,12.32394346,14,8.180740955,8.180610949,224,100.8189889,4,13,17,9,14,23,4,0.402143,0.41969,0,No
11529,gaston,16,12.32394346,14,8.180740955,8.180610949,224,100.8189889,12,7,19,14,7,21,5,0.348962,0.358784,0,No
13626,diagnostic,16,12.32394346,14,8.180740955,8.180610949,224,100.8189889,9,5,14,13,10,23,5,0.384404,0.40066,0,No
15328,cheat,16,12.32394346,14,8.180740955,8.180610949,224,100.8189889,8,11,19,14,14,28,4,0.431017,0.447073,0,No
40,zanzibar,20,12.1007999,12,8.334891634,8.334781631,240,100.8588559,12,13,25,18,16,34,4,0.415325,0.432699,0,No
3847,schoenberg,20,12.1007999,12,8.334891634,8.334781631,240,100.8588559,10,14,24,17,19,36,4,0.430776,0.446928,0,No
8981,lambda,20,12.1007999,12,8.334891634,8.334781631,240,100.8588559,10,3,13,11,15,26,4,0.389781,0.406522,0,No
9682,interrupt,20,12.1007999,12,8.334891634,8.334781631,240,100.8588559,11,6,17,14,10,24,4,0.427426,0.44375,0,No
16035,brute,20,12.1007999,12,8.334891634,8.334781631,240,100.8588559,8,3,11,18,19,37,5,0.398433,0.416171,0,No
14749,compressive,22,12.00548972,11,8.421903011,8.421803008,242,101.1090701,13,3,16,19,21,40,5,0.324249,0.327604,0,No
15304,cheney,22,12.00548972,11,8.421903011,8.421803008,242,101.1090701,7,14,21,17,18,35,4,0.408247,0.425816,0,No
96,yen,17,12.26331883,13,8.254848927,8.254728922,221,101.2318443,12,11,23,16,16,32,4,0.453769,0.466368,0,No
1414,transferring,17,12.26331883,13,8.254848927,8.254728922,221,101.2318443,8,8,16,14,15,29,5,0.403056,0.420884,0,No
2902,spacetime,17,12.26331883,13,8.254848927,8.254728922,221,101.2318443,8,12,20,15,13,28,4,0.394967,0.412535,0,No
5956,perimeter,17,12.26331883,13,8.254848927,8.254728922,221,101.2318443,9,6,15,15,16,31,4,0.40916,0.426553,0,No
9223,kellogg,17,12.26331883,13,8.254848927,8.254728922,221,101.2318443,10,11,21,11,13,24,4,0.409132,0.426779,0,No
10407,holman,17,12.26331883,13,8.254848927,8.254728922,221,101.2318443,4,8,12,17,17,34,5,0.388102,0.40481,0,No
11178,gramophone,17,12.26331883,13,8.254848927,8.254728922,221,101.2318443,9,4,13,16,4,20,4,0.391725,0.408878,0,No
12454,exploitation,17,12.26331883,13,8.254848927,8.254728922,221,101.2318443,10,9,19,13,14,27,4,0.43874,0.45381,0,No
13580,dietary,17,12.26331883,13,8.254848927,8.254728922,221,101.2318443,8,1,9,12,1,13,5,0.317566,0.321122,0,No
14625,consensus,17,12.26331883,13,8.254848927,8.254728922,221,101.2318443,13,10,23,16,16,32,4,0.422311,0.439219,0,No
15456,centennial,17,12.26331883,13,8.254848927,8.254728922,221,101.2318443,11,8,19,12,13,25,4,0.39063,0.407512,0,No
2254,surplus,19,12.1520932,12,8.334891634,8.334781631,228,101.2863799,10,13,23,16,15,31,4,0.416808,0.434065,0,No
2359,suez,19,12.1520932,12,8.334891634,8.334781631,228,101.2863799,9,8,17,19,19,38,5,0.361167,0.373903,0,No
4021,samson,19,12.1520932,12,8.334891634,8.334781631,228,101.2863799,12,14,26,14,17,31,4,0.437378,0.452726,0,No
4543,rental,19,12.1520932,12,8.334891634,8.334781631,228,101.2863799,7,6,13,16,6,22,5,0.412612,0.429978,0,No
6370,paddle,19,12.1520932,12,8.334891634,8.334781631,228,101.2863799,11,11,22,18,13,31,5,0.386,0.402669,0,No
6790,nubia,19,12.1520932,12,8.334891634,8.334781631,228,101.2863799,12,13,25,17,19,36,4,0.44501,0.45919,0,No
8405,luggage,19,12.1520932,12,8.334891634,8.334781631,228,101.2863799,10,11,21,13,13,26,4,0.446431,0.460378,0,No
8998,lagos,19,12.1520932,12,8.334891634,8.334781631,228,101.2863799,11,15,26,13,18,31,4,0.410846,0.428351,0,No
15392,champlain,19,12.1520932,12,8.334891634,8.334781631,228,101.2863799,2,9,11,16,11,27,5,0.356739,0.36823,0,No
17679,ani,19,12.1520932,12,8.334891634,8.334781631,228,101.2863799,11,11,22,12,14,26,4,0.417268,0.434567,0,No
45,zachary,15,12.38848198,14,8.180740955,8.180610949,210,101.3469619,9,4,13,12,13,25,5,0.324717,0.328145,0,No
261,withstand,15,12.38848198,14,8.180740955,8.180610949,210,101.3469619,4,9,13,15,13,28,4,0.418074,0.435567,0,No
707,vivid,15,12.38848198,14,8.180740955,8.180610949,210,101.3469619,8,11,19,13,12,25,5,0.385171,0.401632,0,No
2397,submit,15,12.38848198,14,8.180740955,8.180610949,210,101.3469619,4,11,15,13,13,26,4,0.447963,0.461627,0,No
2786,spokesperson,15,12.38848198,14,8.180740955,8.180610949,210,101.3469619,6,4,10,15,14,29,5,0.392305,0.409383,0,No
3552,sewn,15,12.38848198,14,8.180740955,8.180610949,210,101.3469619,7,8,15,11,14,25,5,0.398469,0.415795,0,No
4854,quiz,15,12.38848198,14,8.180740955,8.180610949,210,101.3469619,8,5,13,14,13,27,5,0.351784,0.362146,0,No
6167,patagonia,15,12.38848198,14,8.180740955,8.180610949,210,101.3469619,8,6,14,14,13,27,4,0.416856,0.434107,0,No
6205,participant,15,12.38848198,14,8.180740955,8.180610949,210,101.3469619,5,7,12,11,13,24,5,0.398076,0.41542,0,No
10152,hypotheses,15,12.38848198,14,8.180740955,8.180610949,210,101.3469619,11,9,20,11,13,24,4,0.428509,0.444801,0,No
12677,erwin,15,12.38848198,14,8.180740955,8.180610949,210,101.3469619,11,4,15,11,4,15,5,0.314628,0.319025,0,No
12849,employ,15,12.38848198,14,8.180740955,8.180610949,210,101.3469619,10,12,22,14,13,27,4,0.432751,0.448815,0,No
13034,eduardo,15,12.38848198,14,8.180740955,8.180610949,210,101.3469619,8,1,9,8,1,9,5,0.306411,0.311601,0,No
13674,detector,15,12.38848198,14,8.180740955,8.180610949,210,101.3469619,7,9,16,10,12,22,4,0.428955,0.445205,0,No
14100,custody,15,12.38848198,14,8.180740955,8.180610949,210,101.3469619,9,7,16,14,13,27,5,0.399473,0.416905,0,No
16118,brigadier,15,12.38848198,14,8.180740955,8.180610949,210,101.3469619,7,2,9,13,13,26,5,0.327497,0.331342,0,No
16386,bodyguard,15,12.38848198,14,8.180740955,8.180610949,210,101.3469619,6,10,16,14,14,28,4,0.423268,0.440083,0,No
3753,scurvy,21,12.05200974,11,8.421903011,8.421803008,231,101.5008571,11,16,27,18,20,38,5,0.386707,0.403561,0,No
16019,bucket,21,12.05200974,11,8.421903011,8.421803008,231,101.5008571,6,15,21,19,19,38,4,0.44393,0.458345,0,No
175,wrath,16,12.32394346,13,8.254848927,8.254728922,208,101.7322914,5,7,12,13,11,24,4,0.410371,0.42776,0,No
2457,strife,16,12.32394346,13,8.254848927,8.254728922,208,101.7322914,7,10,17,13,13,26,4,0.400998,0.418422,0,No
5828,phonograph,16,12.32394346,13,8.254848927,8.254728922,208,101.7322914,5,7,12,14,8,22,4,0.394862,0.411996,0,No
7429,monmouth,16,12.32394346,13,8.254848927,8.254728922,208,101.7322914,7,9,16,12,13,25,4,0.433279,0.44905,0,No
8314,mackenzie,16,12.32394346,13,8.254848927,8.254728922,208,101.7322914,10,10,20,13,10,23,5,0.373454,0.388567,0,No
15937,burgundian,16,12.32394346,13,8.254848927,8.254728922,208,101.7322914,5,5,10,14,11,25,5,0.384929,0.401228,0,No
15951,burbank,16,12.32394346,13,8.254848927,8.254728922,208,101.7322914,6,8,14,13,15,28,5,0.350367,0.360523,0,No
16364,bolshevik,16,12.32394346,13,8.254848927,8.254728922,208,101.7322914,5,9,14,16,11,27,5,0.387264,0.403895,0,No
16517,bizet,16,12.32394346,13,8.254848927,8.254728922,208,101.7322914,4,9,13,5,14,19,4,0.41095,0.428511,0,No
17262,athenian,16,12.32394346,13,8.254848927,8.254728922,208,101.7322914,7,13,20,13,14,27,5,0.396192,0.413542,0,No
2653,starfish,18,12.20616042,12,8.334891634,8.334781631,216,101.7370244,13,12,25,13,15,28,5,0.41116,0.428658,0,No
4121,rwanda,18,12.20616042,12,8.334891634,8.334781631,216,101.7370244,8,12,20,14,14,28,4,0.439044,0.454139,0,No
12393,fabian,18,12.20616042,12,8.334891634,8.334781631,216,101.7370244,11,7,18,16,10,26,5,0.340175,0.347143,0,No
13634,dhabi,18,12.20616042,12,8.334891634,8.334781631,216,101.7370244,0,10,10,0,13,13,4,0.430289,0.446405,0,No
16198,brandt,18,12.20616042,12,8.334891634,8.334781631,216,101.7370244,4,8,12,7,9,16,5,0.374099,0.389224,0,No
16817,beaumont,18,12.20616042,12,8.334891634,8.334781631,216,101.7370244,9,9,18,12,12,24,5,0.353169,0.364084,0,No
10769,hash,27,11.80069531,9,8.622573707,8.622493705,243,101.7523651,8,9,17,17,19,36,5,0.354135,0.365163,0,No
3494,shea,23,11.96103796,10,8.517213191,8.517123189,230,101.8747103,12,11,23,19,23,42,4,0.428551,0.444853,0,No
4592,reindeer,23,11.96103796,10,8.517213191,8.517123189,230,101.8747103,11,13,24,19,18,37,4,0.404923,0.422497,0,No
8055,marrow,23,11.96103796,10,8.517213191,8.517123189,230,101.8747103,4,12,16,23,21,44,5,0.406378,0.424034,0,No
16686,beowulf,23,11.96103796,10,8.517213191,8.517123189,230,101.8747103,17,12,29,21,20,41,4,0.433861,0.449627,0,No
601,walpole,14,12.45747485,14,8.180740955,8.180610949,196,101.9113747,2,9,11,13,9,22,4,0.413016,0.430492,0,No
841,versatile,14,12.45747485,14,8.180740955,8.180610949,196,101.9113747,6,5,11,13,8,21,5,0.385757,0.402148,0,No
1897,tempo,14,12.45747485,14,8.180740955,8.180610949,196,101.9113747,8,9,17,11,11,22,5,0.38828,0.405188,0,No
2095,tabloid,14,12.45747485,14,8.180740955,8.180610949,196,101.9113747,8,5,13,12,10,22,5,0.332727,0.337554,0,No
2284,superstition,14,12.45747485,14,8.180740955,8.180610949,196,101.9113747,7,10,17,13,12,25,4,0.435918,0.451378,0,No
3283,simplify,14,12.45747485,14,8.180740955,8.180610949,196,101.9113747,6,4,10,13,9,22,4,0.40128,0.418897,0,No
4337,risen,14,12.45747485,14,8.180740955,8.180610949,196,101.9113747,4,6,10,14,13,27,5,0.375365,0.390719,0,No
5130,prosperous,14,12.45747485,14,8.180740955,8.180610949,196,101.9113747,7,11,18,14,14,28,5,0.38658,0.403167,0,No
5312,preparatory,14,12.45747485,14,8.180740955,8.180610949,196,101.9113747,8,4,12,11,13,24,5,0.328546,0.332375,0,No
5439,portrayal,14,12.45747485,14,8.180740955,8.180610949,196,101.9113747,6,2,8,13,14,27,5,0.381914,0.398024,0,No
6024,peninsular,14,12.45747485,14,8.180740955,8.180610949,196,101.9113747,7,3,10,11,12,23,5,0.329577,0.333736,0,No
7753,merge,14,12.45747485,14,8.180740955,8.180610949,196,101.9113747,4,8,12,10,11,21,4,0.423621,0.440379,0,No
8144,manipulate,14,12.45747485,14,8.180740955,8.180610949,196,101.9113747,6,6,12,14,9,23,4,0.408793,0.426436,0,No
8252,maharaja,14,12.45747485,14,8.180740955,8.180610949,196,101.9113747,9,4,13,11,9,20,4,0.424716,0.441407,0,No
8644,limp,14,12.45747485,14,8.180740955,8.180610949,196,101.9113747,6,8,14,10,8,18,4,0.394449,0.411564,0,No
10067,imitate,14,12.45747485,14,8.180740955,8.180610949,196,101.9113747,6,7,13,9,14,23,4,0.422844,0.439905,0,No
13201,ductile,14,12.45747485,14,8.180740955,8.180610949,196,101.9113747,6,6,12,13,11,24,4,0.422955,0.439679,0,No
13628,diagnose,14,12.45747485,14,8.180740955,8.180610949,196,101.9113747,5,6,11,12,12,24,4,0.436625,0.451928,0,No
16168,breakup,14,12.45747485,14,8.180740955,8.180610949,196,101.9113747,6,6,12,14,14,28,5,0.394677,0.41188,0,No
16471,blew,14,12.45747485,14,8.180740955,8.180610949,196,101.9113747,9,9,18,10,14,24,4,0.389114,0.405864,0,No
17333,ashore,14,12.45747485,14,8.180740955,8.180610949,196,101.9113747,5,7,12,6,13,19,4,0.411818,0.429229,0,No
10795,harmonic,20,12.1007999,11,8.421903011,8.421803008,220,101.9117632,15,11,26,20,13,33,4,0.411093,0.428544,0,No
15942,burg,20,12.1007999,11,8.421903011,8.421803008,220,101.9117632,10,7,17,11,8,19,4,0.445099,0.459167,0,No
1229,tucson,17,12.26331883,12,8.334891634,8.334781631,204,102.2134336,10,7,17,16,17,33,5,0.37542,0.390832,0,No
1395,transmitter,17,12.26331883,12,8.334891634,8.334781631,204,102.2134336,12,9,21,17,10,27,4,0.434318,0.449961,0,No
2811,spire,17,12.26331883,12,8.334891634,8.334781631,204,102.2134336,8,14,22,17,17,34,4,0.438318,0.453608,0,No
3951,satanic,17,12.26331883,12,8.334891634,8.334781631,204,102.2134336,7,2,9,16,3,19,5,0.32213,0.325483,0,No
4305,robe,17,12.26331883,12,8.334891634,8.334781631,204,102.2134336,11,11,22,15,15,30,4,0.432941,0.448792,0,No
4670,reconnaissance,17,12.26331883,12,8.334891634,8.334781631,204,102.2134336,8,9,17,12,10,22,5,0.388263,0.404984,0,No
5020,pumpkin,17,12.26331883,12,8.334891634,8.334781631,204,102.2134336,8,9,17,9,9,18,5,0.370801,0.385487,0,No
5064,psychosis,17,12.26331883,12,8.334891634,8.334781631,204,102.2134336,10,13,23,14,13,27,4,0.40471,0.422258,0,No
5492,pompeii,17,12.26331883,12,8.334891634,8.334781631,204,102.2134336,8,7,15,10,13,23,4,0.396706,0.413963,0,No
6418,ova,17,12.26331883,12,8.334891634,8.334781631,204,102.2134336,9,9,18,15,16,31,4,0.427611,0.444106,0,No
9307,jung,17,12.26331883,12,8.334891634,8.334781631,204,102.2134336,6,11,17,13,13,26,4,0.401715,0.419192,0,No
9479,janus,17,12.26331883,12,8.334891634,8.334781631,204,102.2134336,11,8,19,15,10,25,4,0.439349,0.454317,0,No
10134,iceberg,17,12.26331883,12,8.334891634,8.334781631,204,102.2134336,7,12,19,16,14,30,4,0.430233,0.446397,0,No
12349,fallout,17,12.26331883,12,8.334891634,8.334781631,204,102.2134336,7,11,18,16,13,29,4,0.40238,0.419897,0,No
15545,catalyst,17,12.26331883,12,8.334891634,8.334781631,204,102.2134336,2,10,12,17,16,33,4,0.429079,0.445327,0,No
15563,cassius,17,12.26331883,12,8.334891634,8.334781631,204,102.2134336,7,7,14,12,10,22,5,0.343167,0.350994,0,No
3521,shame,15,12.38848198,13,8.254848927,8.254728922,195,102.2650471,8,10,18,12,14,26,4,0.460336,0.47157,0,No
5341,precision,15,12.38848198,13,8.254848927,8.254728922,195,102.2650471,8,9,17,12,12,24,4,0.427683,0.444064,0,No
6761,nutrient,15,12.38848198,13,8.254848927,8.254728922,195,102.2650471,7,8,15,12,9,21,5,0.371593,0.386156,0,No
7289,mrs,15,12.38848198,13,8.254848927,8.254728922,195,102.2650471,9,4,13,11,4,15,5,0.327969,0.33204,0,No
7765,mercenary,15,12.38848198,13,8.254848927,8.254728922,195,102.2650471,9,10,19,12,10,22,5,0.399986,0.417368,0,No
10812,hardin,15,12.38848198,13,8.254848927,8.254728922,195,102.2650471,7,6,13,13,14,27,4,0.400709,0.418066,0,No
11482,gemstone,15,12.38848198,13,8.254848927,8.254728922,195,102.2650471,8,10,18,15,11,26,4,0.405422,0.422896,0,No
12772,eocene,15,12.38848198,13,8.254848927,8.254728922,195,102.2650471,5,7,12,14,13,27,4,0.396272,0.413512,0,No
14314,craftsmen,15,12.38848198,13,8.254848927,8.254728922,195,102.2650471,9,10,19,13,14,27,4,0.432888,0.448712,0,No
17561,apex,15,12.38848198,13,8.254848927,8.254728922,195,102.2650471,11,7,18,14,8,22,4,0.42073,0.437689,0,No
18196,ada,15,12.38848198,13,8.254848927,8.254728922,195,102.2650471,11,10,21,13,12,25,4,0.400917,0.418385,0,No
2046,tam,19,12.1520932,11,8.421903011,8.421803008,209,102.3437503,11,7,18,14,10,24,4,0.401834,0.41923,0,No
2615,stealth,19,12.1520932,11,8.421903011,8.421803008,209,102.3437503,10,11,21,14,16,30,5,0.364243,0.377748,0,No
3486,sheen,19,12.1520932,11,8.421903011,8.421803008,209,102.3437503,11,15,26,16,16,32,4,0.404001,0.421572,0,No
4538,repel,19,12.1520932,11,8.421903011,8.421803008,209,102.3437503,7,12,19,13,19,32,4,0.430484,0.446843,0,No
5717,piracy,19,12.1520932,11,8.421903011,8.421803008,209,102.3437503,10,12,22,11,15,26,4,0.418488,0.435698,0,No
7556,minuet,19,12.1520932,11,8.421903011,8.421803008,209,102.3437503,10,11,21,17,19,36,4,0.409774,0.427286,0,No
11890,forensic,19,12.1520932,11,8.421903011,8.421803008,209,102.3437503,9,3,12,13,7,20,5,0.326629,0.330217,0,No
15592,cartesian,19,12.1520932,11,8.421903011,8.421803008,209,102.3437503,8,7,15,18,16,34,4,0.407657,0.425375,0,No
15721,canoe,19,12.1520932,11,8.421903011,8.421803008,209,102.3437503,7,12,19,14,15,29,4,0.440264,0.455172,0,No
11828,fourier,21,12.05200974,10,8.517213191,8.517123189,210,102.6495363,10,9,19,16,17,33,5,0.344646,0.352997,0,No
13989,danzig,21,12.05200974,10,8.517213191,8.517123189,210,102.6495363,10,17,27,20,19,39,4,0.405533,0.423155,0,No
16299,borg,21,12.05200974,10,8.517213191,8.517123189,210,102.6495363,6,16,22,14,20,34,5,0.376216,0.39174,0,No
17290,asthma,21,12.05200974,10,8.517213191,8.517123189,210,102.6495363,12,10,22,17,16,33,4,0.419516,0.436661,0,No
223,woodside,34,11.57017165,7,8.873888135,8.873828135,238,102.672409,23,20,43,28,27,55,5,0.375309,0.390816,0,No
2782,spontaneous,16,12.32394346,12,8.334891634,8.334781631,192,102.7187332,8,5,13,11,5,16,5,0.398594,0.416368,0,No
3136,slot,16,12.32394346,12,8.334891634,8.334781631,192,102.7187332,9,10,19,15,13,28,4,0.436926,0.452355,0,No
3650,semi,16,12.32394346,12,8.334891634,8.334781631,192,102.7187332,11,7,18,14,11,25,5,0.360302,0.372964,0,No
3762,scrub,16,12.32394346,12,8.334891634,8.334781631,192,102.7187332,10,11,21,12,11,23,4,0.428261,0.444618,0,No
4947,pythagoras,16,12.32394346,12,8.334891634,8.334781631,192,102.7187332,7,11,18,9,14,23,5,0.41266,0.430072,0,No
5308,prescott,16,12.32394346,12,8.334891634,8.334781631,192,102.7187332,10,8,18,14,15,29,4,0.391837,0.408846,0,No
5646,platonic,16,12.32394346,12,8.334891634,8.334781631,192,102.7187332,7,4,11,13,6,19,5,0.328534,0.332516,0,No
6387,ozark,16,12.32394346,12,8.334891634,8.334781631,192,102.7187332,7,7,14,14,10,24,5,0.356919,0.368584,0,No
7844,medley,16,12.32394346,12,8.334891634,8.334781631,192,102.7187332,9,10,19,14,12,26,5,0.406639,0.424142,0,No
9302,junk,16,12.32394346,12,8.334891634,8.334781631,192,102.7187332,12,6,18,12,13,25,4,0.423207,0.439891,0,No
10210,husbandry,16,12.32394346,12,8.334891634,8.334781631,192,102.7187332,3,10,13,16,12,28,4,0.429494,0.445712,0,No
10781,harrow,16,12.32394346,12,8.334891634,8.334781631,192,102.7187332,11,9,20,13,14,27,4,0.427117,0.443529,0,No
13377,domesday,16,12.32394346,12,8.334891634,8.334781631,192,102.7187332,2,2,4,16,16,32,5,0.355945,0.367776,0,No
14486,copernicus,16,12.32394346,12,8.334891634,8.334781631,192,102.7187332,5,12,17,6,14,20,4,0.391924,0.408968,0,No
16970,banquet,16,12.32394346,12,8.334891634,8.334781631,192,102.7187332,6,9,15,9,13,22,5,0.395839,0.413199,0,No
1703,threshold,18,12.20616042,11,8.421903011,8.421803008,198,102.7990992,12,14,26,13,15,28,4,0.446095,0.460134,0,No
4093,safari,18,12.20616042,11,8.421903011,8.421803008,198,102.7990992,11,14,25,14,15,29,4,0.406239,0.423779,0,No
5200,projectile,18,12.20616042,11,8.421903011,8.421803008,198,102.7990992,6,14,20,17,15,32,4,0.429442,0.445904,0,No
5489,ponce,18,12.20616042,11,8.421903011,8.421803008,198,102.7990992,6,7,13,15,18,33,4,0.390896,0.407789,0,No
6868,noodle,18,12.20616042,11,8.421903011,8.421803008,198,102.7990992,12,8,20,18,15,33,5,0.349739,0.359727,0,No
7366,morley,18,12.20616042,11,8.421903011,8.421803008,198,102.7990992,13,11,24,16,15,31,4,0.438697,0.45382,0,No
7399,monticello,18,12.20616042,11,8.421903011,8.421803008,198,102.7990992,11,12,23,12,18,30,5,0.364587,0.378131,0,No
11496,gecko,18,12.20616042,11,8.421903011,8.421803008,198,102.7990992,7,8,15,14,10,24,4,0.42549,0.442027,0,No
12182,fiddle,18,12.20616042,11,8.421903011,8.421803008,198,102.7990992,9,8,17,11,10,21,4,0.402946,0.420413,0,No
15794,calligraphy,18,12.20616042,11,8.421903011,8.421803008,198,102.7990992,10,12,22,13,13,26,5,0.371959,0.386832,0,No
17050,badminton,18,12.20616042,11,8.421903011,8.421803008,198,102.7990992,11,9,20,14,11,25,4,0.427323,0.443717,0,No
116,yarmouth,28,11.76432767,8,8.740356743,8.740286741,224,102.8244206,15,19,34,23,25,48,4,0.427941,0.444449,0,No
780,viewpoint,14,12.45747485,13,8.254848927,8.254728922,182,102.8345729,9,8,17,12,12,24,4,0.442558,0.457054,0,No
802,viceroy,14,12.45747485,13,8.254848927,8.254728922,182,102.8345729,7,6,13,12,13,25,5,0.406993,0.424433,0,No
2383,subtle,14,12.45747485,13,8.254848927,8.254728922,182,102.8345729,6,6,12,11,6,17,4,0.429422,0.445562,0,No
3221,sketch,14,12.45747485,13,8.254848927,8.254728922,182,102.8345729,5,5,10,10,12,22,5,0.385514,0.40207,0,No
4158,rump,14,12.45747485,13,8.254848927,8.254728922,182,102.8345729,5,3,8,13,10,23,5,0.34071,0.34811,0,No
4315,roadrunner,14,12.45747485,13,8.254848927,8.254728922,182,102.8345729,8,0,8,13,0,13,0,0,0,0,No
6381,pace,14,12.45747485,13,8.254848927,8.254728922,182,102.8345729,7,10,17,9,12,21,5,0.407741,0.425316,0,No
6402,owl,14,12.45747485,13,8.254848927,8.254728922,182,102.8345729,5,10,15,11,10,21,4,0.412622,0.430112,0,No
6932,nightshade,14,12.45747485,13,8.254848927,8.254728922,182,102.8345729,2,3,5,10,13,23,5,0.367105,0.381128,0,No
7596,mimic,14,12.45747485,13,8.254848927,8.254728922,182,102.8345729,9,10,19,14,14,28,4,0.423884,0.440759,0,No
8904,lateran,14,12.45747485,13,8.254848927,8.254728922,182,102.8345729,2,8,10,14,8,22,5,0.368906,0.383226,0,No
10523,hibernate,14,12.45747485,13,8.254848927,8.254728922,182,102.8345729,6,6,12,8,11,19,5,0.370244,0.384656,0,No
11466,genital,14,12.45747485,13,8.254848927,8.254728922,182,102.8345729,10,7,17,13,8,21,5,0.395989,0.41319,0,No
12654,esteem,14,12.45747485,13,8.254848927,8.254728922,182,102.8345729,5,11,16,12,13,25,4,0.42192,0.438933,0,No
13444,diurnal,14,12.45747485,13,8.254848927,8.254728922,182,102.8345729,7,7,14,12,9,21,5,0.350686,0.361072,0,No
13698,descriptive,14,12.45747485,13,8.254848927,8.254728922,182,102.8345729,10,7,17,13,8,21,5,0.387272,0.403848,0,No
13769,demolition,14,12.45747485,13,8.254848927,8.254728922,182,102.8345729,6,8,14,10,13,23,4,0.420251,0.437327,0,No
13817,delay,14,12.45747485,13,8.254848927,8.254728922,182,102.8345729,7,11,18,11,12,23,4,0.441041,0.455829,0,No
15228,choctaw,14,12.45747485,13,8.254848927,8.254728922,182,102.8345729,7,8,15,12,11,23,5,0.348346,0.357852,0,No
16491,blanche,14,12.45747485,13,8.254848927,8.254728922,182,102.8345729,8,10,18,13,13,26,5,0.414211,0.43156,0,No
17285,astrologer,14,12.45747485,13,8.254848927,8.254728922,182,102.8345729,6,5,11,13,7,20,5,0.384595,0.400881,0,No
17316,assassinate,14,12.45747485,13,8.254848927,8.254728922,182,102.8345729,2,8,10,14,10,24,4,0.400718,0.418404,0,No
4558,renal,20,12.1007999,10,8.517213191,8.517123189,200,103.0650926,9,2,11,18,19,37,5,0.344158,0.35261,0,No
12190,fibonacci,20,12.1007999,10,8.517213191,8.517123189,200,103.0650926,8,9,17,16,11,27,4,0.391267,0.408216,0,No
15954,bunyan,20,12.1007999,10,8.517213191,8.517123189,200,103.0650926,6,13,19,17,14,31,4,0.410618,0.428164,0,No
16690,bentley,20,12.1007999,10,8.517213191,8.517123189,200,103.0650926,12,12,24,15,14,29,4,0.404176,0.421699,0,No
17992,alamo,20,12.1007999,10,8.517213191,8.517123189,200,103.0650926,6,12,18,19,15,34,4,0.429069,0.445327,0,No
399,whip,15,12.38848198,12,8.334891634,8.334781631,180,103.2566548,8,12,20,13,13,26,4,0.432371,0.448454,0,No
5152,propose,15,12.38848198,12,8.334891634,8.334781631,180,103.2566548,9,11,20,11,12,23,4,0.404489,0.422216,0,No
6638,ogden,15,12.38848198,12,8.334891634,8.334781631,180,103.2566548,9,8,17,13,8,21,4,0.391474,0.408442,0,No
9635,invertebrate,15,12.38848198,12,8.334891634,8.334781631,180,103.2566548,7,8,15,12,9,21,4,0.409935,0.427455,0,No
10472,hippo,15,12.38848198,12,8.334891634,8.334781631,180,103.2566548,5,11,16,15,13,28,4,0.432276,0.448205,0,No
11327,glide,15,12.38848198,12,8.334891634,8.334781631,180,103.2566548,8,10,18,12,13,25,5,0.392487,0.409594,0,No
12969,electra,15,12.38848198,12,8.334891634,8.334781631,180,103.2566548,5,10,15,10,12,22,4,0.415568,0.432957,0,No
15489,ceasefire,15,12.38848198,12,8.334891634,8.334781631,180,103.2566548,7,9,16,13,10,23,5,0.394003,0.41119,0,No
16023,bucharest,15,12.38848198,12,8.334891634,8.334781631,180,103.2566548,7,13,20,13,15,28,4,0.433363,0.449242,0,No
5389,potomac,17,12.26331883,11,8.421903011,8.421803008,187,103.2804818,2,5,7,15,14,29,5,0.365044,0.378651,0,No
5409,postmaster,17,12.26331883,11,8.421903011,8.421803008,187,103.2804818,7,3,10,10,17,27,5,0.330042,0.334515,0,No
7906,mcgill,17,12.26331883,11,8.421903011,8.421803008,187,103.2804818,10,6,16,16,7,23,4,0.395574,0.412733,0,No
8390,lumpur,17,12.26331883,11,8.421903011,8.421803008,187,103.2804818,0,7,7,0,16,16,5,0.375211,0.390622,0,No
10188,hydrochloric,17,12.26331883,11,8.421903011,8.421803008,187,103.2804818,10,2,12,13,17,30,5,0.384337,0.400533,0,No
12539,excel,17,12.26331883,11,8.421903011,8.421803008,187,103.2804818,3,9,12,3,12,15,5,0.364759,0.378161,0,No
14929,coffin,17,12.26331883,11,8.421903011,8.421803008,187,103.2804818,8,15,23,17,16,33,4,0.428685,0.445135,0,No
16967,bantu,17,12.26331883,11,8.421903011,8.421803008,187,103.2804818,8,9,17,15,14,29,5,0.363378,0.376476,0,No
18035,ah,17,12.26331883,11,8.421903011,8.421803008,187,103.2804818,6,9,15,9,12,21,5,0.379506,0.395545,0,No
176,wrap,13,12.53158282,13,8.254848927,8.254728922,169,103.446323,8,7,15,13,11,24,4,0.371438,0.386175,0,No
2128,synod,13,12.53158282,13,8.254848927,8.254728922,169,103.446323,3,5,8,9,12,21,4,0.409935,0.427305,0,No
2229,sustain,13,12.53158282,13,8.254848927,8.254728922,169,103.446323,4,8,12,12,12,24,4,0.436121,0.451529,0,No
2788,spokesman,13,12.53158282,13,8.254848927,8.254728922,169,103.446323,8,7,15,11,12,23,4,0.390974,0.407869,0,No
2892,spare,13,12.53158282,13,8.254848927,8.254728922,169,103.446323,7,2,9,13,10,23,5,0.330049,0.334376,0,No
3004,solitary,13,12.53158282,13,8.254848927,8.254728922,169,103.446323,9,7,16,10,7,17,5,0.405126,0.422584,0,No
3167,sleepy,13,12.53158282,13,8.254848927,8.254728922,169,103.446323,8,9,17,9,13,22,4,0.408313,0.42592,0,No
4274,rogue,13,12.53158282,13,8.254848927,8.254728922,169,103.446323,9,9,18,12,12,24,4,0.423389,0.440121,0,No
5328,preference,13,12.53158282,13,8.254848927,8.254728922,169,103.446323,10,4,14,11,11,22,5,0.403386,0.420884,0,No
8033,martyrdom,13,12.53158282,13,8.254848927,8.254728922,169,103.446323,8,8,16,11,13,24,4,0.413911,0.43122,0,No
8228,majorca,13,12.53158282,13,8.254848927,8.254728922,169,103.446323,4,10,14,10,11,21,4,0.390441,0.407479,0,No
9818,inhabit,13,12.53158282,13,8.254848927,8.254728922,169,103.446323,5,7,12,9,10,19,4,0.42069,0.437849,0,No
10052,immoral,13,12.53158282,13,8.254848927,8.254728922,169,103.446323,7,8,15,10,10,20,4,0.416495,0.433717,0,No
10691,heartbeat,13,12.53158282,13,8.254848927,8.254728922,169,103.446323,10,8,18,12,11,23,4,0.402271,0.419713,0,No
11535,gaseous,13,12.53158282,13,8.254848927,8.254728922,169,103.446323,9,5,14,11,6,17,5,0.327183,0.330982,0,No
12954,elegant,13,12.53158282,13,8.254848927,8.254728922,169,103.446323,6,10,16,11,11,22,5,0.38696,0.403561,0,No
13298,downfall,13,12.53158282,13,8.254848927,8.254728922,169,103.446323,3,7,10,9,12,21,4,0.438827,0.453857,0,No
13373,dominate,13,12.53158282,13,8.254848927,8.254728922,169,103.446323,6,9,15,8,13,21,4,0.412133,0.429657,0,No
13838,definitive,13,12.53158282,13,8.254848927,8.254728922,169,103.446323,6,9,15,12,10,22,5,0.385205,0.401632,0,No
16151,brendan,13,12.53158282,13,8.254848927,8.254728922,169,103.446323,9,6,15,9,8,17,5,0.328728,0.33283,0,No
17474,arboreal,13,12.53158282,13,8.254848927,8.254728922,169,103.446323,4,7,11,8,9,17,4,0.43549,0.450951,0,No
18263,accommodate,13,12.53158282,13,8.254848927,8.254728922,169,103.446323,3,5,8,13,7,20,4,0.399959,0.417638,0,No
12037,flea,31,11.66254497,7,8.873888135,8.873828135,217,103.4921195,12,18,30,22,24,46,4,0.406648,0.424328,0,No
8257,magnolia,19,12.1520932,10,8.517213191,8.517123189,190,103.5019685,13,13,26,16,18,34,5,0.361086,0.373898,0,No
10949,gypsy,19,12.1520932,10,8.517213191,8.517123189,190,103.5019685,12,10,22,17,17,34,4,0.382763,0.399503,0,No
11412,gettysburg,19,12.1520932,10,8.517213191,8.517123189,190,103.5019685,5,7,12,18,12,30,4,0.4177,0.434905,0,No
6473,orphanage,22,12.00548972,9,8.622573707,8.622493705,198,103.51822,4,14,18,21,19,40,4,0.412891,0.430375,0,No
14386,coulomb,22,12.00548972,9,8.622573707,8.622493705,198,103.51822,11,10,21,20,19,39,4,0.43808,0.453359,0,No
15008,clot,22,12.00548972,9,8.622573707,8.622493705,198,103.51822,5,12,17,22,17,39,4,0.439479,0.454589,0,No
15231,chlorophyll,22,12.00548972,9,8.622573707,8.622493705,198,103.51822,15,11,26,16,19,35,4,0.437454,0.452744,0,No
6384,pa,16,12.32394346,13,8.421903011,8.421803008,208,103.7910565,6,6,12,8,7,15,4,0.425143,0.441679,0,No
2990,somatic,16,12.32394346,11,8.421903011,8.421803008,176,103.7910565,8,4,12,15,11,26,5,0.325653,0.329355,0,No
5682,placental,16,12.32394346,11,8.421903011,8.421803008,176,103.7910565,9,3,12,15,3,18,5,0.325988,0.32955,0,No
6305,panhandle,16,12.32394346,11,8.421903011,8.421803008,176,103.7910565,6,12,18,15,15,30,4,0.443553,0.457974,0,No
8290,madras,16,12.32394346,11,8.421903011,8.421803008,176,103.7910565,9,7,16,12,10,22,4,0.390733,0.40762,0,No
8449,louisa,16,12.32394346,11,8.421903011,8.421803008,176,103.7910565,10,11,21,10,15,25,4,0.401207,0.418681,0,No
9008,laden,16,12.32394346,11,8.421903011,8.421803008,176,103.7910565,2,9,11,11,11,22,4,0.432498,0.44836,0,No
9196,kerr,16,12.32394346,11,8.421903011,8.421803008,176,103.7910565,7,11,18,10,11,21,4,0.416524,0.433858,0,No
10110,idiom,16,12.32394346,11,8.421903011,8.421803008,176,103.7910565,8,12,20,15,13,28,4,0.427951,0.444327,0,No
12632,ethernet,16,12.32394346,11,8.421903011,8.421803008,176,103.7910565,11,12,23,13,12,25,4,0.42209,0.439088,0,No
13813,delft,16,12.32394346,11,8.421903011,8.421803008,176,103.7910565,8,10,18,13,14,27,4,0.429973,0.446125,0,No
13984,darius,16,12.32394346,11,8.421903011,8.421803008,176,103.7910565,4,5,9,5,9,14,4,0.406192,0.423751,0,No
14850,comb,16,12.32394346,11,8.421903011,8.421803008,176,103.7910565,8,12,20,15,15,30,4,0.429754,0.44598,0,No
15435,cern,16,12.32394346,11,8.421903011,8.421803008,176,103.7910565,4,8,12,11,15,26,4,0.419338,0.436436,0,No
16836,beacon,16,12.32394346,11,8.421903011,8.421803008,176,103.7910565,10,11,21,10,14,24,5,0.362791,0.375727,0,No
17957,aldrin,16,12.32394346,11,8.421903011,8.421803008,176,103.7910565,8,9,17,16,9,25,4,0.39444,0.411582,0,No
55,yugoslav,14,12.45747485,12,8.334891634,8.334781631,168,103.8317029,5,3,8,11,4,15,5,0.335666,0.341802,0,No
80,yogurt,14,12.45747485,12,8.334891634,8.334781631,168,103.8317029,9,10,19,14,13,27,4,0.423631,0.440374,0,No
3298,silvery,14,12.45747485,12,8.334891634,8.334781631,168,103.8317029,10,5,15,14,10,24,5,0.329118,0.333792,0,No
4648,redundant,14,12.45747485,12,8.334891634,8.334781631,168,103.8317029,9,10,19,13,11,24,4,0.395469,0.4127,0,No
4663,rector,14,12.45747485,12,8.334891634,8.334781631,168,103.8317029,8,9,17,10,14,24,4,0.422572,0.439515,0,No
4830,racket,14,12.45747485,12,8.334891634,8.334781631,168,103.8317029,6,7,13,10,10,20,4,0.400456,0.417868,0,No
5202,prohibition,14,12.45747485,12,8.334891634,8.334781631,168,103.8317029,11,7,18,14,12,26,5,0.388569,0.405436,0,No
6624,okay,14,12.45747485,12,8.334891634,8.334781631,168,103.8317029,9,12,21,12,13,25,5,0.382647,0.399003,0,No
8564,livery,14,12.45747485,12,8.334891634,8.334781631,168,103.8317029,7,7,14,10,9,19,4,0.435276,0.450777,0,No
8813,leftover,14,12.45747485,12,8.334891634,8.334781631,168,103.8317029,5,10,15,12,14,26,5,0.328442,0.332786,0,No
9366,josephine,14,12.45747485,12,8.334891634,8.334781631,168,103.8317029,9,8,17,11,11,22,4,0.436647,0.451993,0,No
9455,jehovah,14,12.45747485,12,8.334891634,8.334781631,168,103.8317029,6,3,9,8,4,12,5,0.329436,0.334635,0,No
9938,incumbent,14,12.45747485,12,8.334891634,8.334781631,168,103.8317029,9,9,18,14,10,24,4,0.390664,0.407592,0,No
10547,hessian,14,12.45747485,12,8.334891634,8.334781631,168,103.8317029,7,3,10,13,3,16,5,0.326954,0.330541,0,No
11775,frederic,14,12.45747485,12,8.334891634,8.334781631,168,103.8317029,9,8,17,11,10,21,5,0.401198,0.419021,0,No
15810,calf,14,12.45747485,12,8.334891634,8.334781631,168,103.8317029,8,11,19,13,12,25,4,0.438296,0.453589,0,No
16935,barnard,14,12.45747485,12,8.334891634,8.334781631,168,103.8317029,6,8,14,9,12,21,5,0.396281,0.413518,0,No
18256,accordion,14,12.45747485,12,8.334891634,8.334781631,168,103.8317029,8,10,18,13,13,26,4,0.393052,0.410165,0,No
70,yosemite,21,12.05200974,9,8.622573707,8.622493705,189,103.9193423,14,3,17,17,8,25,5,0.329914,0.334517,0,No
1981,tau,21,12.05200974,9,8.622573707,8.622493705,189,103.9193423,6,11,17,9,12,21,4,0.401243,0.418685,0,No
7654,middleweight,21,12.05200974,9,8.622573707,8.622493705,189,103.9193423,8,6,14,15,17,32,4,0.390664,0.407503,0,No
7936,mazda,21,12.05200974,9,8.622573707,8.622493705,189,103.9193423,10,12,22,14,17,31,4,0.427313,0.443764,0,No
622,wakefield,18,12.20616042,10,8.517213191,8.517123189,180,103.9624705,8,12,20,16,17,33,4,0.443542,0.458026,0,No
6258,paralysis,18,12.20616042,10,8.517213191,8.517123189,180,103.9624705,8,14,22,15,15,30,4,0.408266,0.425793,0,No
6701,occidental,18,12.20616042,10,8.517213191,8.517123189,180,103.9624705,9,11,20,10,15,25,5,0.381119,0.397224,0,No
8400,lulu,18,12.20616042,10,8.517213191,8.517123189,180,103.9624705,11,12,23,13,15,28,4,0.409434,0.426906,0,No
11175,grandchild,18,12.20616042,10,8.517213191,8.517123189,180,103.9624705,8,6,14,17,18,35,5,0.400845,0.418351,0,No
12238,feminism,18,12.20616042,10,8.517213191,8.517123189,180,103.9624705,11,9,20,11,14,25,4,0.410504,0.427957,0,No
15653,cardiac,18,12.20616042,10,8.517213191,8.517123189,180,103.9624705,13,5,18,15,16,31,5,0.385523,0.40189,0,No
1313,trigonometry,15,12.38848198,11,8.421903011,8.421803008,165,104.3345937,7,11,18,11,12,23,4,0.436357,0.451796,0,No
2335,sulfuric,15,12.38848198,11,8.421903011,8.421803008,165,104.3345937,6,3,9,10,15,25,5,0.355425,0.367209,0,No
2863,spectator,15,12.38848198,11,8.421903011,8.421803008,165,104.3345937,7,7,14,15,9,24,5,0.38036,0.39643,0,No
4522,reprise,15,12.38848198,11,8.421903011,8.421803008,165,104.3345937,11,8,19,11,8,19,4,0.41836,0.435525,0,No
5003,pupa,15,12.38848198,11,8.421903011,8.421803008,165,104.3345937,4,12,16,14,14,28,4,0.436089,0.451571,0,No
5138,prosecutor,15,12.38848198,11,8.421903011,8.421803008,165,104.3345937,6,6,12,15,11,26,4,0.408275,0.425713,0,No
5267,principia,15,12.38848198,11,8.421903011,8.421803008,165,104.3345937,6,2,8,9,2,11,5,0.361292,0.374074,0,No
6004,pentecost,15,12.38848198,11,8.421903011,8.421803008,165,104.3345937,5,9,14,10,10,20,4,0.425235,0.441806,0,No
7122,natal,15,12.38848198,11,8.421903011,8.421803008,165,104.3345937,7,11,18,9,13,22,4,0.434754,0.450439,0,No
7777,menstrual,15,12.38848198,11,8.421903011,8.421803008,165,104.3345937,8,4,12,14,14,28,5,0.325503,0.328989,0,No
10473,hippie,15,12.38848198,11,8.421903011,8.421803008,165,104.3345937,4,7,11,14,9,23,5,0.384787,0.40112,0,No
11730,frigate,15,12.38848198,11,8.421903011,8.421803008,165,104.3345937,7,6,13,13,8,21,5,0.369143,0.383546,0,No
15241,chitin,15,12.38848198,11,8.421903011,8.421803008,165,104.3345937,9,8,17,12,8,20,4,0.410608,0.428159,0,No
16215,brahmaputra,15,12.38848198,11,8.421903011,8.421803008,165,104.3345937,6,6,12,14,9,23,5,0.397862,0.415119,0,No
17485,aquinas,15,12.38848198,11,8.421903011,8.421803008,165,104.3345937,3,7,10,14,9,23,4,0.400392,0.417761,0,No
791,vida,20,12.1007999,9,8.622573707,8.622493705,180,104.3400391,2,9,11,19,18,37,5,0.371671,0.386468,0,No
3297,sima,20,12.1007999,9,8.622573707,8.622493705,180,104.3400391,15,2,17,17,2,19,5,0.331299,0.335809,0,No
3491,shearer,20,12.1007999,9,8.622573707,8.622493705,180,104.3400391,8,11,19,17,14,31,5,0.360661,0.373211,0,No
11792,frankfort,20,12.1007999,9,8.622573707,8.622493705,180,104.3400391,12,8,20,17,15,32,5,0.37199,0.386835,0,No
12345,falsetto,20,12.1007999,9,8.622573707,8.622493705,180,104.3400391,6,11,17,14,18,32,4,0.435116,0.450712,0,No
17337,ashland,20,12.1007999,9,8.622573707,8.622493705,180,104.3400391,15,13,28,18,18,36,4,0.39374,0.410892,0,No
17522,appendix,20,12.1007999,9,8.622573707,8.622493705,180,104.3400391,5,12,17,16,14,30,4,0.42882,0.445111,0,No
486,wee,17,12.26331883,10,8.517213191,8.517123189,170,104.4493009,7,7,14,15,10,25,5,0.329228,0.333566,0,No
801,vichy,17,12.26331883,10,8.517213191,8.517123189,170,104.4493009,7,8,15,14,13,27,4,0.393802,0.411113,0,No
3522,shaman,17,12.26331883,10,8.517213191,8.517123189,170,104.4493009,5,9,14,14,14,28,4,0.432382,0.448374,0,No
4852,quo,17,12.26331883,10,8.517213191,8.517123189,170,104.4493009,5,7,12,15,12,27,4,0.423439,0.440276,0,No
5260,priscilla,17,12.26331883,10,8.517213191,8.517123189,170,104.4493009,10,5,15,12,5,17,5,0.387602,0.404195,0,No
6548,operetta,17,12.26331883,10,8.517213191,8.517123189,170,104.4493009,10,10,20,15,13,28,4,0.401171,0.41861,0,No
10317,horseshoe,17,12.26331883,10,8.517213191,8.517123189,170,104.4493009,8,5,13,15,12,27,5,0.398469,0.416255,0,No
14051,dacca,17,12.26331883,10,8.517213191,8.517123189,170,104.4493009,9,11,20,15,13,28,4,0.404019,0.421718,0,No
14559,continuity,17,12.26331883,10,8.517213191,8.517123189,170,104.4493009,11,8,19,14,14,28,5,0.402335,0.4199,0,No
17035,bait,17,12.26331883,10,8.517213191,8.517123189,170,104.4493009,10,11,21,14,14,28,4,0.450419,0.463641,0,No
17231,attica,17,12.26331883,10,8.517213191,8.517123189,170,104.4493009,8,9,17,13,13,26,5,0.352608,0.363342,0,No
391,whistle,13,12.53158282,12,8.334891634,8.334781631,156,104.4493848,8,12,20,13,13,26,4,0.441754,0.456458,0,No
2347,suggestion,13,12.53158282,12,8.334891634,8.334781631,156,104.4493848,9,6,15,13,11,24,4,0.425847,0.442477,0,No
5261,priory,13,12.53158282,12,8.334891634,8.334781631,156,104.4493848,5,4,9,6,7,13,5,0.394283,0.411436,0,No
5321,preliminary,13,12.53158282,12,8.334891634,8.334781631,156,104.4493848,8,8,16,12,9,21,5,0.333622,0.338727,0,No
6172,pastoral,13,12.53158282,12,8.334891634,8.334781631,156,104.4493848,7,9,16,12,10,22,5,0.385456,0.401885,0,No
6244,parcel,13,12.53158282,12,8.334891634,8.334781631,156,104.4493848,7,7,14,8,10,18,5,0.360404,0.373095,0,No
6302,panorama,13,12.53158282,12,8.334891634,8.334781631,156,104.4493848,8,11,19,8,13,21,5,0.383242,0.399659,0,No
7800,memoir,13,12.53158282,12,8.334891634,8.334781631,156,104.4493848,3,9,12,12,11,23,4,0.41116,0.428553,0,No
7935,maze,13,12.53158282,12,8.334891634,8.334781631,156,104.4493848,6,7,13,12,10,22,4,0.436711,0.452021,0,No
7997,mat,13,12.53158282,12,8.334891634,8.334781631,156,104.4493848,7,11,18,11,11,22,4,0.444698,0.458932,0,No
8168,mandate,13,12.53158282,12,8.334891634,8.334781631,156,104.4493848,7,8,15,10,12,22,4,0.414685,0.431957,0,No
9284,juvenile,13,12.53158282,12,8.334891634,8.334781631,156,104.4493848,6,9,15,11,10,21,5,0.385196,0.401608,0,No
9640,inventory,13,12.53158282,12,8.334891634,8.334781631,156,104.4493848,9,7,16,11,11,22,4,0.433289,0.449022,0,No
12970,electorate,13,12.53158282,12,8.334891634,8.334781631,156,104.4493848,2,7,9,11,12,23,5,0.409273,0.426785,0,No
13303,dowager,13,12.53158282,12,8.334891634,8.334781631,156,104.4493848,6,7,13,12,9,21,5,0.408896,0.426302,0,No
13362,donate,13,12.53158282,12,8.334891634,8.334781631,156,104.4493848,6,8,14,11,12,23,4,0.421089,0.43813,0,No
13696,deserve,13,12.53158282,12,8.334891634,8.334781631,156,104.4493848,7,9,16,11,13,24,4,0.429359,0.445726,0,No
13751,denote,13,12.53158282,12,8.334891634,8.334781631,156,104.4493848,2,5,7,11,9,20,5,0.416075,0.433663,0,No
14064,cyril,13,12.53158282,12,8.334891634,8.334781631,156,104.4493848,7,6,13,8,10,18,5,0.405932,0.423372,0,No
16832,beagle,13,12.53158282,12,8.334891634,8.334781631,156,104.4493848,3,7,10,8,7,15,5,0.371959,0.386797,0,No
17711,andrei,13,12.53158282,12,8.334891634,8.334781631,156,104.4493848,8,2,10,9,2,11,5,0.32786,0.331685,0,No
6427,ounce,19,12.1520932,9,8.622573707,8.622493705,171,104.7823193,4,11,15,16,17,33,4,0.444542,0.458786,0,No
8514,logarithmic,19,12.1520932,9,8.622573707,8.622493705,171,104.7823193,7,8,15,17,15,32,5,0.374865,0.389994,0,No
8591,lisp,19,12.1520932,9,8.622573707,8.622493705,171,104.7823193,9,11,20,15,15,30,4,0.42209,0.439046,0,No
372,wholesale,14,12.45747485,11,8.421903011,8.421803008,154,104.9156449,9,5,14,12,6,18,5,0.331887,0.336841,0,No
2718,squirrel,14,12.45747485,11,8.421903011,8.421803008,154,104.9156449,6,6,12,9,7,16,5,0.355461,0.366697,0,No
3174,slavonic,14,12.45747485,11,8.421903011,8.421803008,154,104.9156449,4,6,10,11,10,21,5,0.386884,0.403402,0,No
3499,shave,14,12.45747485,11,8.421903011,8.421803008,154,104.9156449,5,6,11,14,13,27,4,0.428602,0.444825,0,No
4188,rub,14,12.45747485,11,8.421903011,8.421803008,154,104.9156449,9,10,19,12,13,25,4,0.419745,0.437107,0,No
4309,roast,14,12.45747485,11,8.421903011,8.421803008,154,104.9156449,10,11,21,11,13,24,4,0.414211,0.431732,0,No
4677,recital,14,12.45747485,11,8.421903011,8.421803008,154,104.9156449,6,9,15,13,14,27,4,0.412862,0.43029,0,No
5884,petition,14,12.45747485,11,8.421903011,8.421803008,154,104.9156449,4,7,11,12,14,26,4,0.448156,0.461796,0,No
6351,pal,14,12.45747485,11,8.421903011,8.421803008,154,104.9156449,5,3,8,9,5,14,5,0.3278,0.331772,0,No
6404,owe,14,12.45747485,11,8.421903011,8.421803008,154,104.9156449,10,9,19,14,12,26,4,0.400248,0.417915,0,No
6763,nutmeg,14,12.45747485,11,8.421903011,8.421803008,154,104.9156449,5,8,13,9,9,18,4,0.431425,0.447388,0,No
7493,modem,14,12.45747485,11,8.421903011,8.421803008,154,104.9156449,7,8,15,13,11,24,5,0.377874,0.39374,0,No
8120,maori,14,12.45747485,11,8.421903011,8.421803008,154,104.9156449,5,9,14,14,11,25,4,0.441326,0.456035,0,No
10518,hickory,14,12.45747485,11,8.421903011,8.421803008,154,104.9156449,12,8,20,12,10,22,5,0.351526,0.361751,0,No
11340,glassware,14,12.45747485,11,8.421903011,8.421803008,154,104.9156449,4,8,12,12,10,22,4,0.426379,0.442858,0,No
12639,eternity,14,12.45747485,11,8.421903011,8.421803008,154,104.9156449,8,8,16,12,11,23,5,0.405218,0.422682,0,No
14520,convergent,14,12.45747485,11,8.421903011,8.421803008,154,104.9156449,7,3,10,12,12,24,5,0.321658,0.324902,0,No
16716,bench,14,12.45747485,11,8.421903011,8.421803008,154,104.9156449,5,9,14,14,11,25,4,0.42062,0.437642,0,No
17058,backyard,14,12.45747485,11,8.421903011,8.421803008,154,104.9156449,7,10,17,12,11,23,4,0.423429,0.440219,0,No
17208,auditory,14,12.45747485,11,8.421903011,8.421803008,154,104.9156449,9,5,14,13,9,22,5,0.328582,0.332705,0,No
17714,andover,14,12.45747485,11,8.421903011,8.421803008,154,104.9156449,5,7,12,8,11,19,4,0.414511,0.431938,0,No
2484,stratford,12,12.45747485,10,8.421903011,8.421803008,120,104.9156449,8,7,15,9,9,18,5,0.371827,0.386543,0,No
2964,sonoma,22,12.00548972,8,8.740356743,8.740286741,176,104.9322631,9,5,14,17,21,38,5,0.385523,0.401904,0,No
4676,recitative,22,12.00548972,8,8.740356743,8.740286741,176,104.9322631,13,11,24,20,17,37,4,0.444831,0.459026,0,No
679,voltaire,16,12.32394346,10,8.517213191,8.517123189,160,104.9656538,9,9,18,9,14,23,4,0.409963,0.427441,0,No
1174,tuscaloosa,16,12.32394346,10,8.517213191,8.517123189,160,104.9656538,9,6,15,16,16,32,5,0.372584,0.387559,0,No
2475,stray,16,12.32394346,10,8.517213191,8.517123189,160,104.9656538,6,5,11,11,5,16,5,0.343379,0.351618,0,No
3649,seminal,16,12.32394346,10,8.517213191,8.517123189,160,104.9656538,4,4,8,12,7,19,5,0.321082,0.324524,0,No
5683,placenta,16,12.32394346,10,8.517213191,8.517123189,160,104.9656538,3,6,9,14,11,25,4,0.427087,0.443435,0,No
5776,pidgin,16,12.32394346,10,8.517213191,8.517123189,160,104.9656538,11,8,19,13,11,24,4,0.391491,0.408437,0,No
6155,pathogen,16,12.32394346,10,8.517213191,8.517123189,160,104.9656538,6,7,13,16,10,26,4,0.419635,0.436605,0,No
6721,obscene,16,12.32394346,10,8.517213191,8.517123189,160,104.9656538,9,9,18,10,10,20,4,0.401997,0.419441,0,No
7830,mekong,16,12.32394346,10,8.517213191,8.517123189,160,104.9656538,4,7,11,16,13,29,5,0.350762,0.36099,0,No
9333,judo,16,12.32394346,10,8.517213191,8.517123189,160,104.9656538,5,14,19,9,14,23,4,0.42881,0.445172,0,No
10217,hurley,16,12.32394346,10,8.517213191,8.517123189,160,104.9656538,8,8,16,14,9,23,5,0.398317,0.415819,0,No
10223,huntington,16,12.32394346,10,8.517213191,8.517123189,160,104.9656538,8,10,18,13,12,25,4,0.40704,0.424657,0,No
11150,graphite,16,12.32394346,10,8.517213191,8.517123189,160,104.9656538,9,10,19,12,12,24,4,0.411732,0.429131,0,No
11268,godwin,16,12.32394346,10,8.517213191,8.517123189,160,104.9656538,11,9,20,14,12,26,4,0.43015,0.446407,0,No
11331,glendale,16,12.32394346,10,8.517213191,8.517123189,160,104.9656538,9,7,16,15,15,30,5,0.376112,0.391553,0,No
11508,gautama,16,12.32394346,10,8.517213191,8.517123189,160,104.9656538,6,7,13,6,15,21,4,0.403588,0.421173,0,No
16989,banbury,16,12.32394346,10,8.517213191,8.517123189,160,104.9656538,9,8,17,10,11,21,4,0.433374,0.449111,0,No
8973,lana,10,12.32394346,8,8.517213191,8.517123189,80,104.9656538,6,5,11,6,6,12,5,0.38574,0.402139,0,No
11599,galena,26,11.83843564,7,8.873888135,8.873828135,182,105.0529536,14,12,26,19,23,42,5,0.386614,0.403472,0,No
1957,teal,25,11.83843564,6,8.873888135,8.873828135,150,105.0529536,14,11,25,16,13,29,4,0.441512,0.456275,0,No
525,watery,12,12.61162553,12,8.334891634,8.334781631,144,105.1165321,7,7,14,8,7,15,5,0.356976,0.369142,0,No
1041,upstream,12,12.61162553,12,8.334891634,8.334781631,144,105.1165321,5,8,13,6,10,16,4,0.441567,0.456228,0,No
1288,triumph,12,12.61162553,12,8.334891634,8.334781631,144,105.1165321,6,5,11,12,12,24,4,0.410238,0.4276,0,No
4896,quay,12,12.61162553,12,8.334891634,8.334781631,144,105.1165321,10,9,19,11,9,20,4,0.413323,0.430774,0,No
5986,perceive,12,12.61162553,12,8.334891634,8.334781631,144,105.1165321,7,6,13,10,8,18,4,0.421479,0.43828,0,No
6428,ought,12,12.61162553,12,8.334891634,8.334781631,144,105.1165321,6,1,7,10,12,22,5,0.359172,0.371523,0,No
8708,liberate,12,12.61162553,12,8.334891634,8.334781631,144,105.1165321,4,6,10,10,8,18,5,0.340579,0.34801,0,No
8854,lazarus,12,12.61162553,12,8.334891634,8.334781631,144,105.1165321,5,5,10,6,7,13,5,0.346767,0.355866,0,No
9229,keen,12,12.61162553,12,8.334891634,8.334781631,144,105.1165321,7,6,13,12,8,20,5,0.364295,0.377743,0,No
9649,invalid,12,12.61162553,12,8.334891634,8.334781631,144,105.1165321,7,9,16,10,9,19,4,0.444988,0.459171,0,No
9764,insert,12,12.61162553,12,8.334891634,8.334781631,144,105.1165321,6,8,14,10,10,20,4,0.423874,0.440717,0,No
10304,hostile,12,12.61162553,12,8.334891634,8.334781631,144,105.1165321,8,5,13,11,7,18,5,0.360127,0.372715,0,No
10865,handbook,12,12.61162553,12,8.334891634,8.334781631,144,105.1165321,5,2,7,9,10,19,5,0.382837,0.399116,0,No
11089,grief,12,12.61162553,12,8.334891634,8.334781631,144,105.1165321,9,8,17,10,11,21,4,0.450384,0.463575,0,No
11542,garry,12,12.61162553,12,8.334891634,8.334781631,144,105.1165321,6,5,11,8,8,16,5,0.311208,0.31644,0,No
13711,derive,12,12.61162553,12,8.334891634,8.334781631,144,105.1165321,5,6,11,7,10,17,4,0.398326,0.415803,0,No
14123,curious,12,12.61162553,12,8.334891634,8.334781631,144,105.1165321,8,9,17,12,10,22,5,0.356589,0.368046,0,No
17239,attain,12,12.61162553,12,8.334891634,8.334781631,144,105.1165321,2,8,10,12,8,20,4,0.42881,0.445219,0,No
17420,aristocrat,12,12.61162553,12,8.334891634,8.334781631,144,105.1165321,10,7,17,10,9,19,5,0.396237,0.413495,0,No
18114,advocacy,12,12.61162553,12,8.334891634,8.334781631,144,105.1165321,4,5,9,5,8,13,5,0.406359,0.423753,0,No
18222,acquire,12,12.61162553,12,8.334891634,8.334781631,144,105.1165321,4,8,12,11,10,21,4,0.421789,0.438956,0,No
6777,null,18,12.20616042,9,8.622573707,8.622493705,162,105.2485179,6,7,13,17,18,35,5,0.395918,0.41311,0,No
7637,migrant,18,12.20616042,9,8.622573707,8.622493705,162,105.2485179,13,2,15,17,2,19,5,0.359274,0.371668,0,No
8754,leprosy,18,12.20616042,9,8.622573707,8.622493705,162,105.2485179,8,13,21,13,16,29,4,0.40884,0.426366,0,No
16810,bebop,18,12.20616042,9,8.622573707,8.622493705,162,105.2485179,7,9,16,16,11,27,4,0.406601,0.424108,0,No
17424,aries,18,12.20616042,9,8.622573707,8.622493705,162,105.2485179,8,8,16,11,14,25,4,0.437605,0.452815,0,No
1425,transcendental,21,12.05200974,8,8.740356743,8.740286741,168,105.3388646,12,2,14,20,2,22,5,0.326882,0.331794,0,No
16687,benzene,21,12.05200974,8,8.740356743,8.740286741,168,105.3388646,12,13,25,16,18,34,4,0.403808,0.421319,0,No
18025,ainu,21,12.05200974,8,8.740356743,8.740286741,168,105.3388646,10,8,18,15,18,33,5,0.362273,0.375152,0,No
1523,topography,15,12.38848198,10,8.517213191,8.517123189,150,105.5153421,6,7,13,10,11,21,5,0.384138,0.400551,0,No
2368,sucrose,15,12.38848198,10,8.517213191,8.517123189,150,105.5153421,8,7,15,9,15,24,4,0.417641,0.434713,0,No
5618,pleiades,15,12.38848198,10,8.517213191,8.517123189,150,105.5153421,2,10,12,13,11,24,5,0.400239,0.417668,0,No
8373,lust,15,12.38848198,10,8.517213191,8.517123189,150,105.5153421,9,8,17,13,14,27,4,0.404121,0.421601,0,No
8771,lenny,15,12.38848198,10,8.517213191,8.517123189,150,105.5153421,12,8,20,12,9,21,5,0.344599,0.352795,0,No
9972,incest,15,12.38848198,10,8.517213191,8.517123189,150,105.5153421,7,8,15,12,12,24,4,0.394537,0.411686,0,No
10932,hackney,15,12.38848198,10,8.517213191,8.517123189,150,105.5153421,9,7,16,14,11,25,5,0.371998,0.386802,0,No
11408,ghent,15,12.38848198,10,8.517213191,8.517123189,150,105.5153421,11,7,18,15,10,25,5,0.385816,0.402482,0,No
14102,custer,15,12.38848198,10,8.517213191,8.517123189,150,105.5153421,9,10,19,13,13,26,4,0.398935,0.41631,0,No
16107,brine,15,12.38848198,10,8.517213191,8.517123189,150,105.5153421,10,7,17,10,12,22,5,0.375182,0.390524,0,No
16658,bernoulli,15,12.38848198,10,8.517213191,8.517123189,150,105.5153421,8,8,16,10,13,23,5,0.367569,0.381567,0,No
17930,algonquian,15,12.38848198,10,8.517213191,8.517123189,150,105.5153421,7,7,14,13,10,23,5,0.340364,0.347817,0,No
538,watergate,13,12.53158282,11,8.421903011,8.421803008,143,105.5397751,3,1,4,12,11,23,5,0.307515,0.312551,0,No
1364,tray,13,12.53158282,11,8.421903011,8.421803008,143,105.5397751,7,11,18,9,11,20,5,0.393531,0.410763,0,No
1855,terrace,13,12.53158282,11,8.421903011,8.421803008,143,105.5397751,6,8,14,10,9,19,5,0.374747,0.389991,0,No
2032,tanganyika,13,12.53158282,11,8.421903011,8.421803008,143,105.5397751,5,8,13,12,10,22,5,0.388042,0.404932,0,No
4290,rockies,13,12.53158282,11,8.421903011,8.421803008,143,105.5397751,6,9,15,12,11,23,5,0.414443,0.431757,0,No
4301,robertson,13,12.53158282,11,8.421903011,8.421803008,143,105.5397751,8,11,19,11,11,22,5,0.390535,0.407601,0,No
5367,practise,13,12.53158282,11,8.421903011,8.421803008,143,105.5397751,8,8,16,13,8,21,4,0.399455,0.416939,0,No
6917,nineveh,13,12.53158282,11,8.421903011,8.421803008,143,105.5397751,4,12,16,10,12,22,4,0.447151,0.460974,0,No
7334,mosquitoes,13,12.53158282,11,8.421903011,8.421803008,143,105.5397751,9,8,17,10,11,21,4,0.43086,0.446886,0,No
7726,mestizo,13,12.53158282,11,8.421903011,8.421803008,143,105.5397751,6,8,14,11,8,19,4,0.419596,0.436581,0,No
8007,massey,13,12.53158282,11,8.421903011,8.421803008,143,105.5397751,8,8,16,10,11,21,5,0.388238,0.405081,0,No
8487,longitudinal,13,12.53158282,11,8.421903011,8.421803008,143,105.5397751,9,1,10,13,4,17,5,0.321425,0.324627,0,No
9317,julio,13,12.53158282,11,8.421903011,8.421803008,143,105.5397751,9,4,13,10,4,14,5,0.328874,0.333034,0,No
9406,joanne,13,12.53158282,11,8.421903011,8.421803008,143,105.5397751,12,8,20,12,9,21,4,0.390673,0.407555,0,No
10016,impress,13,12.53158282,11,8.421903011,8.421803008,143,105.5397751,4,10,14,10,10,20,4,0.439806,0.454744,0,No
10638,hellenic,13,12.53158282,11,8.421903011,8.421803008,143,105.5397751,6,6,12,10,7,17,4,0.399905,0.417577,0,No
11814,fragment,13,12.53158282,11,8.421903011,8.421803008,143,105.5397751,9,7,16,12,12,24,5,0.384346,0.40084,0,No
11816,fracture,13,12.53158282,11,8.421903011,8.421803008,143,105.5397751,8,8,16,13,11,24,4,0.450202,0.463481,0,No
12097,fisherman,13,12.53158282,11,8.421903011,8.421803008,143,105.5397751,6,10,16,10,10,20,5,0.394423,0.411612,0,No
13209,dub,13,12.53158282,11,8.421903011,8.421803008,143,105.5397751,7,9,16,8,12,20,5,0.406844,0.424325,0,No
14002,dane,13,12.53158282,11,8.421903011,8.421803008,143,105.5397751,7,7,14,11,10,21,5,0.374478,0.389771,0,No
14502,cooke,13,12.53158282,11,8.421903011,8.421803008,143,105.5397751,6,10,16,10,11,21,5,0.411046,0.428489,0,No
15009,closure,13,12.53158282,11,8.421903011,8.421803008,143,105.5397751,8,7,15,9,12,21,5,0.39863,0.415993,0,No
17559,aphelion,13,12.53158282,11,8.421903011,8.421803008,143,105.5397751,8,7,15,11,11,22,4,0.407077,0.424666,0,No
5582,pneumatic,17,12.26331883,9,8.622573707,8.622493705,153,105.7413705,6,11,17,8,11,19,5,0.355903,0.367914,0,No
7655,middletown,17,12.26331883,9,8.622573707,8.622493705,153,105.7413705,9,9,18,12,17,29,4,0.405265,0.422915,0,No
12962,electrode,17,12.26331883,9,8.622573707,8.622493705,153,105.7413705,5,7,12,13,15,28,4,0.418942,0.435952,0,No
13167,dunkirk,17,12.26331883,9,8.622573707,8.622493705,153,105.7413705,11,12,23,13,15,28,4,0.393452,0.410789,0,No
13264,dravidian,17,12.26331883,9,8.622573707,8.622493705,153,105.7413705,11,2,13,15,11,26,5,0.351123,0.361084,0,No
2791,spokane,24,11.91847835,7,8.873888135,8.873828135,168,105.7632436,10,9,19,21,16,37,4,0.42791,0.444243,0,No
4885,queue,24,11.91847835,7,8.873888135,8.873828135,168,105.7632436,6,16,22,23,22,45,4,0.451438,0.464584,0,No
573,warp,20,12.1007999,8,8.740356743,8.740286741,160,105.765308,13,12,25,18,17,35,4,0.422834,0.43967,0,No
4371,riemann,20,12.1007999,8,8.740356743,8.740286741,160,105.765308,6,8,14,19,18,37,5,0.338204,0.344899,0,No
7316,motorola,20,12.1007999,8,8.740356743,8.740286741,160,105.765308,12,6,18,17,12,29,4,0.404627,0.422192,0,No
17375,arsenic,20,12.1007999,8,8.740356743,8.740286741,160,105.765308,13,12,25,13,19,32,4,0.432392,0.448308,0,No
539,waterfront,14,12.45747485,10,8.517213191,8.517123189,140,106.1029691,5,6,11,13,9,22,4,0.426194,0.442632,0,No
885,vengeance,14,12.45747485,10,8.517213191,8.517123189,140,106.1029691,8,10,18,11,11,22,4,0.383424,0.399851,0,No
4105,sacrament,14,12.45747485,10,8.517213191,8.517123189,140,106.1029691,6,9,15,12,11,23,4,0.432687,0.448618,0,No
4349,rink,14,12.45747485,10,8.517213191,8.517123189,140,106.1029691,3,8,11,8,9,17,4,0.402435,0.419878,0,No
4996,puppy,14,12.45747485,10,8.517213191,8.517123189,140,106.1029691,9,10,19,13,10,23,4,0.403093,0.420821,0,No
6502,ordnance,14,12.45747485,10,8.517213191,8.517123189,140,106.1029691,4,6,10,7,12,19,5,0.34978,0.359967,0,No
6607,oligocene,14,12.45747485,10,8.517213191,8.517123189,140,106.1029691,2,8,10,7,10,17,4,0.398219,0.415559,0,No
7093,nazism,14,12.45747485,10,8.517213191,8.517123189,140,106.1029691,7,8,15,12,11,23,4,0.432719,0.448533,0,No
7656,middleton,14,12.45747485,10,8.517213191,8.517123189,140,106.1029691,8,12,20,9,12,21,4,0.429536,0.445773,0,No
8451,loudspeaker,14,12.45747485,10,8.517213191,8.517123189,140,106.1029691,5,10,15,13,11,24,4,0.419576,0.436703,0,No
11598,galilean,14,12.45747485,10,8.517213191,8.517123189,140,106.1029691,4,2,6,12,2,14,5,0.323227,0.326581,0,No
12851,emphysema,14,12.45747485,10,8.517213191,8.517123189,140,106.1029691,7,6,13,11,11,22,4,0.408294,0.425727,0,No
13834,deforestation,14,12.45747485,10,8.517213191,8.517123189,140,106.1029691,8,9,17,11,13,24,4,0.441534,0.456204,0,No
16373,boise,14,12.45747485,10,8.517213191,8.517123189,140,106.1029691,11,7,18,13,13,26,5,0.352987,0.363722,0,No
18060,agatha,14,12.45747485,10,8.517213191,8.517123189,140,106.1029691,10,7,17,13,13,26,5,0.383019,0.399346,0,No
18062,agar,14,12.45747485,10,8.517213191,8.517123189,140,106.1029691,8,6,14,10,10,20,5,0.396254,0.413448,0,No
4119,ryder,19,12.1520932,8,8.740356743,8.740286741,152,106.2136297,9,9,18,12,15,27,4,0.402535,0.420005,0,No
6049,pelican,19,12.1520932,8,8.740356743,8.740286741,152,106.2136297,8,9,17,13,9,22,5,0.373989,0.389154,0,No
11489,gelatin,19,12.1520932,8,8.740356743,8.740286741,152,106.2136297,11,12,23,15,17,32,4,0.417268,0.434511,0,No
11972,fluorescent,19,12.1520932,8,8.740356743,8.740286741,152,106.2136297,8,5,13,14,11,25,4,0.387441,0.403963,0,No
13513,dirac,19,12.1520932,8,8.740356743,8.740286741,152,106.2136297,5,11,16,13,13,26,4,0.416905,0.434201,0,No
16651,bertha,19,12.1520932,8,8.740356743,8.740286741,152,106.2136297,9,7,16,15,13,28,5,0.355105,0.366126,0,No
850,vernacular,12,12.61162553,11,8.421903011,8.421803008,132,106.213887,7,10,17,9,11,20,4,0.391483,0.408432,0,No
1906,temper,12,12.61162553,11,8.421903011,8.421803008,132,106.213887,9,5,14,11,9,20,5,0.385958,0.40235,0,No
1943,technician,12,12.61162553,11,8.421903011,8.421803008,132,106.213887,5,8,13,6,9,15,4,0.435746,0.451233,0,No
2246,surveyor,12,12.61162553,11,8.421903011,8.421803008,132,106.213887,7,7,14,12,11,23,5,0.396919,0.414171,0,No
2470,streetcar,12,12.61162553,11,8.421903011,8.421803008,132,106.213887,7,5,12,11,6,17,5,0.356553,0.36859,0,No
3191,slain,12,12.61162553,11,8.421903011,8.421803008,132,106.213887,6,6,12,12,11,23,5,0.380898,0.396895,0,No
4359,rightful,12,12.61162553,11,8.421903011,8.421803008,132,106.213887,2,7,9,12,9,21,5,0.331206,0.33536,0,No
4366,rig,12,12.61162553,11,8.421903011,8.421803008,132,106.213887,7,5,12,11,10,21,5,0.360448,0.373109,0,No
4875,quid,12,12.61162553,11,8.421903011,8.421803008,132,106.213887,2,2,4,11,3,14,5,0.360873,0.373562,0,No
5139,prosecution,12,12.61162553,11,8.421903011,8.421803008,132,106.213887,3,7,10,11,11,22,4,0.4361,0.451496,0,No
5215,profound,12,12.61162553,11,8.421903011,8.421803008,132,106.213887,6,4,10,10,5,15,5,0.32533,0.328781,0,No
5240,proceed,12,12.61162553,11,8.421903011,8.421803008,132,106.213887,7,6,13,10,11,21,5,0.380767,0.39693,0,No
5317,premise,12,12.61162553,11,8.421903011,8.421803008,132,106.213887,7,9,16,10,12,22,4,0.442448,0.456988,0,No
5412,postgraduate,12,12.61162553,11,8.421903011,8.421803008,132,106.213887,8,7,15,11,7,18,4,0.415364,0.432689,0,No
6847,northerly,12,12.61162553,11,8.421903011,8.421803008,132,106.213887,3,9,12,12,9,21,5,0.332765,0.337799,0,No
6874,nominal,12,12.61162553,11,8.421903011,8.421803008,132,106.213887,5,7,12,10,7,17,5,0.356861,0.36901,0,No
7472,molar,12,12.61162553,11,8.421903011,8.421803008,132,106.213887,6,8,14,8,11,19,4,0.406025,0.423638,0,No
8734,lev,12,12.61162553,11,8.421903011,8.421803008,132,106.213887,7,1,8,8,1,9,5,0.398067,0.415814,0,No
9213,kennel,12,12.61162553,11,8.421903011,8.421803008,132,106.213887,4,1,5,5,7,12,5,0.322745,0.32609,0,No
9402,jockey,12,12.61162553,11,8.421903011,8.421803008,132,106.213887,3,11,14,12,11,23,4,0.405367,0.422859,0,No
9548,isolate,12,12.61162553,11,8.421903011,8.421803008,132,106.213887,4,10,14,11,12,23,4,0.39846,0.416122,0,No
10097,ignite,12,12.61162553,11,8.421903011,8.421803008,132,106.213887,8,8,16,12,10,22,4,0.414327,0.431736,0,No
13183,dumb,12,12.61162553,11,8.421903011,8.421803008,132,106.213887,10,9,19,11,9,20,5,0.385824,0.402298,0,No
13297,downhill,12,12.61162553,11,8.421903011,8.421803008,132,106.213887,1,6,7,1,6,7,5,0.36009,0.372255,0,No
13819,delano,12,12.61162553,11,8.421903011,8.421803008,132,106.213887,4,3,7,12,11,23,5,0.39863,0.416382,0,No
14160,cucumber,12,12.61162553,11,8.421903011,8.421803008,132,106.213887,7,6,13,11,9,20,5,0.391293,0.408185,0,No
14454,cornerstone,12,12.61162553,11,8.421903011,8.421803008,132,106.213887,6,4,10,11,11,22,5,0.383176,0.399505,0,No
14503,cookbook,12,12.61162553,11,8.421903011,8.421803008,132,106.213887,8,7,15,9,8,17,4,0.42213,0.439027,0,No
14509,convince,12,12.61162553,11,8.421903011,8.421803008,132,106.213887,1,9,10,11,12,23,4,0.404185,0.421882,0,No
14900,coliseum,12,12.61162553,11,8.421903011,8.421803008,132,106.213887,5,6,11,12,11,23,4,0.427622,0.444078,0,No
16285,bosporus,12,12.61162553,11,8.421903011,8.421803008,132,106.213887,3,7,10,12,9,21,4,0.42911,0.445294,0,No
16535,bishopric,12,12.61162553,11,8.421903011,8.421803008,132,106.213887,3,7,10,10,11,21,4,0.433882,0.449552,0,No
17191,aurelius,12,12.61162553,11,8.421903011,8.421803008,132,106.213887,4,6,10,11,6,17,4,0.390381,0.407221,0,No
17510,appoint,12,12.61162553,11,8.421903011,8.421803008,132,106.213887,3,6,9,9,9,18,4,0.422844,0.439881,0,No
17730,anatomist,12,12.61162553,11,8.421903011,8.421803008,132,106.213887,8,6,14,11,8,19,5,0.406956,0.424396,0,No
696,vogue,16,12.32394346,9,8.622573707,8.622493705,144,106.2641108,9,10,19,13,15,28,4,0.429038,0.445294,0,No
1510,torpedo,16,12.32394346,9,8.622573707,8.622493705,144,106.2641108,10,12,22,15,12,27,4,0.397675,0.415042,0,No
3071,snoop,16,12.32394346,9,8.622573707,8.622493705,144,106.2641108,9,2,11,10,3,13,5,0.321914,0.32541,0,No
6036,pence,16,12.32394346,9,8.622573707,8.622493705,144,106.2641108,11,11,22,15,15,30,4,0.399914,0.4173,0,No
6430,ouagadougou,16,12.32394346,9,8.622573707,8.622493705,144,106.2641108,6,6,12,12,9,21,5,0.372271,0.387116,0,No
8480,loom,16,12.32394346,9,8.622573707,8.622493705,144,106.2641108,7,10,17,12,14,26,4,0.435843,0.451313,0,No
9097,knob,16,12.32394346,9,8.622573707,8.622493705,144,106.2641108,7,10,17,14,14,28,4,0.423732,0.440496,0,No
10479,hindustan,16,12.32394346,9,8.622573707,8.622493705,144,106.2641108,6,9,15,9,10,19,4,0.440493,0.455317,0,No
15792,callisto,16,12.32394346,9,8.622573707,8.622493705,144,106.2641108,8,9,17,15,14,29,5,0.358244,0.370366,0,No
16560,binomial,16,12.32394346,9,8.622573707,8.622493705,144,106.2641108,10,4,14,15,13,28,5,0.345942,0.354939,0,No
17902,allegory,16,12.32394346,9,8.622573707,8.622493705,144,106.2641108,8,10,18,16,14,30,4,0.451886,0.464885,0,No
10434,hoboken,18,12.20616042,8,8.740356743,8.740286741,144,106.6861965,12,7,19,17,15,32,5,0.37797,0.393646,0,No
16614,bey,18,12.20616042,8,8.740356743,8.740286741,144,106.6861965,5,6,11,5,7,12,4,0.4221,0.439018,0,No
16840,bazaar,18,12.20616042,8,8.740356743,8.740286741,144,106.6861965,8,7,15,12,11,23,4,0.427611,0.444064,0,No
1818,textual,13,12.53158282,10,8.517213191,8.517123189,130,106.7341625,5,3,8,6,7,13,5,0.324569,0.328171,0,No
2625,statutory,13,12.53158282,10,8.517213191,8.517123189,130,106.7341625,10,4,14,12,10,22,5,0.35586,0.36773,0,No
3181,slater,13,12.53158282,10,8.517213191,8.517123189,130,106.7341625,9,9,18,11,12,23,4,0.402207,0.419652,0,No
4002,sandman,13,12.53158282,10,8.517213191,8.517123189,130,106.7341625,6,9,15,13,11,24,4,0.425051,0.441637,0,No
4180,rubin,13,12.53158282,10,8.517213191,8.517123189,130,106.7341625,6,7,13,12,8,20,4,0.394291,0.411428,0,No
5633,playhouse,13,12.53158282,10,8.517213191,8.517123189,130,106.7341625,5,7,12,10,12,22,5,0.40558,0.423034,0,No
6051,pelagic,13,12.53158282,10,8.517213191,8.517123189,130,106.7341625,11,4,15,12,7,19,5,0.355881,0.367782,0,No
7538,misery,13,12.53158282,10,8.517213191,8.517123189,130,106.7341625,9,6,15,10,8,18,5,0.387306,0.404056,0,No
8437,lowell,13,12.53158282,10,8.517213191,8.517123189,130,106.7341625,8,8,16,11,11,22,4,0.412162,0.429591,0,No
10007,improvise,13,12.53158282,10,8.517213191,8.517123189,130,106.7341625,5,9,14,11,11,22,5,0.419516,0.436893,0,No
10344,hooves,13,12.53158282,10,8.517213191,8.517123189,130,106.7341625,8,9,17,9,10,19,4,0.437788,0.453012,0,No
10641,helix,13,12.53158282,10,8.517213191,8.517123189,130,106.7341625,5,7,12,12,8,20,5,0.355696,0.367131,0,No
10924,hadron,13,12.53158282,10,8.517213191,8.517123189,130,106.7341625,2,4,6,13,4,17,4,0.426799,0.443266,0,No
11541,garter,13,12.53158282,10,8.517213191,8.517123189,130,106.7341625,2,7,9,12,11,23,4,0.417023,0.434149,0,No
12180,fidelity,13,12.53158282,10,8.517213191,8.517123189,130,106.7341625,5,9,14,12,10,22,4,0.424604,0.441299,0,No
12203,fetch,13,12.53158282,10,8.517213191,8.517123189,130,106.7341625,4,8,12,9,11,20,4,0.425286,0.441853,0,No
12745,epitaph,13,12.53158282,10,8.517213191,8.517123189,130,106.7341625,6,3,9,11,3,14,5,0.366068,0.379666,0,No
13470,disposal,13,12.53158282,10,8.517213191,8.517123189,130,106.7341625,6,9,15,12,11,23,4,0.436604,0.451965,0,No
15200,christendom,13,12.53158282,10,8.517213191,8.517123189,130,106.7341625,8,10,18,12,11,23,4,0.43625,0.451787,0,No
15487,cecilia,13,12.53158282,10,8.517213191,8.517123189,130,106.7341625,8,5,13,11,7,18,5,0.370654,0.385215,0,No
15700,capacitor,13,12.53158282,10,8.517213191,8.517123189,130,106.7341625,5,5,10,13,5,18,4,0.413237,0.430469,0,No
16463,blitz,13,12.53158282,10,8.517213191,8.517123189,130,106.7341625,6,8,14,12,10,22,4,0.420062,0.437257,0,No
16771,begging,13,12.53158282,10,8.517213191,8.517123189,130,106.7341625,9,5,14,10,11,21,4,0.426194,0.442623,0,No
17815,ambient,13,12.53158282,10,8.517213191,8.517123189,130,106.7341625,8,8,16,10,11,21,5,0.341287,0.348816,0,No
17903,allegheny,13,12.53158282,10,8.517213191,8.517123189,130,106.7341625,7,9,16,9,12,21,4,0.409019,0.426741,0,No
17976,albino,13,12.53158282,10,8.517213191,8.517123189,130,106.7341625,9,5,14,11,5,16,5,0.337536,0.343776,0,No
4713,rca,15,12.38848198,9,8.622573707,8.622493705,135,106.820599,8,3,11,11,3,14,5,0.339193,0.345828,0,No
7470,mold,15,12.38848198,9,8.622573707,8.622493705,135,106.820599,8,8,16,14,9,23,4,0.437659,0.452867,0,No
9300,junta,15,12.38848198,9,8.622573707,8.622493705,135,106.820599,7,9,16,14,12,26,4,0.422211,0.439182,0,No
9633,invest,15,12.38848198,9,8.622573707,8.622493705,135,106.820599,6,6,12,14,13,27,4,0.42939,0.445698,0,No
10997,gujarati,15,12.38848198,9,8.622573707,8.622493705,135,106.820599,10,5,15,13,8,21,5,0.350977,0.361265,0,No
14447,corolla,15,12.38848198,9,8.622573707,8.622493705,135,106.820599,5,5,10,15,10,25,4,0.425969,0.442416,0,No
14515,convertible,15,12.38848198,9,8.622573707,8.622493705,135,106.820599,5,6,11,14,8,22,4,0.399977,0.417338,0,No
14667,confucius,15,12.38848198,9,8.622573707,8.622493705,135,106.820599,7,8,15,9,9,18,5,0.355262,0.366731,0,No
15845,cadillac,15,12.38848198,9,8.622573707,8.622493705,135,106.820599,5,7,12,5,9,14,5,0.386244,0.40292,0,No
15850,cacti,15,12.38848198,9,8.622573707,8.622493705,135,106.820599,11,9,20,13,13,26,5,0.390802,0.407716,0,No
16142,brew,15,12.38848198,9,8.622573707,8.622493705,135,106.820599,5,10,15,11,13,24,4,0.443066,0.457528,0,No
17099,aylesbury,15,12.38848198,9,8.622573707,8.622493705,135,106.820599,9,7,16,9,8,17,4,0.409575,0.42699,0,No
201,workplace,11,12.6986369,11,8.421903011,8.421803008,121,106.9466884,4,9,13,10,10,20,4,0.437896,0.453092,0,No
250,woke,11,12.6986369,11,8.421903011,8.421803008,121,106.9466884,7,4,11,8,11,19,5,0.343194,0.351131,0,No
345,wilbur,11,12.6986369,11,8.421903011,8.421803008,121,106.9466884,8,4,12,9,7,16,5,0.384462,0.400712,0,No
412,whereby,11,12.6986369,11,8.421903011,8.421803008,121,106.9466884,7,6,13,8,7,15,5,0.34923,0.359098,0,No
580,warehouse,11,12.6986369,11,8.421903011,8.421803008,121,106.9466884,3,9,12,6,10,16,4,0.427539,0.443933,0,No
1472,townsend,11,12.6986369,11,8.421903011,8.421803008,121,106.9466884,7,8,15,9,8,17,4,0.400998,0.418615,0,No
1516,tore,11,12.6986369,11,8.421903011,8.421803008,121,106.9466884,7,8,15,9,9,18,4,0.416377,0.43391,0,No
2508,stormy,11,12.6986369,11,8.421903011,8.421803008,121,106.9466884,7,8,15,8,8,16,5,0.340664,0.347831,0,No
3419,shortage,11,12.6986369,11,8.421903011,8.421803008,121,106.9466884,6,5,11,9,11,20,5,0.392634,0.409706,0,No
4600,regulatory,11,12.6986369,11,8.421903011,8.421803008,121,106.9466884,8,5,13,9,5,14,5,0.329057,0.333473,0,No
5245,problematic,11,12.6986369,11,8.421903011,8.421803008,121,106.9466884,7,6,13,10,10,20,5,0.34912,0.358796,0,No
5480,pony,11,12.6986369,11,8.421903011,8.421803008,121,106.9466884,7,7,14,10,10,20,5,0.40157,0.419382,0,No
6072,peculiar,11,12.6986369,11,8.421903011,8.421803008,121,106.9466884,6,8,14,10,9,19,5,0.391164,0.408228,0,No
6128,patti,11,12.6986369,11,8.421903011,8.421803008,121,106.9466884,6,5,11,6,6,12,5,0.380727,0.396753,0,No
6962,niche,11,12.6986369,11,8.421903011,8.421803008,121,106.9466884,4,6,10,9,8,17,5,0.373257,0.388187,0,No
6990,newborn,11,12.6986369,11,8.421903011,8.421803008,121,106.9466884,7,5,12,9,5,14,4,0.389943,0.406738,0,No
7050,negotiate,11,12.6986369,11,8.421903011,8.421803008,121,106.9466884,2,6,8,8,10,18,4,0.398433,0.415986,0,No
7582,mineralogy,11,12.6986369,11,8.421903011,8.421803008,121,106.9466884,9,8,17,9,9,18,4,0.448088,0.461683,0,No
7732,mess,11,12.6986369,11,8.421903011,8.421803008,121,106.9466884,9,10,19,10,11,21,5,0.375127,0.390428,0,No
8001,mastery,11,12.6986369,11,8.421903011,8.421803008,121,106.9466884,7,6,13,9,11,20,5,0.411636,0.428982,0,No
9627,invite,11,12.6986369,11,8.421903011,8.421803008,121,106.9466884,6,9,15,10,10,20,4,0.417052,0.434534,0,No
9749,inspire,11,12.6986369,11,8.421903011,8.421803008,121,106.9466884,6,7,13,10,8,18,4,0.404139,0.421798,0,No
9793,inlet,11,12.6986369,11,8.421903011,8.421803008,121,106.9466884,5,8,13,8,11,19,5,0.398756,0.416239,0,No
10505,highlight,11,12.6986369,11,8.421903011,8.421803008,121,106.9466884,5,6,11,9,10,19,4,0.426984,0.443496,0,No
11145,grassy,11,12.6986369,11,8.421903011,8.421803008,121,106.9466884,6,6,12,9,6,15,5,0.385012,0.40135,0,No
11586,galloway,11,12.6986369,11,8.421903011,8.421803008,121,106.9466884,3,11,14,10,11,21,4,0.405765,0.423258,0,No
11679,fulfill,11,12.6986369,11,8.421903011,8.421803008,121,106.9466884,4,9,13,11,11,22,4,0.405848,0.423596,0,No
11978,fluent,11,12.6986369,11,8.421903011,8.421803008,121,106.9466884,7,7,14,8,10,18,5,0.405691,0.423142,0,No
12075,fl,11,12.6986369,11,8.421903011,8.421803008,121,106.9466884,5,6,11,5,7,12,5,0.351442,0.361688,0,No
12431,exterior,11,12.6986369,11,8.421903011,8.421803008,121,106.9466884,6,8,14,11,8,19,4,0.414143,0.431394,0,No
12513,excuse,11,12.6986369,11,8.421903011,8.421803008,121,106.9466884,4,5,9,10,11,21,5,0.396537,0.413889,0,No
13033,educate,11,12.6986369,11,8.421903011,8.421803008,121,106.9466884,4,6,10,9,9,18,4,0.402544,0.420235,0,No
13704,descend,11,12.6986369,11,8.421903011,8.421803008,121,106.9466884,10,3,13,10,10,20,5,0.3664,0.380316,0,No
14205,crucial,11,12.6986369,11,8.421903011,8.421803008,121,106.9466884,7,8,15,10,9,19,4,0.435928,0.451374,0,No
14490,cope,11,12.6986369,11,8.421903011,8.421803008,121,106.9466884,4,5,9,9,10,19,4,0.427035,0.44351,0,No
14539,contributor,11,12.6986369,11,8.421903011,8.421803008,121,106.9466884,7,6,13,8,10,18,4,0.433279,0.448989,0,No
14747,comprise,11,12.6986369,11,8.421903011,8.421803008,121,106.9466884,3,4,7,3,10,13,4,0.418103,0.435483,0,No
15540,catastrophic,11,12.6986369,11,8.421903011,8.421803008,121,106.9466884,9,6,15,9,7,16,5,0.32731,0.330999,0,No
16643,besiege,11,12.6986369,11,8.421903011,8.421803008,121,106.9466884,3,5,8,5,8,13,4,0.422512,0.439238,0,No
16706,beneficial,11,12.6986369,11,8.421903011,8.421803008,121,106.9466884,6,7,13,7,10,17,5,0.369535,0.384041,0,No
16893,baseman,11,12.6986369,11,8.421903011,8.421803008,121,106.9466884,3,7,10,11,10,21,4,0.402828,0.420235,0,No
16957,barbarian,11,12.6986369,11,8.421903011,8.421803008,121,106.9466884,6,6,12,10,6,16,4,0.403102,0.420681,0,No
17811,ambitious,11,12.6986369,11,8.421903011,8.421803008,121,106.9466884,5,9,14,8,10,18,5,0.409283,0.426715,0,No
18351,abdicate,11,12.6986369,11,8.421903011,8.421803008,121,106.9466884,2,7,9,11,10,21,4,0.419894,0.436896,0,No
649,wa,10,12.6986369,10,8.421903011,8.421803008,100,106.9466884,2,4,6,3,4,7,5,0.348729,0.358427,0,No
3786,scranton,21,12.05200974,7,8.873888135,8.873828135,147,106.9481862,11,10,21,17,20,37,4,0.412095,0.429596,0,No
2219,swahili,17,12.26331883,8,8.740356743,8.740286741,136,107.1857815,6,8,14,15,14,29,4,0.427302,0.443679,0,No
2963,sonora,17,12.26331883,8,8.740356743,8.740286741,136,107.1857815,13,11,24,14,14,28,5,0.398389,0.41587,0,No
10688,hearth,17,12.26331883,8,8.740356743,8.740286741,136,107.1857815,6,9,15,15,14,29,4,0.416289,0.433511,0,No
11157,granville,17,12.26331883,8,8.740356743,8.740286741,136,107.1857815,10,4,14,14,16,30,4,0.390759,0.407963,0,No
13224,druid,17,12.26331883,8,8.740356743,8.740286741,136,107.1857815,9,9,18,10,10,20,4,0.412651,0.430149,0,No
13341,doppler,17,12.26331883,8,8.740356743,8.740286741,136,107.1857815,6,5,11,11,16,27,5,0.326942,0.331109,0,No
13363,donaldson,17,12.26331883,8,8.740356743,8.740286741,136,107.1857815,10,14,24,14,16,30,4,0.420271,0.437304,0,No
13744,denton,17,12.26331883,8,8.740356743,8.740286741,136,107.1857815,6,9,15,11,12,23,4,0.396821,0.41423,0,No
2200,swaziland,20,12.1007999,7,8.873888135,8.873828135,140,107.3811447,9,11,20,18,16,34,4,0.436239,0.451683,0,No
17598,antimony,20,12.1007999,7,8.873888135,8.873828135,140,107.3811447,13,10,23,17,16,33,5,0.379701,0.395693,0,No
1565,tolstoy,14,12.45747485,9,8.622573707,8.622493705,126,107.4154951,7,8,15,13,8,21,4,0.384371,0.401175,0,No
2242,sus,14,12.45747485,9,8.622573707,8.622493705,126,107.4154951,6,4,10,14,8,22,4,0.390398,0.407662,0,No
6265,paragraph,14,12.45747485,9,8.622573707,8.622493705,126,107.4154951,8,9,17,13,11,24,5,0.397381,0.414791,0,No
7919,mccormick,14,12.45747485,9,8.622573707,8.622493705,126,107.4154951,6,7,13,8,10,18,4,0.391863,0.408841,0,No
9142,kingsley,14,12.45747485,9,8.622573707,8.622493705,126,107.4154951,9,6,15,10,7,17,5,0.366264,0.379959,0,No
12282,fayette,14,12.45747485,9,8.622573707,8.622493705,126,107.4154951,8,5,13,13,12,25,4,0.391707,0.408634,0,No
12321,fargo,14,12.45747485,9,8.622573707,8.622493705,126,107.4154951,7,8,15,8,11,19,4,0.404029,0.421474,0,No
15550,catalina,14,12.45747485,9,8.622573707,8.622493705,126,107.4154951,7,5,12,11,14,25,5,0.364557,0.378027,0,No
15834,caine,14,12.45747485,9,8.622573707,8.622493705,126,107.4154951,5,8,13,13,12,25,4,0.396263,0.413498,0,No
15918,burroughs,14,12.45747485,9,8.622573707,8.622493705,126,107.4154951,7,11,18,13,12,25,5,0.390063,0.406909,0,No
17858,alpert,14,12.45747485,9,8.622573707,8.622493705,126,107.4154951,2,7,9,13,11,24,4,0.423116,0.43983,0,No
302,windward,12,12.61162553,10,8.517213191,8.517123189,120,107.4159033,2,2,4,11,3,14,5,0.319067,0.322469,0,No
1880,tennyson,12,12.61162553,10,8.517213191,8.517123189,120,107.4159033,5,10,15,11,12,23,4,0.420899,0.438083,0,No
2010,tapestry,12,12.61162553,10,8.517213191,8.517123189,120,107.4159033,6,9,15,7,12,19,4,0.438719,0.453782,0,No
2319,sumter,12,12.61162553,10,8.517213191,8.517123189,120,107.4159033,5,5,10,11,11,22,5,0.385372,0.401735,0,No
2768,spotlight,12,12.61162553,10,8.517213191,8.517123189,120,107.4159033,4,5,9,5,6,11,4,0.406723,0.424277,0,No
3995,sane,12,12.61162553,10,8.517213191,8.517123189,120,107.4159033,6,8,14,9,10,19,5,0.399464,0.416823,0,No
4732,ratify,12,12.61162553,10,8.517213191,8.517123189,120,107.4159033,4,4,8,12,12,24,4,0.41626,0.433717,0,No
5411,posthumous,12,12.61162553,10,8.517213191,8.517123189,120,107.4159033,7,5,12,11,9,20,5,0.332142,0.336933,0,No
5484,pont,12,12.61162553,10,8.517213191,8.517123189,120,107.4159033,5,6,11,11,10,21,5,0.362621,0.375764,0,No
6133,patronage,12,12.61162553,10,8.517213191,8.517123189,120,107.4159033,4,4,8,10,11,21,4,0.421829,0.438736,0,No
6324,pamela,12,12.61162553,10,8.517213191,8.517123189,120,107.4159033,6,7,13,7,9,16,5,0.338411,0.345019,0,No
8181,mammoth,12,12.61162553,10,8.517213191,8.517123189,120,107.4159033,5,9,14,7,10,17,5,0.400275,0.417659,0,No
8701,librarian,12,12.61162553,10,8.517213191,8.517123189,120,107.4159033,6,7,13,11,10,21,4,0.415053,0.4323,0,No
9718,integrate,12,12.61162553,10,8.517213191,8.517123189,120,107.4159033,3,10,13,11,11,22,4,0.438026,0.453219,0,No
10353,honshu,12,12.61162553,10,8.517213191,8.517123189,120,107.4159033,5,7,12,10,12,22,4,0.414249,0.431516,0,No
10712,headmaster,12,12.61162553,10,8.517213191,8.517123189,120,107.4159033,7,7,14,12,10,22,5,0.390449,0.407486,0,No
12053,flap,12,12.61162553,10,8.517213191,8.517123189,120,107.4159033,5,5,10,11,8,19,4,0.421479,0.438445,0,No
12638,ethan,12,12.61162553,10,8.517213191,8.517123189,120,107.4159033,7,7,14,10,9,19,5,0.38674,0.403284,0,No
12648,estrogen,12,12.61162553,10,8.517213191,8.517123189,120,107.4159033,6,5,11,6,9,15,4,0.429515,0.445627,0,No
13608,diaphragm,12,12.61162553,10,8.517213191,8.517123189,120,107.4159033,4,8,12,12,9,21,4,0.421099,0.438116,0,No
14303,cranium,12,12.61162553,10,8.517213191,8.517123189,120,107.4159033,4,8,12,11,11,22,4,0.438968,0.453989,0,No
14872,colombo,12,12.61162553,10,8.517213191,8.517123189,120,107.4159033,8,9,17,9,11,20,4,0.420053,0.437154,0,No
15077,classroom,12,12.61162553,10,8.517213191,8.517123189,120,107.4159033,5,9,14,8,9,17,4,0.423288,0.440032,0,No
15532,caterpillar,12,12.61162553,10,8.517213191,8.517123189,120,107.4159033,6,7,13,12,10,22,4,0.435362,0.450857,0,No
16563,bing,12,12.61162553,10,8.517213191,8.517123189,120,107.4159033,8,6,14,8,12,20,5,0.391405,0.408441,0,No
17005,ballot,12,12.61162553,10,8.517213191,8.517123189,120,107.4159033,6,9,15,8,11,19,4,0.404121,0.421587,0,No
5685,placebo,24,11.91847835,6,9.028038815,9.027988815,144,107.6004851,12,11,23,19,22,41,4,0.395636,0.413118,0,No
123,yamaha,16,12.32394346,8,8.740356743,8.740286741,128,107.7156623,8,10,18,11,12,23,4,0.395213,0.412625,0,No
1207,tungsten,16,12.32394346,8,8.740356743,8.740286741,128,107.7156623,10,9,19,13,13,26,4,0.417317,0.434581,0,No
4745,rapture,16,12.32394346,8,8.740356743,8.740286741,128,107.7156623,3,12,15,14,13,27,4,0.430432,0.446599,0,No
7011,neural,16,12.32394346,8,8.740356743,8.740286741,128,107.7156623,12,5,17,16,9,25,5,0.323793,0.327304,0,No
9154,kimono,16,12.32394346,8,8.740356743,8.740286741,128,107.7156623,11,12,23,15,14,29,4,0.418458,0.435661,0,No
11547,garner,16,12.32394346,8,8.740356743,8.740286741,128,107.7156623,9,11,20,10,12,22,4,0.397933,0.41531,0,No
14552,contraception,16,12.32394346,8,8.740356743,8.740286741,128,107.7156623,5,11,16,9,14,23,4,0.433808,0.449679,0,No
15140,circadian,16,12.32394346,8,8.740356743,8.740286741,128,107.7156623,8,1,9,11,7,18,5,0.313329,0.317654,0,No
16128,bridgeport,16,12.32394346,8,8.740356743,8.740286741,128,107.7156623,11,9,20,12,14,26,4,0.404259,0.421709,0,No
5641,platypus,19,12.1520932,7,8.873888135,8.873828135,133,107.8363156,7,9,16,15,14,29,4,0.428344,0.444637,0,No
5997,peoria,19,12.1520932,7,8.873888135,8.873828135,133,107.8363156,8,7,15,17,17,34,4,0.409028,0.426563,0,No
9221,kelp,19,12.1520932,7,8.873888135,8.873828135,133,107.8363156,11,9,20,13,12,25,4,0.400845,0.418277,0,No
12634,ether,19,12.1520932,7,8.873888135,8.873828135,133,107.8363156,14,15,29,15,17,32,4,0.442746,0.457312,0,No
13236,drone,19,12.1520932,7,8.873888135,8.873828135,133,107.8363156,12,12,24,18,14,32,4,0.43292,0.448904,0,No
13514,dipole,19,12.1520932,7,8.873888135,8.873828135,133,107.8363156,6,7,13,18,19,37,4,0.406816,0.424413,0,No
11764,freeport,23,11.96103796,6,9.028038815,9.027988815,138,107.984715,11,14,25,18,20,38,5,0.369866,0.384222,0,No
167,wrestle,13,12.53158282,9,8.622573707,8.622493705,117,108.0544965,6,7,13,11,13,24,5,0.381906,0.398087,0,No
1485,touchdown,13,12.53158282,9,8.622573707,8.622493705,117,108.0544965,6,7,13,12,9,21,4,0.397817,0.415113,0,No
1889,tenant,13,12.53158282,9,8.622573707,8.622493705,117,108.0544965,4,4,8,12,7,19,5,0.383275,0.399604,0,No
3202,skunk,13,12.53158282,9,8.622573707,8.622493705,117,108.0544965,7,7,14,10,10,20,4,0.393671,0.410747,0,No
4855,quixote,13,12.53158282,9,8.622573707,8.622493705,117,108.0544965,2,10,12,13,11,24,4,0.379952,0.395907,0,No
6100,paz,13,12.53158282,9,8.622573707,8.622493705,117,108.0544965,3,8,11,10,9,19,4,0.390974,0.407893,0,No
6735,obese,13,12.53158282,9,8.622573707,8.622493705,117,108.0544965,6,9,15,7,11,18,4,0.404886,0.422324,0,No
7098,nawab,13,12.53158282,9,8.622573707,8.622493705,117,108.0544965,7,7,14,10,8,18,5,0.38198,0.398227,0,No
9296,jure,13,12.53158282,9,8.622573707,8.622493705,117,108.0544965,2,6,8,13,10,23,5,0.351686,0.36214,0,No
10516,hidalgo,13,12.53158282,9,8.622573707,8.622493705,117,108.0544965,7,7,14,9,9,18,4,0.394204,0.411606,0,No
10741,havilland,13,12.53158282,9,8.622573707,8.622493705,117,108.0544965,1,11,12,13,12,25,5,0.391336,0.408345,0,No
10753,hatteras,13,12.53158282,9,8.622573707,8.622493705,117,108.0544965,2,6,8,13,12,25,4,0.406946,0.424544,0,No
12960,electrolyte,13,12.53158282,9,8.622573707,8.622493705,117,108.0544965,7,10,17,13,11,24,4,0.448031,0.461664,0,No
13335,doria,13,12.53158282,9,8.622573707,8.622493705,117,108.0544965,2,5,7,12,7,19,5,0.386892,0.403425,0,No
13756,denial,13,12.53158282,9,8.622573707,8.622493705,117,108.0544965,9,4,13,10,11,21,4,0.427477,0.4439,0,No
14621,conservatism,13,12.53158282,9,8.622573707,8.622493705,117,108.0544965,9,8,17,11,9,20,4,0.410551,0.427976,0,No
15870,byrne,13,12.53158282,9,8.622573707,8.622493705,117,108.0544965,10,12,22,12,13,25,4,0.368232,0.38242,0,No
16621,betsy,13,12.53158282,9,8.622573707,8.622493705,117,108.0544965,7,8,15,9,9,18,5,0.35626,0.367786,0,No
17407,armageddon,13,12.53158282,9,8.622573707,8.622493705,117,108.0544965,8,7,15,10,10,20,4,0.43039,0.446416,0,No
17593,antique,13,12.53158282,9,8.622573707,8.622493705,117,108.0544965,8,4,12,10,6,16,5,0.3463,0.355389,0,No
18068,aftermath,13,12.53158282,9,8.622573707,8.622493705,117,108.0544965,3,4,7,12,10,22,5,0.383292,0.399568,0,No
3643,sen,11,12.6986369,11,8.517213191,8.517123189,121,108.1569978,7,4,11,7,9,16,5,0.33062,0.335793,0,No
146,wyatt,11,12.6986369,10,8.517213191,8.517123189,110,108.1569978,5,6,11,8,8,16,5,0.387492,0.404087,0,No
833,vertex,11,12.6986369,10,8.517213191,8.517123189,110,108.1569978,7,6,13,9,8,17,4,0.417553,0.434661,0,No
1708,threaten,11,12.6986369,10,8.517213191,8.517123189,110,108.1569978,7,7,14,11,11,22,4,0.414211,0.4316,0,No
2236,suspect,11,12.6986369,10,8.517213191,8.517123189,110,108.1569978,7,10,17,10,11,21,4,0.404683,0.422169,0,No
3064,snowfall,11,12.6986369,10,8.517213191,8.517123189,110,108.1569978,4,6,10,8,10,18,5,0.390063,0.407101,0,No
3351,sidewalk,11,12.6986369,10,8.517213191,8.517123189,110,108.1569978,4,9,13,10,10,20,5,0.39014,0.407218,0,No
3734,seamen,11,12.6986369,10,8.517213191,8.517123189,110,108.1569978,4,8,12,7,8,15,4,0.416163,0.433454,0,No
4668,recruit,11,12.6986369,10,8.517213191,8.517123189,110,108.1569978,7,5,12,11,6,17,4,0.399662,0.417324,0,No
4918,quantitative,11,12.6986369,10,8.517213191,8.517123189,110,108.1569978,8,7,15,9,8,17,5,0.384795,0.40113,0,No
6422,outermost,11,12.6986369,10,8.517213191,8.517123189,110,108.1569978,2,4,6,11,5,16,5,0.326113,0.329733,0,No
6822,notebook,11,12.6986369,10,8.517213191,8.517123189,110,108.1569978,7,9,16,8,9,17,4,0.429017,0.445332,0,No
7426,monogamous,11,12.6986369,10,8.517213191,8.517123189,110,108.1569978,5,4,9,11,9,20,4,0.424158,0.440745,0,No
8392,luminous,11,12.6986369,10,8.517213191,8.517123189,110,108.1569978,7,3,10,7,3,10,5,0.335589,0.341849,0,No
8842,lean,11,12.6986369,10,8.517213191,8.517123189,110,108.1569978,7,11,18,10,11,21,4,0.409594,0.427173,0,No
9019,lac,11,12.6986369,10,8.517213191,8.517123189,110,108.1569978,6,7,13,8,8,16,5,0.371251,0.385943,0,No
9645,invasive,11,12.6986369,10,8.517213191,8.517123189,110,108.1569978,4,2,6,9,8,17,5,0.325796,0.329629,0,No
9776,inquiry,11,12.6986369,10,8.517213191,8.517123189,110,108.1569978,4,8,12,9,10,19,5,0.383316,0.39958,0,No
10814,hardcover,11,12.6986369,10,8.517213191,8.517123189,110,108.1569978,5,5,10,6,8,14,5,0.365315,0.378956,0,No
10848,handy,11,12.6986369,10,8.517213191,8.517123189,110,108.1569978,8,5,13,9,7,16,4,0.388586,0.405226,0,No
10849,handwritten,11,12.6986369,10,8.517213191,8.517123189,110,108.1569978,9,6,15,10,7,17,5,0.33627,0.342235,0,No
10980,gunman,11,12.6986369,10,8.517213191,8.517123189,110,108.1569978,6,4,10,10,5,15,5,0.35636,0.367575,0,No
11353,gladiator,11,12.6986369,10,8.517213191,8.517123189,110,108.1569978,8,8,16,9,9,18,4,0.389823,0.406625,0,No
12297,fatima,11,12.6986369,10,8.517213191,8.517123189,110,108.1569978,5,4,9,7,4,11,5,0.341339,0.348798,0,No
12807,enhance,11,12.6986369,10,8.517213191,8.517123189,110,108.1569978,6,7,13,11,10,21,4,0.403579,0.421357,0,No
12882,embryonic,11,12.6986369,10,8.517213191,8.517123189,110,108.1569978,6,4,10,9,7,16,5,0.332734,0.338545,0,No
13961,dauphin,11,12.6986369,10,8.517213191,8.517123189,110,108.1569978,9,8,17,11,11,22,4,0.419894,0.437041,0,No
14631,conscience,11,12.6986369,10,8.517213191,8.517123189,110,108.1569978,7,10,17,10,11,21,4,0.412689,0.430084,0,No
15824,calcareous,11,12.6986369,10,8.517213191,8.517123189,110,108.1569978,7,4,11,11,4,15,5,0.34572,0.354426,0,No
16417,blur,11,12.6986369,10,8.517213191,8.517123189,110,108.1569978,7,9,16,8,10,18,4,0.425296,0.441872,0,No
17737,analyst,11,12.6986369,10,8.517213191,8.517123189,110,108.1569978,4,6,10,8,11,19,5,0.393026,0.410195,0,No
18040,agricola,11,12.6986369,10,8.517213191,8.517123189,110,108.1569978,4,8,12,6,9,15,5,0.341641,0.349094,0,No
18278,accelerate,11,12.6986369,10,8.517213191,8.517123189,110,108.1569978,4,8,12,8,10,18,4,0.420411,0.437496,0,No
2123,synoptic,15,12.38848198,8,8.740356743,8.740286741,120,108.279752,6,6,12,12,8,20,5,0.347181,0.356488,0,No
3923,savonarola,15,12.38848198,8,8.740356743,8.740286741,120,108.279752,5,8,13,5,11,16,5,0.353352,0.364122,0,No
4989,purgatory,15,12.38848198,8,8.740356743,8.740286741,120,108.279752,7,9,16,13,13,26,4,0.433893,0.449594,0,No
6017,pennant,15,12.38848198,8,8.740356743,8.740286741,120,108.279752,6,5,11,14,12,26,4,0.400176,0.417793,0,No
6439,othello,15,12.38848198,8,8.740356743,8.740286741,120,108.279752,6,9,15,11,13,24,4,0.434105,0.449876,0,No
7008,neuron,15,12.38848198,8,8.740356743,8.740286741,120,108.279752,11,10,21,15,13,28,4,0.438806,0.45389,0,No
7746,mermaid,15,12.38848198,8,8.740356743,8.740286741,120,108.279752,7,12,19,15,15,30,4,0.404029,0.421544,0,No
15051,clemens,15,12.38848198,8,8.740356743,8.740286741,120,108.279752,8,10,18,11,10,21,5,0.388595,0.405355,0,No
15131,circumcision,15,12.38848198,8,8.740356743,8.740286741,120,108.279752,8,9,17,9,12,21,5,0.38616,0.402871,0,No
15322,checkpoint,15,12.38848198,8,8.740356743,8.740286741,120,108.279752,9,7,16,12,14,26,5,0.37376,0.388989,0,No
16236,boycott,15,12.38848198,8,8.740356743,8.740286741,120,108.279752,8,8,16,12,11,23,4,0.428509,0.444862,0,No
16395,boca,15,12.38848198,8,8.740356743,8.740286741,120,108.279752,8,2,10,12,2,14,5,0.315248,0.320172,0,No
16433,blowfish,15,12.38848198,8,8.740356743,8.740286741,120,108.279752,11,11,22,12,13,25,4,0.407722,0.425258,0,No
17489,aqueduct,15,12.38848198,8,8.740356743,8.740286741,120,108.279752,8,10,18,9,13,22,4,0.417121,0.434309,0,No
18100,aeschylus,15,12.38848198,8,8.740356743,8.740286741,120,108.279752,12,6,18,15,11,26,4,0.389285,0.406019,0,No
18253,accra,15,12.38848198,8,8.740356743,8.740286741,120,108.279752,10,11,21,14,14,28,5,0.360866,0.373572,0,No
1729,thoreau,18,12.20616042,7,8.873888135,8.873828135,126,108.3161021,8,12,20,15,12,27,4,0.431793,0.447862,0,No
6055,pegasus,18,12.20616042,7,8.873888135,8.873828135,126,108.3161021,12,13,25,14,16,30,4,0.376751,0.392368,0,No
861,verdict,12,12.61162553,9,8.622573707,8.622493705,108,108.7446707,4,8,12,10,11,21,4,0.438513,0.453613,0,No
1484,touchstone,12,12.61162553,9,8.622573707,8.622493705,108,108.7446707,7,2,9,9,2,11,5,0.381529,0.397634,0,No
2598,stein,12,12.61162553,9,8.622573707,8.622493705,108,108.7446707,5,9,14,7,9,16,5,0.352063,0.362666,0,No
2699,stagecoach,12,12.61162553,9,8.622573707,8.622493705,108,108.7446707,7,8,15,10,11,21,5,0.389892,0.407331,0,No
3524,shalom,12,12.61162553,9,8.622573707,8.622493705,108,108.7446707,8,8,16,10,8,18,5,0.384146,0.400566,0,No
3763,scrotum,12,12.61162553,9,8.622573707,8.622493705,108,108.7446707,2,9,11,12,12,24,4,0.439751,0.454688,0,No
4051,salivary,12,12.61162553,9,8.622573707,8.622493705,108,108.7446707,8,1,9,10,2,12,5,0.311143,0.315701,0,No
6306,pangaea,12,12.61162553,9,8.622573707,8.622493705,108,108.7446707,6,5,11,7,11,18,4,0.424016,0.440618,0,No
6513,orca,12,12.61162553,9,8.622573707,8.622493705,108,108.7446707,5,7,12,7,7,14,4,0.406053,0.423746,0,No
7816,mellon,12,12.61162553,9,8.622573707,8.622493705,108,108.7446707,7,5,12,12,7,19,5,0.338411,0.344962,0,No
8193,malt,12,12.61162553,9,8.622573707,8.622493705,108,108.7446707,7,9,16,10,9,19,5,0.396307,0.413561,0,No
8445,lounge,12,12.61162553,9,8.622573707,8.622493705,108,108.7446707,6,9,15,7,11,18,4,0.422593,0.439529,0,No
9009,lad,12,12.61162553,9,8.622573707,8.622493705,108,108.7446707,6,10,16,10,11,21,4,0.443753,0.45811,0,No
9859,infertile,12,12.61162553,9,8.622573707,8.622493705,108,108.7446707,10,6,16,11,7,18,5,0.366378,0.38018,0,No
11253,goldsmith,12,12.61162553,9,8.622573707,8.622493705,108,108.7446707,3,6,9,8,7,15,4,0.413131,0.43038,0,No
11911,footpath,12,12.61162553,9,8.622573707,8.622493705,108,108.7446707,7,7,14,10,7,17,4,0.40118,0.418563,0,No
12524,exclamation,12,12.61162553,9,8.622573707,8.622493705,108,108.7446707,4,4,8,11,9,20,5,0.349051,0.3585,0,No
14302,crank,12,12.61162553,9,8.622573707,8.622493705,108,108.7446707,10,7,17,11,11,22,4,0.421089,0.438121,0,No
15339,chastity,12,12.61162553,9,8.622573707,8.622493705,108,108.7446707,8,11,19,9,11,20,4,0.434839,0.450435,0,No
15938,burglary,12,12.61162553,9,8.622573707,8.622493705,108,108.7446707,9,6,15,11,10,21,4,0.426502,0.442909,0,No
17832,alva,12,12.61162553,9,8.622573707,8.622493705,108,108.7446707,5,5,10,10,7,17,4,0.405552,0.42314,0,No
604,wallpaper,21,12.05200974,6,9.028038815,9.027988815,126,108.8060117,10,11,21,13,18,31,4,0.365563,0.37919,0,No
1289,triton,21,12.05200974,6,9.028038815,9.027988815,126,108.8060117,13,12,25,15,18,33,4,0.41136,0.428858,0,No
4767,rancid,21,12.05200974,6,9.028038815,9.027988815,126,108.8060117,15,13,28,16,17,33,4,0.393557,0.41069,0,No
11211,gotham,21,12.05200974,6,9.028038815,9.027988815,126,108.8060117,11,4,15,20,14,34,5,0.360434,0.372858,0,No
11433,gerbil,21,12.05200974,6,9.028038815,9.027988815,126,108.8060117,7,11,18,19,19,38,4,0.428696,0.444984,0,No
609,wallaby,17,12.26331883,7,8.873888135,8.873828135,119,108.8233195,5,5,10,7,5,12,4,0.389986,0.40678,0,No
3792,scottsdale,17,12.26331883,7,8.873888135,8.873828135,119,108.8233195,14,7,21,16,13,29,5,0.354205,0.365422,0,No
5430,positron,17,12.26331883,7,8.873888135,8.873828135,119,108.8233195,3,12,15,15,14,29,4,0.400248,0.417953,0,No
5545,polio,17,12.26331883,7,8.873888135,8.873828135,119,108.8233195,11,10,21,16,13,29,5,0.388646,0.405538,0,No
7902,mcgraw,17,12.26331883,7,8.873888135,8.873828135,119,108.8233195,11,12,23,14,13,27,4,0.419041,0.436229,0,No
10768,hashish,17,12.26331883,7,8.873888135,8.873828135,119,108.8233195,9,10,19,16,15,31,4,0.408783,0.426262,0,No
11562,ganymede,17,12.26331883,7,8.873888135,8.873828135,119,108.8233195,12,7,19,16,16,32,4,0.392765,0.409775,0,No
71,yorktown,14,12.45747485,8,8.740356743,8.740286741,112,108.8827743,4,10,14,13,12,25,4,0.414288,0.43176,0,No
1015,ursa,14,12.45747485,8,8.740356743,8.740286741,112,108.8827743,6,2,8,7,14,21,5,0.326245,0.330095,0,No
1126,typhoid,14,12.45747485,8,8.740356743,8.740286741,112,108.8827743,8,5,13,10,11,21,4,0.391086,0.407958,0,No
2366,sud,14,12.45747485,8,8.740356743,8.740286741,112,108.8827743,3,5,8,13,8,21,4,0.402599,0.42022,0,No
3093,smyrna,14,12.45747485,8,8.740356743,8.740286741,112,108.8827743,9,10,19,11,12,23,5,0.372482,0.38732,0,No
3228,skateboard,14,12.45747485,8,8.740356743,8.740286741,112,108.8827743,7,8,15,11,8,19,4,0.423379,0.440102,0,No
3433,shiver,14,12.45747485,8,8.740356743,8.740286741,112,108.8827743,6,11,17,6,11,17,4,0.428075,0.444426,0,No
4291,rockford,14,12.45747485,8,8.740356743,8.740286741,112,108.8827743,6,7,13,10,11,21,4,0.42071,0.437703,0,No
4914,quark,14,12.45747485,8,8.740356743,8.740286741,112,108.8827743,10,8,18,14,13,27,4,0.392166,0.409146,0,No
6252,paranormal,14,12.45747485,8,8.740356743,8.740286741,112,108.8827743,7,7,14,13,9,22,4,0.411303,0.428858,0,No
8070,marlborough,14,12.45747485,8,8.740356743,8.740286741,112,108.8827743,6,9,15,13,11,24,5,0.373839,0.389041,0,No
8320,machiavelli,14,12.45747485,8,8.740356743,8.740286741,112,108.8827743,6,8,14,7,9,16,4,0.374383,0.38957,0,No
9078,koch,14,12.45747485,8,8.740356743,8.740286741,112,108.8827743,6,10,16,11,10,21,4,0.40704,0.424596,0,No
11295,glyph,14,12.45747485,8,8.740356743,8.740286741,112,108.8827743,5,7,12,14,13,27,4,0.42071,0.437703,0,No
12735,epsom,14,12.45747485,8,8.740356743,8.740286741,112,108.8827743,5,8,13,9,11,20,4,0.422713,0.439482,0,No
13824,deimos,14,12.45747485,8,8.740356743,8.740286741,112,108.8827743,9,9,18,11,12,23,5,0.385933,0.402641,0,No
17645,anode,14,12.45747485,8,8.740356743,8.740286741,112,108.8827743,4,10,14,14,12,26,4,0.434914,0.450491,0,No
591,wander,10,12.79394708,10,8.517213191,8.517123189,100,108.9687749,4,7,11,9,9,18,4,0.437691,0.452871,0,No
789,videotape,10,12.79394708,10,8.517213191,8.517123189,100,108.9687749,5,6,11,8,6,14,5,0.395971,0.413143,0,No
856,verlag,10,12.79394708,10,8.517213191,8.517123189,100,108.9687749,1,4,5,1,4,5,5,0.376895,0.393531,0,No
2144,sympathetic,10,12.79394708,10,8.517213191,8.517123189,100,108.9687749,7,3,10,9,5,14,5,0.359448,0.371884,0,No
2272,suppress,10,12.79394708,10,8.517213191,8.517123189,100,108.9687749,2,7,9,9,8,17,4,0.422683,0.439759,0,No
2702,stafford,10,12.79394708,10,8.517213191,8.517123189,100,108.9687749,8,6,14,9,7,16,5,0.380131,0.396124,0,No
3567,setup,10,12.79394708,10,8.517213191,8.517123189,100,108.9687749,8,10,18,8,10,18,4,0.42063,0.437623,0,No
4537,repelled,10,12.79394708,10,8.517213191,8.517123189,100,108.9687749,5,2,7,9,9,18,5,0.405756,0.42333,0,No
4591,reinforce,10,12.79394708,10,8.517213191,8.517123189,100,108.9687749,3,6,9,9,8,17,4,0.422562,0.439304,0,No
5291,prevalent,10,12.79394708,10,8.517213191,8.517123189,100,108.9687749,8,6,14,10,8,18,5,0.362413,0.375377,0,No
5402,postwar,10,12.79394708,10,8.517213191,8.517123189,100,108.9687749,5,9,14,9,9,18,5,0.330319,0.334869,0,No
5440,portray,10,12.79394708,10,8.517213191,8.517123189,100,108.9687749,2,5,7,7,8,15,4,0.415053,0.432633,0,No
5595,plunder,10,12.79394708,10,8.517213191,8.517123189,100,108.9687749,5,7,12,8,10,18,4,0.423429,0.440107,0,No
6183,passionate,10,12.79394708,10,8.517213191,8.517123189,100,108.9687749,6,7,13,9,8,17,5,0.385523,0.401937,0,No
7324,motif,10,12.79394708,10,8.517213191,8.517123189,100,108.9687749,7,9,16,7,9,16,5,0.354835,0.365765,0,No
7764,mercer,10,12.79394708,10,8.517213191,8.517123189,100,108.9687749,6,6,12,9,9,18,5,0.355262,0.366267,0,No
8343,lyre,10,12.79394708,10,8.517213191,8.517123189,100,108.9687749,4,7,11,9,9,18,4,0.418192,0.435238,0,No
8504,lois,10,12.79394708,10,8.517213191,8.517123189,100,108.9687749,7,4,11,9,5,14,5,0.38447,0.400721,0,No
8831,leathery,10,12.79394708,10,8.517213191,8.517123189,100,108.9687749,6,7,13,10,9,19,5,0.384979,0.401336,0,No
9499,jacobus,10,12.79394708,10,8.517213191,8.517123189,100,108.9687749,6,5,11,6,7,13,5,0.36597,0.379888,0,No
9798,injure,10,12.79394708,10,8.517213191,8.517123189,100,108.9687749,7,5,12,10,8,18,4,0.422221,0.439299,0,No
10059,immense,10,12.79394708,10,8.517213191,8.517123189,100,108.9687749,6,6,12,9,6,15,5,0.362199,0.375219,0,No
10094,ignore,10,12.79394708,10,8.517213191,8.517123189,100,108.9687749,7,7,14,8,9,17,4,0.40356,0.421216,0,No
11260,goldberg,10,12.79394708,10,8.517213191,8.517123189,100,108.9687749,2,6,8,2,6,8,5,0.36446,0.377928,0,No
11536,gascony,10,12.79394708,10,8.517213191,8.517123189,100,108.9687749,3,8,11,10,10,20,4,0.414443,0.431844,0,No
12031,fleeing,10,12.79394708,10,8.517213191,8.517123189,100,108.9687749,6,7,13,6,10,16,4,0.430755,0.446942,0,No
12441,expressive,10,12.79394708,10,8.517213191,8.517123189,100,108.9687749,7,6,13,9,6,15,5,0.337183,0.343502,0,No
12457,explicit,10,12.79394708,10,8.517213191,8.517123189,100,108.9687749,8,8,16,8,10,18,4,0.413844,0.431267,0,No
12523,exclude,10,12.79394708,10,8.517213191,8.517123189,100,108.9687749,5,7,12,9,8,17,4,0.40207,0.419742,0,No
12586,evaluate,10,12.79394708,10,8.517213191,8.517123189,100,108.9687749,5,8,13,10,9,19,4,0.429038,0.445261,0,No
12879,emerge,10,12.79394708,10,8.517213191,8.517123189,100,108.9687749,5,7,12,6,9,15,5,0.377673,0.39332,0,No
12886,embrace,10,12.79394708,10,8.517213191,8.517123189,100,108.9687749,6,7,13,9,10,19,4,0.415743,0.433304,0,No
13115,eager,10,12.79394708,10,8.517213191,8.517123189,100,108.9687749,6,2,8,10,9,19,5,0.359252,0.371635,0,No
14735,concave,10,12.79394708,10,8.517213191,8.517123189,100,108.9687749,7,7,14,9,9,18,4,0.407441,0.425159,0,No
14789,compelled,10,12.79394708,10,8.517213191,8.517123189,100,108.9687749,5,3,8,8,10,18,5,0.370283,0.384743,0,No
15032,climax,10,12.79394708,10,8.517213191,8.517123189,100,108.9687749,6,5,11,9,8,17,5,0.401434,0.418957,0,No
15104,claimant,10,12.79394708,10,8.517213191,8.517123189,100,108.9687749,7,3,10,8,10,18,5,0.378688,0.394505,0,No
15490,cease,10,12.79394708,10,8.517213191,8.517123189,100,108.9687749,8,3,11,10,6,16,5,0.365563,0.379325,0,No
15589,cartilaginous,10,12.79394708,10,8.517213191,8.517123189,100,108.9687749,4,3,7,6,7,13,5,0.384429,0.400655,0,No
16051,brownish,10,12.79394708,10,8.517213191,8.517123189,100,108.9687749,8,4,12,10,5,15,5,0.395901,0.41304,0,No
16251,bovine,10,12.79394708,10,8.517213191,8.517123189,100,108.9687749,3,6,9,8,7,15,5,0.35689,0.368898,0,No
17063,backstage,10,12.79394708,10,8.517213191,8.517123189,100,108.9687749,4,6,10,6,6,12,5,0.37292,0.387865,0,No
17235,attendant,10,12.79394708,10,8.517213191,8.517123189,100,108.9687749,3,7,10,7,7,14,4,0.401243,0.418648,0,No
17354,arturo,10,12.79394708,10,8.517213191,8.517123189,100,108.9687749,5,2,7,5,2,7,5,0.327963,0.33196,0,No
17423,arise,10,12.79394708,10,8.517213191,8.517123189,100,108.9687749,5,5,10,6,10,16,5,0.345727,0.354529,0,No
17453,archival,10,12.79394708,10,8.517213191,8.517123189,100,108.9687749,8,3,11,8,4,12,5,0.324213,0.32761,0,No
17743,analgesic,10,12.79394708,10,8.517213191,8.517123189,100,108.9687749,4,7,11,7,8,15,4,0.41671,0.434192,0,No
18091,affiliate,10,12.79394708,10,8.517213191,8.517123189,100,108.9687749,6,4,10,7,9,16,5,0.389541,0.406399,0,No
18120,advertise,10,12.79394708,10,8.517213191,8.517123189,100,108.9687749,2,5,7,9,9,18,4,0.42208,0.438914,0,No
18178,aden,10,12.79394708,10,8.517213191,8.517123189,100,108.9687749,3,6,9,8,8,16,5,0.399249,0.416546,0,No
18327,abolish,10,12.79394708,10,8.517213191,8.517123189,100,108.9687749,5,5,10,10,9,19,5,0.414172,0.431935,0,No
7508,mo,9,12.79394708,9,8.517213191,8.517123189,81,108.9687749,5,3,8,5,3,8,5,0.389618,0.406474,0,No
4847,quotient,20,12.1007999,6,9.028038815,9.027988815,120,109.2464912,4,13,17,16,19,35,4,0.42217,0.439144,0,No
2238,sushi,16,12.32394346,7,8.873888135,8.873828135,112,109.3612956,7,8,15,13,10,23,4,0.437572,0.452782,0,No
2801,spitz,16,12.32394346,7,8.873888135,8.873828135,112,109.3612956,10,9,19,10,12,22,4,0.393121,0.410193,0,No
2992,somali,16,12.32394346,7,8.873888135,8.873828135,112,109.3612956,6,10,16,15,13,28,4,0.426471,0.442966,0,No
9173,khrushchev,16,12.32394346,7,8.873888135,8.873828135,112,109.3612956,5,11,16,5,12,17,4,0.416319,0.43367,0,No
11217,gorton,16,12.32394346,7,8.873888135,8.873828135,112,109.3612956,9,11,20,13,12,25,5,0.387416,0.404233,0,No
1120,typography,11,12.6986369,9,8.622573707,8.622493705,99,109.4949327,7,5,12,9,9,18,4,0.412843,0.430088,0,No
1244,truthful,11,12.6986369,9,8.622573707,8.622493705,99,109.4949327,5,7,12,9,8,17,5,0.390922,0.407824,0,No
1568,tolerant,11,12.6986369,9,8.622573707,8.622493705,99,109.4949327,8,5,13,9,8,17,4,0.419507,0.436506,0,No
1851,terre,11,12.6986369,9,8.622573707,8.622493705,99,109.4949327,4,3,7,8,3,11,5,0.384304,0.400515,0,No
2449,strive,11,12.6986369,9,8.622573707,8.622493705,99,109.4949327,5,3,8,8,11,19,5,0.368087,0.382295,0,No
2969,songbird,11,12.6986369,9,8.622573707,8.622493705,99,109.4949327,5,10,15,6,11,17,5,0.390046,0.407068,0,No
5733,pinnacle,11,12.6986369,9,8.622573707,8.622493705,99,109.4949327,6,6,12,10,11,21,4,0.421879,0.43882,0,No
5896,pesticide,11,12.6986369,9,8.622573707,8.622493705,99,109.4949327,4,10,14,8,10,18,4,0.429245,0.445463,0,No
5941,permian,11,12.6986369,9,8.622573707,8.622493705,99,109.4949327,3,5,8,9,9,18,4,0.421529,0.438346,0,No
6257,parameter,11,12.6986369,9,8.622573707,8.622493705,99,109.4949327,6,7,13,7,8,15,4,0.41669,0.433961,0,No
6799,novo,11,12.6986369,9,8.622573707,8.622493705,99,109.4949327,2,5,7,4,6,10,5,0.342307,0.349964,0,No
7402,montevideo,11,12.6986369,9,8.622573707,8.622493705,99,109.4949327,8,5,13,10,11,21,4,0.4076,0.425079,0,No
7804,melvin,11,12.6986369,9,8.622573707,8.622493705,99,109.4949327,9,7,16,9,7,16,5,0.36314,0.376208,0,No
8307,macro,11,12.6986369,9,8.622573707,8.622493705,99,109.4949327,5,7,12,7,7,14,4,0.422713,0.439464,0,No
8759,leonid,11,12.6986369,9,8.622573707,8.622493705,99,109.4949327,9,1,10,10,1,11,6,0.258825,0.262519,0,No
9394,johanna,11,12.6986369,9,8.622573707,8.622493705,99,109.4949327,7,2,9,8,2,10,5,0.311722,0.316448,0,No
9527,ito,11,12.6986369,9,8.622573707,8.622493705,99,109.4949327,2,10,12,3,10,13,4,0.42822,0.444538,0,No
9740,instinct,11,12.6986369,9,8.622573707,8.622493705,99,109.4949327,8,7,15,9,9,18,4,0.430411,0.446468,0,No
9768,insectivorous,11,12.6986369,9,8.622573707,8.622493705,99,109.4949327,6,6,12,7,6,13,5,0.340097,0.347994,0,No
10492,hillside,11,12.6986369,9,8.622573707,8.622493705,99,109.4949327,4,7,11,9,9,18,4,0.429785,0.4459,0,No
11000,guise,11,12.6986369,9,8.622573707,8.622493705,99,109.4949327,3,5,8,9,5,14,4,0.408698,0.426089,0,No
11143,grateful,11,12.6986369,9,8.622573707,8.622493705,99,109.4949327,6,4,10,11,11,22,4,0.395292,0.412423,0,No
11276,goddard,11,12.6986369,9,8.622573707,8.622493705,99,109.4949327,6,5,11,8,8,16,5,0.348216,0.357707,0,No
11355,glad,11,12.6986369,9,8.622573707,8.622493705,99,109.4949327,9,7,16,10,11,21,5,0.368255,0.382433,0,No
11363,giuliano,11,12.6986369,9,8.622573707,8.622493705,99,109.4949327,3,7,10,5,9,14,5,0.387797,0.404453,0,No
11947,foil,11,12.6986369,9,8.622573707,8.622493705,99,109.4949327,7,7,14,9,9,18,4,0.418557,0.435722,0,No
12596,euripides,11,12.6986369,9,8.622573707,8.622493705,99,109.4949327,6,8,14,10,9,19,4,0.425174,0.441726,0,No
12679,erupt,11,12.6986369,9,8.622573707,8.622493705,99,109.4949327,6,8,14,8,9,17,5,0.368286,0.38248,0,No
13221,drummond,11,12.6986369,9,8.622573707,8.622493705,99,109.4949327,6,6,12,8,7,15,4,0.390544,0.407385,0,No
13367,domino,11,12.6986369,9,8.622573707,8.622493705,99,109.4949327,8,10,18,8,10,18,4,0.423985,0.440698,0,No
14057,czar,11,12.6986369,9,8.622573707,8.622493705,99,109.4949327,8,7,15,8,11,19,5,0.405292,0.422748,0,No
14649,coniferous,11,12.6986369,9,8.622573707,8.622493705,99,109.4949327,5,3,8,8,5,13,5,0.324284,0.327646,0,No
15315,cheerleader,11,12.6986369,9,8.622573707,8.622493705,99,109.4949327,4,8,12,9,8,17,4,0.433025,0.44881,0,No
16439,bloomfield,11,12.6986369,9,8.622573707,8.622493705,99,109.4949327,6,6,12,7,7,14,5,0.349443,0.359431,0,No
16512,blackboard,11,12.6986369,9,8.622573707,8.622493705,99,109.4949327,5,8,13,10,11,21,4,0.400935,0.418563,0,No
17175,authoritarian,11,12.6986369,9,8.622573707,8.622493705,99,109.4949327,8,3,11,10,4,14,5,0.356267,0.368104,0,No
17933,algiers,11,12.6986369,9,8.622573707,8.622493705,99,109.4949327,6,9,15,9,10,19,5,0.374028,0.389168,0,No
18057,agenda,11,12.6986369,9,8.622573707,8.622493705,99,109.4949327,7,9,16,9,11,20,4,0.422401,0.439248,0,No
18194,adair,11,12.6986369,9,8.622573707,8.622493705,99,109.4949327,8,4,12,9,9,18,5,0.351609,0.362201,0,No
894,vendetta,13,12.53158282,8,8.740356743,8.740286741,104,109.5305044,3,8,11,12,11,23,4,0.395539,0.412728,0,No
1999,taro,13,12.53158282,8,8.740356743,8.740286741,104,109.5305044,6,6,12,8,6,14,4,0.38254,0.398851,0,No
5681,placid,13,12.53158282,8,8.740356743,8.740286741,104,109.5305044,3,7,10,13,11,24,4,0.423328,0.440036,0,No
6558,opaque,13,12.53158282,8,8.740356743,8.740286741,104,109.5305044,7,8,15,9,10,19,4,0.392548,0.409573,0,No
6688,oceanography,13,12.53158282,8,8.740356743,8.740286741,104,109.5305044,5,8,13,6,8,14,4,0.410049,0.427718,0,No
9380,joliet,13,12.53158282,8,8.740356743,8.740286741,104,109.5305044,9,7,16,12,13,25,4,0.396617,0.413831,0,No
10285,hove,13,12.53158282,8,8.740356743,8.740286741,104,109.5305044,4,6,10,12,6,18,4,0.43311,0.448834,0,No
11199,governess,13,12.53158282,8,8.740356743,8.740286741,104,109.5305044,5,11,16,13,12,25,4,0.402408,0.420014,0,No
11243,gonzalez,13,12.53158282,8,8.740356743,8.740286741,104,109.5305044,12,7,19,12,7,19,5,0.332914,0.337936,0,No
11381,gillespie,13,12.53158282,8,8.740356743,8.740286741,104,109.5305044,5,8,13,8,8,16,5,0.355183,0.366498,0,No
11628,gable,13,12.53158282,8,8.740356743,8.740286741,104,109.5305044,7,10,17,12,10,22,5,0.387365,0.404026,0,No
12216,ferrer,13,12.53158282,8,8.740356743,8.740286741,104,109.5305044,3,8,11,5,11,16,5,0.346199,0.354939,0,No
13471,disposable,13,12.53158282,8,8.740356743,8.740286741,104,109.5305044,11,9,20,13,9,22,5,0.339888,0.346822,0,No
15349,charlottesville,13,12.53158282,8,8.740356743,8.740286741,104,109.5305044,4,6,10,11,11,22,4,0.391863,0.408827,0,No
15445,cerberus,13,12.53158282,8,8.740356743,8.740286741,104,109.5305044,8,8,16,11,11,22,4,0.409037,0.42653,0,No
16322,boomerang,13,12.53158282,8,8.740356743,8.740286741,104,109.5305044,10,8,18,11,12,23,4,0.391543,0.408512,0,No
16327,bookstore,13,12.53158282,8,8.740356743,8.740286741,104,109.5305044,7,8,15,11,13,24,4,0.436335,0.451815,0,No
9687,interpol,19,12.1520932,6,9.028038815,9.027988815,114,109.7095691,11,9,20,15,16,31,4,0.427148,0.443567,0,No
11344,glans,19,12.1520932,6,9.028038815,9.027988815,114,109.7095691,3,8,11,17,17,34,5,0.37136,0.386069,0,No
17899,allele,19,12.1520932,6,9.028038815,9.027988815,114,109.7095691,11,8,19,16,15,31,5,0.404434,0.422016,0,No
3065,snowball,15,12.38848198,7,8.873888135,8.873828135,105,109.9340032,11,9,20,14,13,27,5,0.349898,0.359929,0,No
5566,pogrom,15,12.38848198,7,8.873888135,8.873828135,105,109.9340032,5,8,13,10,11,21,5,0.379481,0.395247,0,No
5923,persephone,15,12.38848198,7,8.873888135,8.873828135,105,109.9340032,10,12,22,11,15,26,4,0.413218,0.430722,0,No
7106,nautilus,15,12.38848198,7,8.873888135,8.873828135,105,109.9340032,6,8,14,10,11,21,4,0.42346,0.440379,0,No
7143,nap,15,12.38848198,7,8.873888135,8.873828135,105,109.9340032,10,10,20,15,13,28,4,0.410276,0.427741,0,No
8305,macroscopic,15,12.38848198,7,8.873888135,8.873828135,105,109.9340032,8,9,17,12,10,22,5,0.368225,0.382621,0,No
10913,haines,15,12.38848198,7,8.873888135,8.873828135,105,109.9340032,7,9,16,9,14,23,4,0.413824,0.431098,0,No
17486,aquila,15,12.38848198,7,8.873888135,8.873828135,105,109.9340032,7,6,13,9,9,18,4,0.410998,0.428441,0,No
5032,pulley,18,12.20616042,6,9.028038815,9.027988815,108,110.19769,8,10,18,12,17,29,4,0.427879,0.444252,0,No
17718,andersen,18,12.20616042,6,9.028038815,9.027988815,108,110.19769,6,8,14,12,11,23,4,0.404176,0.421751,0,No
21,zion,12,12.61162553,8,8.740356743,8.740286741,96,110.2301062,7,8,15,9,12,21,5,0.37432,0.389299,0,No
469,welch,12,12.61162553,8,8.740356743,8.740286741,96,110.2301062,6,9,15,7,11,18,4,0.393723,0.41085,0,No
1592,toast,12,12.61162553,8,8.740356743,8.740286741,96,110.2301062,10,9,19,11,10,21,4,0.435789,0.451242,0,No
2052,tallahassee,12,12.61162553,8,8.740356743,8.740286741,96,110.2301062,5,6,11,8,10,18,4,0.37624,0.391668,0,No
2063,takeover,12,12.61162553,8,8.740356743,8.740286741,96,110.2301062,4,6,10,6,12,18,5,0.389054,0.405929,0,No
2622,stave,12,12.61162553,8,8.740356743,8.740286741,96,110.2301062,6,9,15,12,11,23,5,0.383258,0.399679,0,No
5195,proletariat,12,12.61162553,8,8.740356743,8.740286741,96,110.2301062,3,10,13,9,11,20,4,0.419586,0.436731,0,No
5281,priestley,12,12.61162553,8,8.740356743,8.740286741,96,110.2301062,7,8,15,11,9,20,5,0.387873,0.404481,0,No
5500,polytope,12,12.61162553,8,8.740356743,8.740286741,96,110.2301062,5,6,11,12,10,22,4,0.426491,0.442919,0,No
5637,playback,12,12.61162553,8,8.740356743,8.740286741,96,110.2301062,8,8,16,9,9,18,5,0.38477,0.401313,0,No
5952,periphery,12,12.61162553,8,8.740356743,8.740286741,96,110.2301062,4,7,11,10,10,20,4,0.41057,0.427957,0,No
6516,orb,12,12.61162553,8,8.740356743,8.740286741,96,110.2301062,3,8,11,11,9,20,4,0.440013,0.454904,0,No
6746,oakley,12,12.61162553,8,8.740356743,8.740286741,96,110.2301062,8,9,17,9,11,20,4,0.392244,0.409282,0,No
7239,mural,12,12.61162553,8,8.740356743,8.740286741,96,110.2301062,6,9,15,12,11,23,4,0.430421,0.446519,0,No
8105,mardi,12,12.61162553,8,8.740356743,8.740286741,96,110.2301062,9,1,10,10,1,11,5,0.360829,0.373487,0,No
8530,lockout,12,12.61162553,8,8.740356743,8.740286741,96,110.2301062,3,8,11,6,8,14,4,0.450888,0.463979,0,No
8682,lifeboat,12,12.61162553,8,8.740356743,8.740286741,96,110.2301062,5,10,15,8,11,19,4,0.433374,0.449144,0,No
8997,lagrange,12,12.61162553,8,8.740356743,8.740286741,96,110.2301062,11,5,16,11,7,18,5,0.351359,0.361467,0,No
9057,krebs,12,12.61162553,8,8.740356743,8.740286741,96,110.2301062,4,6,10,8,11,19,5,0.354029,0.36496,0,No
9905,indochina,12,12.61162553,8,8.740356743,8.740286741,96,110.2301062,6,9,15,10,11,21,4,0.430275,0.446369,0,No
10412,holloway,12,12.61162553,8,8.740356743,8.740286741,96,110.2301062,7,7,14,7,8,15,5,0.34996,0.359678,0,No
10623,hemingway,12,12.61162553,8,8.740356743,8.740286741,96,110.2301062,3,9,12,9,10,19,4,0.428758,0.445022,0,No
11108,greet,12,12.61162553,8,8.740356743,8.740286741,96,110.2301062,5,6,11,12,11,23,4,0.435789,0.451205,0,No
11232,goofy,12,12.61162553,8,8.740356743,8.740286741,96,110.2301062,8,9,17,10,11,21,4,0.426553,0.443013,0,No
15209,choreography,12,12.61162553,8,8.740356743,8.740286741,96,110.2301062,5,6,11,7,11,18,4,0.425163,0.441773,0,No
15772,camellia,12,12.61162553,8,8.740356743,8.740286741,96,110.2301062,9,4,13,10,4,14,5,0.350547,0.360495,0,No
16337,boo,12,12.61162553,8,8.740356743,8.740286741,96,110.2301062,6,5,11,10,7,17,4,0.405107,0.422704,0,No
17136,avian,12,12.61162553,8,8.740356743,8.740286741,96,110.2301062,9,4,13,11,10,21,5,0.32157,0.324979,0,No
17258,atkins,12,12.61162553,8,8.740356743,8.740286741,96,110.2301062,7,9,16,8,11,19,4,0.394774,0.411963,0,No
18214,acropolis,12,12.61162553,8,8.740356743,8.740286741,96,110.2301062,4,6,10,12,9,21,4,0.427436,0.443881,0,No
182,wotan,10,12.79394708,9,8.622573707,8.622493705,90,110.3167517,8,7,15,9,10,19,4,0.436346,0.451773,0,No
737,virtuous,10,12.79394708,9,8.622573707,8.622493705,90,110.3167517,8,8,16,10,9,19,5,0.363118,0.376391,0,No
805,vicar,10,12.79394708,9,8.622573707,8.622493705,90,110.3167517,5,5,10,9,10,19,5,0.411207,0.428546,0,No
941,vanguard,10,12.79394708,9,8.622573707,8.622493705,90,110.3167517,7,6,13,9,7,16,5,0.398738,0.416551,0,No
1394,transmitting,10,12.79394708,9,8.622573707,8.622493705,90,110.3167517,8,6,14,10,7,17,4,0.418163,0.435389,0,No
2815,spinoff,10,12.79394708,9,8.622573707,8.622493705,90,110.3167517,3,4,7,7,9,16,5,0.379952,0.395906,0,No
2917,southward,10,12.79394708,9,8.622573707,8.622493705,90,110.3167517,2,6,8,2,6,8,4,0.396555,0.41377,0,No
3224,skeletal,10,12.79394708,9,8.622573707,8.622493705,90,110.3167517,7,3,10,9,8,17,5,0.326107,0.329877,0,No
3746,seabed,10,12.79394708,9,8.622573707,8.622493705,90,110.3167517,4,5,9,10,6,16,5,0.385791,0.402186,0,No
3795,scotsman,10,12.79394708,9,8.622573707,8.622493705,90,110.3167517,5,8,13,7,9,16,4,0.400618,0.417995,0,No
3884,scarf,10,12.79394708,9,8.622573707,8.622493705,90,110.3167517,6,5,11,10,5,15,4,0.394283,0.411376,0,No
4025,sammy,10,12.79394708,9,8.622573707,8.622493705,90,110.3167517,8,2,10,9,7,16,5,0.384304,0.400496,0,No
4185,rubbish,10,12.79394708,9,8.622573707,8.622493705,90,110.3167517,9,6,15,9,6,15,4,0.400077,0.41746,0,No
4528,replicate,10,12.79394708,9,8.622573707,8.622493705,90,110.3167517,3,6,9,7,9,16,4,0.430025,0.446106,0,No
4682,recife,10,12.79394708,9,8.622573707,8.622493705,90,110.3167517,9,7,16,10,8,18,4,0.421199,0.438309,0,No
4940,quad,10,12.79394708,9,8.622573707,8.622493705,90,110.3167517,3,2,5,10,2,12,5,0.327927,0.331772,0,No
5071,psycho,10,12.79394708,9,8.622573707,8.622493705,90,110.3167517,7,4,11,7,8,15,4,0.389832,0.406597,0,No
5346,precinct,10,12.79394708,9,8.622573707,8.622493705,90,110.3167517,6,4,10,9,5,14,5,0.38931,0.40615,0,No
5448,portfolio,10,12.79394708,9,8.622573707,8.622493705,90,110.3167517,9,4,13,9,4,13,5,0.34676,0.355737,0,No
5638,playa,10,12.79394708,9,8.622573707,8.622493705,90,110.3167517,5,5,10,7,7,14,5,0.387992,0.404636,0,No
5839,philology,10,12.79394708,9,8.622573707,8.622493705,90,110.3167517,6,8,14,7,9,16,4,0.413902,0.431328,0,No
6170,pasture,10,12.79394708,9,8.622573707,8.622493705,90,110.3167517,7,9,16,8,9,17,4,0.420072,0.437154,0,No
6773,numeric,10,12.79394708,9,8.622573707,8.622493705,90,110.3167517,7,2,9,9,2,11,5,0.357321,0.369482,0,No
7101,navigable,10,12.79394708,9,8.622573707,8.622493705,90,110.3167517,8,7,15,9,8,17,5,0.370221,0.384703,0,No
7611,millennia,10,12.79394708,9,8.622573707,8.622493705,90,110.3167517,7,7,14,10,7,17,4,0.436733,0.452144,0,No
8231,majestic,10,12.79394708,9,8.622573707,8.622493705,90,110.3167517,5,7,12,7,7,14,5,0.393889,0.410974,0,No
8596,liquor,10,12.79394708,9,8.622573707,8.622493705,90,110.3167517,7,6,13,9,6,15,5,0.369466,0.383818,0,No
8959,landmass,10,12.79394708,9,8.622573707,8.622493705,90,110.3167517,6,8,14,7,10,17,4,0.428634,0.44498,0,No
9432,jessie,10,12.79394708,9,8.622573707,8.622493705,90,110.3167517,6,5,11,6,7,13,5,0.33942,0.346065,0,No
9767,insecure,10,12.79394708,9,8.622573707,8.622493705,90,110.3167517,5,4,9,8,7,15,5,0.331114,0.335584,0,No
9880,inexpensive,10,12.79394708,9,8.622573707,8.622493705,90,110.3167517,8,8,16,10,8,18,4,0.397924,0.415254,0,No
10808,hardwood,10,12.79394708,9,8.622573707,8.622493705,90,110.3167517,7,7,14,9,8,17,4,0.425632,0.442163,0,No
11062,groin,10,12.79394708,9,8.622573707,8.622493705,90,110.3167517,4,7,11,10,10,20,4,0.400474,0.417878,0,No
11643,furthest,10,12.79394708,9,8.622573707,8.622493705,90,110.3167517,3,7,10,10,10,20,5,0.367044,0.381147,0,No
12465,expertise,10,12.79394708,9,8.622573707,8.622493705,90,110.3167517,5,10,15,6,10,16,4,0.439055,0.454115,0,No
13157,durable,10,12.79394708,9,8.622573707,8.622493705,90,110.3167517,7,6,13,9,8,17,5,0.385422,0.401796,0,No
13293,downstream,10,12.79394708,9,8.622573707,8.622493705,90,110.3167517,8,5,13,9,7,16,4,0.419953,0.437055,0,No
13442,divan,10,12.79394708,9,8.622573707,8.622493705,90,110.3167517,5,6,11,9,7,16,5,0.385347,0.401944,0,No
14241,criterion,10,12.79394708,9,8.622573707,8.622493705,90,110.3167517,7,7,14,7,8,15,5,0.398103,0.415504,0,No
14348,courtyard,10,12.79394708,9,8.622573707,8.622493705,90,110.3167517,6,7,13,8,9,17,4,0.436582,0.451909,0,No
16290,borrow,10,12.79394708,9,8.622573707,8.622493705,90,110.3167517,6,3,9,10,7,17,5,0.345249,0.35386,0,No
16295,borne,10,12.79394708,9,8.622573707,8.622493705,90,110.3167517,4,4,8,6,6,12,5,0.373454,0.388431,0,No
16422,bluish,10,12.79394708,9,8.622573707,8.622493705,90,110.3167517,7,8,15,8,8,16,5,0.357854,0.370143,0,No
16562,bingham,10,12.79394708,9,8.622573707,8.622493705,90,110.3167517,6,5,11,9,7,16,5,0.363765,0.377116,0,No
17156,autonomic,10,12.79394708,9,8.622573707,8.622493705,90,110.3167517,4,2,6,10,10,20,5,0.324628,0.328045,0,No
18147,adolph,10,12.79394708,9,8.622573707,8.622493705,90,110.3167517,5,6,11,8,7,15,5,0.405265,0.422692,0,No
735,visa,14,12.45747485,7,8.873888135,8.873828135,98,110.5462382,6,11,17,13,12,25,5,0.392904,0.410214,0,No
751,viper,14,12.45747485,7,8.873888135,8.873828135,98,110.5462382,4,4,8,14,12,26,5,0.373038,0.387957,0,No
4251,rook,14,12.45747485,7,8.873888135,8.873828135,98,110.5462382,5,12,17,11,13,24,4,0.43384,0.449613,0,No
4269,rollins,14,12.45747485,7,8.873888135,8.873828135,98,110.5462382,11,7,18,13,8,21,5,0.351575,0.361744,0,No
9396,jogging,14,12.45747485,7,8.873888135,8.873828135,98,110.5462382,9,6,15,10,9,19,4,0.397853,0.415141,0,No
10657,heine,14,12.45747485,7,8.873888135,8.873828135,98,110.5462382,8,7,15,13,8,21,5,0.366491,0.380215,0,No
11324,glitter,14,12.45747485,7,8.873888135,8.873828135,98,110.5462382,4,11,15,11,13,24,4,0.431824,0.447806,0,No
14852,comanche,14,12.45747485,7,8.873888135,8.873828135,98,110.5462382,9,10,19,13,12,25,4,0.373682,0.388776,0,No
15117,citric,14,12.45747485,7,8.873888135,8.873828135,98,110.5462382,10,1,11,10,14,24,5,0.318238,0.321893,0,No
16123,brie,14,12.45747485,7,8.873888135,8.873828135,98,110.5462382,9,8,17,10,13,23,4,0.419269,0.436262,0,No
17581,anvil,14,12.45747485,7,8.873888135,8.873828135,98,110.5462382,6,8,14,13,11,24,4,0.409935,0.427384,0,No
4786,rajah,22,12.00548972,5,9.210360372,9.210320372,110,110.5748868,9,7,16,10,10,20,4,0.397381,0.414958,0,No
6109,pawn,22,12.00548972,5,9.210360372,9.210320372,110,110.5748868,6,10,16,21,18,39,4,0.435362,0.451012,0,No
461,welles,17,12.26331883,6,9.028038815,9.027988815,102,110.7137184,3,11,14,4,11,15,4,0.416202,0.433534,0,No
8253,magpie,17,12.26331883,6,9.028038815,9.027988815,102,110.7137184,9,10,19,15,13,28,4,0.431373,0.447538,0,No
8797,lehigh,17,12.26331883,6,9.028038815,9.027988815,102,110.7137184,7,7,14,13,17,30,5,0.365857,0.379461,0,No
9982,incandescent,17,12.26331883,6,9.028038815,9.027988815,102,110.7137184,6,3,9,14,12,26,5,0.324521,0.327998,0,No
10136,icc,17,12.26331883,6,9.028038815,9.027988815,102,110.7137184,4,9,13,17,11,28,4,0.42553,0.442168,0,No
11684,fugue,17,12.26331883,6,9.028038815,9.027988815,102,110.7137184,6,14,20,17,15,32,5,0.38005,0.396153,0,No
15990,buick,17,12.26331883,6,9.028038815,9.027988815,102,110.7137184,13,6,19,13,10,23,5,0.378995,0.394797,0,No
1531,toothpaste,11,12.6986369,8,8.740356743,8.740286741,88,110.9906167,9,6,15,9,10,19,4,0.39112,0.408015,0,No
2322,summon,11,12.6986369,8,8.740356743,8.740286741,88,110.9906167,7,4,11,11,8,19,4,0.423056,0.439712,0,No
3377,shun,11,12.6986369,8,8.740356743,8.740286741,88,110.9906167,7,4,11,9,5,14,5,0.334136,0.339575,0,No
5746,pinball,11,12.6986369,8,8.740356743,8.740286741,88,110.9906167,3,5,8,3,6,9,5,0.348777,0.358431,0,No
6074,pectoral,11,12.6986369,8,8.740356743,8.740286741,88,110.9906167,6,2,8,11,3,14,5,0.384254,0.400439,0,No
6601,olivine,11,12.6986369,8,8.740356743,8.740286741,88,110.9906167,7,8,15,7,9,16,4,0.43235,0.448228,0,No
7792,menace,11,12.6986369,8,8.740356743,8.740286741,88,110.9906167,3,10,13,10,11,21,4,0.381144,0.397222,0,No
7827,melanesia,11,12.6986369,8,8.740356743,8.740286741,88,110.9906167,7,9,16,11,11,22,4,0.404434,0.421878,0,No
8256,magnum,11,12.6986369,8,8.740356743,8.740286741,88,110.9906167,8,7,15,8,9,17,5,0.352545,0.363232,0,No
8566,livermore,11,12.6986369,8,8.740356743,8.740286741,88,110.9906167,4,6,10,9,7,16,5,0.358592,0.370725,0,No
9285,jutland,11,12.6986369,8,8.740356743,8.740286741,88,110.9906167,8,8,16,10,9,19,4,0.426645,0.443074,0,No
9762,insight,11,12.6986369,8,8.740356743,8.740286741,88,110.9906167,9,8,17,11,9,20,4,0.424624,0.441388,0,No
10027,implicit,11,12.6986369,8,8.740356743,8.740286741,88,110.9906167,6,3,9,8,3,11,5,0.350422,0.360272,0,No
10162,hyphen,11,12.6986369,8,8.740356743,8.740286741,88,110.9906167,2,6,8,11,8,19,4,0.427859,0.444144,0,No
10229,hundredth,11,12.6986369,8,8.740356743,8.740286741,88,110.9906167,5,5,10,11,11,22,4,0.418084,0.435285,0,No
10379,homogeneous,11,12.6986369,8,8.740356743,8.740286741,88,110.9906167,5,10,15,9,11,20,4,0.396281,0.413864,0,No
12618,eucalyptus,11,12.6986369,8,8.740356743,8.740286741,88,110.9906167,5,5,10,7,6,13,5,0.353951,0.364908,0,No
13162,duodenum,11,12.6986369,8,8.740356743,8.740286741,88,110.9906167,3,7,10,11,10,21,4,0.429567,0.445698,0,No
13180,dump,11,12.6986369,8,8.740356743,8.740286741,88,110.9906167,7,6,13,10,7,17,5,0.38767,0.404265,0,No
13912,debra,11,12.6986369,8,8.740356743,8.740286741,88,110.9906167,7,5,12,10,5,15,5,0.347425,0.356819,0,No
14105,cushing,11,12.6986369,8,8.740356743,8.740286741,88,110.9906167,5,7,12,8,8,16,4,0.42062,0.437623,0,No
14748,compressor,11,12.6986369,8,8.740356743,8.740286741,88,110.9906167,3,8,11,8,10,18,4,0.394195,0.411634,0,No
16593,biennial,11,12.6986369,8,8.740356743,8.740286741,88,110.9906167,4,4,8,7,10,17,4,0.396122,0.413296,0,No
16632,bestselling,11,12.6986369,8,8.740356743,8.740286741,88,110.9906167,6,7,13,10,10,20,5,0.335532,0.341,0,No
17518,applause,11,12.6986369,8,8.740356743,8.740286741,88,110.9906167,5,6,11,8,8,16,4,0.391673,0.408611,0,No
17697,angelina,11,12.6986369,8,8.740356743,8.740286741,88,110.9906167,7,2,9,7,2,9,5,0.384312,0.400505,0,No
1832,testosterone,13,12.53158282,7,8.873888135,8.873828135,91,111.2038641,8,8,16,11,10,21,5,0.378446,0.394294,0,No
4229,rosetta,13,12.53158282,7,8.873888135,8.873828135,91,111.2038641,4,3,7,12,10,22,5,0.33091,0.335445,0,No
4804,rag,13,12.53158282,7,8.873888135,8.873828135,91,111.2038641,8,7,15,10,9,19,4,0.402417,0.419817,0,No
7481,modulus,13,12.53158282,7,8.873888135,8.873828135,91,111.2038641,6,8,14,13,13,26,5,0.397416,0.414899,0,No
8213,malden,13,12.53158282,7,8.873888135,8.873828135,91,111.2038641,11,9,20,11,12,23,4,0.41198,0.429394,0,No
9061,krakow,13,12.53158282,7,8.873888135,8.873828135,91,111.2038641,4,8,12,12,11,23,4,0.410418,0.427844,0,No
9270,kamikaze,13,12.53158282,7,8.873888135,8.873828135,91,111.2038641,8,6,14,11,6,17,5,0.364849,0.378215,0,No
9470,javelin,13,12.53158282,7,8.873888135,8.873828135,91,111.2038641,6,7,13,11,11,22,5,0.386884,0.403665,0,No
10205,hut,13,12.53158282,7,8.873888135,8.873828135,91,111.2038641,5,9,14,13,11,24,4,0.392886,0.410132,0,No
10279,howell,13,12.53158282,7,8.873888135,8.873828135,91,111.2038641,8,8,16,10,12,22,5,0.385958,0.402449,0,No
11595,gall,13,12.53158282,7,8.873888135,8.873828135,91,111.2038641,9,9,18,11,10,21,4,0.409368,0.426981,0,No
14859,colossus,13,12.53158282,7,8.873888135,8.873828135,91,111.2038641,3,4,7,13,12,25,5,0.386042,0.402643,0,No
16842,bayou,13,12.53158282,7,8.873888135,8.873828135,91,111.2038641,11,6,17,12,11,23,5,0.348791,0.358453,0,No
17107,axiom,13,12.53158282,7,8.873888135,8.873828135,91,111.2038641,6,6,12,12,13,25,4,0.435116,0.450608,0,No
17321,aspirin,13,12.53158282,7,8.873888135,8.873828135,91,111.2038641,10,7,17,10,9,19,5,0.379912,0.395883,0,No
386,whitehead,9,12.8993076,9,8.622573707,8.622493705,81,111.2252305,6,5,11,8,7,15,5,0.386051,0.402449,0,No
540,waterfowl,9,12.8993076,9,8.622573707,8.622493705,81,111.2252305,5,7,12,5,8,13,4,0.401643,0.419037,0,No
1135,tying,9,12.8993076,9,8.622573707,8.622493705,81,111.2252305,6,7,13,8,9,17,4,0.423359,0.440351,0,No
1494,tory,9,12.8993076,9,8.622573707,8.622493705,81,111.2252305,6,5,11,8,7,15,5,0.384554,0.400834,0,No
1869,tenure,9,12.8993076,9,8.622573707,8.622493705,81,111.2252305,6,6,12,9,7,16,4,0.383192,0.399452,0,No
1920,teleost,9,12.8993076,9,8.622573707,8.622493705,81,111.2252305,4,1,5,9,9,18,5,0.322499,0.325684,0,No
2225,suzanne,9,12.8993076,9,8.622573707,8.622493705,81,111.2252305,5,3,8,7,3,10,5,0.317885,0.321791,0,No
2231,suspicious,9,12.8993076,9,8.622573707,8.622493705,81,111.2252305,5,2,7,7,3,10,5,0.379481,0.395368,0,No
2232,suspicion,9,12.8993076,9,8.622573707,8.622493705,81,111.2252305,4,4,8,7,6,13,4,0.412852,0.430117,0,No
2239,susceptible,9,12.8993076,9,8.622573707,8.622493705,81,111.2252305,4,2,6,7,9,16,5,0.360083,0.372579,0,No
2252,surreal,9,12.8993076,9,8.622573707,8.622493705,81,111.2252305,5,6,11,8,8,16,5,0.384887,0.401223,0,No
2503,stout,9,12.8993076,9,8.622573707,8.622493705,81,111.2252305,7,6,13,7,8,15,5,0.397141,0.414392,0,No
2533,stockton,9,12.8993076,9,8.622573707,8.622493705,81,111.2252305,4,4,8,8,7,15,5,0.40508,0.422476,0,No
2568,steward,9,12.8993076,9,8.622573707,8.622493705,81,111.2252305,6,6,12,9,7,16,5,0.406304,0.42372,0,No
2582,stepson,9,12.8993076,9,8.622573707,8.622493705,81,111.2252305,6,7,13,9,7,16,4,0.409888,0.427295,0,No
2628,stature,9,12.8993076,9,8.622573707,8.622493705,81,111.2252305,5,5,10,9,7,16,5,0.407245,0.424659,0,No
3083,snare,9,12.8993076,9,8.622573707,8.622493705,81,111.2252305,5,4,9,7,9,16,5,0.329283,0.334817,0,No
3353,sidereal,9,12.8993076,9,8.622573707,8.622493705,81,111.2252305,3,6,9,7,9,16,5,0.334401,0.339704,0,No
3365,sibling,9,12.8993076,9,8.622573707,8.622493705,81,111.2252305,5,8,13,8,8,16,5,0.407797,0.425255,0,No
3415,shorten,9,12.8993076,9,8.622573707,8.622493705,81,111.2252305,4,4,8,5,5,10,4,0.413506,0.430896,0,No
3631,sensible,9,12.8993076,9,8.622573707,8.622493705,81,111.2252305,7,7,14,8,7,15,4,0.400664,0.418042,0,No
3668,seldom,9,12.8993076,9,8.622573707,8.622493705,81,111.2252305,7,3,10,8,3,11,5,0.349966,0.359602,0,No
3853,schloss,9,12.8993076,9,8.622573707,8.622493705,81,111.2252305,8,2,10,8,2,10,5,0.321227,0.325157,0,No
4552,rene,9,12.8993076,9,8.622573707,8.622493705,81,111.2252305,7,1,8,7,2,9,5,0.300773,0.306441,0,No
4768,rancho,9,12.8993076,9,8.622573707,8.622493705,81,111.2252305,6,4,10,7,5,12,5,0.33231,0.337077,0,No
4808,rae,9,12.8993076,9,8.622573707,8.622493705,81,111.2252305,5,8,13,6,8,14,5,0.410979,0.42863,0,No
4987,purify,9,12.8993076,9,8.622573707,8.622493705,81,111.2252305,3,8,11,8,9,17,4,0.403056,0.420742,0,No
5093,provision,9,12.8993076,9,8.622573707,8.622493705,81,111.2252305,5,5,10,7,9,16,4,0.389746,0.406616,0,No
5777,picturesque,9,12.8993076,9,8.622573707,8.622493705,81,111.2252305,5,6,11,7,7,14,5,0.385548,0.401951,0,No
5779,pictorial,9,12.8993076,9,8.622573707,8.622493705,81,111.2252305,5,8,13,7,8,15,5,0.332378,0.337213,0,No
6368,paddy,9,12.8993076,9,8.622573707,8.622493705,81,111.2252305,5,3,8,5,3,8,5,0.334086,0.33977,0,No
6395,oxen,9,12.8993076,9,8.622573707,8.622493705,81,111.2252305,5,5,10,6,7,13,4,0.440373,0.455139,0,No
6582,omnivore,9,12.8993076,9,8.622573707,8.622493705,81,111.2252305,5,8,13,9,8,17,4,0.404756,0.422244,0,No
6869,nonetheless,9,12.8993076,9,8.622573707,8.622493705,81,111.2252305,6,6,12,6,8,14,4,0.400881,0.418549,0,No
6979,newsletter,9,12.8993076,9,8.622573707,8.622493705,81,111.2252305,3,7,10,5,7,12,4,0.434201,0.449975,0,No
7151,namesake,9,12.8993076,9,8.622573707,8.622493705,81,111.2252305,3,4,7,8,9,17,5,0.386564,0.403235,0,No
7229,muscovy,9,12.8993076,9,8.622573707,8.622493705,81,111.2252305,4,3,7,9,3,12,5,0.384504,0.400735,0,No
7498,mock,9,12.8993076,9,8.622573707,8.622493705,81,111.2252305,5,5,10,7,5,12,5,0.326089,0.329719,0,No
7897,mcintyre,9,12.8993076,9,8.622573707,8.622493705,81,111.2252305,6,6,12,7,6,13,5,0.387441,0.404031,0,No
8284,maestro,9,12.8993076,9,8.622573707,8.622493705,81,111.2252305,6,3,9,9,3,12,5,0.361542,0.374379,0,No
8780,lend,9,12.8993076,9,8.622573707,8.622493705,81,111.2252305,5,8,13,8,9,17,4,0.432846,0.448815,0,No
9619,inward,9,12.8993076,9,8.622573707,8.622493705,81,111.2252305,3,6,9,3,7,10,4,0.43549,0.450928,0,No
9999,inability,9,12.8993076,9,8.622573707,8.622493705,81,111.2252305,8,1,9,8,9,17,5,0.359172,0.371523,0,No
10318,horsepower,9,12.8993076,9,8.622573707,8.622493705,81,111.2252305,8,6,14,8,8,16,4,0.425602,0.442092,0,No
10723,hazardous,9,12.8993076,9,8.622573707,8.622493705,81,111.2252305,4,1,5,6,2,8,5,0.359172,0.371523,0,No
10902,haley,9,12.8993076,9,8.622573707,8.622493705,81,111.2252305,4,6,10,5,7,12,5,0.385038,0.401392,0,No
10965,gustave,9,12.8993076,9,8.622573707,8.622493705,81,111.2252305,6,1,7,6,1,7,5,0.35519,0.366885,0,No
11149,grasp,9,12.8993076,9,8.622573707,8.622493705,81,111.2252305,4,5,9,8,7,15,4,0.419199,0.436346,0,No
11273,godfrey,9,12.8993076,9,8.622573707,8.622493705,81,111.2252305,7,6,13,8,8,16,5,0.411761,0.429109,0,No
11278,goblet,9,12.8993076,9,8.622573707,8.622493705,81,111.2252305,2,3,5,8,9,17,5,0.406201,0.423579,0,No
11865,formosa,9,12.8993076,9,8.622573707,8.622493705,81,111.2252305,2,5,7,3,6,9,4,0.41588,0.433384,0,No
11923,foolish,9,12.8993076,9,8.622573707,8.622493705,81,111.2252305,8,7,15,8,7,15,4,0.398836,0.416554,0,No
11957,foam,9,12.8993076,9,8.622573707,8.622493705,81,111.2252305,8,7,15,8,7,15,5,0.376799,0.392369,0,No
12217,ferreira,9,12.8993076,9,8.622573707,8.622493705,81,111.2252305,2,3,5,2,4,6,5,0.326864,0.330459,0,No
12439,expulsion,9,12.8993076,9,8.622573707,8.622493705,81,111.2252305,4,3,7,7,9,16,5,0.380091,0.396077,0,No
12446,expose,9,12.8993076,9,8.622573707,8.622493705,81,111.2252305,4,6,10,7,6,13,4,0.412411,0.429915,0,No
12579,evaporate,9,12.8993076,9,8.622573707,8.622493705,81,111.2252305,3,7,10,9,7,16,5,0.41368,0.431203,0,No
12601,euphoria,9,12.8993076,9,8.622573707,8.622493705,81,111.2252305,4,6,10,8,6,14,4,0.39014,0.40694,0,No
12747,epistemology,9,12.8993076,9,8.622573707,8.622493705,81,111.2252305,4,7,11,4,8,12,4,0.431069,0.447059,0,No
12809,englishman,9,12.8993076,9,8.622573707,8.622493705,81,111.2252305,6,6,12,7,7,14,5,0.36291,0.376076,0,No
13175,dunbar,9,12.8993076,9,8.622573707,8.622493705,81,111.2252305,3,8,11,7,8,15,4,0.41267,0.430131,0,No
13549,dilute,9,12.8993076,9,8.622573707,8.622493705,81,111.2252305,4,6,10,9,9,18,5,0.41715,0.434771,0,No
13842,deficit,9,12.8993076,9,8.622573707,8.622493705,81,111.2252305,8,8,16,9,8,17,5,0.384887,0.401479,0,No
14150,cultivate,9,12.8993076,9,8.622573707,8.622493705,81,111.2252305,3,6,9,8,8,16,4,0.429038,0.445224,0,No
14353,courtesy,9,12.8993076,9,8.622573707,8.622493705,81,111.2252305,7,5,12,9,7,16,5,0.38152,0.397659,0,No
14359,courageous,9,12.8993076,9,8.622573707,8.622493705,81,111.2252305,7,4,11,8,5,13,4,0.422582,0.439285,0,No
14445,corona,9,12.8993076,9,8.622573707,8.622493705,81,111.2252305,7,4,11,9,6,15,5,0.398935,0.416697,0,No
14679,configure,9,12.8993076,9,8.622573707,8.622493705,81,111.2252305,5,5,10,6,9,15,4,0.422754,0.439464,0,No
14752,compress,9,12.8993076,9,8.622573707,8.622493705,81,111.2252305,4,6,10,9,8,17,4,0.419289,0.436581,0,No
14796,compartment,9,12.8993076,9,8.622573707,8.622493705,81,111.2252305,8,8,16,8,9,17,4,0.412804,0.430276,0,No
14809,communal,9,12.8993076,9,8.622573707,8.622493705,81,111.2252305,4,5,9,8,5,13,5,0.326599,0.330294,0,No
15359,charisma,9,12.8993076,9,8.622573707,8.622493705,81,111.2252305,7,5,12,7,8,15,4,0.430108,0.446158,0,No
15370,chaplain,9,12.8993076,9,8.622573707,8.622493705,81,111.2252305,6,7,13,8,8,16,5,0.405867,0.423433,0,No
15433,certainty,9,12.8993076,9,8.622573707,8.622493705,81,111.2252305,5,8,13,9,8,17,4,0.436647,0.451993,0,No
15587,cartography,9,12.8993076,9,8.622573707,8.622493705,81,111.2252305,5,6,11,7,8,15,4,0.445479,0.459472,0,No
15901,bust,9,12.8993076,9,8.622573707,8.622493705,81,111.2252305,3,6,9,7,6,13,4,0.406946,0.424488,0,No
16305,borderline,9,12.8993076,9,8.622573707,8.622493705,81,111.2252305,6,2,8,8,2,10,4,0.412325,0.42953,0,No
16374,bois,9,12.8993076,9,8.622573707,8.622493705,81,111.2252305,5,6,11,6,7,13,4,0.405913,0.423535,0,No
16582,bilateral,9,12.8993076,9,8.622573707,8.622493705,81,111.2252305,8,2,10,9,3,12,5,0.323039,0.327641,0,No
16633,bestseller,9,12.8993076,9,8.622573707,8.622493705,81,111.2252305,3,4,7,3,6,9,5,0.356632,0.368606,0,No
17344,ascetic,9,12.8993076,9,8.622573707,8.622493705,81,111.2252305,5,5,10,7,5,12,5,0.405052,0.422476,0,No
17648,annulled,9,12.8993076,9,8.622573707,8.622493705,81,111.2252305,4,6,10,9,6,15,5,0.374557,0.389766,0,No
17688,anglo,9,12.8993076,9,8.622573707,8.622493705,81,111.2252305,5,3,8,7,6,13,5,0.323681,0.327165,0,No
17762,amphibian,9,12.8993076,9,8.622573707,8.622493705,81,111.2252305,6,7,13,8,7,15,5,0.384188,0.400654,0,No
17802,americana,9,12.8993076,9,8.622573707,8.622493705,81,111.2252305,4,6,10,4,7,11,5,0.355724,0.367147,0,No
18020,airfield,9,12.8993076,9,8.622573707,8.622493705,81,111.2252305,6,6,12,9,7,16,4,0.41517,0.432431,0,No
18054,aggregate,9,12.8993076,9,8.622573707,8.622493705,81,111.2252305,5,8,13,6,9,15,5,0.41157,0.42895,0,No
18254,accountant,9,12.8993076,9,8.622573707,8.622493705,81,111.2252305,2,5,7,7,9,16,5,0.388893,0.405603,0,No
18359,abandon,9,12.8993076,9,8.622573707,8.622493705,81,111.2252305,2,6,8,7,7,14,5,0.400881,0.418734,0,No
10870,hamster,16,12.32394346,6,9.028038815,9.027988815,96,111.2610399,6,10,16,9,12,21,4,0.439806,0.454754,0,No
12754,epiphany,16,12.32394346,6,9.028038815,9.027988815,96,111.2610399,9,10,19,11,10,21,5,0.375492,0.390891,0,No
13673,detention,16,12.32394346,6,9.028038815,9.027988815,96,111.2610399,12,12,24,13,12,25,4,0.38772,0.404419,0,No
15622,carmine,16,12.32394346,6,9.028038815,9.027988815,96,111.2610399,11,7,18,13,10,23,4,0.413304,0.43068,0,No
16740,bellamy,16,12.32394346,6,9.028038815,9.027988815,96,111.2610399,6,8,14,12,14,26,4,0.392261,0.409277,0,No
17460,archetype,16,12.32394346,6,9.028038815,9.027988815,96,111.2610399,7,9,16,14,14,28,4,0.448949,0.462396,0,No
15280,chianti,27,11.80069531,4,9.433503923,9.433473923,108,111.3219055,9,6,15,23,14,37,5,0.355639,0.366859,0,No
694,void,10,12.79394708,8,8.740356743,8.740286741,80,111.8236617,6,9,15,9,9,18,5,0.335526,0.34126,0,No
1039,upton,10,12.79394708,8,8.740356743,8.740286741,80,111.8236617,8,6,14,8,9,17,5,0.34996,0.359882,0,No
1367,traverse,10,12.79394708,8,8.740356743,8.740286741,80,111.8236617,6,5,11,8,7,15,5,0.357451,0.36888,0,No
2064,takeoff,10,12.79394708,8,8.740356743,8.740286741,80,111.8236617,6,5,11,6,10,16,4,0.43087,0.446848,0,No
2364,sudanese,10,12.79394708,8,8.740356743,8.740286741,80,111.8236617,3,7,10,7,7,14,5,0.335793,0.341425,0,No
2483,stratosphere,10,12.79394708,8,8.740356743,8.740286741,80,111.8236617,2,10,12,10,10,20,4,0.433015,0.448839,0,No
2683,stallion,10,12.79394708,8,8.740356743,8.740286741,80,111.8236617,9,6,15,10,7,17,5,0.405348,0.422786,0,No
3147,slit,10,12.79394708,8,8.740356743,8.740286741,80,111.8236617,5,8,13,7,10,17,4,0.416329,0.433539,0,No
3153,slime,10,12.79394708,8,8.740356743,8.740286741,80,111.8236617,7,4,11,7,5,12,5,0.354163,0.365185,0,No
3442,shipwreck,10,12.79394708,8,8.740356743,8.740286741,80,111.8236617,4,9,13,9,10,19,4,0.41518,0.432422,0,No
3469,shepard,10,12.79394708,8,8.740356743,8.740286741,80,111.8236617,7,8,15,9,8,17,5,0.391172,0.408092,0,No
3470,shenandoah,10,12.79394708,8,8.740356743,8.740286741,80,111.8236617,4,6,10,7,10,17,5,0.354616,0.365966,0,No
3825,schuster,10,12.79394708,8,8.740356743,8.740286741,80,111.8236617,2,6,8,8,6,14,5,0.358903,0.371053,0,No
3915,sawmill,10,12.79394708,8,8.740356743,8.740286741,80,111.8236617,5,8,13,9,8,17,4,0.427766,0.444111,0,No
4061,salerno,10,12.79394708,8,8.740356743,8.740286741,80,111.8236617,2,9,11,7,10,17,4,0.420769,0.437806,0,No
4218,roth,10,12.79394708,8,8.740356743,8.740286741,80,111.8236617,7,8,15,8,9,17,4,0.389131,0.406278,0,No
4310,roar,10,12.79394708,8,8.740356743,8.740286741,80,111.8236617,5,8,13,9,10,19,5,0.384554,0.401077,0,No
4335,risky,10,12.79394708,8,8.740356743,8.740286741,80,111.8236617,7,7,14,8,8,16,4,0.407068,0.424511,0,No
4527,repository,10,12.79394708,8,8.740356743,8.740286741,80,111.8236617,6,8,14,6,9,15,4,0.423046,0.439947,0,No
4722,ravine,10,12.79394708,8,8.740356743,8.740286741,80,111.8236617,5,8,13,6,10,16,5,0.381898,0.398185,0,No
4946,pythagorean,10,12.79394708,8,8.740356743,8.740286741,80,111.8236617,4,5,9,9,9,18,5,0.395724,0.412875,0,No
5134,prospect,10,12.79394708,8,8.740356743,8.740286741,80,111.8236617,6,6,12,7,6,13,5,0.385933,0.402563,0,No
5193,prologue,10,12.79394708,8,8.740356743,8.740286741,80,111.8236617,4,5,9,6,9,15,4,0.399815,0.417127,0,No
5242,procedural,10,12.79394708,8,8.740356743,8.740286741,80,111.8236617,4,7,11,8,8,16,4,0.405635,0.423258,0,No
5451,portage,10,12.79394708,8,8.740356743,8.740286741,80,111.8236617,5,5,10,8,10,18,5,0.349587,0.359521,0,No
6345,palazzo,10,12.79394708,8,8.740356743,8.740286741,80,111.8236617,3,3,6,5,3,8,5,0.311339,0.316186,0,No
6600,olsen,10,12.79394708,8,8.740356743,8.740286741,80,111.8236617,3,6,9,4,7,11,4,0.400023,0.417361,0,No
6616,oldenburg,10,12.79394708,8,8.740356743,8.740286741,80,111.8236617,5,7,12,9,7,16,5,0.374052,0.389135,0,No
6900,nj,10,12.79394708,8,8.740356743,8.740286741,80,111.8236617,5,6,11,6,6,12,5,0.385984,0.402425,0,No
6965,nibelung,10,12.79394708,8,8.740356743,8.740286741,80,111.8236617,3,6,9,10,8,18,4,0.412929,0.430342,0,No
7047,nehru,10,12.79394708,8,8.740356743,8.740286741,80,111.8236617,0,10,10,0,10,10,4,0.448623,0.462173,0,No
7501,mobster,10,12.79394708,8,8.740356743,8.740286741,80,111.8236617,5,7,12,8,8,16,5,0.351248,0.361587,0,No
7564,minos,10,12.79394708,8,8.740356743,8.740286741,80,111.8236617,4,5,9,9,10,19,5,0.405228,0.42264,0,No
7901,mcgregor,10,12.79394708,8,8.740356743,8.740286741,80,111.8236617,4,6,10,4,9,13,4,0.430192,0.446238,0,No
8163,mane,10,12.79394708,8,8.740356743,8.740286741,80,111.8236617,7,5,12,10,6,16,4,0.392209,0.409169,0,No
8632,lindsey,10,12.79394708,8,8.740356743,8.740286741,80,111.8236617,5,7,12,8,7,15,5,0.358461,0.370393,0,No
8772,lennox,10,12.79394708,8,8.740356743,8.740286741,80,111.8236617,7,5,12,10,8,18,5,0.384545,0.40082,0,No
8895,lattice,10,12.79394708,8,8.740356743,8.740286741,80,111.8236617,8,7,15,9,8,17,5,0.323669,0.32708,0,No
9753,insomniac,10,12.79394708,8,8.740356743,8.740286741,80,111.8236617,6,4,10,7,4,11,5,0.359456,0.371574,0,No
10231,hunchback,10,12.79394708,8,8.740356743,8.740286741,80,111.8236617,1,1,2,10,10,20,5,0.378607,0.394397,0,No
10471,hippocrates,10,12.79394708,8,8.740356743,8.740286741,80,111.8236617,5,7,12,7,8,15,4,0.415529,0.432868,0,No
10477,hinge,10,12.79394708,8,8.740356743,8.740286741,80,111.8236617,6,9,15,9,10,19,4,0.431195,0.447191,0,No
10796,harmon,10,12.79394708,8,8.740356743,8.740286741,80,111.8236617,8,5,13,8,8,16,5,0.384987,0.401308,0,No
11561,gao,10,12.79394708,8,8.740356743,8.740286741,80,111.8236617,6,4,10,6,4,10,5,0.363996,0.377398,0,No
11685,fugitive,10,12.79394708,8,8.740356743,8.740286741,80,111.8236617,2,5,7,8,9,17,5,0.346997,0.356069,0,No
11739,frick,10,12.79394708,8,8.740356743,8.740286741,80,111.8236617,7,8,15,9,9,18,4,0.40596,0.423544,0,No
11878,forgiven,10,12.79394708,8,8.740356743,8.740286741,80,111.8236617,4,9,13,10,10,20,4,0.421759,0.438675,0,No
12076,fjord,10,12.79394708,8,8.740356743,8.740286741,80,111.8236617,6,8,14,9,8,17,4,0.42553,0.442158,0,No
12100,fiscal,10,12.79394708,8,8.740356743,8.740286741,80,111.8236617,7,2,9,9,7,16,5,0.326858,0.330344,0,No
12331,fanny,10,12.79394708,8,8.740356743,8.740286741,80,111.8236617,8,6,14,9,8,17,5,0.327189,0.330843,0,No
12395,faa,10,12.79394708,8,8.740356743,8.740286741,80,111.8236617,1,6,7,6,8,14,4,0.39227,0.409254,0,No
12478,expectation,10,12.79394708,8,8.740356743,8.740286741,80,111.8236617,7,8,15,10,10,20,5,0.390699,0.407697,0,No
12501,exhaust,10,12.79394708,8,8.740356743,8.740286741,80,111.8236617,7,5,12,10,9,19,5,0.398353,0.416162,0,No
13399,doe,10,12.79394708,8,8.740356743,8.740286741,80,111.8236617,6,8,14,8,9,17,4,0.419269,0.436276,0,No
13426,dixie,10,12.79394708,8,8.740356743,8.740286741,80,111.8236617,8,4,12,8,5,13,5,0.330337,0.334621,0,No
13572,differentiate,10,12.79394708,8,8.740356743,8.740286741,80,111.8236617,5,5,10,10,9,19,4,0.418646,0.435745,0,No
13871,decode,10,12.79394708,8,8.740356743,8.740286741,80,111.8236617,6,6,12,9,9,18,4,0.422482,0.439229,0,No
14045,dade,10,12.79394708,8,8.740356743,8.740286741,80,111.8236617,8,6,14,9,10,19,5,0.353247,0.364009,0,No
14442,coroner,10,12.79394708,8,8.740356743,8.740286741,80,111.8236617,7,8,15,8,9,17,5,0.363363,0.37645,0,No
14779,compile,10,12.79394708,8,8.740356743,8.740286741,80,111.8236617,5,6,11,9,7,16,4,0.400691,0.418375,0,No
15375,chaotic,10,12.79394708,8,8.740356743,8.740286741,80,111.8236617,6,4,10,9,5,14,5,0.327232,0.331253,0,No
15783,calvert,10,12.79394708,8,8.740356743,8.740286741,80,111.8236617,7,6,13,9,8,17,5,0.338792,0.345504,0,No
16176,breadth,10,12.79394708,8,8.740356743,8.740286741,80,111.8236617,6,4,10,10,9,19,4,0.433628,0.44928,0,No
16368,bolivar,10,12.79394708,8,8.740356743,8.740286741,80,111.8236617,3,7,10,8,7,15,4,0.402709,0.420314,0,No
16525,bitten,10,12.79394708,8,8.740356743,8.740286741,80,111.8236617,7,4,11,9,10,19,5,0.353824,0.36433,0,No
17215,audible,10,12.79394708,8,8.740356743,8.740286741,80,111.8236617,3,6,9,9,6,15,5,0.358345,0.370526,0,No
17265,atheism,10,12.79394708,8,8.740356743,8.740286741,80,111.8236617,7,6,13,9,8,17,4,0.432624,0.448411,0,No
164,wrigley,15,12.38848198,6,9.028038815,9.027988815,90,111.8436961,9,11,20,12,15,27,5,0.352734,0.363495,0,No
1681,thule,15,12.38848198,6,9.028038815,9.027988815,90,111.8436961,6,9,15,10,13,23,5,0.373155,0.388177,0,No
2798,spleen,15,12.38848198,6,9.028038815,9.027988815,90,111.8436961,5,5,10,14,9,23,5,0.357782,0.369612,0,No
4027,samba,15,12.38848198,6,9.028038815,9.027988815,90,111.8436961,6,9,15,12,10,22,4,0.437637,0.452876,0,No
6519,orangutan,15,12.38848198,6,9.028038815,9.027988815,90,111.8436961,6,6,12,9,8,17,5,0.365616,0.379264,0,No
9459,jeep,15,12.38848198,6,9.028038815,9.027988815,90,111.8436961,9,10,19,13,11,24,4,0.374517,0.389757,0,No
14858,colt,15,12.38848198,6,9.028038815,9.027988815,90,111.8436961,9,7,16,12,10,22,4,0.42353,0.440238,0,No
16843,bayonne,15,12.38848198,6,9.028038815,9.027988815,90,111.8436961,8,9,17,12,14,26,4,0.434882,0.450468,0,No
799,vicious,12,12.61162553,7,8.873888135,8.873828135,84,111.9141541,6,10,16,6,11,17,4,0.443531,0.457918,0,No
1136,tycoon,12,12.61162553,7,8.873888135,8.873828135,84,111.9141541,5,10,15,11,11,22,4,0.42352,0.440365,0,No
1765,thesaurus,12,12.61162553,7,8.873888135,8.873828135,84,111.9141541,3,9,12,10,10,20,4,0.417288,0.434468,0,No
3514,shanty,12,12.61162553,7,8.873888135,8.873828135,84,111.9141541,7,3,10,11,4,15,5,0.414211,0.431898,0,No
4655,redemption,12,12.61162553,7,8.873888135,8.873828135,84,111.9141541,4,7,11,9,11,20,5,0.382779,0.399052,0,No
6153,pathology,12,12.61162553,7,8.873888135,8.873828135,84,111.9141541,5,9,14,10,11,21,4,0.438578,0.453674,0,No
7168,naacp,12,12.61162553,7,8.873888135,8.873828135,84,111.9141541,3,9,12,12,9,21,4,0.391491,0.408446,0,No
8926,lark,12,12.61162553,7,8.873888135,8.873828135,84,111.9141541,9,4,13,9,11,20,5,0.351846,0.362323,0,No
9733,instrumentation,12,12.61162553,7,8.873888135,8.873828135,84,111.9141541,10,6,16,11,6,17,5,0.377135,0.392815,0,No
10079,illiterate,12,12.61162553,7,8.873888135,8.873828135,84,111.9141541,5,9,14,5,9,14,4,0.396537,0.413817,0,No
10258,huggins,12,12.61162553,7,8.873888135,8.873828135,84,111.9141541,4,10,14,8,11,19,4,0.428168,0.444505,0,No
11407,ghetto,12,12.61162553,7,8.873888135,8.873828135,84,111.9141541,8,7,15,12,8,20,4,0.373587,0.388612,0,No
12691,erode,12,12.61162553,7,8.873888135,8.873828135,84,111.9141541,10,6,16,11,11,22,4,0.44423,0.45842,0,No
15058,clearance,12,12.61162553,7,8.873888135,8.873828135,84,111.9141541,3,6,9,3,9,12,4,0.428841,0.445036,0,No
15416,chadwick,12,12.61162553,7,8.873888135,8.873828135,84,111.9141541,7,8,15,11,9,20,5,0.397425,0.414702,0,No
16627,bethel,12,12.61162553,7,8.873888135,8.873828135,84,111.9141541,8,7,15,11,11,22,5,0.351888,0.362223,0,No
17664,annapolis,12,12.61162553,7,8.873888135,8.873828135,84,111.9141541,7,7,14,11,12,23,4,0.426902,0.443294,0,No
7219,musk,19,12.1520932,5,9.210360372,9.210320372,95,111.9251576,11,4,15,11,18,29,5,0.321035,0.324386,0,No
7966,maul,19,12.1520932,5,9.210360372,9.210320372,95,111.9251576,1,9,10,1,13,14,4,0.409869,0.427342,0,No
14243,criss,19,12.1520932,5,9.210360372,9.210320372,95,111.9251576,5,7,12,15,18,33,4,0.40197,0.419371,0,No
1290,tritium,18,12.20616042,5,9.210360372,9.210320372,90,112.4231362,15,9,24,16,17,33,4,0.40312,0.420521,0,No
4776,ramp,18,12.20616042,5,9.210360372,9.210320372,90,112.4231362,11,9,20,13,17,30,4,0.426594,0.443322,0,No
85,yin,14,12.45747485,6,9.028038815,9.027988815,84,112.4665665,3,7,10,3,9,12,5,0.389841,0.406768,0,No
135,xerxes,14,12.45747485,6,9.028038815,9.027988815,84,112.4665665,7,9,16,8,10,18,4,0.430891,0.446928,0,No
5543,polis,14,12.45747485,6,9.028038815,9.027988815,84,112.4665665,9,11,20,12,12,24,4,0.4235,0.440355,0,No
7176,mysore,14,12.45747485,6,9.028038815,9.027988815,84,112.4665665,7,8,15,11,11,22,4,0.40883,0.426295,0,No
10370,hondo,14,12.45747485,6,9.028038815,9.027988815,84,112.4665665,5,6,11,10,6,16,5,0.351484,0.361807,0,No
10500,hilbert,14,12.45747485,6,9.028038815,9.027988815,84,112.4665665,7,7,14,12,8,20,5,0.38723,0.403801,0,No
11763,freetown,14,12.45747485,6,9.028038815,9.027988815,84,112.4665665,8,10,18,11,12,23,4,0.412852,0.430243,0,No
16016,buckley,14,12.45747485,6,9.028038815,9.027988815,84,112.4665665,9,9,18,14,11,25,4,0.391975,0.408982,0,No
17130,avogadro,14,12.45747485,6,9.028038815,9.027988815,84,112.4665665,7,4,11,10,8,18,4,0.398702,0.416385,0,No
17749,anaconda,14,12.45747485,6,9.028038815,9.027988815,84,112.4665665,4,5,9,8,6,14,4,0.399455,0.416793,0,No
43,zaire,11,12.6986369,7,8.873888135,8.873828135,77,112.6862834,7,6,13,8,7,15,4,0.425082,0.441609,0,No
246,wolfe,11,12.6986369,7,8.873888135,8.873828135,77,112.6862834,6,7,13,11,7,18,5,0.366771,0.380644,0,No
2082,tactic,11,12.6986369,7,8.873888135,8.873828135,77,112.6862834,6,6,12,10,8,18,5,0.406518,0.423959,0,No
2775,spore,11,12.6986369,7,8.873888135,8.873828135,77,112.6862834,8,8,16,8,10,18,4,0.429401,0.445689,0,No
3464,sheridan,11,12.6986369,7,8.873888135,8.873828135,77,112.6862834,6,9,15,6,10,16,5,0.369412,0.383677,0,No
4729,rattle,11,12.6986369,7,8.873888135,8.873828135,77,112.6862834,7,5,12,10,8,18,4,0.424401,0.44097,0,No
5934,permutation,11,12.6986369,7,8.873888135,8.873828135,77,112.6862834,5,8,13,9,9,18,4,0.439175,0.454167,0,No
6175,pasteur,11,12.6986369,7,8.873888135,8.873828135,77,112.6862834,3,7,10,10,8,18,4,0.424513,0.441116,0,No
7157,nairobi,11,12.6986369,7,8.873888135,8.873828135,77,112.6862834,8,7,15,9,11,20,5,0.351526,0.361952,0,No
7273,muffin,11,12.6986369,7,8.873888135,8.873828135,77,112.6862834,9,8,17,11,9,20,5,0.368255,0.382316,0,No
7423,monologue,11,12.6986369,7,8.873888135,8.873828135,77,112.6862834,4,8,12,10,9,19,4,0.427076,0.443684,0,No
7497,mockingbird,11,12.6986369,7,8.873888135,8.873828135,77,112.6862834,2,8,10,10,11,21,4,0.429172,0.445379,0,No
7838,megabyte,11,12.6986369,7,8.873888135,8.873828135,77,112.6862834,4,6,10,8,7,15,4,0.42431,0.441064,0,No
8182,mammary,11,12.6986369,7,8.873888135,8.873828135,77,112.6862834,6,1,7,7,1,8,5,0.311143,0.315701,0,No
8310,mackintosh,11,12.6986369,7,8.873888135,8.873828135,77,112.6862834,5,7,12,8,8,16,5,0.371515,0.386343,0,No
10957,gwen,11,12.6986369,7,8.873888135,8.873828135,77,112.6862834,3,2,5,5,2,7,5,0.343506,0.35165,0,No
11028,guano,11,12.6986369,7,8.873888135,8.873828135,77,112.6862834,6,7,13,8,7,15,4,0.417248,0.43444,0,No
12103,firmware,11,12.6986369,7,8.873888135,8.873828135,77,112.6862834,5,7,12,7,11,18,4,0.412584,0.429929,0,No
13390,doherty,11,12.6986369,7,8.873888135,8.873828135,77,112.6862834,6,5,11,9,7,16,5,0.411627,0.429175,0,No
13522,dip,11,12.6986369,7,8.873888135,8.873828135,77,112.6862834,7,6,13,11,8,19,4,0.407657,0.425361,0,No
13528,diode,11,12.6986369,7,8.873888135,8.873828135,77,112.6862834,8,7,15,11,10,21,5,0.376344,0.391783,0,No
15544,catalytic,11,12.6986369,7,8.873888135,8.873828135,77,112.6862834,4,2,6,10,2,12,5,0.322927,0.326132,0,No
15695,capillary,11,12.6986369,7,8.873888135,8.873828135,77,112.6862834,6,4,10,8,4,12,4,0.389806,0.406569,0,No
16424,blueprint,11,12.6986369,7,8.873888135,8.873828135,77,112.6862834,5,7,12,11,10,21,4,0.434318,0.450026,0,No
17607,anti,11,12.6986369,7,8.873888135,8.873828135,77,112.6862834,7,7,14,7,8,15,5,0.334262,0.33956,0,No
17860,alp,11,12.6986369,7,8.873888135,8.873828135,77,112.6862834,6,5,11,9,7,16,4,0.415141,0.432445,0,No
48,yvette,9,12.8993076,8,8.740356743,8.740286741,72,112.7445502,5,2,7,6,2,8,5,0.336793,0.342929,0,No
76,yolk,9,12.8993076,8,8.740356743,8.740286741,72,112.7445502,5,7,12,9,8,17,4,0.437443,0.452669,0,No
102,yell,9,12.8993076,8,8.740356743,8.740286741,72,112.7445502,8,5,13,9,7,16,5,0.386017,0.40243,0,No
314,wilt,9,12.8993076,8,8.740356743,8.740286741,72,112.7445502,5,5,10,8,9,17,5,0.365902,0.379688,0,No
557,wasp,9,12.8993076,8,8.740356743,8.740286741,72,112.7445502,5,4,9,6,6,12,5,0.376607,0.393122,0,No
788,vie,9,12.8993076,8,8.740356743,8.740286741,72,112.7445502,2,5,7,8,7,15,5,0.32588,0.329332,0,No
1080,unify,9,12.8993076,8,8.740356743,8.740286741,72,112.7445502,3,3,6,8,9,17,4,0.410903,0.428366,0,No
1222,tuition,9,12.8993076,8,8.740356743,8.740286741,72,112.7445502,7,2,9,8,2,10,5,0.395557,0.412641,0,No
1381,transverse,9,12.8993076,8,8.740356743,8.740286741,72,112.7445502,6,4,10,8,5,13,5,0.326281,0.330705,0,No
1802,thee,9,12.8993076,8,8.740356743,8.740286741,72,112.7445502,7,7,14,9,7,16,5,0.336289,0.342423,0,No
2084,tacoma,9,12.8993076,8,8.740356743,8.740286741,72,112.7445502,6,6,12,8,8,16,4,0.408332,0.425901,0,No
2186,sweetheart,9,12.8993076,8,8.740356743,8.740286741,72,112.7445502,4,7,11,5,8,13,5,0.396024,0.413232,0,No
2511,storey,9,12.8993076,8,8.740356743,8.740286741,72,112.7445502,7,7,14,7,7,14,4,0.422572,0.439445,0,No
2553,stimulate,9,12.8993076,8,8.740356743,8.740286741,72,112.7445502,4,4,8,6,9,15,4,0.400429,0.418052,0,No
2576,sternum,9,12.8993076,8,8.740356743,8.740286741,72,112.7445502,6,5,11,9,7,16,4,0.415034,0.432347,0,No
2706,stacy,9,12.8993076,8,8.740356743,8.740286741,72,112.7445502,5,3,8,5,3,8,5,0.356517,0.368439,0,No
3010,solicitor,9,12.8993076,8,8.740356743,8.740286741,72,112.7445502,6,6,12,9,8,17,4,0.42553,0.442036,0,No
3118,sly,9,12.8993076,8,8.740356743,8.740286741,72,112.7445502,6,4,10,8,6,14,4,0.423016,0.439689,0,No
3397,showy,9,12.8993076,8,8.740356743,8.740286741,72,112.7445502,5,2,7,6,2,8,4,0.395116,0.412197,0,No
3597,serge,9,12.8993076,8,8.740356743,8.740286741,72,112.7445502,4,2,6,4,2,6,5,0.328509,0.332778,0,No
4042,saloon,9,12.8993076,8,8.740356743,8.740286741,72,112.7445502,6,8,14,7,9,16,4,0.427817,0.444163,0,No
4377,riddle,9,12.8993076,8,8.740356743,8.740286741,72,112.7445502,4,7,11,8,9,17,4,0.411198,0.428591,0,No
4525,repression,9,12.8993076,8,8.740356743,8.740286741,72,112.7445502,5,7,12,6,8,14,5,0.420261,0.437254,0,No
6053,pejorative,9,12.8993076,8,8.740356743,8.740286741,72,112.7445502,5,4,9,7,8,15,5,0.345525,0.354753,0,No
6460,orville,9,12.8993076,8,8.740356743,8.740286741,72,112.7445502,6,5,11,7,9,16,4,0.389806,0.406569,0,No
6547,opiate,9,12.8993076,8,8.740356743,8.740286741,72,112.7445502,4,8,12,6,8,14,5,0.359645,0.371992,0,No
6784,nucleotide,9,12.8993076,8,8.740356743,8.740286741,72,112.7445502,5,3,8,8,5,13,5,0.35237,0.362889,0,No
6987,newell,9,12.8993076,8,8.740356743,8.740286741,72,112.7445502,5,4,9,6,6,12,5,0.350429,0.360469,0,No
8200,mallet,9,12.8993076,8,8.740356743,8.740286741,72,112.7445502,2,8,10,4,9,13,4,0.431646,0.447576,0,No
8302,madam,9,12.8993076,8,8.740356743,8.740286741,72,112.7445502,7,5,12,7,5,12,5,0.381054,0.397119,0,No
8716,lexicon,9,12.8993076,8,8.740356743,8.740286741,72,112.7445502,7,6,13,8,7,15,4,0.408811,0.426197,0,No
9658,introductory,9,12.8993076,8,8.740356743,8.740286741,72,112.7445502,6,4,10,8,6,14,5,0.323221,0.32641,0,No
9680,intersect,9,12.8993076,8,8.740356743,8.740286741,72,112.7445502,5,6,11,8,8,16,5,0.3859,0.40246,0,No
10106,idle,9,12.8993076,8,8.740356743,8.740286741,72,112.7445502,2,7,9,7,7,14,4,0.39381,0.411085,0,No
10453,historiography,9,12.8993076,8,8.740356743,8.740286741,72,112.7445502,4,6,10,5,6,11,4,0.392739,0.410151,0,No
10464,hiroshi,9,12.8993076,8,8.740356743,8.740286741,72,112.7445502,3,2,5,3,2,5,5,0.329809,0.33406,0,No
11105,gregg,9,12.8993076,8,8.740356743,8.740286741,72,112.7445502,5,1,6,5,1,6,5,0.314913,0.319035,0,No
11311,glossy,9,12.8993076,8,8.740356743,8.740286741,72,112.7445502,7,7,14,7,9,16,5,0.38879,0.405519,0,No
11347,glamour,9,12.8993076,8,8.740356743,8.740286741,72,112.7445502,7,4,11,7,9,16,5,0.361653,0.374506,0,No
11392,gig,9,12.8993076,8,8.740356743,8.740286741,72,112.7445502,5,7,12,8,8,16,5,0.383598,0.399975,0,No
11455,gentry,9,12.8993076,8,8.740356743,8.740286741,72,112.7445502,7,6,13,8,6,14,4,0.41669,0.433924,0,No
11879,forgive,9,12.8993076,8,8.740356743,8.740286741,72,112.7445502,4,5,9,9,7,16,5,0.340599,0.348124,0,No
11905,forage,9,12.8993076,8,8.740356743,8.740286741,72,112.7445502,7,3,10,7,6,13,5,0.367988,0.382037,0,No
12581,evanston,9,12.8993076,8,8.740356743,8.740286741,72,112.7445502,3,2,5,9,9,18,5,0.346936,0.356101,0,No
12635,ethel,9,12.8993076,8,8.740356743,8.740286741,72,112.7445502,7,2,9,9,2,11,5,0.318907,0.322777,0,No
14052,dab,9,12.8993076,8,8.740356743,8.740286741,72,112.7445502,9,7,16,9,9,18,4,0.390329,0.407184,0,No
14187,crustacean,9,12.8993076,8,8.740356743,8.740286741,72,112.7445502,7,9,16,9,9,18,4,0.394721,0.411888,0,No
14350,courtney,9,12.8993076,8,8.740356743,8.740286741,72,112.7445502,7,2,9,8,5,13,5,0.384504,0.400721,0,No
14409,cosmetic,9,12.8993076,8,8.740356743,8.740286741,72,112.7445502,5,5,10,8,5,13,5,0.355682,0.367529,0,No
14427,corrode,9,12.8993076,8,8.740356743,8.740286741,72,112.7445502,5,7,12,7,7,14,4,0.413035,0.430558,0,No
15089,clarendon,9,12.8993076,8,8.740356743,8.740286741,72,112.7445502,5,7,12,8,9,17,5,0.348284,0.35784,0,No
15276,chick,9,12.8993076,8,8.740356743,8.740286741,72,112.7445502,8,5,13,8,5,13,5,0.350001,0.359746,0,No
16075,bromley,9,12.8993076,8,8.740356743,8.740286741,72,112.7445502,4,4,8,7,6,13,5,0.370136,0.384738,0,No
16155,breeze,9,12.8993076,8,8.740356743,8.740286741,72,112.7445502,6,8,14,8,8,16,5,0.353001,0.363732,0,No
16363,bolshoi,9,12.8993076,8,8.740356743,8.740286741,72,112.7445502,3,0,3,9,0,9,0,0,0,0,No
17036,baird,9,12.8993076,8,8.740356743,8.740286741,72,112.7445502,4,3,7,4,3,7,5,0.387695,0.404261,0,No
17246,atop,9,12.8993076,8,8.740356743,8.740286741,72,112.7445502,2,3,5,2,9,11,4,0.399716,0.417343,0,No
17672,anise,9,12.8993076,8,8.740356743,8.740286741,72,112.7445502,6,8,14,7,8,15,5,0.391707,0.408678,0,No
18280,acapulco,9,12.8993076,8,8.740356743,8.740286741,72,112.7445502,4,5,9,8,8,16,4,0.406667,0.424253,0,No
15096,clank,23,11.96103796,4,9.433503923,9.433473923,92,112.8344985,6,9,15,12,14,26,4,0.376807,0.392377,0,No
4134,russo,17,12.26331883,5,9.210360372,9.210320372,85,112.9495858,7,11,18,13,12,25,4,0.389387,0.406212,0,No
7240,muon,17,12.26331883,5,9.210360372,9.210320372,85,112.9495858,4,10,14,17,15,32,4,0.430609,0.446703,0,No
3657,selma,13,12.53158282,6,9.028038815,9.027988815,78,113.1356161,8,5,13,13,5,18,5,0.370732,0.385423,0,No
4172,rudy,13,12.53158282,6,9.028038815,9.027988815,78,113.1356161,8,9,17,9,9,18,4,0.410304,0.427793,0,No
4500,resistor,13,12.53158282,6,9.028038815,9.027988815,78,113.1356161,6,8,14,12,10,22,4,0.410456,0.428042,0,No
5454,porpoise,13,12.53158282,6,9.028038815,9.027988815,78,113.1356161,5,7,12,7,8,15,4,0.434605,0.450172,0,No
6679,octane,13,12.53158282,6,9.028038815,9.027988815,78,113.1356161,8,5,13,11,7,18,4,0.390098,0.406902,0,No
7397,montpelier,13,12.53158282,6,9.028038815,9.027988815,78,113.1356161,7,5,12,10,12,22,4,0.405719,0.423328,0,No
8964,landis,13,12.53158282,6,9.028038815,9.027988815,78,113.1356161,8,4,12,11,9,20,5,0.338475,0.344932,0,No
12854,empathy,13,12.53158282,6,9.028038815,9.027988815,78,113.1356161,9,9,18,9,11,20,5,0.357156,0.368934,0,No
13429,divisor,13,12.53158282,6,9.028038815,9.027988815,78,113.1356161,4,4,8,12,12,24,4,0.435052,0.450533,0,No
14147,culver,13,12.53158282,6,9.028038815,9.027988815,78,113.1356161,7,6,13,11,13,24,5,0.34336,0.351089,0,No
14832,commando,13,12.53158282,6,9.028038815,9.027988815,78,113.1356161,4,9,13,4,9,13,4,0.388893,0.405977,0,No
8931,laredo,22,12.00548972,4,9.433503923,9.433473923,88,113.2538344,8,7,15,11,19,30,4,0.373469,0.388495,0,No
10168,hymen,22,12.00548972,4,9.433503923,9.433473923,88,113.2538344,4,11,15,19,14,33,4,0.409736,0.427337,0,No
8410,lufthansa,16,12.32394346,5,9.210360372,9.210320372,80,113.5079604,9,8,17,11,12,23,4,0.391664,0.408615,0,No
10555,hershey,16,12.32394346,5,9.210360372,9.210320372,80,113.5079604,9,6,15,12,8,20,4,0.400131,0.417451,0,No
15603,carrara,16,12.32394346,5,9.210360372,9.210320372,80,113.5079604,9,8,17,13,12,25,4,0.394186,0.411329,0,No
18124,adverb,16,12.32394346,5,9.210360372,9.210320372,80,113.5079604,4,10,14,13,12,25,4,0.427364,0.443759,0,No
88,yew,10,12.79394708,7,8.873888135,8.873828135,70,113.5320552,5,6,11,5,7,12,5,0.388561,0.405214,0,No
709,vivaldi,10,12.79394708,7,8.873888135,8.873828135,70,113.5320552,3,6,9,8,9,17,5,0.336454,0.34227,0,No
835,vertebral,10,12.79394708,7,8.873888135,8.873828135,70,113.5320552,4,1,5,8,8,16,5,0.317192,0.320849,0,No
1372,traumatic,10,12.79394708,7,8.873888135,8.873828135,70,113.5320552,7,4,11,9,9,18,5,0.357134,0.369142,0,No
2050,talmud,10,12.79394708,7,8.873888135,8.873828135,70,113.5320552,3,6,9,10,7,17,4,0.426573,0.442989,0,No
2158,sykes,10,12.79394708,7,8.873888135,8.873828135,70,113.5320552,5,7,12,7,9,16,5,0.39188,0.408833,0,No
2502,stove,10,12.79394708,7,8.873888135,8.873828135,70,113.5320552,5,6,11,9,8,17,5,0.379157,0.395033,0,No
3405,shovel,10,12.79394708,7,8.873888135,8.873828135,70,113.5320552,3,6,9,8,10,18,4,0.391932,0.408874,0,No
3735,seaman,10,12.79394708,7,8.873888135,8.873828135,70,113.5320552,8,6,14,9,8,17,4,0.376081,0.391457,0,No
3968,sarcasm,10,12.79394708,7,8.873888135,8.873828135,70,113.5320552,7,5,12,8,9,17,4,0.400591,0.417967,0,No
4022,sampson,10,12.79394708,7,8.873888135,8.873828135,70,113.5320552,6,6,12,8,8,16,5,0.348496,0.35776,0,No
4131,rusty,10,12.79394708,7,8.873888135,8.873828135,70,113.5320552,3,3,6,4,6,10,5,0.336321,0.342403,0,No
4152,rung,10,12.79394708,7,8.873888135,8.873828135,70,113.5320552,6,7,13,10,9,19,5,0.387873,0.40461,0,No
4182,ruben,10,12.79394708,7,8.873888135,8.873828135,70,113.5320552,6,4,10,7,4,11,5,0.412555,0.42987,0,No
4740,rasmussen,10,12.79394708,7,8.873888135,8.873828135,70,113.5320552,1,6,7,1,8,9,5,0.402636,0.420035,0,No
5035,pulaski,10,12.79394708,7,8.873888135,8.873828135,70,113.5320552,6,7,13,7,9,16,5,0.350727,0.361049,0,No
5070,psychoanalysis,10,12.79394708,7,8.873888135,8.873828135,70,113.5320552,6,9,15,9,10,19,4,0.397523,0.414822,0,No
5379,pow,10,12.79394708,7,8.873888135,8.873828135,70,113.5320552,5,5,10,8,9,17,5,0.351109,0.36149,0,No
5531,pollinate,10,12.79394708,7,8.873888135,8.873828135,70,113.5320552,8,7,15,9,10,19,4,0.414191,0.431516,0,No
5882,petri,10,12.79394708,7,8.873888135,8.873828135,70,113.5320552,3,1,4,6,4,10,5,0.319039,0.32236,0,No
6050,pelham,10,12.79394708,7,8.873888135,8.873828135,70,113.5320552,8,4,12,9,6,15,5,0.352552,0.363054,0,No
6505,ordinal,10,12.79394708,7,8.873888135,8.873828135,70,113.5320552,5,1,6,7,1,8,5,0.345599,0.354479,0,No
6536,oppression,10,12.79394708,7,8.873888135,8.873828135,70,113.5320552,8,4,12,8,7,15,5,0.390527,0.407432,0,No
6633,ohm,10,12.79394708,7,8.873888135,8.873828135,70,113.5320552,6,5,11,6,10,16,5,0.369335,0.383628,0,No
7193,mycenae,10,12.79394708,7,8.873888135,8.873828135,70,113.5320552,2,6,8,10,10,20,4,0.425541,0.44205,0,No
7506,moat,10,12.79394708,7,8.873888135,8.873828135,70,113.5320552,4,6,10,10,7,17,5,0.364677,0.378004,0,No
7929,mccall,10,12.79394708,7,8.873888135,8.873828135,70,113.5320552,6,7,13,6,9,15,4,0.426471,0.442905,0,No
8657,lilly,10,12.79394708,7,8.873888135,8.873828135,70,113.5320552,5,6,11,6,6,12,5,0.398836,0.416133,0,No
8725,leviticus,10,12.79394708,7,8.873888135,8.873828135,70,113.5320552,6,5,11,8,5,13,5,0.366431,0.38006,0,No
8799,legume,10,12.79394708,7,8.873888135,8.873828135,70,113.5320552,4,2,6,10,5,15,5,0.346848,0.355957,0,No
9577,irreplaceable,10,12.79394708,7,8.873888135,8.873828135,70,113.5320552,6,7,13,8,7,15,4,0.373579,0.388621,0,No
10182,hydrolysis,10,12.79394708,7,8.873888135,8.873828135,70,113.5320552,8,6,14,8,7,15,5,0.412564,0.43002,0,No
10726,haynes,10,12.79394708,7,8.873888135,8.873828135,70,113.5320552,5,9,14,7,9,16,5,0.334969,0.340646,0,No
11094,greyhound,10,12.79394708,7,8.873888135,8.873828135,70,113.5320552,3,4,7,7,7,14,5,0.385129,0.401667,0,No
11099,gresham,10,12.79394708,7,8.873888135,8.873828135,70,113.5320552,5,6,11,9,10,19,5,0.38574,0.402162,0,No
11351,gladstone,10,12.79394708,7,8.873888135,8.873828135,70,113.5320552,3,5,8,4,6,10,5,0.339025,0.345716,0,No
12181,fide,10,12.79394708,7,8.873888135,8.873828135,70,113.5320552,3,7,10,3,7,10,4,0.416729,0.434187,0,No
12315,farmington,10,12.79394708,7,8.873888135,8.873828135,70,113.5320552,7,6,13,8,9,17,5,0.349698,0.359753,0,No
12398,ezekiel,10,12.79394708,7,8.873888135,8.873828135,70,113.5320552,4,6,10,7,8,15,4,0.416163,0.433647,0,No
12436,extensible,10,12.79394708,7,8.873888135,8.873828135,70,113.5320552,5,1,6,5,1,6,5,0.331268,0.335748,0,No
13401,dodo,10,12.79394708,7,8.873888135,8.873828135,70,113.5320552,4,6,10,10,8,18,4,0.440155,0.454974,0,No
13489,discus,10,12.79394708,7,8.873888135,8.873828135,70,113.5320552,5,5,10,9,10,19,5,0.331485,0.336575,0,No
15512,cauliflower,10,12.79394708,7,8.873888135,8.873828135,70,113.5320552,3,6,9,6,9,15,4,0.39924,0.416596,0,No
15925,burnham,10,12.79394708,7,8.873888135,8.873828135,70,113.5320552,7,6,13,8,8,16,5,0.348018,0.357232,0,No
16513,blackbird,10,12.79394708,7,8.873888135,8.873828135,70,113.5320552,3,7,10,9,7,16,5,0.37365,0.388745,0,No
16845,baylor,10,12.79394708,7,8.873888135,8.873828135,70,113.5320552,6,3,9,7,5,12,5,0.331739,0.336569,0,No
17020,bale,10,12.79394708,7,8.873888135,8.873828135,70,113.5320552,4,6,10,9,9,18,4,0.396016,0.413202,0,No
17761,amphibious,10,12.79394708,7,8.873888135,8.873828135,70,113.5320552,4,7,11,6,7,13,5,0.358194,0.370749,0,No
18241,acetic,10,12.79394708,7,8.873888135,8.873828135,70,113.5320552,6,1,7,8,10,18,5,0.318238,0.321893,0,No
4,zoroastrian,8,13.01709064,8,8.740356743,8.740286741,64,113.7740159,3,6,9,6,7,13,5,0.388467,0.405134,0,No
245,wolff,8,13.01709064,8,8.740356743,8.740286741,64,113.7740159,4,4,8,7,4,11,5,0.362361,0.375302,0,No
550,watanabe,8,13.01709064,8,8.740356743,8.740286741,64,113.7740159,1,6,7,1,7,8,4,0.403093,0.42069,0,No
607,waller,8,13.01709064,8,8.740356743,8.740286741,64,113.7740159,4,6,10,7,7,14,4,0.395372,0.412503,0,No
927,vase,8,13.01709064,8,8.740356743,8.740286741,64,113.7740159,4,6,10,7,7,14,4,0.435714,0.451223,0,No
967,vain,8,13.01709064,8,8.740356743,8.740286741,64,113.7740159,6,7,13,7,8,15,5,0.396219,0.413439,0,No
1006,usc,8,13.01709064,8,8.740356743,8.740286741,64,113.7740159,5,6,11,6,6,12,4,0.399941,0.417638,0,No
1187,turmoil,8,13.01709064,8,8.740356743,8.740286741,64,113.7740159,2,5,7,4,5,9,4,0.432708,0.448482,0,No
1286,triumphant,8,13.01709064,8,8.740356743,8.740286741,64,113.7740159,5,6,11,6,6,12,5,0.362051,0.37505,0,No
1664,ti,8,13.01709064,8,8.740356743,8.740286741,64,113.7740159,4,2,6,4,2,6,5,0.349994,0.359746,0,No
1772,thereof,8,13.01709064,8,8.740356743,8.740286741,64,113.7740159,4,7,11,4,7,11,5,0.382754,0.399125,0,No
2209,swanson,8,13.01709064,8,8.740356743,8.740286741,64,113.7740159,4,7,11,5,7,12,5,0.391915,0.408857,0,No
2212,swampy,8,13.01709064,8,8.740356743,8.740286741,64,113.7740159,6,5,11,8,6,14,5,0.329736,0.334104,0,No
2288,superintendent,8,13.01709064,8,8.740356743,8.740286741,64,113.7740159,6,2,8,6,8,14,5,0.378672,0.394481,0,No
2417,stunt,8,13.01709064,8,8.740356743,8.740286741,64,113.7740159,5,4,9,7,4,11,5,0.365932,0.379549,0,No
2601,steer,8,13.01709064,8,8.740356743,8.740286741,64,113.7740159,2,4,6,7,7,14,4,0.408238,0.425793,0,No
3044,societal,8,13.01709064,8,8.740356743,8.740286741,64,113.7740159,4,2,6,5,2,7,5,0.326173,0.329687,0,No
3165,sleeve,8,13.01709064,8,8.740356743,8.740286741,64,113.7740159,7,5,12,8,5,13,5,0.36127,0.374051,0,No
3536,shaggy,8,13.01709064,8,8.740356743,8.740286741,64,113.7740159,5,6,11,6,7,13,4,0.400248,0.41785,0,No
3660,selkirk,8,13.01709064,8,8.740356743,8.740286741,64,113.7740159,4,5,9,8,8,16,4,0.392001,0.408949,0,No
3733,seamstress,8,13.01709064,8,8.740356743,8.740286741,64,113.7740159,3,8,11,6,8,14,4,0.416163,0.433464,0,No
3837,schoolteacher,8,13.01709064,8,8.740356743,8.740286741,64,113.7740159,1,6,7,7,8,15,5,0.396537,0.413753,0,No
4036,salute,8,13.01709064,8,8.740356743,8.740286741,64,113.7740159,5,7,12,7,8,15,4,0.412325,0.42983,0,No
4311,roam,8,13.01709064,8,8.740356743,8.740286741,64,113.7740159,4,7,11,7,7,14,4,0.413564,0.431004,0,No
5191,prom,8,13.01709064,8,8.740356743,8.740286741,64,113.7740159,5,7,12,6,7,13,4,0.425347,0.441886,0,No
5371,pr,8,13.01709064,8,8.740356743,8.740286741,64,113.7740159,5,6,11,7,6,13,5,0.403294,0.42111,0,No
5734,pinkish,8,13.01709064,8,8.740356743,8.740286741,64,113.7740159,6,5,11,7,5,12,5,0.363586,0.376734,0,No
6192,paschal,8,13.01709064,8,8.740356743,8.740286741,64,113.7740159,4,3,7,7,6,13,5,0.329828,0.333929,0,No
6263,paraguayan,8,13.01709064,8,8.740356743,8.740286741,64,113.7740159,3,2,5,5,4,9,5,0.328625,0.332398,0,No
6315,pancreatic,8,13.01709064,8,8.740356743,8.740286741,64,113.7740159,7,3,10,8,8,16,5,0.384296,0.400505,0,No
6759,nutritious,8,13.01709064,8,8.740356743,8.740286741,64,113.7740159,3,5,8,4,7,11,5,0.384504,0.400768,0,No
6988,newcomer,8,13.01709064,8,8.740356743,8.740286741,64,113.7740159,3,8,11,5,8,13,4,0.414356,0.431666,0,No
7100,navigate,8,13.01709064,8,8.740356743,8.740286741,64,113.7740159,3,7,10,8,7,15,4,0.4367,0.452007,0,No
7562,minotaur,8,13.01709064,8,8.740356743,8.740286741,64,113.7740159,2,6,8,8,6,14,4,0.429505,0.445627,0,No
7700,methodology,8,13.01709064,8,8.740356743,8.740286741,64,113.7740159,4,3,7,4,4,8,4,0.422442,0.439135,0,No
8046,marshy,8,13.01709064,8,8.740356743,8.740286741,64,113.7740159,6,3,9,8,4,12,4,0.412382,0.4296,0,No
8048,marshland,8,13.01709064,8,8.740356743,8.740286741,64,113.7740159,5,5,10,5,6,11,4,0.435778,0.451186,0,No
8268,magnate,8,13.01709064,8,8.740356743,8.740286741,64,113.7740159,4,6,10,5,6,11,5,0.333854,0.339108,0,No
8509,logician,8,13.01709064,8,8.740356743,8.740286741,64,113.7740159,3,5,8,7,6,13,5,0.385749,0.402148,0,No
8511,logging,8,13.01709064,8,8.740356743,8.740286741,64,113.7740159,8,7,15,8,7,15,4,0.418596,0.435694,0,No
8601,lipstick,8,13.01709064,8,8.740356743,8.740286741,64,113.7740159,4,6,10,4,6,10,4,0.392443,0.409442,0,No
8719,lexical,8,13.01709064,8,8.740356743,8.740286741,64,113.7740159,3,4,7,4,5,9,5,0.384354,0.400585,0,No
8847,leaflet,8,13.01709064,8,8.740356743,8.740286741,64,113.7740159,6,6,12,8,7,15,4,0.375325,0.390654,0,No
9188,kettle,8,13.01709064,8,8.740356743,8.740286741,64,113.7740159,6,5,11,7,6,13,5,0.358259,0.370258,0,No
9216,kendall,8,13.01709064,8,8.740356743,8.740286741,64,113.7740159,5,3,8,6,3,9,5,0.384929,0.401205,0,No
9230,keel,8,13.01709064,8,8.740356743,8.740286741,64,113.7740159,4,6,10,6,7,13,5,0.407544,0.425111,0,No
9628,invitation,8,13.01709064,8,8.740356743,8.740286741,64,113.7740159,4,4,8,8,8,16,4,0.428282,0.444632,0,No
9710,intend,8,13.01709064,8,8.740356743,8.740286741,64,113.7740159,5,4,9,7,8,15,4,0.402572,0.420164,0,No
9788,innermost,8,13.01709064,8,8.740356743,8.740286741,64,113.7740159,3,4,7,8,4,12,5,0.378753,0.394598,0,No
9796,injustice,8,13.01709064,8,8.740356743,8.740286741,64,113.7740159,5,6,11,7,6,13,4,0.425551,0.44206,0,No
9817,inhabitant,8,13.01709064,8,8.740356743,8.740286741,64,113.7740159,6,3,9,7,8,15,5,0.380449,0.396467,0,No
9960,inclusive,8,13.01709064,8,8.740356743,8.740286741,64,113.7740159,7,4,11,7,5,12,5,0.382293,0.398579,0,No
9961,inclusion,8,13.01709064,8,8.740356743,8.740286741,64,113.7740159,4,4,8,5,8,13,5,0.391232,0.408223,0,No
10354,honorific,8,13.01709064,8,8.740356743,8.740286741,64,113.7740159,4,3,7,8,6,14,5,0.388586,0.405371,0,No
10400,holst,8,13.01709064,8,8.740356743,8.740286741,64,113.7740159,2,5,7,8,7,15,4,0.40108,0.418681,0,No
10683,heathen,8,13.01709064,8,8.740356743,8.740286741,64,113.7740159,4,7,11,7,7,14,5,0.385606,0.402031,0,No
11197,gown,8,13.01709064,8,8.740356743,8.740286741,64,113.7740159,3,4,7,5,5,10,5,0.384362,0.400735,0,No
11811,fragrant,8,13.01709064,8,8.740356743,8.740286741,64,113.7740159,4,6,10,5,8,13,5,0.337998,0.344624,0,No
11877,forgot,8,13.01709064,8,8.740356743,8.740286741,64,113.7740159,7,6,13,8,8,16,5,0.368952,0.383295,0,No
12226,ferment,8,13.01709064,8,8.740356743,8.740286741,64,113.7740159,5,8,13,8,8,16,4,0.414549,0.431947,0,No
12284,fawn,8,13.01709064,8,8.740356743,8.740286741,64,113.7740159,4,7,11,6,7,13,5,0.386421,0.402904,0,No
12467,experimentation,8,13.01709064,8,8.740356743,8.740286741,64,113.7740159,5,2,7,5,5,10,5,0.394633,0.411702,0,No
12475,expel,8,13.01709064,8,8.740356743,8.740286741,64,113.7740159,3,5,8,6,8,14,4,0.400275,0.417925,0,No
12522,exclusion,8,13.01709064,8,8.740356743,8.740286741,64,113.7740159,4,5,9,7,8,15,5,0.385246,0.401807,0,No
12723,equipped,8,13.01709064,8,8.740356743,8.740286741,64,113.7740159,5,8,13,8,8,16,5,0.389225,0.406125,0,No
13072,echoes,8,13.01709064,8,8.740356743,8.740286741,64,113.7740159,8,5,13,8,6,14,5,0.3924,0.409481,0,No
13331,dormitory,8,13.01709064,8,8.740356743,8.740286741,64,113.7740159,3,2,5,8,5,13,5,0.398433,0.416162,0,No
13356,donor,8,13.01709064,8,8.740356743,8.740286741,64,113.7740159,4,8,12,7,8,15,4,0.386068,0.402724,0,No
13733,depict,8,13.01709064,8,8.740356743,8.740286741,64,113.7740159,4,5,9,5,5,10,5,0.334514,0.340189,0,No
13804,delight,8,13.01709064,8,8.740356743,8.740286741,64,113.7740159,3,6,9,4,6,10,5,0.398371,0.416011,0,No
14080,cyclic,8,13.01709064,8,8.740356743,8.740286741,64,113.7740159,6,3,9,7,3,10,5,0.327033,0.331549,0,No
14095,cute,8,13.01709064,8,8.740356743,8.740286741,64,113.7740159,6,3,9,6,5,11,4,0.389858,0.406602,0,No
14291,crawl,8,13.01709064,8,8.740356743,8.740286741,64,113.7740159,7,6,13,7,7,14,5,0.371632,0.386358,0,No
14358,courier,8,13.01709064,8,8.740356743,8.740286741,64,113.7740159,5,5,10,5,6,11,5,0.397452,0.414683,0,No
14717,conclude,8,13.01709064,8,8.740356743,8.740286741,64,113.7740159,3,4,7,6,7,13,4,0.408088,0.425539,0,No
14812,commonplace,8,13.01709064,8,8.740356743,8.740286741,64,113.7740159,5,6,11,8,8,16,5,0.381882,0.398172,0,No
14889,collectible,8,13.01709064,8,8.740356743,8.740286741,64,113.7740159,5,1,6,6,4,10,5,0.318181,0.32192,0,No
15716,canopy,8,13.01709064,8,8.740356743,8.740286741,64,113.7740159,6,4,10,6,4,10,4,0.438069,0.453153,0,No
16256,bourgeois,8,13.01709064,8,8.740356743,8.740286741,64,113.7740159,5,3,8,5,3,8,5,0.369997,0.384419,0,No
16302,borealis,8,13.01709064,8,8.740356743,8.740286741,64,113.7740159,1,7,8,5,7,12,4,0.436582,0.451909,0,No
16933,barnet,8,13.01709064,8,8.740356743,8.740286741,64,113.7740159,5,5,10,7,5,12,4,0.438675,0.453683,0,No
17312,assemble,8,13.01709064,8,8.740356743,8.740286741,64,113.7740159,2,6,8,5,6,11,5,0.392036,0.408988,0,No
17395,aroma,8,13.01709064,8,8.740356743,8.740286741,64,113.7740159,6,5,11,7,6,13,5,0.408661,0.426058,0,No
17521,appetite,8,13.01709064,8,8.740356743,8.740286741,64,113.7740159,4,6,10,7,8,15,4,0.403735,0.421399,0,No
17540,apostrophe,8,13.01709064,8,8.740356743,8.740286741,64,113.7740159,3,6,9,8,7,15,5,0.355454,0.366697,0,No
17907,alkaloid,8,13.01709064,8,8.740356743,8.740286741,64,113.7740159,5,3,8,8,6,14,5,0.335425,0.341109,0,No
18142,adoptive,8,13.01709064,8,8.740356743,8.740286741,64,113.7740159,7,3,10,8,5,13,5,0.327051,0.330695,0,No
18159,administer,8,13.01709064,8,8.740356743,8.740286741,64,113.7740159,3,7,10,8,8,16,5,0.385682,0.402106,0,No
216,woolworth,12,12.61162553,6,9.028038815,9.027988815,72,113.8582448,5,3,8,8,3,11,5,0.325175,0.32866,0,No
1271,troposphere,12,12.61162553,6,9.028038815,9.027988815,72,113.8582448,1,6,7,9,10,19,4,0.42642,0.442848,0,No
1361,tread,12,12.61162553,6,9.028038815,9.027988815,72,113.8582448,4,7,11,11,8,19,4,0.441271,0.455951,0,No
1499,tort,12,12.61162553,6,9.028038815,9.027988815,72,113.8582448,8,7,15,10,11,21,4,0.4243,0.441074,0,No
1701,thrice,12,12.61162553,6,9.028038815,9.027988815,72,113.8582448,8,7,15,9,8,17,4,0.381923,0.398179,0,No
2827,spiegel,12,12.61162553,6,9.028038815,9.027988815,72,113.8582448,4,7,11,8,9,17,4,0.405941,0.423563,0,No
3204,skopje,12,12.61162553,6,9.028038815,9.027988815,72,113.8582448,9,5,14,9,9,18,4,0.415578,0.432863,0,No
4892,queer,12,12.61162553,6,9.028038815,9.027988815,72,113.8582448,6,6,12,10,11,21,5,0.392374,0.409528,0,No
5244,proboscis,12,12.61162553,6,9.028038815,9.027988815,72,113.8582448,8,6,14,11,9,20,4,0.414559,0.431868,0,No
5479,poodle,12,12.61162553,6,9.028038815,9.027988815,72,113.8582448,8,7,15,12,9,21,4,0.4082,0.425652,0,No
5931,peroxide,12,12.61162553,6,9.028038815,9.027988815,72,113.8582448,3,9,12,12,10,22,5,0.390922,0.408049,0,No
6613,oleander,12,12.61162553,6,9.028038815,9.027988815,72,113.8582448,5,4,9,8,7,15,4,0.390261,0.407062,0,No
6804,novak,12,12.61162553,6,9.028038815,9.027988815,72,113.8582448,9,5,14,9,6,15,5,0.342122,0.349678,0,No
7878,mead,12,12.61162553,6,9.028038815,9.027988815,72,113.8582448,9,6,15,10,10,20,5,0.390905,0.407927,0,No
9251,karma,12,12.61162553,6,9.028038815,9.027988815,72,113.8582448,8,5,13,11,7,18,5,0.350146,0.36038,0,No
10233,humus,12,12.61162553,6,9.028038815,9.027988815,72,113.8582448,6,7,13,8,7,15,4,0.431195,0.447275,0,No
11166,grandparent,12,12.61162553,6,9.028038815,9.027988815,72,113.8582448,7,7,14,12,10,22,4,0.440406,0.455308,0,No
11244,gonzales,12,12.61162553,6,9.028038815,9.027988815,72,113.8582448,6,6,12,10,9,19,4,0.403267,0.420826,0,No
12350,fallopian,12,12.61162553,6,9.028038815,9.027988815,72,113.8582448,2,1,3,11,3,14,5,0.32023,0.323457,0,No
13213,dryden,12,12.61162553,6,9.028038815,9.027988815,72,113.8582448,8,8,16,11,8,19,4,0.40368,0.421263,0,No
14946,cocoon,12,12.61162553,6,9.028038815,9.027988815,72,113.8582448,6,8,14,12,10,22,4,0.422412,0.439257,0,No
16696,bennington,12,12.61162553,6,9.028038815,9.027988815,72,113.8582448,5,9,14,10,9,19,5,0.40484,0.42233,0,No
17799,amethyst,12,12.61162553,6,9.028038815,9.027988815,72,113.8582448,8,7,15,9,9,18,4,0.392123,0.40946,0,No
17986,alb,12,12.61162553,6,9.028038815,9.027988815,72,113.8582448,0,6,6,0,7,7,4,0.426382,0.442814,0,No
6625,okapi,15,12.38848198,5,9.210360372,9.210320372,75,114.1023835,4,8,12,14,11,25,4,0.413112,0.430549,0,No
11101,grendel,15,12.38848198,5,9.210360372,9.210320372,75,114.1023835,11,8,19,13,10,23,4,0.425755,0.44228,0,No
14112,cursor,15,12.38848198,5,9.210360372,9.210320372,75,114.1023835,7,7,14,15,11,26,4,0.420251,0.437295,0,No
14236,crochet,15,12.38848198,5,9.210360372,9.210320372,75,114.1023835,10,6,16,13,11,24,4,0.407853,0.425446,0,No
3070,snoopy,20,12.1007999,4,9.433503923,9.433473923,80,114.1529434,8,14,22,15,17,32,5,0.391725,0.40889,0,No
13272,dram,20,12.1007999,4,9.433503923,9.433473923,80,114.1529434,10,13,23,17,19,36,4,0.43384,0.449608,0,No
16012,buckwheat,20,12.1007999,4,9.433503923,9.433473923,80,114.1529434,15,9,24,18,16,34,5,0.386681,0.403481,0,No
456,wendell,9,12.8993076,7,8.873888135,8.873828135,63,114.4670127,8,5,13,8,6,14,5,0.346584,0.35577,0,No
460,wellesley,9,12.8993076,7,8.873888135,8.873828135,63,114.4670127,3,5,8,8,9,17,5,0.341444,0.348669,0,No
512,waxy,9,12.8993076,7,8.873888135,8.873828135,63,114.4670127,8,2,10,9,2,11,5,0.325976,0.329876,0,No
1008,usaf,9,12.8993076,7,8.873888135,8.873828135,63,114.4670127,2,7,9,9,8,17,4,0.421289,0.438412,0,No
1093,umpire,9,12.8993076,7,8.873888135,8.873828135,63,114.4670127,4,9,13,8,9,17,4,0.40187,0.419324,0,No
2106,tab,9,12.8993076,7,8.873888135,8.873828135,63,114.4670127,6,6,12,6,6,12,4,0.403001,0.420389,0,No
2205,swastika,9,12.8993076,7,8.873888135,8.873828135,63,114.4670127,3,8,11,9,9,18,4,0.443055,0.457458,0,No
2291,superb,9,12.8993076,7,8.873888135,8.873828135,63,114.4670127,4,3,7,9,4,13,5,0.322265,0.325421,0,No
2317,sunburn,9,12.8993076,7,8.873888135,8.873828135,63,114.4670127,3,8,11,6,9,15,4,0.426891,0.443308,0,No
2536,stockade,9,12.8993076,7,8.873888135,8.873828135,63,114.4670127,2,4,6,9,7,16,4,0.406816,0.424338,0,No
2982,somers,9,12.8993076,7,8.873888135,8.873828135,63,114.4670127,6,5,11,8,6,14,5,0.363222,0.376189,0,No
3038,socket,9,12.8993076,7,8.873888135,8.873828135,63,114.4670127,8,6,14,9,7,16,4,0.403955,0.421389,0,No
3651,semester,9,12.8993076,7,8.873888135,8.873828135,63,114.4670127,5,8,13,8,9,17,4,0.433734,0.449435,0,No
3653,semaphore,9,12.8993076,7,8.873888135,8.873828135,63,114.4670127,4,5,9,5,6,11,5,0.346753,0.355868,0,No
3813,sclerosis,9,12.8993076,7,8.873888135,8.873828135,63,114.4670127,2,3,5,9,4,13,4,0.416651,0.433703,0,No
3820,sci,9,12.8993076,7,8.873888135,8.873828135,63,114.4670127,4,0,4,8,0,8,0,0,0,0,No
4531,repetitive,9,12.8993076,7,8.873888135,8.873828135,63,114.4670127,6,5,11,7,6,13,5,0.385029,0.401345,0,No
5060,psychotherapy,9,12.8993076,7,8.873888135,8.873828135,63,114.4670127,6,7,13,7,7,14,4,0.405181,0.422798,0,No
5331,prefect,9,12.8993076,7,8.873888135,8.873828135,63,114.4670127,3,5,8,3,7,10,4,0.421629,0.438572,0,No
5963,pergamon,9,12.8993076,7,8.873888135,8.873828135,63,114.4670127,6,4,10,9,8,17,5,0.384712,0.400989,0,No
6441,ostrich,9,12.8993076,7,8.873888135,8.873828135,63,114.4670127,4,5,9,9,5,14,4,0.424006,0.440614,0,No
7202,mute,9,12.8993076,7,8.873888135,8.873828135,63,114.4670127,6,7,13,8,8,16,4,0.417043,0.434318,0,No
7590,minaret,9,12.8993076,7,8.873888135,8.873828135,63,114.4670127,4,5,9,8,8,16,4,0.414191,0.431426,0,No
7780,mennonite,9,12.8993076,7,8.873888135,8.873828135,63,114.4670127,7,2,9,8,2,10,5,0.32311,0.327014,0,No
8551,loaf,9,12.8993076,7,8.873888135,8.873828135,63,114.4670127,7,8,15,7,8,15,4,0.416036,0.433393,0,No
8884,laundry,9,12.8993076,7,8.873888135,8.873828135,63,114.4670127,9,6,15,9,6,15,5,0.376336,0.392911,0,No
9063,kraft,9,12.8993076,7,8.873888135,8.873828135,63,114.4670127,5,2,7,5,2,7,5,0.325074,0.329247,0,No
9179,keystone,9,12.8993076,7,8.873888135,8.873828135,63,114.4670127,6,5,11,7,5,12,5,0.351053,0.361319,0,No
10799,harley,9,12.8993076,7,8.873888135,8.873828135,63,114.4670127,7,6,13,7,8,15,5,0.384704,0.401022,0,No
11133,grayson,9,12.8993076,7,8.873888135,8.873828135,63,114.4670127,6,4,10,8,8,16,5,0.348209,0.357763,0,No
11517,gauguin,9,12.8993076,7,8.873888135,8.873828135,63,114.4670127,4,7,11,8,8,16,5,0.387737,0.404364,0,No
11652,furious,9,12.8993076,7,8.873888135,8.873828135,63,114.4670127,5,5,10,8,8,16,4,0.391517,0.408409,0,No
12069,flagler,9,12.8993076,7,8.873888135,8.873828135,63,114.4670127,4,5,9,8,9,17,5,0.391621,0.408514,0,No
12213,ferris,9,12.8993076,7,8.873888135,8.873828135,63,114.4670127,6,2,8,7,6,13,5,0.325456,0.329604,0,No
12806,enid,9,12.8993076,7,8.873888135,8.873828135,63,114.4670127,6,3,9,6,3,9,4,0.405459,0.423023,0,No
13368,dominique,9,12.8993076,7,8.873888135,8.873828135,63,114.4670127,7,3,10,8,4,12,5,0.318815,0.323342,0,No
13417,dobson,9,12.8993076,7,8.873888135,8.873828135,63,114.4670127,7,7,14,7,8,15,5,0.385866,0.402317,0,No
14104,cushion,9,12.8993076,7,8.873888135,8.873828135,63,114.4670127,7,6,13,9,8,17,4,0.416241,0.43353,0,No
14181,crypt,9,12.8993076,7,8.873888135,8.873828135,63,114.4670127,5,8,13,8,8,16,4,0.396254,0.413437,0,No
14663,congenital,9,12.8993076,7,8.873888135,8.873828135,63,114.4670127,3,3,6,5,4,9,5,0.321844,0.325071,0,No
14995,clubhouse,9,12.8993076,7,8.873888135,8.873828135,63,114.4670127,6,5,11,8,5,13,4,0.390329,0.407132,0,No
15399,chameleon,9,12.8993076,7,8.873888135,8.873828135,63,114.4670127,4,5,9,5,7,12,5,0.38518,0.401519,0,No
15462,censor,9,12.8993076,7,8.873888135,8.873828135,63,114.4670127,6,6,12,8,6,14,5,0.358367,0.370427,0,No
16430,blubber,9,12.8993076,7,8.873888135,8.873828135,63,114.4670127,4,5,9,7,6,13,4,0.42352,0.440168,0,No
16498,blaine,9,12.8993076,7,8.873888135,8.873828135,63,114.4670127,8,6,14,8,8,16,5,0.349072,0.358863,0,No
16769,beginner,9,12.8993076,7,8.873888135,8.873828135,63,114.4670127,5,3,8,6,3,9,5,0.319763,0.32376,0,No
17299,assurance,9,12.8993076,7,8.873888135,8.873828135,63,114.4670127,6,5,11,8,5,13,4,0.408764,0.426117,0,No
17339,asher,9,12.8993076,7,8.873888135,8.873828135,63,114.4670127,7,6,13,7,7,14,4,0.390286,0.407484,0,No
18218,acrobat,9,12.8993076,7,8.873888135,8.873828135,63,114.4670127,3,7,10,8,7,15,5,0.38728,0.403838,0,No
816,veterinary,11,12.6986369,6,9.028038815,9.027988815,66,114.6437869,10,4,14,10,8,18,5,0.328455,0.33248,0,No
1410,transfusion,11,12.6986369,6,9.028038815,9.027988815,66,114.6437869,2,8,10,11,11,22,4,0.410874,0.428295,0,No
1617,tinker,11,12.6986369,6,9.028038815,9.027988815,66,114.6437869,10,5,15,11,10,21,5,0.376264,0.392799,0,No
2640,staten,11,12.6986369,6,9.028038815,9.027988815,66,114.6437869,7,3,10,7,10,17,5,0.379173,0.395864,0,No
3000,solon,11,12.6986369,6,9.028038815,9.027988815,66,114.6437869,6,7,13,6,7,13,5,0.375341,0.390806,0,No
3501,shasta,11,12.6986369,6,9.028038815,9.027988815,66,114.6437869,5,5,10,8,8,16,5,0.345538,0.354232,0,No
5692,pixel,11,12.6986369,6,9.028038815,9.027988815,66,114.6437869,5,7,12,9,8,17,5,0.357379,0.369221,0,No
5821,phosphor,11,12.6986369,6,9.028038815,9.027988815,66,114.6437869,4,8,12,11,9,20,5,0.369851,0.384334,0,No
6297,pantheon,11,12.6986369,6,9.028038815,9.027988815,66,114.6437869,4,7,11,11,9,20,4,0.414743,0.43199,0,No
7409,montague,11,12.6986369,6,9.028038815,9.027988815,66,114.6437869,8,8,16,9,8,17,5,0.331219,0.335919,0,No
7435,mongoose,11,12.6986369,6,9.028038815,9.027988815,66,114.6437869,4,8,12,11,8,19,4,0.409623,0.427225,0,No
8801,legitimacy,11,12.6986369,6,9.028038815,9.027988815,66,114.6437869,9,10,19,10,10,20,5,0.411408,0.428926,0,No
11154,grapevine,11,12.6986369,6,9.028038815,9.027988815,66,114.6437869,5,8,13,8,10,18,4,0.391707,0.408686,0,No
11297,glycogen,11,12.6986369,6,9.028038815,9.027988815,66,114.6437869,7,5,12,9,6,15,4,0.400167,0.417535,0,No
12083,fitzroy,11,12.6986369,6,9.028038815,9.027988815,66,114.6437869,7,6,13,11,11,22,5,0.340305,0.347392,0,No
13080,ebony,11,12.6986369,6,9.028038815,9.027988815,66,114.6437869,9,8,17,9,9,18,4,0.419755,0.436731,0,No
16059,brothel,11,12.6986369,6,9.028038815,9.027988815,66,114.6437869,4,9,13,11,10,21,4,0.404314,0.421929,0,No
16137,bribe,11,12.6986369,6,9.028038815,9.027988815,66,114.6437869,3,8,11,11,10,21,4,0.410741,0.428154,0,No
16324,boolean,11,12.6986369,6,9.028038815,9.027988815,66,114.6437869,9,3,12,9,11,20,5,0.321111,0.324427,0,No
16878,bassoon,11,12.6986369,6,9.028038815,9.027988815,66,114.6437869,4,9,13,11,11,22,4,0.410105,0.427643,0,No
17770,amorphous,11,12.6986369,6,9.028038815,9.027988815,66,114.6437869,4,7,11,10,10,20,5,0.384579,0.400899,0,No
17982,albatross,11,12.6986369,6,9.028038815,9.027988815,66,114.6437869,7,7,14,10,8,18,5,0.36899,0.38333,0,No
17999,akron,11,12.6986369,6,9.028038815,9.027988815,66,114.6437869,6,7,13,7,10,17,5,0.348702,0.358469,0,No
18211,acrylic,11,12.6986369,6,9.028038815,9.027988815,66,114.6437869,7,6,13,11,9,20,5,0.37851,0.395197,0,No
1143,twinkle,14,12.45747485,5,9.210360372,9.210320372,70,114.7378327,4,2,6,12,14,26,5,0.319073,0.323884,0,No
7689,mew,14,12.45747485,5,9.210360372,9.210320372,70,114.7378327,9,7,16,9,9,18,5,0.368998,0.383126,0,No
11411,geyser,14,12.45747485,5,9.210360372,9.210320372,70,114.7378327,9,7,16,9,13,22,4,0.431835,0.447731,0,No
14127,curia,14,12.45747485,5,9.210360372,9.210320372,70,114.7378327,4,8,12,14,11,25,4,0.410352,0.42791,0,No
15423,cessna,14,12.45747485,5,9.210360372,9.210320372,70,114.7378327,7,9,16,11,12,23,4,0.391181,0.408113,0,No
3344,siegmund,13,12.53158282,5,9.210360372,9.210320372,65,115.4203938,8,6,14,9,6,15,4,0.39333,0.410385,0,No
6704,ocarina,13,12.53158282,5,9.210360372,9.210320372,65,115.4203938,6,6,12,9,12,21,5,0.390862,0.407824,0,No
8555,llama,13,12.53158282,5,9.210360372,9.210320372,65,115.4203938,7,8,15,13,12,25,4,0.432645,0.448468,0,No
10155,hypotenuse,13,12.53158282,5,9.210360372,9.210320372,65,115.4203938,1,6,7,12,13,25,4,0.424818,0.441506,0,No
12623,etiquette,13,12.53158282,5,9.210360372,9.210320372,65,115.4203938,9,10,19,10,10,20,4,0.433936,0.449641,0,No
15542,cataract,13,12.53158282,5,9.210360372,9.210320372,65,115.4203938,9,5,14,13,12,25,4,0.42881,0.445083,0,No
524,watkins,10,12.79394708,6,9.028038815,9.027988815,60,115.5042509,6,7,13,10,9,19,5,0.340671,0.347695,0,No
1382,transvaal,10,12.79394708,6,9.028038815,9.027988815,60,115.5042509,3,9,12,8,9,17,4,0.40345,0.420929,0,No
2623,staunton,10,12.79394708,6,9.028038815,9.027988815,60,115.5042509,6,5,11,8,9,17,5,0.349044,0.358739,0,No
3706,secretariat,10,12.79394708,6,9.028038815,9.027988815,60,115.5042509,4,3,7,7,7,14,5,0.38674,0.40338,0,No
4128,rutgers,10,12.79394708,6,9.028038815,9.027988815,60,115.5042509,6,4,10,7,4,11,4,0.409869,0.4273,0,No
5385,poughkeepsie,10,12.79394708,6,9.028038815,9.027988815,60,115.5042509,7,7,14,9,10,19,4,0.391854,0.408784,0,No
5456,porosity,10,12.79394708,6,9.028038815,9.027988815,60,115.5042509,7,6,13,10,10,20,4,0.428065,0.444459,0,No
6222,parmesan,10,12.79394708,6,9.028038815,9.027988815,60,115.5042509,7,3,10,8,10,18,5,0.369774,0.384159,0,No
6291,pap,10,12.79394708,6,9.028038815,9.027988815,60,115.5042509,9,6,15,9,7,16,4,0.394353,0.41193,0,No
6470,orr,10,12.79394708,6,9.028038815,9.027988815,60,115.5042509,5,7,12,10,8,18,5,0.34322,0.350885,0,No
6575,oneida,10,12.79394708,6,9.028038815,9.027988815,60,115.5042509,4,3,7,6,8,14,5,0.348332,0.357847,0,No
6726,oblivion,10,12.79394708,6,9.028038815,9.027988815,60,115.5042509,7,7,14,10,8,18,4,0.416456,0.433736,0,No
6793,nozzle,10,12.79394708,6,9.028038815,9.027988815,60,115.5042509,5,7,12,10,9,19,5,0.384637,0.401192,0,No
7197,mutton,10,12.79394708,6,9.028038815,9.027988815,60,115.5042509,6,8,14,7,8,15,5,0.385054,0.401681,0,No
8150,manifest,10,12.79394708,6,9.028038815,9.027988815,60,115.5042509,7,7,14,9,9,18,5,0.385916,0.402608,0,No
8199,mallow,10,12.79394708,6,9.028038815,9.027988815,60,115.5042509,6,6,12,8,7,15,4,0.426512,0.442923,0,No
10875,hamlin,10,12.79394708,6,9.028038815,9.027988815,60,115.5042509,8,5,13,9,5,14,5,0.354036,0.364835,0,No
10950,gypsum,10,12.79394708,6,9.028038815,9.027988815,60,115.5042509,7,6,13,7,9,16,4,0.40368,0.421127,0,No
11910,footprint,10,12.79394708,6,9.028038815,9.027988815,60,115.5042509,5,6,11,10,9,19,4,0.425888,0.44236,0,No
13159,dupont,10,12.79394708,6,9.028038815,9.027988815,60,115.5042509,9,5,14,10,6,16,5,0.363959,0.377198,0,No
13283,draco,10,12.79394708,6,9.028038815,9.027988815,60,115.5042509,6,4,10,7,7,14,5,0.346165,0.35523,0,No
13778,demi,10,12.79394708,6,9.028038815,9.027988815,60,115.5042509,6,2,8,7,3,10,5,0.331646,0.33619,0,No
13935,deadline,10,12.79394708,6,9.028038815,9.027988815,60,115.5042509,3,7,10,9,10,19,4,0.429069,0.445383,0,No
15236,chloe,10,12.79394708,6,9.028038815,9.027988815,60,115.5042509,7,6,13,8,6,14,4,0.394756,0.411874,0,No
16180,brazzaville,10,12.79394708,6,9.028038815,9.027988815,60,115.5042509,7,6,13,10,9,19,4,0.427354,0.443693,0,No
16467,blink,10,12.79394708,6,9.028038815,9.027988815,60,115.5042509,8,7,15,9,7,16,5,0.346449,0.355326,0,No
17031,bakersfield,10,12.79394708,6,9.028038815,9.027988815,60,115.5042509,7,5,12,7,9,16,4,0.390261,0.407085,0,No
17306,assign,10,12.79394708,6,9.028038815,9.027988815,60,115.5042509,4,6,10,9,6,15,4,0.381037,0.397705,0,No
18337,abidjan,10,12.79394708,6,9.028038815,9.027988815,60,115.5042509,5,7,12,7,10,17,5,0.351644,0.361913,0,No
233,woo,8,13.01709064,7,8.873888135,8.873828135,56,115.5122061,4,4,8,7,5,12,4,0.387526,0.404015,0,No
660,vow,8,13.01709064,7,8.873888135,8.873828135,56,115.5122061,6,8,14,8,8,16,4,0.436733,0.452153,0,No
703,viz,8,13.01709064,7,8.873888135,8.873828135,56,115.5122061,5,2,7,5,4,9,5,0.324711,0.32815,0,No
730,viscous,8,13.01709064,7,8.873888135,8.873828135,56,115.5122061,6,7,13,6,7,13,5,0.358237,0.370548,0,No
891,venerable,8,13.01709064,7,8.873888135,8.873828135,56,115.5122061,3,3,6,7,3,10,5,0.363214,0.376302,0,No
1118,tyranny,8,13.01709064,7,8.873888135,8.873828135,56,115.5122061,2,4,6,5,8,13,4,0.42351,0.440294,0,No
1156,tweed,8,13.01709064,7,8.873888135,8.873828135,56,115.5122061,6,3,9,6,3,9,5,0.386707,0.403172,0,No
1195,turbulent,8,13.01709064,7,8.873888135,8.873828135,56,115.5122061,7,3,10,8,6,14,5,0.326647,0.330259,0,No
1795,thematic,8,13.01709064,7,8.873888135,8.873828135,56,115.5122061,5,4,9,5,4,9,5,0.384371,0.400604,0,No
1838,testes,8,13.01709064,7,8.873888135,8.873828135,56,115.5122061,2,3,5,7,3,10,5,0.369428,0.383768,0,No
2784,spongy,8,13.01709064,7,8.873888135,8.873828135,56,115.5122061,3,4,7,5,5,10,5,0.325426,0.329103,0,No
2856,spectroscopic,8,13.01709064,7,8.873888135,8.873828135,56,115.5122061,8,4,12,8,4,12,5,0.32351,0.327,0,No
2959,soot,8,13.01709064,7,8.873888135,8.873828135,56,115.5122061,5,6,11,7,8,15,5,0.386665,0.403176,0,No
3368,siamese,8,13.01709064,7,8.873888135,8.873828135,56,115.5122061,5,3,8,7,3,10,5,0.328521,0.332316,0,No
3709,secrecy,8,13.01709064,7,8.873888135,8.873828135,56,115.5122061,2,5,7,6,5,11,5,0.396537,0.413716,0,No
3713,secession,8,13.01709064,7,8.873888135,8.873828135,56,115.5122061,4,3,7,7,3,10,4,0.421849,0.438745,0,No
3969,saratoga,8,13.01709064,7,8.873888135,8.873828135,56,115.5122061,4,5,9,7,5,12,4,0.415335,0.432628,0,No
3970,sarasota,8,13.01709064,7,8.873888135,8.873828135,56,115.5122061,2,2,4,6,8,14,5,0.346625,0.355826,0,No
4438,revive,8,13.01709064,7,8.873888135,8.873828135,56,115.5122061,2,3,5,8,6,14,5,0.417003,0.434588,0,No
4445,revere,8,13.01709064,7,8.873888135,8.873828135,56,115.5122061,3,8,11,8,8,16,4,0.429141,0.445346,0,No
4529,replica,8,13.01709064,7,8.873888135,8.873828135,56,115.5122061,5,6,11,6,7,13,4,0.413738,0.431159,0,No
5203,prohibit,8,13.01709064,7,8.873888135,8.873828135,56,115.5122061,4,5,9,5,5,10,5,0.390166,0.407631,0,No
5614,plentiful,8,13.01709064,7,8.873888135,8.873828135,56,115.5122061,6,7,13,8,8,16,5,0.363088,0.376245,0,No
5694,pivot,8,13.01709064,7,8.873888135,8.873828135,56,115.5122061,3,4,7,6,4,10,5,0.348941,0.358575,0,No
5827,phonology,8,13.01709064,7,8.873888135,8.873828135,56,115.5122061,6,5,11,6,8,14,4,0.422945,0.439787,0,No
6720,obscure,8,13.01709064,7,8.873888135,8.873828135,56,115.5122061,6,6,12,6,6,12,4,0.411188,0.428685,0,No
6724,oblong,8,13.01709064,7,8.873888135,8.873828135,56,115.5122061,5,6,11,6,7,13,5,0.366537,0.380318,0,No
6918,ninety,8,13.01709064,7,8.873888135,8.873828135,56,115.5122061,4,5,9,4,5,9,5,0.352363,0.363112,0,No
6970,nguyen,8,13.01709064,7,8.873888135,8.873828135,56,115.5122061,4,5,9,4,5,9,5,0.384554,0.400834,0,No
7076,nebuchadnezzar,8,13.01709064,7,8.873888135,8.873828135,56,115.5122061,4,2,6,7,7,14,5,0.32857,0.332492,0,No
7192,mycenaean,8,13.01709064,7,8.873888135,8.873828135,56,115.5122061,4,4,8,8,5,13,5,0.327715,0.331513,0,No
7364,moroccan,8,13.01709064,7,8.873888135,8.873828135,56,115.5122061,5,5,10,8,5,13,5,0.334546,0.339879,0,No
7496,modal,8,13.01709064,7,8.873888135,8.873828135,56,115.5122061,5,5,10,7,7,14,5,0.384504,0.400768,0,No
7674,michele,8,13.01709064,7,8.873888135,8.873828135,56,115.5122061,7,5,12,7,5,12,4,0.392947,0.409977,0,No
7719,metalloid,8,13.01709064,7,8.873888135,8.873828135,56,115.5122061,5,6,11,8,8,16,4,0.404747,0.422399,0,No
8013,masquerade,8,13.01709064,7,8.873888135,8.873828135,56,115.5122061,5,4,9,8,5,13,5,0.364729,0.378151,0,No
8241,mailman,8,13.01709064,7,8.873888135,8.873828135,56,115.5122061,4,7,11,8,7,15,4,0.40806,0.425511,0,No
8438,lowe,8,13.01709064,7,8.873888135,8.873828135,56,115.5122061,5,5,10,5,5,10,5,0.365397,0.378921,0,No
8492,longevity,8,13.01709064,7,8.873888135,8.873828135,56,115.5122061,6,4,10,8,4,12,4,0.41837,0.435544,0,No
8956,landslide,8,13.01709064,7,8.873888135,8.873828135,56,115.5122061,3,4,7,8,4,12,4,0.408623,0.426117,0,No
8961,landlord,8,13.01709064,7,8.873888135,8.873828135,56,115.5122061,3,5,8,8,7,15,5,0.409188,0.426588,0,No
9069,koran,8,13.01709064,7,8.873888135,8.873828135,56,115.5122061,1,7,8,7,7,14,4,0.410314,0.427779,0,No
9816,inhalation,8,13.01709064,7,8.873888135,8.873828135,56,115.5122061,6,5,11,6,8,14,4,0.437023,0.452256,0,No
10290,housemate,8,13.01709064,7,8.873888135,8.873828135,56,115.5122061,1,3,4,7,7,14,5,0.365074,0.378604,0,No
10757,hatfield,8,13.01709064,7,8.873888135,8.873828135,56,115.5122061,6,5,11,8,5,13,5,0.387856,0.404481,0,No
11418,gestapo,8,13.01709064,7,8.873888135,8.873828135,56,115.5122061,2,6,8,8,7,15,4,0.403799,0.421347,0,No
11485,gemini,8,13.01709064,7,8.873888135,8.873828135,56,115.5122061,6,6,12,6,6,12,4,0.432614,0.448402,0,No
11578,galveston,8,13.01709064,7,8.873888135,8.873828135,56,115.5122061,6,7,13,7,8,15,5,0.351074,0.361028,0,No
11813,fragmentary,8,13.01709064,7,8.873888135,8.873828135,56,115.5122061,5,2,7,7,2,9,5,0.341668,0.348955,0,No
11943,foliage,8,13.01709064,7,8.873888135,8.873828135,56,115.5122061,5,6,11,6,6,12,5,0.370028,0.384419,0,No
12184,fictitious,8,13.01709064,7,8.873888135,8.873828135,56,115.5122061,4,8,12,8,8,16,5,0.332671,0.337623,0,No
12242,felony,8,13.01709064,7,8.873888135,8.873828135,56,115.5122061,5,7,12,7,7,14,4,0.412124,0.429633,0,No
12332,fang,8,13.01709064,7,8.873888135,8.873828135,56,115.5122061,6,5,11,6,6,12,4,0.417445,0.434492,0,No
12380,factorial,8,13.01709064,7,8.873888135,8.873828135,56,115.5122061,4,6,10,8,7,15,4,0.422552,0.43944,0,No
12389,facade,8,13.01709064,7,8.873888135,8.873828135,56,115.5122061,4,6,10,8,6,14,4,0.408416,0.426079,0,No
12730,equestrian,8,13.01709064,7,8.873888135,8.873828135,56,115.5122061,5,4,9,7,4,11,5,0.375452,0.392033,0,No
12860,emitting,8,13.01709064,7,8.873888135,8.873828135,56,115.5122061,7,7,14,8,8,16,5,0.39906,0.416894,0,No
12988,ejaculate,8,13.01709064,7,8.873888135,8.873828135,56,115.5122061,5,6,11,7,6,13,5,0.378462,0.394188,0,No
13583,diem,8,13.01709064,7,8.873888135,8.873828135,56,115.5122061,2,7,9,2,8,10,4,0.431101,0.447087,0,No
13588,dido,8,13.01709064,7,8.873888135,8.873828135,56,115.5122061,5,5,10,5,6,11,4,0.422552,0.439276,0,No
13709,derogatory,8,13.01709064,7,8.873888135,8.873828135,56,115.5122061,3,6,9,6,7,13,5,0.380408,0.397118,0,No
13815,delete,8,13.01709064,7,8.873888135,8.873828135,56,115.5122061,7,6,13,7,6,13,4,0.413179,0.430426,0,No
14107,curvature,8,13.01709064,7,8.873888135,8.873828135,56,115.5122061,3,4,7,7,8,15,5,0.405552,0.422936,0,No
14697,conduit,8,13.01709064,7,8.873888135,8.873828135,56,115.5122061,6,7,13,6,7,13,4,0.424381,0.440994,0,No
14742,compulsive,8,13.01709064,7,8.873888135,8.873828135,56,115.5122061,4,0,4,6,0,6,0,0,0,0,No
14993,clue,8,13.01709064,7,8.873888135,8.873828135,56,115.5122061,5,5,10,8,8,16,5,0.388,0.404852,0,No
15205,chou,8,13.01709064,7,8.873888135,8.873828135,56,115.5122061,3,6,9,6,7,13,5,0.386985,0.403528,0,No
15381,chanson,8,13.01709064,7,8.873888135,8.873828135,56,115.5122061,6,5,11,7,6,13,4,0.412881,0.430337,0,No
16852,bauhaus,8,13.01709064,7,8.873888135,8.873828135,56,115.5122061,4,5,9,6,7,13,4,0.406294,0.423821,0,No
16947,bard,8,13.01709064,7,8.873888135,8.873828135,56,115.5122061,2,3,5,5,6,11,5,0.379506,0.395448,0,No
17940,alga,8,13.01709064,7,8.873888135,8.873828135,56,115.5122061,8,6,14,8,7,15,4,0.389943,0.406714,0,No
17944,alfalfa,8,13.01709064,7,8.873888135,8.873828135,56,115.5122061,6,3,9,6,5,11,5,0.385606,0.401956,0,No
17961,alden,8,13.01709064,7,8.873888135,8.873828135,56,115.5122061,6,6,12,6,6,12,5,0.350796,0.361098,0,No
18004,aisle,8,13.01709064,7,8.873888135,8.873828135,56,115.5122061,5,6,11,6,7,13,5,0.406993,0.424401,0,No
18157,admiralty,8,13.01709064,7,8.873888135,8.873828135,56,115.5122061,3,6,9,8,7,15,4,0.396051,0.413258,0,No
10708,headset,17,12.26331883,4,9.433503923,9.433473923,68,115.6860663,8,11,19,13,16,29,4,0.447918,0.461589,0,No
876,ventricle,12,12.61162553,5,9.210360372,9.210320372,60,116.157616,4,7,11,12,9,21,4,0.422814,0.439698,0,No
3135,sloth,12,12.61162553,5,9.210360372,9.210320372,60,116.157616,9,5,14,10,8,18,5,0.386244,0.402679,0,No
4205,rousseau,12,12.61162553,5,9.210360372,9.210320372,60,116.157616,6,9,15,7,9,16,4,0.427087,0.443515,0,No
4772,ramsey,12,12.61162553,5,9.210360372,9.210320372,60,116.157616,9,8,17,9,11,20,4,0.427529,0.443886,0,No
5293,pretoria,12,12.61162553,5,9.210360372,9.210320372,60,116.157616,7,9,16,11,11,22,4,0.427601,0.443947,0,No
6533,optic,12,12.61162553,5,9.210360372,9.210320372,60,116.157616,1,3,4,11,7,18,5,0.313014,0.317395,0,No
6680,octal,12,12.61162553,5,9.210360372,9.210320372,60,116.157616,4,6,10,9,10,19,4,0.411427,0.428966,0,No
8420,lucifer,12,12.61162553,5,9.210360372,9.210320372,60,116.157616,6,6,12,6,12,18,5,0.371648,0.386356,0,No
8490,longhorn,12,12.61162553,5,9.210360372,9.210320372,60,116.157616,5,8,13,6,9,15,4,0.407619,0.425192,0,No
9002,lag,12,12.61162553,5,9.210360372,9.210320372,60,116.157616,3,8,11,10,10,20,5,0.375635,0.391097,0,No
9547,isolde,12,12.61162553,5,9.210360372,9.210320372,60,116.157616,5,8,13,8,11,19,4,0.425704,0.442332,0,No
10609,henley,12,12.61162553,5,9.210360372,9.210320372,60,116.157616,8,7,15,10,11,21,5,0.389841,0.406632,0,No
11303,gluten,12,12.61162553,5,9.210360372,9.210320372,60,116.157616,7,10,17,8,11,19,5,0.389995,0.407082,0,No
11790,frankfurter,12,12.61162553,5,9.210360372,9.210320372,60,116.157616,4,0,4,10,0,10,0,0,0,0,No
13925,dearborn,12,12.61162553,5,9.210360372,9.210320372,60,116.157616,8,8,16,11,11,22,5,0.367729,0.381722,0,No
14903,coleridge,12,12.61162553,5,9.210360372,9.210320372,60,116.157616,6,8,14,10,9,19,4,0.40883,0.426337,0,No
16659,bernini,12,12.61162553,5,9.210360372,9.210320372,60,116.157616,4,9,13,4,12,16,4,0.385925,0.402883,0,No
16922,barr,12,12.61162553,5,9.210360372,9.210320372,60,116.157616,4,7,11,4,9,13,4,0.415899,0.433168,0,No
17621,antecedent,12,12.61162553,5,9.210360372,9.210320372,60,116.157616,3,8,11,10,12,22,4,0.431835,0.447749,0,No
17789,amman,12,12.61162553,5,9.210360372,9.210320372,60,116.157616,7,7,14,7,9,16,5,0.332441,0.337681,0,No
3977,sappho,16,12.32394346,4,9.433503923,9.433473923,64,116.2579689,10,4,14,13,9,22,5,0.338385,0.344791,0,No
9150,kindle,16,12.32394346,4,9.433503923,9.433473923,64,116.2579689,7,11,18,16,16,32,5,0.359128,0.371311,0,No
301,windy,9,12.8993076,6,9.028038815,9.027988815,54,116.4554497,7,5,12,8,7,15,5,0.396431,0.413608,0,No
321,williamson,9,12.8993076,6,9.028038815,9.027988815,54,116.4554497,7,8,15,9,8,17,4,0.399033,0.41638,0,No
521,wattle,9,12.8993076,6,9.028038815,9.027988815,54,116.4554497,5,7,12,5,7,12,4,0.408793,0.426337,0,No
603,wally,9,12.8993076,6,9.028038815,9.027988815,54,116.4554497,2,5,7,2,6,8,5,0.384537,0.400787,0,No
1300,trioxide,9,12.8993076,6,9.028038815,9.027988815,54,116.4554497,3,7,10,9,9,18,5,0.363207,0.376208,0,No
1790,theocracy,9,12.8993076,6,9.028038815,9.027988815,54,116.4554497,8,5,13,9,6,15,4,0.421679,0.438609,0,No
2223,suzerainty,9,12.8993076,6,9.028038815,9.027988815,54,116.4554497,7,5,12,9,7,16,5,0.382969,0.399239,0,No
2420,stump,9,12.8993076,6,9.028038815,9.027988815,54,116.4554497,3,4,7,9,6,15,5,0.381619,0.397791,0,No
2676,stampede,9,12.8993076,6,9.028038815,9.027988815,54,116.4554497,5,5,10,8,5,13,5,0.398058,0.415478,0,No
2710,stab,9,12.8993076,6,9.028038815,9.027988815,54,116.4554497,5,7,12,6,7,13,4,0.423247,0.439952,0,No
3745,seaboard,9,12.8993076,6,9.028038815,9.027988815,54,116.4554497,3,9,12,9,9,18,4,0.434137,0.449914,0,No
3772,scribe,9,12.8993076,6,9.028038815,9.027988815,54,116.4554497,5,7,12,8,7,15,4,0.427015,0.443398,0,No
3828,schulz,9,12.8993076,6,9.028038815,9.027988815,54,116.4554497,3,6,9,7,8,15,5,0.386194,0.402632,0,No
4684,recessive,9,12.8993076,6,9.028038815,9.027988815,54,116.4554497,7,5,12,9,6,15,5,0.36211,0.375072,0,No
4839,rabin,9,12.8993076,6,9.028038815,9.027988815,54,116.4554497,0,6,6,0,8,8,4,0.424445,0.441035,0,No
5405,postscript,9,12.8993076,6,9.028038815,9.027988815,54,116.4554497,4,5,9,6,7,13,5,0.367462,0.381579,0,No
5573,podium,9,12.8993076,6,9.028038815,9.027988815,54,116.4554497,5,4,9,8,5,13,5,0.398219,0.415861,0,No
5859,pheasant,9,12.8993076,6,9.028038815,9.027988815,54,116.4554497,3,5,8,6,7,13,5,0.364572,0.377917,0,No
6798,novosibirsk,9,12.8993076,6,9.028038815,9.027988815,54,116.4554497,6,5,11,7,5,12,5,0.376304,0.39175,0,No
7462,moline,9,12.8993076,6,9.028038815,9.027988815,54,116.4554497,5,4,9,8,9,17,4,0.390613,0.407432,0,No
8014,masque,9,12.8993076,6,9.028038815,9.027988815,54,116.4554497,5,5,10,9,8,17,4,0.428571,0.444914,0,No
9075,kodiak,9,12.8993076,6,9.028038815,9.027988815,54,116.4554497,7,6,13,9,9,18,5,0.34998,0.359979,0,No
9238,katz,9,12.8993076,6,9.028038815,9.027988815,54,116.4554497,5,6,11,5,6,11,5,0.385707,0.402134,0,No
9250,karol,9,12.8993076,6,9.028038815,9.027988815,54,116.4554497,7,2,9,8,2,10,5,0.336193,0.342239,0,No
10574,hermetic,9,12.8993076,6,9.028038815,9.027988815,54,116.4554497,2,3,5,9,9,18,5,0.323717,0.326966,0,No
11400,gibbon,9,12.8993076,6,9.028038815,9.027988815,54,116.4554497,3,7,10,4,7,11,5,0.385958,0.402406,0,No
11572,gamete,9,12.8993076,6,9.028038815,9.027988815,54,116.4554497,9,6,15,9,7,16,4,0.37406,0.389161,0,No
11634,fuzz,9,12.8993076,6,9.028038815,9.027988815,54,116.4554497,5,6,11,8,8,16,4,0.416778,0.433882,0,No
11785,fraternal,9,12.8993076,6,9.028038815,9.027988815,54,116.4554497,5,2,7,6,4,10,5,0.384246,0.40043,0,No
13337,dorchester,9,12.8993076,6,9.028038815,9.027988815,54,116.4554497,6,7,13,9,7,16,5,0.368057,0.382301,0,No
13434,dividend,9,12.8993076,6,9.028038815,9.027988815,54,116.4554497,4,7,11,9,9,18,4,0.419507,0.436487,0,No
14413,cos,9,12.8993076,6,9.028038815,9.027988815,54,116.4554497,6,6,12,6,6,12,4,0.405357,0.42276,0,No
14491,cop,9,12.8993076,6,9.028038815,9.027988815,54,116.4554497,3,7,10,4,9,13,4,0.390535,0.407414,0,No
14694,coney,9,12.8993076,6,9.028038815,9.027988815,54,116.4554497,7,2,9,8,9,17,5,0.330405,0.33494,0,No
15060,cleanup,9,12.8993076,6,9.028038815,9.027988815,54,116.4554497,6,7,13,8,8,16,4,0.407469,0.424892,0,No
16177,breadfruit,9,12.8993076,6,9.028038815,9.027988815,54,116.4554497,5,1,6,8,1,9,5,0.284517,0.290767,0,No
16223,bradbury,9,12.8993076,6,9.028038815,9.027988815,54,116.4554497,7,7,14,9,7,16,4,0.422764,0.43951,0,No
16620,bette,9,12.8993076,6,9.028038815,9.027988815,54,116.4554497,5,1,6,5,6,11,5,0.314016,0.318321,0,No
16798,bedrock,9,12.8993076,6,9.028038815,9.027988815,54,116.4554497,6,7,13,7,9,16,4,0.415714,0.433276,0,No
16943,barge,9,12.8993076,6,9.028038815,9.027988815,54,116.4554497,7,7,14,8,8,16,4,0.421869,0.438858,0,No
17488,aqueous,9,12.8993076,6,9.028038815,9.027988815,54,116.4554497,4,4,8,8,7,15,5,0.38772,0.404308,0,No
644,waco,7,13.15062203,7,8.873888135,8.873828135,49,116.6971488,2,3,5,6,7,13,5,0.341951,0.349631,0,No
800,vicinity,7,13.15062203,7,8.873888135,8.873828135,49,116.6971488,2,3,5,5,6,11,5,0.380531,0.396509,0,No
809,vibrant,7,13.15062203,7,8.873888135,8.873828135,49,116.6971488,6,3,9,7,3,10,5,0.324231,0.327461,0,No
938,vanity,7,13.15062203,7,8.873888135,8.873828135,49,116.6971488,5,4,9,5,6,11,5,0.38457,0.40081,0,No
1019,urinate,7,13.15062203,7,8.873888135,8.873828135,49,116.6971488,4,6,10,7,7,14,4,0.409009,0.426675,0,No
1123,typhus,7,13.15062203,7,8.873888135,8.873828135,49,116.6971488,4,5,9,5,5,10,5,0.365194,0.378696,0,No
1307,trim,7,13.15062203,7,8.873888135,8.873828135,49,116.6971488,5,4,9,7,4,11,4,0.423056,0.439712,0,No
1348,tremendous,7,13.15062203,7,8.873888135,8.873828135,49,116.6971488,3,5,8,7,6,13,5,0.325092,0.328431,0,No
1489,totalitarian,7,13.15062203,7,8.873888135,8.873828135,49,116.6971488,5,2,7,7,2,9,5,0.328424,0.332424,0,No
1714,thousandth,7,13.15062203,7,8.873888135,8.873828135,49,116.6971488,1,3,4,6,7,13,5,0.404858,0.422232,0,No
1986,tasting,7,13.15062203,7,8.873888135,8.873828135,49,116.6971488,4,5,9,4,5,9,5,0.426348,0.443076,0,No
2148,symbiotic,7,13.15062203,7,8.873888135,8.873828135,49,116.6971488,7,2,9,7,4,11,5,0.322154,0.325988,0,No
2164,swore,7,13.15062203,7,8.873888135,8.873828135,49,116.6971488,4,5,9,5,7,12,4,0.418015,0.435243,0,No
2414,sturdy,7,13.15062203,7,8.873888135,8.873828135,49,116.6971488,4,5,9,7,7,14,5,0.331485,0.336067,0,No
2529,stokes,7,13.15062203,7,8.873888135,8.873828135,49,116.6971488,5,7,12,5,7,12,5,0.352868,0.36357,0,No
2914,souvenir,7,13.15062203,7,8.873888135,8.873828135,49,116.6971488,5,5,10,5,5,10,5,0.387839,0.404449,0,No
2986,someday,7,13.15062203,7,8.873888135,8.873828135,49,116.6971488,7,4,11,7,5,12,4,0.414656,0.431816,0,No
3214,skillful,7,13.15062203,7,8.873888135,8.873828135,49,116.6971488,5,2,7,7,2,9,5,0.322634,0.326219,0,No
3386,shrink,7,13.15062203,7,8.873888135,8.873828135,49,116.6971488,5,6,11,7,6,13,5,0.394862,0.411955,0,No
3716,sec,7,13.15062203,7,8.873888135,8.873828135,49,116.6971488,5,1,6,5,1,6,5,0.345599,0.354479,0,No
3924,saviour,7,13.15062203,7,8.873888135,8.873828135,49,116.6971488,7,5,12,7,5,12,5,0.396396,0.413575,0,No
4186,rubbery,7,13.15062203,7,8.873888135,8.873828135,49,116.6971488,6,6,12,7,6,13,4,0.422693,0.439421,0,No
4190,royce,7,13.15062203,7,8.873888135,8.873828135,49,116.6971488,4,6,10,5,6,11,5,0.386042,0.402587,0,No
4679,reciprocal,7,13.15062203,7,8.873888135,8.873828135,49,116.6971488,4,2,6,6,4,10,5,0.378704,0.394523,0,No
4805,raft,7,13.15062203,7,8.873888135,8.873828135,49,116.6971488,5,6,11,7,6,13,4,0.423561,0.440374,0,No
5054,ptolemaic,7,13.15062203,7,8.873888135,8.873828135,49,116.6971488,2,5,7,7,7,14,5,0.37936,0.395942,0,No
5172,prop,7,13.15062203,7,8.873888135,8.873828135,49,116.6971488,2,3,5,7,5,12,5,0.335361,0.341275,0,No
5180,prone,7,13.15062203,7,8.873888135,8.873828135,49,116.6971488,5,1,6,6,7,13,5,0.359172,0.371523,0,No
5196,prolate,7,13.15062203,7,8.873888135,8.873828135,49,116.6971488,2,1,3,2,7,9,6,0.27022,0.275541,0,No
5351,pre,7,13.15062203,7,8.873888135,8.873828135,49,116.6971488,3,3,6,4,4,8,5,0.337953,0.344279,0,No
5621,plebiscite,7,13.15062203,7,8.873888135,8.873828135,49,116.6971488,2,6,8,7,7,14,5,0.391474,0.408627,0,No
5728,pinto,7,13.15062203,7,8.873888135,8.873828135,49,116.6971488,4,4,8,4,4,8,5,0.361579,0.374476,0,No
5881,petrochemical,7,13.15062203,7,8.873888135,8.873828135,49,116.6971488,5,3,8,7,4,11,5,0.384312,0.400524,0,No
6029,penetrate,7,13.15062203,7,8.873888135,8.873828135,49,116.6971488,4,5,9,5,6,11,4,0.40867,0.426192,0,No
6181,passover,7,13.15062203,7,8.873888135,8.873828135,49,116.6971488,4,4,8,6,6,12,4,0.423005,0.439679,0,No
6224,parliamentarian,7,13.15062203,7,8.873888135,8.873828135,49,116.6971488,5,4,9,6,5,11,5,0.38457,0.400824,0,No
6433,otter,7,13.15062203,7,8.873888135,8.873828135,49,116.6971488,5,3,8,6,4,10,5,0.386278,0.402688,0,No
6477,ornate,7,13.15062203,7,8.873888135,8.873828135,49,116.6971488,3,6,9,5,6,11,5,0.401252,0.419114,0,No
6485,orinoco,7,13.15062203,7,8.873888135,8.873828135,49,116.6971488,3,6,9,7,7,14,5,0.388782,0.405491,0,No
6586,omitted,7,13.15062203,7,8.873888135,8.873828135,49,116.6971488,5,6,11,7,7,14,4,0.429006,0.445336,0,No
6711,obstacle,7,13.15062203,7,8.873888135,8.873828135,49,116.6971488,3,6,9,7,6,13,4,0.431856,0.447726,0,No
7165,nadine,7,13.15062203,7,8.873888135,8.873828135,49,116.6971488,5,2,7,5,2,7,5,0.331157,0.33613,0,No
7302,moustache,7,13.15062203,7,8.873888135,8.873828135,49,116.6971488,4,4,8,4,6,10,5,0.38674,0.403214,0,No
7442,monastic,7,13.15062203,7,8.873888135,8.873828135,49,116.6971488,5,3,8,6,4,10,5,0.328066,0.331935,0,No
7541,mischievous,7,13.15062203,7,8.873888135,8.873828135,49,116.6971488,6,5,11,7,5,12,5,0.385464,0.401834,0,No
7624,milestone,7,13.15062203,7,8.873888135,8.873828135,49,116.6971488,6,5,11,6,6,12,5,0.371313,0.385961,0,No
7736,mesh,7,13.15062203,7,8.873888135,8.873828135,49,116.6971488,5,5,10,5,5,10,5,0.362591,0.37564,0,No
7798,memorable,7,13.15062203,7,8.873888135,8.873828135,49,116.6971488,5,3,8,6,3,9,5,0.322681,0.326305,0,No
7815,mellow,7,13.15062203,7,8.873888135,8.873828135,49,116.6971488,7,6,13,7,6,13,5,0.385221,0.401585,0,No
7835,megawatt,7,13.15062203,7,8.873888135,8.873828135,49,116.6971488,4,2,6,6,2,8,5,0.323988,0.327628,0,No
7869,meantime,7,13.15062203,7,8.873888135,8.873828135,49,116.6971488,1,5,6,7,6,13,4,0.399833,0.41753,0,No
7880,md,7,13.15062203,7,8.873888135,8.873828135,49,116.6971488,5,4,9,5,5,10,5,0.347344,0.35673,0,No
7885,mcmillan,7,13.15062203,7,8.873888135,8.873828135,49,116.6971488,6,6,12,7,6,13,5,0.396945,0.414176,0,No
8326,mace,7,13.15062203,7,8.873888135,8.873828135,49,116.6971488,5,4,9,7,4,11,5,0.38477,0.401045,0,No
8543,lobby,7,13.15062203,7,8.873888135,8.873828135,49,116.6971488,4,2,6,7,5,12,5,0.378672,0.39449,0,No
8583,literate,7,13.15062203,7,8.873888135,8.873828135,49,116.6971488,5,5,10,5,5,10,5,0.410248,0.427893,0,No
9352,jovian,7,13.15062203,7,8.873888135,8.873828135,49,116.6971488,6,3,9,6,3,9,5,0.328042,0.331767,0,No
9364,josephus,7,13.15062203,7,8.873888135,8.873828135,49,116.6971488,3,4,7,3,6,9,5,0.384654,0.400923,0,No
9465,jazzy,7,13.15062203,7,8.873888135,8.873828135,49,116.6971488,3,5,8,4,6,10,5,0.322464,0.326077,0,No
9677,intervene,7,13.15062203,7,8.873888135,8.873828135,49,116.6971488,3,4,7,7,6,13,4,0.416768,0.433976,0,No
9681,interruption,7,13.15062203,7,8.873888135,8.873828135,49,116.6971488,4,5,9,7,5,12,5,0.380474,0.396487,0,No
9945,incorporate,7,13.15062203,7,8.873888135,8.873828135,49,116.6971488,4,7,11,5,7,12,4,0.416192,0.433722,0,No
9988,inaugural,7,13.15062203,7,8.873888135,8.873828135,49,116.6971488,2,5,7,6,7,13,5,0.33054,0.334964,0,No
10047,imp,7,13.15062203,7,8.873888135,8.873828135,49,116.6971488,4,6,10,5,6,11,4,0.42216,0.439079,0,No
10350,hoof,7,13.15062203,7,8.873888135,8.873828135,49,116.6971488,3,5,8,6,5,11,5,0.351714,0.36222,0,No
10387,homeric,7,13.15062203,7,8.873888135,8.873828135,49,116.6971488,2,4,6,7,4,11,5,0.327902,0.331586,0,No
10671,hecuba,7,13.15062203,7,8.873888135,8.873828135,49,116.6971488,5,6,11,6,6,12,5,0.40821,0.425626,0,No
10943,haag,7,13.15062203,7,8.873888135,8.873828135,49,116.6971488,1,5,6,7,6,13,5,0.396493,0.413669,0,No
11514,gaulle,7,13.15062203,7,8.873888135,8.873828135,49,116.6971488,1,4,5,7,4,11,5,0.331348,0.33579,0,No
11605,galapagos,7,13.15062203,7,8.873888135,8.873828135,49,116.6971488,1,1,2,7,1,8,5,0.340155,0.347429,0,No
11608,gala,7,13.15062203,7,8.873888135,8.873828135,49,116.6971488,6,6,12,6,6,12,5,0.355134,0.366124,0,No
11961,flyer,7,13.15062203,7,8.873888135,8.873828135,49,116.6971488,5,5,10,6,5,11,4,0.423985,0.4406,0,No
12049,flashlight,7,13.15062203,7,8.873888135,8.873828135,49,116.6971488,4,6,10,7,7,14,5,0.405117,0.422556,0,No
12193,fiancee,7,13.15062203,7,8.873888135,8.873828135,49,116.6971488,6,3,9,7,5,12,4,0.405209,0.422779,0,No
12201,fetish,7,13.15062203,7,8.873888135,8.873828135,49,116.6971488,5,6,11,7,6,13,5,0.339953,0.347304,0,No
12316,farmhouse,7,13.15062203,7,8.873888135,8.873828135,49,116.6971488,4,3,7,6,5,11,5,0.361822,0.37474,0,No
12376,fad,7,13.15062203,7,8.873888135,8.873828135,49,116.6971488,3,5,8,6,5,11,4,0.388544,0.405184,0,No
12714,erase,7,13.15062203,7,8.873888135,8.873828135,49,116.6971488,4,4,8,7,6,13,5,0.398353,0.416162,0,No
12762,epidemiology,7,13.15062203,7,8.873888135,8.873828135,49,116.6971488,3,4,7,5,4,9,4,0.422723,0.439417,0,No
12775,envoy,7,13.15062203,7,8.873888135,8.873828135,49,116.6971488,5,3,8,6,4,10,5,0.367424,0.381497,0,No
12791,enthusiasm,7,13.15062203,7,8.873888135,8.873828135,49,116.6971488,2,6,8,6,7,13,4,0.407413,0.424957,0,No
13447,disturb,7,13.15062203,7,8.873888135,8.873828135,49,116.6971488,6,5,11,7,6,13,4,0.400239,0.417925,0,No
13463,dissertation,7,13.15062203,7,8.873888135,8.873828135,49,116.6971488,3,4,7,5,4,9,5,0.369228,0.383454,0,No
13473,disperse,7,13.15062203,7,8.873888135,8.873828135,49,116.6971488,5,4,9,7,6,13,4,0.429307,0.445416,0,No
13474,dispersal,7,13.15062203,7,8.873888135,8.873828135,49,116.6971488,7,5,12,7,5,12,4,0.421869,0.438787,0,No
13643,devour,7,13.15062203,7,8.873888135,8.873828135,49,116.6971488,4,6,10,6,6,12,4,0.432266,0.448102,0,No
13746,dentistry,7,13.15062203,7,8.873888135,8.873828135,49,116.6971488,6,6,12,7,6,13,4,0.389362,0.406573,0,No
13809,delicacy,7,13.15062203,7,8.873888135,8.873828135,49,116.6971488,3,4,7,7,4,11,5,0.378301,0.394102,0,No
13886,deception,7,13.15062203,7,8.873888135,8.873828135,49,116.6971488,3,4,7,4,5,9,5,0.398523,0.416321,0,No
13966,dateline,7,13.15062203,7,8.873888135,8.873828135,49,116.6971488,3,5,8,6,6,12,4,0.400636,0.417972,0,No
14375,counterclockwise,7,13.15062203,7,8.873888135,8.873828135,49,116.6971488,5,7,12,5,7,12,4,0.41917,0.436323,0,No
14382,counselor,7,13.15062203,7,8.873888135,8.873828135,49,116.6971488,5,5,10,6,5,11,4,0.395636,0.412798,0,No
14425,corrosive,7,13.15062203,7,8.873888135,8.873828135,49,116.6971488,6,6,12,7,6,13,4,0.395971,0.41316,0,No
14464,corinthian,7,13.15062203,7,8.873888135,8.873828135,49,116.6971488,6,4,10,7,5,12,5,0.330177,0.334362,0,No
14518,converse,7,13.15062203,7,8.873888135,8.873828135,49,116.6971488,4,5,9,6,5,11,5,0.385138,0.401482,0,No
14719,concise,7,13.15062203,7,8.873888135,8.873828135,49,116.6971488,5,4,9,6,5,11,5,0.38467,0.400942,0,No
14778,complain,7,13.15062203,7,8.873888135,8.873828135,49,116.6971488,2,6,8,5,7,12,4,0.440909,0.455627,0,No
14913,coinage,7,13.15062203,7,8.873888135,8.873828135,49,116.6971488,7,7,14,7,7,14,4,0.427879,0.44421,0,No
14924,cognition,7,13.15062203,7,8.873888135,8.873828135,49,116.6971488,5,6,11,6,7,13,5,0.406387,0.423823,0,No
15174,chubby,7,13.15062203,7,8.873888135,8.873828135,49,116.6971488,4,2,6,5,2,7,5,0.321885,0.325436,0,No
15316,cheerful,7,13.15062203,7,8.873888135,8.873828135,49,116.6971488,4,4,8,7,5,12,4,0.387103,0.403574,0,No
15457,centenary,7,13.15062203,7,8.873888135,8.873828135,49,116.6971488,2,5,7,5,7,12,5,0.387255,0.403976,0,No
15485,cede,7,13.15062203,7,8.873888135,8.873828135,49,116.6971488,5,5,10,7,6,13,5,0.39889,0.416678,0,No
15514,caudal,7,13.15062203,7,8.873888135,8.873828135,49,116.6971488,4,2,6,6,7,13,5,0.355219,0.366942,0,No
15631,carleton,7,13.15062203,7,8.873888135,8.873828135,49,116.6971488,4,1,5,6,1,7,5,0.324527,0.32819,0,No
15903,businesswoman,7,13.15062203,7,8.873888135,8.873828135,49,116.6971488,5,6,11,5,7,12,4,0.3932,0.410268,0,No
16504,blackout,7,13.15062203,7,8.873888135,8.873828135,49,116.6971488,7,6,13,7,7,14,4,0.427385,0.443834,0,No
16561,binocular,7,13.15062203,7,8.873888135,8.873828135,49,116.6971488,6,3,9,7,6,13,5,0.345774,0.354742,0,No
16691,benthic,7,13.15062203,7,8.873888135,8.873828135,49,116.6971488,6,4,10,6,4,10,5,0.356045,0.367989,0,No
16727,belmont,7,13.15062203,7,8.873888135,8.873828135,49,116.6971488,4,5,9,7,5,12,5,0.385916,0.403103,0,No
16969,bantam,7,13.15062203,7,8.873888135,8.873828135,49,116.6971488,4,4,8,5,4,9,5,0.35468,0.365791,0,No
17024,balcony,7,13.15062203,7,8.873888135,8.873828135,49,116.6971488,5,6,11,7,7,14,4,0.440275,0.455087,0,No
17178,authentic,7,13.15062203,7,8.873888135,8.873828135,49,116.6971488,7,4,11,7,5,12,5,0.386219,0.402608,0,No
17366,arthropod,7,13.15062203,7,8.873888135,8.873828135,49,116.6971488,7,5,12,7,5,12,5,0.354992,0.366223,0,No
17463,archdiocese,7,13.15062203,7,8.873888135,8.873828135,49,116.6971488,4,4,8,6,6,12,5,0.385322,0.401864,0,No
17534,apparel,7,13.15062203,7,8.873888135,8.873828135,49,116.6971488,3,3,6,3,3,6,5,0.390871,0.40766,0,No
17795,amid,7,13.15062203,7,8.873888135,8.873828135,49,116.6971488,5,2,7,5,4,9,5,0.398094,0.415861,0,No
17804,amend,7,13.15062203,7,8.873888135,8.873828135,49,116.6971488,3,5,8,6,6,12,4,0.408257,0.42592,0,No
17916,align,7,13.15062203,7,8.873888135,8.873828135,49,116.6971488,5,6,11,5,6,11,4,0.407666,0.425192,0,No
18030,aide,7,13.15062203,7,8.873888135,8.873828135,49,116.6971488,7,3,10,7,7,14,5,0.361314,0.374161,0,No
18117,advise,7,13.15062203,7,8.873888135,8.873828135,49,116.6971488,4,6,10,6,6,12,4,0.434754,0.450313,0,No
18166,adjectival,7,13.15062203,7,8.873888135,8.873828135,49,116.6971488,2,1,3,7,7,14,5,0.323481,0.326742,0,No
18173,adequate,7,13.15062203,7,8.873888135,8.873828135,49,116.6971488,6,4,10,6,4,10,5,0.345095,0.353817,0,No
18247,accusation,7,13.15062203,7,8.873888135,8.873828135,49,116.6971488,5,6,11,7,7,14,5,0.39266,0.409744,0,No
9308,juneau,15,12.38848198,4,9.433503923,9.433473923,60,116.8667933,8,10,18,13,14,27,4,0.392409,0.409479,0,No
251,wok,11,12.6986369,5,9.210360372,9.210320372,55,116.9590221,5,5,10,10,9,19,4,0.425337,0.441834,0,No
2137,synapse,11,12.6986369,5,9.210360372,9.210320372,55,116.9590221,4,7,11,10,9,19,4,0.414385,0.431807,0,No
2737,sputnik,11,12.6986369,5,9.210360372,9.210320372,55,116.9590221,5,6,11,8,8,16,4,0.403524,0.421112,0,No
2966,sonnet,11,12.6986369,5,9.210360372,9.210320372,55,116.9590221,7,4,11,9,5,14,5,0.390475,0.407265,0,No
4044,salmonella,11,12.6986369,5,9.210360372,9.210320372,55,116.9590221,8,5,13,9,9,18,5,0.362251,0.375194,0,No
4320,riyadh,11,12.6986369,5,9.210360372,9.210320372,55,116.9590221,8,7,15,11,9,20,4,0.440013,0.454871,0,No
5675,plaintiff,11,12.6986369,5,9.210360372,9.210320372,55,116.9590221,2,9,11,11,10,21,4,0.426748,0.44321,0,No
5961,pericles,11,12.6986369,5,9.210360372,9.210320372,55,116.9590221,6,9,15,7,10,17,4,0.398442,0.41577,0,No
7422,monomer,11,12.6986369,5,9.210360372,9.210320372,55,116.9590221,7,4,11,9,4,13,5,0.344252,0.352745,0,No
8165,mandrake,11,12.6986369,5,9.210360372,9.210320372,55,116.9590221,5,3,8,7,3,10,5,0.348565,0.358197,0,No
8175,managua,11,12.6986369,5,9.210360372,9.210320372,55,116.9590221,9,10,19,10,10,20,4,0.422191,0.439125,0,No
9532,itch,11,12.6986369,5,9.210360372,9.210320372,55,116.9590221,10,6,16,10,9,19,4,0.427467,0.443792,0,No
9904,indochinese,11,12.6986369,5,9.210360372,9.210320372,55,116.9590221,4,3,7,10,10,20,5,0.328436,0.332229,0,No
11421,gershwin,11,12.6986369,5,9.210360372,9.210320372,55,116.9590221,6,7,13,9,7,16,5,0.357321,0.369112,0,No
13288,dowry,11,12.6986369,5,9.210360372,9.210320372,55,116.9590221,7,7,14,11,7,18,5,0.389234,0.40614,0,No
14030,dakar,11,12.6986369,5,9.210360372,9.210320372,55,116.9590221,5,8,13,8,10,18,4,0.417916,0.435102,0,No
5530,pollock,14,12.45747485,4,9.433503923,9.433473923,56,117.5176378,9,9,18,10,14,24,4,0.393182,0.410287,0,No
6557,opec,14,12.45747485,4,9.433503923,9.433473923,56,117.5176378,9,9,18,11,11,22,4,0.43596,0.451392,0,No
6915,niobe,14,12.45747485,4,9.433503923,9.433473923,56,117.5176378,9,7,16,9,8,17,4,0.416866,0.434107,0,No
15320,cheddar,14,12.45747485,4,9.433503923,9.433473923,56,117.5176378,9,4,13,10,11,21,5,0.369959,0.384403,0,No
16212,braille,14,12.45747485,4,9.433503923,9.433473923,56,117.5176378,8,8,16,14,13,27,4,0.427519,0.443876,0,No
647,wabash,8,13.01709064,6,9.028038815,9.027988815,48,117.5187995,3,6,9,6,8,14,5,0.350519,0.360765,0,No
953,valparaiso,8,13.01709064,6,9.028038815,9.027988815,48,117.5187995,5,7,12,6,8,14,4,0.40836,0.425981,0,No
1660,tibia,8,13.01709064,6,9.028038815,9.027988815,48,117.5187995,4,7,11,6,7,13,5,0.347752,0.357139,0,No
1758,thetis,8,13.01709064,6,9.028038815,9.027988815,48,117.5187995,5,6,11,6,6,12,5,0.350803,0.361074,0,No
2215,swami,8,13.01709064,6,9.028038815,9.027988815,48,117.5187995,4,3,7,5,3,8,5,0.338979,0.34603,0,No
3246,siren,8,13.01709064,6,9.028038815,9.027988815,48,117.5187995,5,4,9,7,6,13,4,0.407058,0.424577,0,No
3933,sault,8,13.01709064,6,9.028038815,9.027988815,48,117.5187995,6,2,8,6,2,8,5,0.378704,0.394528,0,No
4006,sandal,8,13.01709064,6,9.028038815,9.027988815,48,117.5187995,6,6,12,7,7,14,5,0.361373,0.374454,0,No
4758,rangoon,8,13.01709064,6,9.028038815,9.027988815,48,117.5187995,5,6,11,6,6,12,4,0.400194,0.417563,0,No
4788,raisin,8,13.01709064,6,9.028038815,9.027988815,48,117.5187995,6,3,9,6,7,13,5,0.322043,0.325231,0,No
5294,presumptive,8,13.01709064,6,9.028038815,9.027988815,48,117.5187995,3,2,5,8,7,15,5,0.359187,0.37156,0,No
5372,ppm,8,13.01709064,6,9.028038815,9.027988815,48,117.5187995,5,5,10,5,6,11,5,0.398657,0.416011,0,No
5426,possessive,8,13.01709064,6,9.028038815,9.027988815,48,117.5187995,5,4,9,8,5,13,5,0.333427,0.338828,0,No
5634,playground,8,13.01709064,6,9.028038815,9.027988815,48,117.5187995,5,5,10,6,6,12,4,0.424594,0.441299,0,No
5833,phoenicia,8,13.01709064,6,9.028038815,9.027988815,48,117.5187995,4,5,9,8,6,14,5,0.390664,0.407505,0,No
5972,peregrine,8,13.01709064,6,9.028038815,9.027988815,48,117.5187995,3,4,7,8,7,15,4,0.427962,0.44421,0,No
6608,oligarchy,8,13.01709064,6,9.028038815,9.027988815,48,117.5187995,6,8,14,7,8,15,4,0.40496,0.422399,0,No
6619,olav,8,13.01709064,6,9.028038815,9.027988815,48,117.5187995,4,2,6,7,3,10,5,0.345949,0.354901,0,No
6739,oatmeal,8,13.01709064,6,9.028038815,9.027988815,48,117.5187995,5,7,12,5,8,13,4,0.427714,0.444027,0,No
7067,necktie,8,13.01709064,6,9.028038815,9.027988815,48,117.5187995,5,7,12,8,8,16,5,0.390398,0.40735,0,No
7145,nantucket,8,13.01709064,6,9.028038815,9.027988815,48,117.5187995,4,5,9,8,8,16,4,0.390132,0.40694,0,No
7199,mutt,8,13.01709064,6,9.028038815,9.027988815,48,117.5187995,4,2,6,6,7,13,5,0.345115,0.35375,0,No
8100,marginal,8,13.01709064,6,9.028038815,9.027988815,48,117.5187995,4,5,9,8,7,15,5,0.326317,0.330022,0,No
8166,mandible,8,13.01709064,6,9.028038815,9.027988815,48,117.5187995,2,6,8,5,7,12,4,0.420212,0.437205,0,No
8272,magistrate,8,13.01709064,6,9.028038815,9.027988815,48,117.5187995,4,7,11,7,7,14,4,0.434669,0.450266,0,No
8945,lansing,8,13.01709064,6,9.028038815,9.027988815,48,117.5187995,6,4,10,6,8,14,5,0.349264,0.359154,0,No
8952,langley,8,13.01709064,6,9.028038815,9.027988815,48,117.5187995,6,7,13,8,8,16,5,0.361609,0.374508,0,No
9067,kosher,8,13.01709064,6,9.028038815,9.027988815,48,117.5187995,8,3,11,8,3,11,4,0.380408,0.396964,0,No
9079,kobayashi,8,13.01709064,6,9.028038815,9.027988815,48,117.5187995,3,5,8,4,5,9,5,0.385657,0.402007,0,No
9549,islet,8,13.01709064,6,9.028038815,9.027988815,48,117.5187995,6,5,11,7,5,12,4,0.415354,0.432652,0,No
9689,intern,8,13.01709064,6,9.028038815,9.027988815,48,117.5187995,5,8,13,8,8,16,4,0.42193,0.438825,0,No
10240,hummel,8,13.01709064,6,9.028038815,9.027988815,48,117.5187995,6,7,13,6,7,13,5,0.412411,0.429954,0,No
10690,heartbreak,8,13.01709064,6,9.028038815,9.027988815,48,117.5187995,7,7,14,8,7,15,4,0.400411,0.417775,0,No
10827,hanson,8,13.01709064,6,9.028038815,9.027988815,48,117.5187995,7,5,12,7,6,13,5,0.349615,0.359427,0,No
10922,hagen,8,13.01709064,6,9.028038815,9.027988815,48,117.5187995,4,2,6,4,2,6,4,0.389755,0.406475,0,No
11427,germanium,8,13.01709064,6,9.028038815,9.027988815,48,117.5187995,7,5,12,7,6,13,4,0.408266,0.425845,0,No
11773,fredericksburg,8,13.01709064,6,9.028038815,9.027988815,48,117.5187995,4,6,10,6,7,13,4,0.391379,0.40831,0,No
12729,equilateral,8,13.01709064,6,9.028038815,9.027988815,48,117.5187995,5,3,8,8,6,14,5,0.329131,0.333585,0,No
13235,droopy,8,13.01709064,6,9.028038815,9.027988815,48,117.5187995,3,4,7,4,5,9,5,0.387593,0.404153,0,No
14004,dandelion,8,13.01709064,6,9.028038815,9.027988815,48,117.5187995,6,6,12,6,6,12,4,0.405265,0.422892,0,No
14251,crimea,8,13.01709064,6,9.028038815,9.027988815,48,117.5187995,4,5,9,7,8,15,5,0.397416,0.41465,0,No
14354,courtesan,8,13.01709064,6,9.028038815,9.027988815,48,117.5187995,3,6,9,8,6,14,4,0.401715,0.419098,0,No
14440,corpora,8,13.01709064,6,9.028038815,9.027988815,48,117.5187995,7,1,8,8,1,9,5,0.345599,0.354479,0,No
14775,complement,8,13.01709064,6,9.028038815,9.027988815,48,117.5187995,5,5,10,8,8,16,4,0.431247,0.44728,0,No
14836,comma,8,13.01709064,6,9.028038815,9.027988815,48,117.5187995,4,4,8,8,5,13,5,0.352727,0.363486,0,No
14856,columbine,8,13.01709064,6,9.028038815,9.027988815,48,117.5187995,4,5,9,8,8,16,4,0.414927,0.432088,0,No
15057,clearwater,8,13.01709064,6,9.028038815,9.027988815,48,117.5187995,4,5,9,4,8,12,5,0.34956,0.359464,0,No
15788,calorie,8,13.01709064,6,9.028038815,9.027988815,48,117.5187995,8,6,14,8,6,14,4,0.393837,0.410897,0,No
16008,budd,8,13.01709064,6,9.028038815,9.027988815,48,117.5187995,1,5,6,3,5,8,4,0.421619,0.438651,0,No
16824,beastie,8,13.01709064,6,9.028038815,9.027988815,48,117.5187995,3,1,4,8,1,9,5,0.345599,0.354479,0,No
17049,baffin,8,13.01709064,6,9.028038815,9.027988815,48,117.5187995,8,5,13,8,8,16,4,0.40558,0.423178,0,No
17206,audubon,8,13.01709064,6,9.028038815,9.027988815,48,117.5187995,8,6,14,8,7,15,5,0.350706,0.360976,0,No
17289,astor,8,13.01709064,6,9.028038815,9.027988815,48,117.5187995,5,3,8,8,3,11,5,0.339427,0.346276,0,No
17345,ascent,8,13.01709064,6,9.028038815,9.027988815,48,117.5187995,5,5,10,7,8,15,4,0.42213,0.439036,0,No
17623,ante,8,13.01709064,6,9.028038815,9.027988815,48,117.5187995,6,2,8,6,2,8,5,0.386538,0.402937,0,No
8,zoom,10,12.79394708,5,9.210360372,9.210320372,50,117.8368632,5,4,9,5,5,10,5,0.362621,0.375745,0,No
545,watchmen,10,12.79394708,5,9.210360372,9.210320372,50,117.8368632,4,7,11,5,9,14,4,0.43611,0.451482,0,No
630,wainwright,10,12.79394708,5,9.210360372,9.210320372,50,117.8368632,6,9,15,7,9,16,5,0.36001,0.372516,0,No
2042,tambourine,10,12.79394708,5,9.210360372,9.210320372,50,117.8368632,4,6,10,7,7,14,4,0.37343,0.388495,0,No
2345,suicidal,10,12.79394708,5,9.210360372,9.210320372,50,117.8368632,7,4,11,7,4,11,5,0.350222,0.360164,0,No
3578,servile,10,12.79394708,5,9.210360372,9.210320372,50,117.8368632,4,1,5,10,8,18,5,0.327685,0.331271,0,No
4785,rake,10,12.79394708,5,9.210360372,9.210320372,50,117.8368632,6,6,12,9,10,19,4,0.400881,0.418249,0,No
5794,pica,10,12.79394708,5,9.210360372,9.210320372,50,117.8368632,7,7,14,9,9,18,5,0.354311,0.365379,0,No
6974,newt,10,12.79394708,5,9.210360372,9.210320372,50,117.8368632,6,4,10,9,5,14,4,0.393121,0.410113,0,No
7612,millard,10,12.79394708,5,9.210360372,9.210320372,50,117.8368632,6,1,7,7,1,8,5,0.384237,0.400402,0,No
9080,koala,10,12.79394708,5,9.210360372,9.210320372,50,117.8368632,2,8,10,8,8,16,5,0.354772,0.366187,0,No
9116,kiwi,10,12.79394708,5,9.210360372,9.210320372,50,117.8368632,5,7,12,9,9,18,4,0.422653,0.439651,0,No
9279,kafka,10,12.79394708,5,9.210360372,9.210320372,50,117.8368632,3,7,10,7,9,16,4,0.403459,0.421019,0,No
9692,interlude,10,12.79394708,5,9.210360372,9.210320372,50,117.8368632,5,5,10,5,6,11,5,0.38189,0.398618,0,No
9976,incendiary,10,12.79394708,5,9.210360372,9.210320372,50,117.8368632,8,3,11,8,4,12,5,0.322869,0.32613,0,No
13899,decadent,10,12.79394708,5,9.210360372,9.210320372,50,117.8368632,6,8,14,8,9,17,4,0.418409,0.435558,0,No
13933,deadwood,10,12.79394708,5,9.210360372,9.210320372,50,117.8368632,6,7,13,7,7,14,5,0.352419,0.363021,0,No
14204,crucible,10,12.79394708,5,9.210360372,9.210320372,50,117.8368632,3,7,10,10,9,19,4,0.428158,0.444576,0,No
14588,consult,10,12.79394708,5,9.210360372,9.210320372,50,117.8368632,7,8,15,9,8,17,5,0.398147,0.415453,0,No
15717,canopus,10,12.79394708,5,9.210360372,9.210320372,50,117.8368632,7,5,12,7,8,15,5,0.376887,0.392442,0,No
16645,beryllium,10,12.79394708,5,9.210360372,9.210320372,50,117.8368632,4,5,9,5,7,12,5,0.350893,0.361143,0,No
17164,autograph,10,12.79394708,5,9.210360372,9.210320372,50,117.8368632,7,6,13,9,6,15,5,0.372677,0.387684,0,No
17190,auric,10,12.79394708,5,9.210360372,9.210320372,50,117.8368632,5,5,10,5,7,12,5,0.386656,0.403153,0,No
17242,atropos,10,12.79394708,5,9.210360372,9.210320372,50,117.8368632,5,6,11,6,8,14,5,0.351345,0.361636,0,No
17552,apocrypha,10,12.79394708,5,9.210360372,9.210320372,50,117.8368632,5,8,13,6,8,14,5,0.371197,0.385729,0,No
17956,ale,10,12.79394708,5,9.210360372,9.210320372,50,117.8368632,4,8,12,10,9,19,4,0.426686,0.44313,0,No
17996,alabaster,10,12.79394708,5,9.210360372,9.210320372,50,117.8368632,6,5,11,8,9,17,4,0.430327,0.44636,0,No
18145,adonis,10,12.79394708,5,9.210360372,9.210320372,50,117.8368632,6,6,12,6,8,14,4,0.429796,0.445886,0,No
15958,bunk,19,12.1520932,3,9.721185996,9.721165996,57,118.1327582,10,5,15,17,6,23,4,0.429255,0.445581,0,No
2480,stratum,13,12.53158282,4,9.433503923,9.433473923,52,118.2167357,6,7,13,9,11,20,5,0.368745,0.383142,0,No
9275,kalamazoo,13,12.53158282,4,9.433503923,9.433473923,52,118.2167357,8,8,16,12,13,25,5,0.363877,0.377055,0,No
10221,huntsville,13,12.53158282,4,9.433503923,9.433473923,52,118.2167357,9,9,18,12,13,25,5,0.388408,0.40535,0,No
11731,frieze,13,12.53158282,4,9.433503923,9.433473923,52,118.2167357,5,10,15,10,11,21,4,0.380637,0.396771,0,No
12961,electrolysis,13,12.53158282,4,9.433503923,9.433473923,52,118.2167357,8,7,15,9,10,19,4,0.43565,0.451167,0,No
13172,dunedin,13,12.53158282,4,9.433503923,9.433473923,52,118.2167357,6,7,13,10,10,20,5,0.385774,0.402439,0,No
14415,corvette,13,12.53158282,4,9.433503923,9.433473923,52,118.2167357,6,9,15,13,13,26,5,0.409774,0.427321,0,No
16703,benelux,13,12.53158282,4,9.433503923,9.433473923,52,118.2167357,5,8,13,12,10,22,4,0.411084,0.428553,0,No
16790,beecham,13,12.53158282,4,9.433503923,9.433473923,52,118.2167357,9,11,20,12,12,24,5,0.3934,0.410523,0,No
17602,antigen,13,12.53158282,4,9.433503923,9.433473923,52,118.2167357,8,7,15,12,11,23,4,0.377031,0.392593,0,No
5729,pint,18,12.20616042,3,9.721185996,9.721165996,54,118.6583557,7,11,18,16,13,29,4,0.445624,0.459702,0,No
197,workstation,7,13.15062203,6,9.028038815,9.027988815,42,118.7243261,4,3,7,4,4,8,4,0.389978,0.406728,0,No
612,walkway,7,13.15062203,6,9.028038815,9.027988815,42,118.7243261,4,6,10,5,6,11,5,0.377721,0.393229,0,No
625,waitress,7,13.15062203,6,9.028038815,9.027988815,42,118.7243261,3,5,8,6,7,13,5,0.369312,0.383782,0,No
713,vitro,7,13.15062203,6,9.028038815,9.027988815,42,118.7243261,1,1,2,7,1,8,5,0.331268,0.335748,0,No
745,virgo,7,13.15062203,6,9.028038815,9.027988815,42,118.7243261,6,6,12,7,7,14,4,0.436958,0.452214,0,No
945,vandal,7,13.15062203,6,9.028038815,9.027988815,42,118.7243261,6,6,12,7,6,13,4,0.407835,0.425436,0,No
1224,tug,7,13.15062203,6,9.028038815,9.027988815,42,118.7243261,5,3,8,6,6,12,5,0.378809,0.394664,0,No
1827,tetrahedron,7,13.15062203,6,9.028038815,9.027988815,42,118.7243261,4,5,9,7,5,12,5,0.385841,0.402233,0,No
1835,testify,7,13.15062203,6,9.028038815,9.027988815,42,118.7243261,5,6,11,7,6,13,4,0.394256,0.411521,0,No
2136,synaptic,7,13.15062203,6,9.028038815,9.027988815,42,118.7243261,3,3,6,3,4,7,5,0.345747,0.354671,0,No
2216,swam,7,13.15062203,6,9.028038815,9.027988815,42,118.7243261,3,5,8,3,5,8,5,0.370538,0.385076,0,No
2234,suspense,7,13.15062203,6,9.028038815,9.027988815,42,118.7243261,4,3,7,4,6,10,5,0.39591,0.413035,0,No
2321,sumner,7,13.15062203,6,9.028038815,9.027988815,42,118.7243261,4,5,9,6,6,12,5,0.349477,0.359223,0,No
2406,stylus,7,13.15062203,6,9.028038815,9.027988815,42,118.7243261,3,7,10,5,7,12,4,0.430839,0.446853,0,No
2607,steele,7,13.15062203,6,9.028038815,9.027988815,42,118.7243261,3,5,8,4,5,9,5,0.344265,0.352382,0,No
2629,statuette,7,13.15062203,6,9.028038815,9.027988815,42,118.7243261,4,5,9,7,7,14,4,0.41423,0.431464,0,No
2713,sst,7,13.15062203,6,9.028038815,9.027988815,42,118.7243261,4,2,6,6,2,8,4,0.389755,0.406475,0,No
2772,sportsmen,7,13.15062203,6,9.028038815,9.027988815,42,118.7243261,2,7,9,3,7,10,4,0.420232,0.437323,0,No
3166,sleet,7,13.15062203,6,9.028038815,9.027988815,42,118.7243261,5,5,10,7,6,13,4,0.408163,0.425577,0,No
3335,sightseeing,7,13.15062203,6,9.028038815,9.027988815,42,118.7243261,4,5,9,5,7,12,4,0.407021,0.424417,0,No
3381,shrunk,7,13.15062203,6,9.028038815,9.027988815,42,118.7243261,4,5,9,7,7,14,5,0.412641,0.430203,0,No
3402,showdown,7,13.15062203,6,9.028038815,9.027988815,42,118.7243261,4,6,10,5,6,11,5,0.371337,0.386032,0,No
3411,shoshone,7,13.15062203,6,9.028038815,9.027988815,42,118.7243261,5,5,10,7,6,13,4,0.39144,0.408348,0,No
3412,shortstop,7,13.15062203,6,9.028038815,9.027988815,42,118.7243261,3,5,8,4,6,10,4,0.393287,0.410306,0,No
3427,shone,7,13.15062203,6,9.028038815,9.027988815,42,118.7243261,4,3,7,6,6,12,5,0.339518,0.346426,0,No
3449,shingle,7,13.15062203,6,9.028038815,9.027988815,42,118.7243261,4,4,8,5,4,9,4,0.407273,0.424943,0,No
3639,seneca,7,13.15062203,6,9.028038815,9.027988815,42,118.7243261,3,3,6,3,3,6,5,0.398362,0.416157,0,No
3675,segovia,7,13.15062203,6,9.028038815,9.027988815,42,118.7243261,4,3,7,5,5,10,4,0.400402,0.417995,0,No
4005,sandalwood,7,13.15062203,6,9.028038815,9.027988815,42,118.7243261,5,5,10,5,5,10,5,0.350831,0.361038,0,No
4082,saginaw,7,13.15062203,6,9.028038815,9.027988815,42,118.7243261,5,3,8,5,5,10,5,0.346462,0.355582,0,No
4224,rosy,7,13.15062203,6,9.028038815,9.027988815,42,118.7243261,4,1,5,5,1,6,5,0.304576,0.309916,0,No
4485,restaurateur,7,13.15062203,6,9.028038815,9.027988815,42,118.7243261,4,5,9,5,6,11,5,0.384429,0.400688,0,No
4505,residue,7,13.15062203,6,9.028038815,9.027988815,42,118.7243261,5,5,10,6,6,12,4,0.416329,0.433445,0,No
4570,remedy,7,13.15062203,6,9.028038815,9.027988815,42,118.7243261,7,5,12,7,5,12,4,0.42062,0.437656,0,No
4574,reluctant,7,13.15062203,6,9.028038815,9.027988815,42,118.7243261,4,2,6,5,4,9,5,0.359492,0.371936,0,No
4865,quintet,7,13.15062203,6,9.028038815,9.027988815,42,118.7243261,6,6,12,6,7,13,4,0.431247,0.447191,0,No
5106,protozoan,7,13.15062203,6,9.028038815,9.027988815,42,118.7243261,4,4,8,7,6,13,5,0.340097,0.347199,0,No
5391,potion,7,13.15062203,6,9.028038815,9.027988815,42,118.7243261,4,5,9,6,6,12,5,0.384737,0.401235,0,No
5416,posterior,7,13.15062203,6,9.028038815,9.027988815,42,118.7243261,4,3,7,6,5,11,5,0.320971,0.324331,0,No
5584,plywood,7,13.15062203,6,9.028038815,9.027988815,42,118.7243261,4,4,8,4,4,8,5,0.397853,0.41511,0,No
5716,piraeus,7,13.15062203,6,9.028038815,9.027988815,42,118.7243261,5,4,9,6,6,12,4,0.405431,0.423009,0,No
6044,pelvic,7,13.15062203,6,9.028038815,9.027988815,42,118.7243261,3,3,6,6,3,9,5,0.325724,0.329205,0,No
6220,parole,7,13.15062203,6,9.028038815,9.027988815,42,118.7243261,4,3,7,5,4,9,5,0.364864,0.378393,0,No
6323,pampa,7,13.15062203,6,9.028038815,9.027988815,42,118.7243261,4,5,9,4,7,11,5,0.372138,0.386926,0,No
6374,packard,7,13.15062203,6,9.028038815,9.027988815,42,118.7243261,4,5,9,6,5,11,5,0.387179,0.403712,0,No
6469,ortega,7,13.15062203,6,9.028038815,9.027988815,42,118.7243261,1,6,7,1,7,8,5,0.350887,0.360732,0,No
6478,ornamentation,7,13.15062203,6,9.028038815,9.027988815,42,118.7243261,5,6,11,6,7,13,5,0.353155,0.363887,0,No
6549,operatic,7,13.15062203,6,9.028038815,9.027988815,42,118.7243261,6,3,9,6,4,10,5,0.319838,0.323237,0,No
6561,onyx,7,13.15062203,6,9.028038815,9.027988815,42,118.7243261,5,4,9,7,7,14,4,0.405821,0.423413,0,No
6562,onward,7,13.15062203,6,9.028038815,9.027988815,42,118.7243261,3,6,9,3,7,10,5,0.36346,0.376767,0,No
6707,obtuse,7,13.15062203,6,9.028038815,9.027988815,42,118.7243261,3,3,6,6,7,13,5,0.32146,0.325,0,No
6873,nominate,7,13.15062203,6,9.028038815,9.027988815,42,118.7243261,3,2,5,7,2,9,5,0.377304,0.393745,0,No
7270,muir,7,13.15062203,6,9.028038815,9.027988815,42,118.7243261,4,6,10,6,6,12,5,0.339407,0.346213,0,No
7559,minstrel,7,13.15062203,6,9.028038815,9.027988815,42,118.7243261,4,4,8,6,6,12,4,0.391776,0.408902,0,No
7604,millionth,7,13.15062203,6,9.028038815,9.027988815,42,118.7243261,1,3,4,7,6,13,5,0.391034,0.4081,0,No
7628,mildred,7,13.15062203,6,9.028038815,9.027988815,42,118.7243261,5,4,9,5,4,9,5,0.330947,0.335713,0,No
7697,methyl,7,13.15062203,6,9.028038815,9.027988815,42,118.7243261,5,2,7,5,3,8,5,0.318838,0.322562,0,No
7744,merrill,7,13.15062203,6,9.028038815,9.027988815,42,118.7243261,3,5,8,3,5,8,5,0.349257,0.359181,0,No
7785,menelaus,7,13.15062203,6,9.028038815,9.027988815,42,118.7243261,5,5,10,7,7,14,5,0.386471,0.402951,0,No
8406,luger,7,13.15062203,6,9.028038815,9.027988815,42,118.7243261,1,5,6,1,5,6,4,0.4155,0.432816,0,No
8428,lubbock,7,13.15062203,6,9.028038815,9.027988815,42,118.7243261,5,5,10,6,7,13,4,0.391388,0.408292,0,No
8502,lola,7,13.15062203,6,9.028038815,9.027988815,42,118.7243261,4,6,10,4,6,10,4,0.399851,0.417178,0,No
8763,leona,7,13.15062203,6,9.028038815,9.027988815,42,118.7243261,6,2,8,6,7,13,5,0.322933,0.326168,0,No
8793,leighton,7,13.15062203,6,9.028038815,9.027988815,42,118.7243261,5,5,10,6,5,11,5,0.349271,0.359159,0,No
9041,kumar,7,13.15062203,6,9.028038815,9.027988815,42,118.7243261,2,4,6,3,4,7,5,0.35626,0.3676,0,No
9183,keyhole,7,13.15062203,6,9.028038815,9.027988815,42,118.7243261,3,3,6,3,4,7,5,0.343233,0.351801,0,No
9236,kaufman,7,13.15062203,6,9.028038815,9.027988815,42,118.7243261,5,7,12,7,7,14,4,0.390346,0.407202,0,No
9340,judd,7,13.15062203,6,9.028038815,9.027988815,42,118.7243261,5,2,7,6,3,9,5,0.360068,0.372602,0,No
9861,inferno,7,13.15062203,6,9.028038815,9.027988815,42,118.7243261,3,4,7,4,4,8,5,0.348756,0.35846,0,No
10174,hydroxyl,7,13.15062203,6,9.028038815,9.027988815,42,118.7243261,6,3,9,7,6,13,5,0.326053,0.32963,0,No
10366,honesty,7,13.15062203,6,9.028038815,9.027988815,42,118.7243261,6,3,9,7,6,13,4,0.422432,0.439125,0,No
10502,hike,7,13.15062203,6,9.028038815,9.027988815,42,118.7243261,4,5,9,6,7,13,4,0.415286,0.432825,0,No
10679,hebe,7,13.15062203,6,9.028038815,9.027988815,42,118.7243261,2,3,5,2,3,5,5,0.389507,0.406223,0,No
10710,headquarter,7,13.15062203,6,9.028038815,9.027988815,42,118.7243261,4,5,9,5,7,12,5,0.396883,0.41419,0,No
10791,harness,7,13.15062203,6,9.028038815,9.027988815,42,118.7243261,6,4,10,7,4,11,4,0.414501,0.432121,0,No
11380,gillette,7,13.15062203,6,9.028038815,9.027988815,42,118.7243261,4,3,7,6,4,10,5,0.32582,0.32944,0,No
11661,fungal,7,13.15062203,6,9.028038815,9.027988815,42,118.7243261,4,3,7,6,3,9,5,0.321973,0.32524,0,No
11940,folio,7,13.15062203,6,9.028038815,9.027988815,42,118.7243261,2,5,7,7,7,14,4,0.414056,0.43144,0,No
12052,flare,7,13.15062203,6,9.028038815,9.027988815,42,118.7243261,5,5,10,6,6,12,5,0.333785,0.339093,0,No
12055,flank,7,13.15062203,6,9.028038815,9.027988815,42,118.7243261,5,6,11,7,6,13,4,0.434169,0.449796,0,No
12112,firemen,7,13.15062203,6,9.028038815,9.027988815,42,118.7243261,5,5,10,7,5,12,5,0.389106,0.405833,0,No
12178,fief,7,13.15062203,6,9.028038815,9.027988815,42,118.7243261,2,3,5,7,6,13,5,0.384545,0.400953,0,No
12761,epidermis,7,13.15062203,6,9.028038815,9.027988815,42,118.7243261,3,5,8,7,6,13,5,0.367455,0.381365,0,No
12784,entourage,7,13.15062203,6,9.028038815,9.027988815,42,118.7243261,7,4,11,7,6,13,4,0.389943,0.406714,0,No
12896,embargo,7,13.15062203,6,9.028038815,9.027988815,42,118.7243261,4,5,9,7,6,13,5,0.357732,0.369507,0,No
13121,dysentery,7,13.15062203,6,9.028038815,9.027988815,42,118.7243261,4,5,9,7,7,14,4,0.404756,0.422145,0,No
13216,drury,7,13.15062203,6,9.028038815,9.027988815,42,118.7243261,5,4,9,6,7,13,5,0.331745,0.336551,0,No
13307,douglass,7,13.15062203,6,9.028038815,9.027988815,42,118.7243261,3,3,6,6,3,9,5,0.398424,0.416208,0,No
13342,dope,7,13.15062203,6,9.028038815,9.027988815,42,118.7243261,3,6,9,6,6,12,4,0.386968,0.403958,0,No
13351,doomsday,7,13.15062203,6,9.028038815,9.027988815,42,118.7243261,5,5,10,7,6,13,5,0.385556,0.401942,0,No
13569,diffuse,7,13.15062203,6,9.028038815,9.027988815,42,118.7243261,5,3,8,7,3,10,5,0.360954,0.373684,0,No
13869,decomposition,7,13.15062203,6,9.028038815,9.027988815,42,118.7243261,5,5,10,5,5,10,5,0.385464,0.402019,0,No
13977,darrell,7,13.15062203,6,9.028038815,9.027988815,42,118.7243261,3,3,6,3,4,7,5,0.336799,0.342873,0,No
14015,damnation,7,13.15062203,6,9.028038815,9.027988815,42,118.7243261,5,6,11,6,7,13,4,0.412977,0.430286,0,No
14025,dalhousie,7,13.15062203,6,9.028038815,9.027988815,42,118.7243261,7,3,10,7,3,10,5,0.388442,0.405064,0,No
14131,curb,7,13.15062203,6,9.028038815,9.027988815,42,118.7243261,4,5,9,5,7,12,5,0.343519,0.351575,0,No
14419,cortez,7,13.15062203,6,9.028038815,9.027988815,42,118.7243261,1,6,7,5,6,11,5,0.350533,0.36063,0,No
14430,correspondent,7,13.15062203,6,9.028038815,9.027988815,42,118.7243261,6,2,8,7,5,12,5,0.349656,0.359617,0,No
14641,connector,7,13.15062203,6,9.028038815,9.027988815,42,118.7243261,3,6,9,3,6,9,5,0.3463,0.35518,0,No
14681,confidential,7,13.15062203,6,9.028038815,9.027988815,42,118.7243261,4,4,8,5,4,9,5,0.334369,0.339816,0,No
14868,colonist,7,13.15062203,6,9.028038815,9.027988815,42,118.7243261,4,4,8,7,6,13,5,0.362858,0.375837,0,No
15088,claret,7,13.15062203,6,9.028038815,9.027988815,42,118.7243261,2,4,6,5,7,12,4,0.40167,0.419019,0,No
15358,charismatic,7,13.15062203,6,9.028038815,9.027988815,42,118.7243261,3,3,6,6,3,9,5,0.325766,0.3295,0,No
15796,callaghan,7,13.15062203,6,9.028038815,9.027988815,42,118.7243261,5,7,12,6,7,13,5,0.381185,0.397354,0,No
16206,brake,7,13.15062203,6,9.028038815,9.027988815,42,118.7243261,5,5,10,6,5,11,4,0.415034,0.432347,0,No
16267,bouillon,7,13.15062203,6,9.028038815,9.027988815,42,118.7243261,5,5,10,6,7,13,4,0.390406,0.407221,0,No
16289,bosch,7,13.15062203,6,9.028038815,9.027988815,42,118.7243261,3,3,6,6,3,9,5,0.328376,0.332138,0,No
16464,blister,7,13.15062203,6,9.028038815,9.027988815,42,118.7243261,5,4,9,6,4,10,5,0.392826,0.410021,0,No
17046,baggage,7,13.15062203,6,9.028038815,9.027988815,42,118.7243261,5,2,7,6,3,9,5,0.325593,0.329061,0,No
17153,autopsy,7,13.15062203,6,9.028038815,9.027988815,42,118.7243261,3,5,8,7,5,12,4,0.390836,0.407695,0,No
17622,anteater,7,13.15062203,6,9.028038815,9.027988815,42,118.7243261,5,3,8,6,4,10,5,0.347303,0.356605,0,No
17693,angie,7,13.15062203,6,9.028038815,9.027988815,42,118.7243261,6,5,11,6,6,12,5,0.340057,0.346936,0,No
17708,andromache,7,13.15062203,6,9.028038815,9.027988815,42,118.7243261,4,4,8,5,4,9,4,0.393575,0.410601,0,No
17750,anabaptist,7,13.15062203,6,9.028038815,9.027988815,42,118.7243261,5,4,9,7,4,11,5,0.330368,0.334987,0,No
17871,almighty,7,13.15062203,6,9.028038815,9.027988815,42,118.7243261,6,5,11,7,6,13,4,0.405886,0.423455,0,No
17895,allergy,7,13.15062203,6,9.028038815,9.027988815,42,118.7243261,6,6,12,7,6,13,4,0.417602,0.434802,0,No
18031,aida,7,13.15062203,6,9.028038815,9.027988815,42,118.7243261,3,5,8,6,6,12,4,0.406993,0.424535,0,No
18286,academia,7,13.15062203,6,9.028038815,9.027988815,42,118.7243261,2,6,8,4,6,10,4,0.39063,0.407493,0,No
18317,abram,7,13.15062203,6,9.028038815,9.027988815,42,118.7243261,5,5,10,6,5,11,5,0.351025,0.361298,0,No
9035,ky,9,12.8993076,6,9.210360372,9.210320372,54,118.8072715,5,4,9,7,4,11,5,0.398371,0.416176,0,No
127,yakima,9,12.8993076,5,9.210360372,9.210320372,45,118.8072715,7,3,10,9,8,17,5,0.347704,0.357079,0,No
961,valhalla,9,12.8993076,5,9.210360372,9.210320372,45,118.8072715,7,8,15,9,9,18,4,0.42214,0.439111,0,No
1625,timon,9,12.8993076,5,9.210360372,9.210320372,45,118.8072715,6,4,10,6,7,13,5,0.405107,0.422504,0,No
3028,softball,9,12.8993076,5,9.210360372,9.210320372,45,118.8072715,7,6,13,8,6,14,4,0.422915,0.439783,0,No
3077,snell,9,12.8993076,5,9.210360372,9.210320372,45,118.8072715,4,2,6,4,7,11,5,0.325539,0.328954,0,No
3078,sneeze,9,12.8993076,5,9.210360372,9.210320372,45,118.8072715,7,8,15,9,9,18,4,0.416602,0.433943,0,No
3441,shipyard,9,12.8993076,5,9.210360372,9.210320372,45,118.8072715,5,4,9,8,5,13,5,0.368798,0.383088,0,No
4549,renoir,9,12.8993076,5,9.210360372,9.210320372,45,118.8072715,4,4,8,5,6,11,4,0.391388,0.408277,0,No
5109,protoplasm,9,12.8993076,5,9.210360372,9.210320372,45,118.8072715,6,5,11,7,7,14,4,0.397951,0.415301,0,No
5510,polymerase,9,12.8993076,5,9.210360372,9.210320372,45,118.8072715,3,6,9,9,7,16,5,0.373847,0.388963,0,No
6106,pax,9,12.8993076,5,9.210360372,9.210320372,45,118.8072715,5,3,8,9,3,12,5,0.384479,0.400707,0,No
6295,pantomime,9,12.8993076,5,9.210360372,9.210320372,45,118.8072715,4,8,12,8,8,16,5,0.357321,0.369164,0,No
7998,mastodon,9,12.8993076,5,9.210360372,9.210320372,45,118.8072715,6,6,12,6,6,12,5,0.347167,0.356164,0,No
8152,manic,9,12.8993076,5,9.210360372,9.210320372,45,118.8072715,7,6,13,9,7,16,5,0.340998,0.348409,0,No
9144,kingfisher,9,12.8993076,5,9.210360372,9.210320372,45,118.8072715,8,5,13,9,8,17,4,0.407226,0.424807,0,No
10310,hospice,9,12.8993076,5,9.210360372,9.210320372,45,118.8072715,8,4,12,9,6,15,4,0.387915,0.40501,0,No
10445,hive,9,12.8993076,5,9.210360372,9.210320372,45,118.8072715,4,6,10,8,8,16,4,0.432087,0.447914,0,No
11117,greenfield,9,12.8993076,5,9.210360372,9.210320372,45,118.8072715,5,5,10,5,7,12,4,0.391647,0.408573,0,No
12067,flagstaff,9,12.8993076,5,9.210360372,9.210320372,45,118.8072715,7,7,14,9,9,18,5,0.37122,0.385882,0,No
12604,euphemism,9,12.8993076,5,9.210360372,9.210320372,45,118.8072715,6,6,12,9,7,16,5,0.380042,0.39597,0,No
12700,ericsson,9,12.8993076,5,9.210360372,9.210320372,45,118.8072715,3,6,9,6,8,14,4,0.424188,0.440797,0,No
12931,elkhart,9,12.8993076,5,9.210360372,9.210320372,45,118.8072715,6,6,12,6,9,15,4,0.407563,0.425187,0,No
13382,dolores,9,12.8993076,5,9.210360372,9.210320372,45,118.8072715,6,2,8,7,6,13,5,0.319326,0.322841,0,No
13647,devonshire,9,12.8993076,5,9.210360372,9.210320372,45,118.8072715,1,4,5,7,4,11,5,0.349973,0.359983,0,No
14489,copeland,9,12.8993076,5,9.210360372,9.210320372,45,118.8072715,6,6,12,7,6,13,5,0.367295,0.381145,0,No
14861,colosseum,9,12.8993076,5,9.210360372,9.210320372,45,118.8072715,1,6,7,9,6,15,5,0.39739,0.414645,0,No
14926,cognac,9,12.8993076,5,9.210360372,9.210320372,45,118.8072715,7,6,13,8,7,15,4,0.427931,0.444224,0,No
14969,coaxial,9,12.8993076,5,9.210360372,9.210320372,45,118.8072715,5,1,6,7,4,11,5,0.315489,0.319444,0,No
15710,cantilever,9,12.8993076,5,9.210360372,9.210320372,45,118.8072715,3,6,9,8,7,15,5,0.364168,0.37743,0,No
15872,byproduct,9,12.8993076,5,9.210360372,9.210320372,45,118.8072715,2,5,7,8,8,16,4,0.425643,0.442271,0,No
16047,bruckner,9,12.8993076,5,9.210360372,9.210320372,45,118.8072715,5,7,12,8,8,16,4,0.427714,0.444031,0,No
4068,salaam,12,12.61162553,4,9.433503923,9.433473923,48,118.9718189,4,7,11,4,9,13,4,0.38851,0.405386,0,No
5788,pickering,12,12.61162553,4,9.433503923,9.433473923,48,118.9718189,8,7,15,10,9,19,5,0.335463,0.341032,0,No
6047,pellet,12,12.61162553,4,9.433503923,9.433473923,48,118.9718189,8,7,15,10,9,19,4,0.42209,0.439032,0,No
8312,mackinac,12,12.61162553,4,9.433503923,9.433473923,48,118.9718189,5,2,7,12,12,24,5,0.326906,0.330475,0,No
9180,keynote,12,12.61162553,4,9.433503923,9.433473923,48,118.9718189,6,9,15,7,9,16,4,0.427869,0.444228,0,No
14216,crossword,12,12.61162553,4,9.433503923,9.433473923,48,118.9718189,8,5,13,10,6,16,5,0.367075,0.381133,0,No
15770,camembert,12,12.61162553,4,9.433503923,9.433473923,48,118.9718189,5,7,12,6,11,17,4,0.402471,0.419887,0,No
17426,arianism,12,12.61162553,4,9.433503923,9.433473923,48,118.9718189,6,9,15,8,10,18,4,0.422331,0.439144,0,No
1976,tautology,17,12.26331883,3,9.721185996,9.721165996,51,119.2140033,4,10,14,13,16,29,5,0.361815,0.374818,0,No
6484,oriole,17,12.26331883,3,9.721185996,9.721165996,51,119.2140033,8,4,12,12,9,21,5,0.369443,0.383841,0,No
168,wrench,11,12.6986369,4,9.433503923,9.433473923,44,119.7926411,7,8,15,10,11,21,4,0.412862,0.430234,0,No
2003,tarantula,11,12.6986369,4,9.433503923,9.433473923,44,119.7926411,5,6,11,9,7,16,4,0.417043,0.434135,0,No
2079,tadpole,11,12.6986369,4,9.433503923,9.433473923,44,119.7926411,5,8,13,10,9,19,5,0.398281,0.415636,0,No
2523,stonewall,11,12.6986369,4,9.433503923,9.433473923,44,119.7926411,6,6,12,9,8,17,5,0.348455,0.358026,0,No
5852,phenotype,11,12.6986369,4,9.433503923,9.433473923,44,119.7926411,4,7,11,10,8,18,5,0.393985,0.411211,0,No
8067,marlowe,11,12.6986369,4,9.433503923,9.433473923,44,119.7926411,8,8,16,10,10,20,5,0.356696,0.368452,0,No
10921,hager,11,12.6986369,4,9.433503923,9.433473923,44,119.7926411,8,9,17,10,10,20,5,0.369543,0.383994,0,No
11651,furlong,11,12.6986369,4,9.433503923,9.433473923,44,119.7926411,5,7,12,11,10,21,4,0.40609,0.423535,0,No
16380,bogota,11,12.6986369,4,9.433503923,9.433473923,44,119.7926411,6,8,14,9,10,19,4,0.416798,0.434065,0,No
16844,bayonet,11,12.6986369,4,9.433503923,9.433473923,44,119.7926411,3,6,9,11,7,18,4,0.406099,0.423657,0,No
18316,abrasion,11,12.6986369,4,9.433503923,9.433473923,44,119.7926411,10,7,17,10,7,17,5,0.353141,0.364082,0,No
103,yeats,8,13.01709064,5,9.210360372,9.210320372,40,119.8920957,4,6,10,7,6,13,4,0.403111,0.420662,0,No
290,winnie,8,13.01709064,5,9.210360372,9.210320372,40,119.8920957,6,4,10,7,7,14,4,0.406452,0.423948,0,No
680,voltaic,8,13.01709064,5,9.210360372,9.210320372,40,119.8920957,3,1,4,8,7,15,5,0.309807,0.314527,0,No
947,vance,8,13.01709064,5,9.210360372,9.210320372,40,119.8920957,7,2,9,8,5,13,5,0.377376,0.393967,0,No
1294,tripod,8,13.01709064,5,9.210360372,9.210320372,40,119.8920957,3,7,10,5,7,12,4,0.404277,0.421948,0,No
2161,sycamore,8,13.01709064,5,9.210360372,9.210320372,40,119.8920957,6,7,13,6,8,14,4,0.396413,0.413639,0,No
2296,sunspot,8,13.01709064,5,9.210360372,9.210320372,40,119.8920957,4,3,7,6,5,11,5,0.348708,0.35837,0,No
2443,strontium,8,13.01709064,5,9.210360372,9.210320372,40,119.8920957,4,6,10,5,7,12,5,0.354368,0.365495,0,No
3125,slum,8,13.01709064,5,9.210360372,9.210320372,40,119.8920957,3,5,8,7,5,12,5,0.35154,0.361922,0,No
4871,quill,8,13.01709064,5,9.210360372,9.210320372,40,119.8920957,7,4,11,8,4,12,5,0.345713,0.354235,0,No
5113,protista,8,13.01709064,5,9.210360372,9.210320372,40,119.8920957,4,2,6,6,5,11,5,0.350409,0.360486,0,No
5280,prima,8,13.01709064,5,9.210360372,9.210320372,40,119.8920957,3,3,6,6,3,9,5,0.338288,0.344783,0,No
5749,pimp,8,13.01709064,5,9.210360372,9.210320372,40,119.8920957,4,7,11,7,7,14,4,0.399473,0.416854,0,No
6056,peg,8,13.01709064,5,9.210360372,9.210320372,40,119.8920957,4,7,11,8,8,16,4,0.432867,0.448641,0,No
6279,paprika,8,13.01709064,5,9.210360372,9.210320372,40,119.8920957,6,7,13,8,8,16,4,0.425469,0.442125,0,No
6358,paine,8,13.01709064,5,9.210360372,9.210320372,40,119.8920957,4,6,10,8,6,14,5,0.384929,0.401247,0,No
6646,offset,8,13.01709064,5,9.210360372,9.210320372,40,119.8920957,5,5,10,6,7,13,5,0.38447,0.400915,0,No
7818,melinda,8,13.01709064,5,9.210360372,9.210320372,40,119.8920957,4,5,9,4,5,9,5,0.339219,0.346225,0,No
8816,leeuwenhoek,8,13.01709064,5,9.210360372,9.210320372,40,119.8920957,2,6,8,8,6,14,5,0.366794,0.380553,0,No
8897,latrobe,8,13.01709064,5,9.210360372,9.210320372,40,119.8920957,5,4,9,7,6,13,5,0.399312,0.417086,0,No
8965,landfill,8,13.01709064,5,9.210360372,9.210320372,40,119.8920957,5,5,10,7,8,15,5,0.36709,0.38109,0,No
9274,kale,8,13.01709064,5,9.210360372,9.210320372,40,119.8920957,4,5,9,4,6,10,4,0.412814,0.430272,0,No
10208,husky,8,13.01709064,5,9.210360372,9.210320372,40,119.8920957,4,3,7,4,5,9,5,0.34714,0.356394,0,No
10239,hummingbird,8,13.01709064,5,9.210360372,9.210320372,40,119.8920957,3,5,8,5,5,10,5,0.364512,0.378051,0,No
10572,hermitage,8,13.01709064,5,9.210360372,9.210320372,40,119.8920957,3,4,7,8,5,13,4,0.389481,0.406555,0,No
10733,hawthorn,8,13.01709064,5,9.210360372,9.210320372,40,119.8920957,6,4,10,6,5,11,5,0.373705,0.388755,0,No
11467,genie,8,13.01709064,5,9.210360372,9.210320372,40,119.8920957,5,5,10,8,6,14,5,0.396016,0.413185,0,No
11569,gander,8,13.01709064,5,9.210360372,9.210320372,40,119.8920957,7,4,11,7,6,13,4,0.392305,0.40924,0,No
12231,fenton,8,13.01709064,5,9.210360372,9.210320372,40,119.8920957,5,8,13,5,8,13,4,0.401715,0.419127,0,No
12744,epithelial,8,13.01709064,5,9.210360372,9.210320372,40,119.8920957,6,2,8,6,2,8,5,0.319636,0.323037,0,No
12766,ephraim,8,13.01709064,5,9.210360372,9.210320372,40,119.8920957,5,2,7,5,2,7,5,0.315955,0.32073,0,No
13661,deus,8,13.01709064,5,9.210360372,9.210320372,40,119.8920957,5,5,10,5,8,13,5,0.356546,0.368199,0,No
14093,cutler,8,13.01709064,5,9.210360372,9.210320372,40,119.8920957,5,3,8,7,4,11,5,0.337247,0.343427,0,No
14111,curt,8,13.01709064,5,9.210360372,9.210320372,40,119.8920957,6,1,7,6,1,7,5,0.31401,0.318155,0,No
14586,consultation,8,13.01709064,5,9.210360372,9.210320372,40,119.8920957,5,7,12,5,8,13,5,0.369851,0.384189,0,No
15199,christensen,8,13.01709064,5,9.210360372,9.210320372,40,119.8920957,2,5,7,6,7,13,5,0.35591,0.367152,0,No
15220,chomsky,8,13.01709064,5,9.210360372,9.210320372,40,119.8920957,4,5,9,4,7,11,4,0.403001,0.42054,0,No
15394,champaign,8,13.01709064,5,9.210360372,9.210320372,40,119.8920957,6,3,9,8,8,16,5,0.348332,0.357847,0,No
15452,centrifugal,8,13.01709064,5,9.210360372,9.210320372,40,119.8920957,5,4,9,6,7,13,5,0.325718,0.329346,0,No
15484,cedric,8,13.01709064,5,9.210360372,9.210320372,40,119.8920957,4,3,7,5,3,8,4,0.422472,0.439163,0,No
15678,capybara,8,13.01709064,5,9.210360372,9.210320372,40,119.8920957,2,5,7,8,7,15,4,0.393418,0.410465,0,No
15842,cady,8,13.01709064,5,9.210360372,9.210320372,40,119.8920957,5,3,8,8,6,14,5,0.345747,0.354662,0,No
16280,botanic,8,13.01709064,5,9.210360372,9.210320372,40,119.8920957,5,3,8,7,3,10,5,0.348941,0.358647,0,No
16638,bessemer,8,13.01709064,5,9.210360372,9.210320372,40,119.8920957,5,5,10,7,5,12,5,0.353458,0.364317,0,No
16950,barbour,8,13.01709064,5,9.210360372,9.210320372,40,119.8920957,6,3,9,7,8,15,5,0.330787,0.335492,0,No
17193,aura,8,13.01709064,5,9.210360372,9.210320372,40,119.8920957,7,2,9,8,3,11,5,0.332914,0.338686,0,No
17378,arroyo,8,13.01709064,5,9.210360372,9.210320372,40,119.8920957,3,1,4,5,1,6,5,0.319412,0.322781,0,No
17866,aloha,8,13.01709064,5,9.210360372,9.210320372,40,119.8920957,7,8,15,7,8,15,4,0.401107,0.418507,0,No
17972,albumin,8,13.01709064,5,9.210360372,9.210320372,40,119.8920957,5,3,8,6,6,12,5,0.346327,0.355375,0,No
18138,adrenaline,8,13.01709064,5,9.210360372,9.210320372,40,119.8920957,6,5,11,6,6,12,4,0.42757,0.443867,0,No
3616,sept,6,13.30477271,12,9.028038815,9.027988815,72,120.1160044,4,4,8,4,5,9,4,0.421119,0.438107,0,No
17146,ave,6,13.30477271,8,9.028038815,9.027988815,48,120.1160044,5,1,6,6,3,9,5,0.311257,0.315997,0,No
52,yuki,6,13.30477271,6,9.028038815,9.027988815,36,120.1160044,5,1,6,5,1,6,5,0.326263,0.329724,0,No
159,writ,6,13.30477271,6,9.028038815,9.027988815,36,120.1160044,5,3,8,6,4,10,5,0.393313,0.410483,0,No
203,workmen,6,13.30477271,6,9.028038815,9.027988815,36,120.1160044,5,6,11,5,6,11,4,0.417651,0.434858,0,No
282,wipe,6,13.30477271,6,9.028038815,9.027988815,36,120.1160044,3,5,8,4,6,10,5,0.400447,0.418222,0,No
382,whitish,6,13.30477271,6,9.028038815,9.027988815,36,120.1160044,5,3,8,6,3,9,5,0.38467,0.400914,0,No
392,whisper,6,13.30477271,6,9.028038815,9.027988815,36,120.1160044,3,6,9,4,6,10,4,0.432972,0.448735,0,No
403,whichever,6,13.30477271,6,9.028038815,9.027988815,36,120.1160044,4,2,6,5,3,8,5,0.328765,0.332562,0,No
445,westchester,6,13.30477271,6,9.028038815,9.027988815,36,120.1160044,4,2,6,6,5,11,5,0.343612,0.351862,0,No
514,wavy,6,13.30477271,6,9.028038815,9.027988815,36,120.1160044,3,3,6,4,4,8,5,0.361152,0.374096,0,No
546,watchman,6,13.30477271,6,9.028038815,9.027988815,36,120.1160044,4,4,8,6,4,10,4,0.411188,0.428685,0,No
701,vladivostok,6,13.30477271,6,9.028038815,9.027988815,36,120.1160044,3,2,5,3,2,5,5,0.322558,0.325876,0,No
776,vigorous,6,13.30477271,6,9.028038815,9.027988815,36,120.1160044,6,4,10,6,5,11,5,0.384612,0.400881,0,No
936,vantage,6,13.30477271,6,9.028038815,9.027988815,36,120.1160044,5,1,6,5,4,9,5,0.323257,0.326421,0,No
1024,urge,6,13.30477271,6,9.028038815,9.027988815,36,120.1160044,3,3,6,5,5,10,4,0.427756,0.444144,0,No
1046,upsetting,6,13.30477271,6,9.028038815,9.027988815,36,120.1160044,4,5,9,5,5,10,4,0.430682,0.446674,0,No
1181,turnover,6,13.30477271,6,9.028038815,9.027988815,36,120.1160044,5,2,7,5,5,10,5,0.385657,0.402208,0,No
1340,tress,6,13.30477271,6,9.028038815,9.027988815,36,120.1160044,3,1,4,3,1,4,5,0.360829,0.373487,0,No
1567,tolerate,6,13.30477271,6,9.028038815,9.027988815,36,120.1160044,3,4,7,6,5,11,5,0.414133,0.431874,0,No
1598,titular,6,13.30477271,6,9.028038815,9.027988815,36,120.1160044,2,5,7,2,6,8,5,0.330171,0.334392,0,No
1639,til,6,13.30477271,6,9.028038815,9.027988815,36,120.1160044,6,4,10,6,6,12,5,0.336321,0.342159,0,No
1725,thorny,6,13.30477271,6,9.028038815,9.027988815,36,120.1160044,4,4,8,4,4,8,5,0.32085,0.324349,0,No
1731,thoracic,6,13.30477271,6,9.028038815,9.027988815,36,120.1160044,5,2,7,6,4,10,5,0.321687,0.324773,0,No
1780,therapist,6,13.30477271,6,9.028038815,9.027988815,36,120.1160044,4,4,8,6,5,11,5,0.385891,0.40228,0,No
1807,thatch,6,13.30477271,6,9.028038815,9.027988815,36,120.1160044,6,5,11,6,5,11,4,0.38845,0.405076,0,No
1823,texan,6,13.30477271,6,9.028038815,9.027988815,36,120.1160044,5,4,9,5,4,9,5,0.361778,0.374677,0,No
1863,terminate,6,13.30477271,6,9.028038815,9.027988815,36,120.1160044,3,5,8,4,5,9,4,0.40177,0.419347,0,No
1954,teamwork,6,13.30477271,6,9.028038815,9.027988815,36,120.1160044,4,5,9,4,5,9,4,0.423449,0.440102,0,No
2271,suppression,6,13.30477271,6,9.028038815,9.027988815,36,120.1160044,3,2,5,5,4,9,5,0.404821,0.422175,0,No
2289,superficial,6,13.30477271,6,9.028038815,9.027988815,36,120.1160044,4,3,7,5,3,8,5,0.320126,0.32344,0,No
2304,sunken,6,13.30477271,6,9.028038815,9.027988815,36,120.1160044,4,3,7,5,3,8,5,0.330399,0.334665,0,No
2422,stuffy,6,13.30477271,6,9.028038815,9.027988815,36,120.1160044,5,3,8,6,5,11,5,0.357472,0.36981,0,No
2463,stressful,6,13.30477271,6,9.028038815,9.027988815,36,120.1160044,4,1,5,5,1,6,5,0.320508,0.323807,0,No
2486,strategist,6,13.30477271,6,9.028038815,9.027988815,36,120.1160044,5,4,9,6,4,10,5,0.411169,0.428489,0,No
2504,storytelling,6,13.30477271,6,9.028038815,9.027988815,36,120.1160044,5,4,9,6,4,10,5,0.333064,0.338067,0,No
2560,stigmata,6,13.30477271,6,9.028038815,9.027988815,36,120.1160044,4,3,7,4,4,8,5,0.384954,0.401471,0,No
2732,squall,6,13.30477271,6,9.028038815,9.027988815,36,120.1160044,4,3,7,5,5,10,5,0.346577,0.355622,0,No
2762,sprang,6,13.30477271,6,9.028038815,9.027988815,36,120.1160044,4,4,8,4,6,10,5,0.412469,0.430011,0,No
3052,soapy,6,13.30477271,6,9.028038815,9.027988815,36,120.1160044,5,4,9,5,6,11,5,0.334023,0.339222,0,No
3055,soak,6,13.30477271,6,9.028038815,9.027988815,36,120.1160044,5,4,9,5,6,11,4,0.401252,0.418864,0,No
3169,sleek,6,13.30477271,6,9.028038815,9.027988815,36,120.1160044,6,6,12,6,6,12,5,0.349898,0.359532,0,No
3266,sinful,6,13.30477271,6,9.028038815,9.027988815,36,120.1160044,4,6,10,5,6,11,5,0.333596,0.33868,0,No
3282,simplistic,6,13.30477271,6,9.028038815,9.027988815,36,120.1160044,3,5,8,3,5,8,4,0.405607,0.423281,0,No
3349,sidewinder,6,13.30477271,6,9.028038815,9.027988815,36,120.1160044,4,3,7,6,3,9,5,0.369489,0.38394,0,No
3426,shook,6,13.30477271,6,9.028038815,9.027988815,36,120.1160044,3,5,8,4,6,10,4,0.405515,0.422995,0,No
3445,shipbuilding,6,13.30477271,6,9.028038815,9.027988815,36,120.1160044,4,4,8,4,5,9,5,0.385556,0.401904,0,No
3508,shareholder,6,13.30477271,6,9.028038815,9.027988815,36,120.1160044,4,5,9,5,6,11,4,0.42758,0.443998,0,No
3728,seashore,6,13.30477271,6,9.028038815,9.027988815,36,120.1160044,2,6,8,5,6,11,4,0.394888,0.41201,0,No
3750,scythia,6,13.30477271,6,9.028038815,9.027988815,36,120.1160044,3,4,7,5,5,10,5,0.396272,0.413434,0,No
3808,scoop,6,13.30477271,6,9.028038815,9.027988815,36,120.1160044,3,5,8,5,6,11,4,0.431856,0.447914,0,No
3961,sargent,6,13.30477271,6,9.028038815,9.027988815,36,120.1160044,3,4,7,6,4,10,5,0.340038,0.347253,0,No
4091,safeguard,6,13.30477271,6,9.028038815,9.027988815,36,120.1160044,5,3,8,6,4,10,5,0.39889,0.416645,0,No
4111,sable,6,13.30477271,6,9.028038815,9.027988815,36,120.1160044,5,4,9,5,4,9,4,0.422593,0.439294,0,No
4148,runoff,6,13.30477271,6,9.028038815,9.027988815,36,120.1160044,3,4,7,4,4,8,5,0.352741,0.363245,0,No
4198,rowdy,6,13.30477271,6,9.028038815,9.027988815,36,120.1160044,4,2,6,5,2,7,5,0.321559,0.325111,0,No
4356,rigorous,6,13.30477271,6,9.028038815,9.027988815,36,120.1160044,5,3,8,6,3,9,5,0.320138,0.323703,0,No
4372,ridiculous,6,13.30477271,6,9.028038815,9.027988815,36,120.1160044,5,3,8,6,4,10,5,0.375762,0.39124,0,No
4453,reuben,6,13.30477271,6,9.028038815,9.027988815,36,120.1160044,3,2,5,3,2,5,5,0.322195,0.325512,0,No
4464,reticulum,6,13.30477271,6,9.028038815,9.027988815,36,120.1160044,0,5,5,0,5,5,4,0.400198,0.417521,0,No
4480,restroom,6,13.30477271,6,9.028038815,9.027988815,36,120.1160044,4,5,9,6,5,11,4,0.422633,0.439487,0,No
4560,rena,6,13.30477271,6,9.028038815,9.027988815,36,120.1160044,4,1,5,4,1,5,5,0.298894,0.304825,0,No
4583,relic,6,13.30477271,6,9.028038815,9.027988815,36,120.1160044,3,4,7,5,5,10,5,0.382837,0.399146,0,No
4620,regal,6,13.30477271,6,9.028038815,9.027988815,36,120.1160044,6,4,10,6,4,10,5,0.367721,0.381874,0,No
4623,refusal,6,13.30477271,6,9.028038815,9.027988815,36,120.1160044,4,3,7,5,6,11,5,0.369635,0.38409,0,No
4641,reel,6,13.30477271,6,9.028038815,9.027988815,36,120.1160044,3,6,9,4,6,10,4,0.411971,0.429356,0,No
4970,pussycat,6,13.30477271,6,9.028038815,9.027988815,36,120.1160044,4,1,5,4,1,5,5,0.375317,0.391855,0,No
5091,provocation,6,13.30477271,6,9.028038815,9.027988815,36,120.1160044,6,3,9,6,3,9,5,0.384979,0.401261,0,No
5194,prolific,6,13.30477271,6,9.028038815,9.027988815,36,120.1160044,2,1,3,5,1,6,5,0.321663,0.325905,0,No
5197,prokaryotic,6,13.30477271,6,9.028038815,9.027988815,36,120.1160044,4,1,5,4,1,5,5,0.384237,0.400402,0,No
5455,porous,6,13.30477271,6,9.028038815,9.027988815,36,120.1160044,4,3,7,5,3,8,5,0.384487,0.400707,0,No
5465,populist,6,13.30477271,6,9.028038815,9.027988815,36,120.1160044,3,3,6,3,3,6,5,0.395592,0.412697,0,No
5503,polysaccharide,6,13.30477271,6,9.028038815,9.027988815,36,120.1160044,4,5,9,6,5,11,5,0.355233,0.366551,0,No
5528,pollute,6,13.30477271,6,9.028038815,9.027988815,36,120.1160044,5,2,7,6,6,12,5,0.398764,0.416481,0,No
5558,poke,6,13.30477271,6,9.028038815,9.027988815,36,120.1160044,5,5,10,6,6,12,5,0.331299,0.336301,0,No
5731,pinniped,6,13.30477271,6,9.028038815,9.027988815,36,120.1160044,3,3,6,6,3,9,5,0.376695,0.393188,0,No
5830,phoneme,6,13.30477271,6,9.028038815,9.027988815,36,120.1160044,4,5,9,6,6,12,4,0.410798,0.428314,0,No
5988,peptide,6,13.30477271,6,9.028038815,9.027988815,36,120.1160044,3,3,6,6,3,9,5,0.355354,0.36713,0,No
5996,pep,6,13.30477271,6,9.028038815,9.027988815,36,120.1160044,5,3,8,6,3,9,5,0.337318,0.343434,0,No
6349,palaeontology,6,13.30477271,6,9.028038815,9.027988815,36,120.1160044,3,4,7,5,5,10,4,0.428447,0.444651,0,No
6378,pacifist,6,13.30477271,6,9.028038815,9.027988815,36,120.1160044,4,4,8,5,6,11,5,0.384737,0.401012,0,No
6617,olden,6,13.30477271,6,9.028038815,9.027988815,36,120.1160044,3,1,4,6,1,7,5,0.330602,0.335239,0,No
6800,novice,6,13.30477271,6,9.028038815,9.027988815,36,120.1160044,4,4,8,5,4,9,5,0.334275,0.339662,0,No
6802,novelty,6,13.30477271,6,9.028038815,9.027988815,36,120.1160044,5,2,7,5,2,7,5,0.388382,0.405131,0,No
6887,nocturne,6,13.30477271,6,9.028038815,9.027988815,36,120.1160044,4,4,8,4,5,9,4,0.427467,0.443764,0,No
6975,newsweek,6,13.30477271,6,9.028038815,9.027988815,36,120.1160044,6,3,9,6,3,9,5,0.376847,0.39332,0,No
7195,muzzle,6,13.30477271,6,9.028038815,9.027988815,36,120.1160044,5,5,10,6,6,12,4,0.42723,0.443571,0,No
7255,multiplicative,6,13.30477271,6,9.028038815,9.027988815,36,120.1160044,4,3,7,5,4,9,5,0.326347,0.330001,0,No
7374,morbid,6,13.30477271,6,9.028038815,9.027988815,36,120.1160044,4,2,6,4,3,7,5,0.320693,0.324075,0,No
7378,morale,6,13.30477271,6,9.028038815,9.027988815,36,120.1160044,5,5,10,5,5,10,5,0.378397,0.394984,0,No
7405,montenegrin,6,13.30477271,6,9.028038815,9.027988815,36,120.1160044,2,3,5,2,4,6,5,0.322464,0.326029,0,No
7476,mohawk,6,13.30477271,6,9.028038815,9.027988815,36,120.1160044,4,2,6,5,2,7,5,0.328363,0.332674,0,No
7489,modesto,6,13.30477271,6,9.028038815,9.027988815,36,120.1160044,2,3,5,4,5,9,5,0.326515,0.33002,0,No
7573,ministerial,6,13.30477271,6,9.028038815,9.027988815,36,120.1160044,5,2,7,6,2,8,5,0.324717,0.328228,0,No
7909,mcfadden,6,13.30477271,6,9.028038815,9.027988815,36,120.1160044,3,4,7,3,4,7,5,0.384795,0.401078,0,No
7971,matsumoto,6,13.30477271,6,9.028038815,9.027988815,36,120.1160044,2,5,7,3,5,8,4,0.422653,0.43937,0,No
7993,mateo,6,13.30477271,6,9.028038815,9.027988815,36,120.1160044,3,3,6,5,3,8,5,0.327787,0.332123,0,No
8224,malabar,6,13.30477271,6,9.028038815,9.027988815,36,120.1160044,4,4,8,4,6,10,5,0.32731,0.330909,0,No
8249,mahogany,6,13.30477271,6,9.028038815,9.027988815,36,120.1160044,3,2,5,4,2,6,5,0.375333,0.391892,0,No
8275,magi,6,13.30477271,6,9.028038815,9.027988815,36,120.1160044,3,4,7,6,4,10,4,0.409802,0.42729,0,No
8374,lush,6,13.30477271,6,9.028038815,9.027988815,36,120.1160044,5,4,9,5,4,9,5,0.386926,0.40343,0,No
8659,lilian,6,13.30477271,6,9.028038815,9.027988815,36,120.1160044,3,5,8,3,5,8,5,0.328753,0.332929,0,No
8692,lichen,6,13.30477271,6,9.028038815,9.027988815,36,120.1160044,6,6,12,6,6,12,4,0.410276,0.427915,0,No
8860,laxative,6,13.30477271,6,9.028038815,9.027988815,36,120.1160044,1,6,7,6,6,12,4,0.432171,0.448031,0,No
8943,lanthanide,6,13.30477271,6,9.028038815,9.027988815,36,120.1160044,2,5,7,6,6,12,5,0.358802,0.371215,0,No
8958,landowner,6,13.30477271,6,9.028038815,9.027988815,36,120.1160044,6,5,11,6,5,11,5,0.396732,0.413941,0,No
8996,lagrangian,6,13.30477271,6,9.028038815,9.027988815,36,120.1160044,2,1,3,4,5,9,5,0.323257,0.326421,0,No
9167,kidnap,6,13.30477271,6,9.028038815,9.027988815,36,120.1160044,2,5,7,6,6,12,5,0.398424,0.416232,0,No
9290,justify,6,13.30477271,6,9.028038815,9.027988815,36,120.1160044,1,3,4,5,4,9,5,0.398764,0.416471,0,No
9440,jerky,6,13.30477271,6,9.028038815,9.027988815,36,120.1160044,5,1,6,5,1,6,5,0.314611,0.318872,0,No
9724,insurgent,6,13.30477271,6,9.028038815,9.027988815,36,120.1160044,6,2,8,6,2,8,5,0.331305,0.335819,0,No
9730,insular,6,13.30477271,6,9.028038815,9.027988815,36,120.1160044,3,4,7,3,5,8,5,0.35646,0.368472,0,No
9833,informative,6,13.30477271,6,9.028038815,9.027988815,36,120.1160044,4,5,9,5,5,10,5,0.332871,0.337638,0,No
9843,inflict,6,13.30477271,6,9.028038815,9.027988815,36,120.1160044,2,2,4,3,5,8,5,0.375357,0.391921,0,No
9890,inefficient,6,13.30477271,6,9.028038815,9.027988815,36,120.1160044,4,4,8,5,5,10,4,0.407404,0.424788,0,No
9901,induce,6,13.30477271,6,9.028038815,9.027988815,36,120.1160044,3,3,6,5,4,9,5,0.413979,0.43171,0,No
9990,inanimate,6,13.30477271,6,9.028038815,9.027988815,36,120.1160044,3,3,6,3,4,7,5,0.331763,0.336448,0,No
10031,impetus,6,13.30477271,6,9.028038815,9.027988815,36,120.1160044,4,4,8,5,5,10,5,0.3833,0.399693,0,No
10055,imminent,6,13.30477271,6,9.028038815,9.027988815,36,120.1160044,4,4,8,6,5,11,5,0.326479,0.330399,0,No
10082,illicit,6,13.30477271,6,9.028038815,9.027988815,36,120.1160044,3,2,5,4,2,6,5,0.317214,0.321039,0,No
10095,ignorant,6,13.30477271,6,9.028038815,9.027988815,36,120.1160044,4,5,9,5,5,10,5,0.391422,0.40845,0,No
10319,horsemen,6,13.30477271,6,9.028038815,9.027988815,36,120.1160044,5,4,9,5,4,9,4,0.445457,0.45943,0,No
10361,honeymoon,6,13.30477271,6,9.028038815,9.027988815,36,120.1160044,5,4,9,6,4,10,5,0.340207,0.347138,0,No
10476,hint,6,13.30477271,6,9.028038815,9.027988815,36,120.1160044,3,4,7,5,6,11,5,0.389097,0.405953,0,No
10491,hilltop,6,13.30477271,6,9.028038815,9.027988815,36,120.1160044,3,4,7,6,6,12,5,0.40557,0.422959,0,No
10749,haul,6,13.30477271,6,9.028038815,9.027988815,36,120.1160044,4,3,7,6,3,9,5,0.381504,0.398191,0,No
10860,handicap,6,13.30477271,6,9.028038815,9.027988815,36,120.1160044,4,4,8,4,5,9,5,0.385272,0.40159,0,No
10883,halt,6,13.30477271,6,9.028038815,9.027988815,36,120.1160044,2,5,7,5,6,11,4,0.435875,0.451252,0,No
10893,hallmark,6,13.30477271,6,9.028038815,9.027988815,36,120.1160044,5,1,6,6,1,7,5,0.378599,0.394387,0,No
11020,guelph,6,13.30477271,6,9.028038815,9.027988815,36,120.1160044,2,4,6,4,4,8,5,0.324961,0.328379,0,No
11159,granular,6,13.30477271,6,9.028038815,9.027988815,36,120.1160044,5,3,8,6,4,10,5,0.328315,0.333336,0,No
11194,graceful,6,13.30477271,6,9.028038815,9.027988815,36,120.1160044,5,3,8,5,4,9,5,0.385548,0.401899,0,No
11350,gladys,6,13.30477271,6,9.028038815,9.027988815,36,120.1160044,3,3,6,3,4,7,5,0.384337,0.400552,0,No
11618,gage,6,13.30477271,6,9.028038815,9.027988815,36,120.1160044,2,3,5,2,3,5,4,0.37793,0.394339,0,No
11750,freshman,6,13.30477271,6,9.028038815,9.027988815,36,120.1160044,4,5,9,6,5,11,5,0.364842,0.378383,0,No
11898,forbidding,6,13.30477271,6,9.028038815,9.027988815,36,120.1160044,4,4,8,4,4,8,5,0.398362,0.416147,0,No
12068,flagpole,6,13.30477271,6,9.028038815,9.027988815,36,120.1160044,4,6,10,6,6,12,4,0.427838,0.444125,0,No
12160,figurine,6,13.30477271,6,9.028038815,9.027988815,36,120.1160044,3,6,9,6,6,12,5,0.351338,0.361566,0,No
12291,faulty,6,13.30477271,6,9.028038815,9.027988815,36,120.1160044,3,3,6,5,3,8,5,0.318609,0.322306,0,No
12333,fanfare,6,13.30477271,6,9.028038815,9.027988815,36,120.1160044,5,4,9,5,5,10,4,0.388399,0.405005,0,No
12425,extracellular,6,13.30477271,6,9.028038815,9.027988815,36,120.1160044,4,2,6,5,4,9,5,0.322681,0.325921,0,No
12455,exploit,6,13.30477271,6,9.028038815,9.027988815,36,120.1160044,2,3,5,5,6,11,4,0.413295,0.430675,0,No
12472,expenditure,6,13.30477271,6,9.028038815,9.027988815,36,120.1160044,5,6,11,5,6,11,5,0.378027,0.393717,0,No
12588,evacuate,6,13.30477271,6,9.028038815,9.027988815,36,120.1160044,1,5,6,5,6,11,5,0.402818,0.420603,0,No
12669,esoteric,6,13.30477271,6,9.028038815,9.027988815,36,120.1160044,3,4,7,3,5,8,5,0.395768,0.412899,0,No
12805,enigma,6,13.30477271,6,9.028038815,9.027988815,36,120.1160044,5,3,8,6,4,10,4,0.417828,0.435022,0,No
13035,edt,6,13.30477271,6,9.028038815,9.027988815,36,120.1160044,4,4,8,5,4,9,5,0.363489,0.37664,0,No
13071,echolocation,6,13.30477271,6,9.028038815,9.027988815,36,120.1160044,4,4,8,5,6,11,4,0.397951,0.415521,0,No
13176,dun,6,13.30477271,6,9.028038815,9.027988815,36,120.1160044,4,2,6,5,2,7,4,0.389755,0.406475,0,No
13218,drunken,6,13.30477271,6,9.028038815,9.027988815,36,120.1160044,5,5,10,6,5,11,5,0.333948,0.339457,0,No
13334,doric,6,13.30477271,6,9.028038815,9.027988815,36,120.1160044,2,2,4,5,4,9,5,0.325623,0.330987,0,No
13357,donner,6,13.30477271,6,9.028038815,9.027988815,36,120.1160044,3,2,5,6,2,8,5,0.398353,0.41611,0,No
13502,disastrous,6,13.30477271,6,9.028038815,9.027988815,36,120.1160044,3,5,8,6,5,11,5,0.331485,0.336175,0,No
13550,dillon,6,13.30477271,6,9.028038815,9.027988815,36,120.1160044,3,3,6,5,3,8,5,0.384679,0.400928,0,No
13630,diacritic,6,13.30477271,6,9.028038815,9.027988815,36,120.1160044,2,4,6,5,4,9,4,0.418113,0.43544,0,No
13721,depressive,6,13.30477271,6,9.028038815,9.027988815,36,120.1160044,3,2,5,6,2,8,5,0.323628,0.326928,0,No
13753,denny,6,13.30477271,6,9.028038815,9.027988815,36,120.1160044,5,2,7,5,2,7,5,0.323257,0.326838,0,No
13806,delicious,6,13.30477271,6,9.028038815,9.027988815,36,120.1160044,6,6,12,6,6,12,5,0.396724,0.413946,0,No
13870,decompose,6,13.30477271,6,9.028038815,9.027988815,36,120.1160044,4,3,7,5,5,10,4,0.400203,0.417803,0,No
13891,deceive,6,13.30477271,6,9.028038815,9.027988815,36,120.1160044,3,6,9,5,6,11,4,0.41772,0.435098,0,No
13915,debit,6,13.30477271,6,9.028038815,9.027988815,36,120.1160044,4,2,6,4,4,8,5,0.355333,0.367073,0,No
14121,curl,6,13.30477271,6,9.028038815,9.027988815,36,120.1160044,5,6,11,6,6,12,4,0.433734,0.449411,0,No
14130,curd,6,13.30477271,6,9.028038815,9.027988815,36,120.1160044,4,1,5,5,1,6,5,0.300834,0.306526,0,No
14138,cunning,6,13.30477271,6,9.028038815,9.027988815,36,120.1160044,5,4,9,6,4,10,5,0.396325,0.413495,0,No
14142,cummings,6,13.30477271,6,9.028038815,9.027988815,36,120.1160044,3,4,7,6,5,11,5,0.356955,0.368579,0,No
14337,covert,6,13.30477271,6,9.028038815,9.027988815,36,120.1160044,3,2,5,3,2,5,5,0.390544,0.407303,0,No
14607,conspicuous,6,13.30477271,6,9.028038815,9.027988815,36,120.1160044,5,2,7,6,2,8,5,0.324658,0.328219,0,No
14669,confrontation,6,13.30477271,6,9.028038815,9.027988815,36,120.1160044,4,4,8,5,6,11,5,0.370129,0.384519,0,No
14687,confess,6,13.30477271,6,9.028038815,9.027988815,36,120.1160044,5,5,10,6,6,12,4,0.428323,0.444712,0,No
14693,confectionery,6,13.30477271,6,9.028038815,9.027988815,36,120.1160044,4,6,10,4,6,10,4,0.436143,0.451514,0,No
14706,condemn,6,13.30477271,6,9.028038815,9.027988815,36,120.1160044,3,5,8,3,6,9,4,0.41918,0.436295,0,No
14787,compendium,6,13.30477271,6,9.028038815,9.027988815,36,120.1160044,3,3,6,3,6,9,5,0.385447,0.401995,0,No
14862,colossal,6,13.30477271,6,9.028038815,9.027988815,36,120.1160044,3,1,4,5,5,10,5,0.30965,0.314451,0,No
14882,collier,6,13.30477271,6,9.028038815,9.027988815,36,120.1160044,5,5,10,5,6,11,5,0.330731,0.335165,0,No
15085,clarity,6,13.30477271,6,9.028038815,9.027988815,36,120.1160044,4,5,9,5,6,11,5,0.418074,0.435165,0,No
15133,circulate,6,13.30477271,6,9.028038815,9.027988815,36,120.1160044,3,4,7,6,4,10,5,0.334603,0.340155,0,No
15146,cinematic,6,13.30477271,6,9.028038815,9.027988815,36,120.1160044,3,3,6,5,5,10,5,0.324486,0.3277,0,No
15260,chime,6,13.30477271,6,9.028038815,9.027988815,36,120.1160044,0,1,1,0,6,6,5,0.341779,0.349673,0,No
15262,chill,6,13.30477271,6,9.028038815,9.027988815,36,120.1160044,5,5,10,5,5,10,5,0.332528,0.338316,0,No
15289,chevalier,6,13.30477271,6,9.028038815,9.027988815,36,120.1160044,4,4,8,4,5,9,5,0.378099,0.394707,0,No
15409,chairwoman,6,13.30477271,6,9.028038815,9.027988815,36,120.1160044,4,3,7,5,6,11,4,0.423389,0.440163,0,No
15473,cellar,6,13.30477271,6,9.028038815,9.027988815,36,120.1160044,4,4,8,5,6,11,5,0.378995,0.394894,0,No
15573,cashier,6,13.30477271,6,9.028038815,9.027988815,36,120.1160044,2,3,5,3,4,7,4,0.429017,0.445139,0,No
15581,carve,6,13.30477271,6,9.028038815,9.027988815,36,120.1160044,3,3,6,4,5,9,4,0.407301,0.424948,0,No
15609,carpal,6,13.30477271,6,9.028038815,9.027988815,36,120.1160044,4,1,5,6,5,11,5,0.319395,0.322773,0,No
15660,carcass,6,13.30477271,6,9.028038815,9.027988815,36,120.1160044,4,3,7,6,4,10,4,0.424269,0.440975,0,No
15724,cannibal,6,13.30477271,6,9.028038815,9.027988815,36,120.1160044,5,3,8,6,5,11,5,0.325605,0.329261,0,No
15926,burnett,6,13.30477271,6,9.028038815,9.027988815,36,120.1160044,2,5,7,4,6,10,4,0.400203,0.417873,0,No
15949,burden,6,13.30477271,6,9.028038815,9.027988815,36,120.1160044,5,4,9,5,5,10,5,0.391699,0.40873,0,No
15975,bullfrog,6,13.30477271,6,9.028038815,9.027988815,36,120.1160044,5,2,7,5,2,7,5,0.384254,0.400439,0,No
15988,buildup,6,13.30477271,6,9.028038815,9.027988815,36,120.1160044,3,3,6,6,6,12,5,0.397675,0.415041,0,No
16052,brownie,6,13.30477271,6,9.028038815,9.027988815,36,120.1160044,4,3,7,4,4,8,5,0.38467,0.400914,0,No
16094,briton,6,13.30477271,6,9.028038815,9.027988815,36,120.1160044,2,4,6,3,4,7,5,0.397987,0.415626,0,No
16571,billionth,6,13.30477271,6,9.028038815,9.027988815,36,120.1160044,2,2,4,5,6,11,5,0.378704,0.394519,0,No
16601,bicameral,6,13.30477271,6,9.028038815,9.027988815,36,120.1160044,3,3,6,6,4,10,5,0.329717,0.334076,0,No
17033,bake,6,13.30477271,6,9.028038815,9.027988815,36,120.1160044,2,4,6,5,4,9,5,0.392965,0.410321,0,No
17135,avid,6,13.30477271,6,9.028038815,9.027988815,36,120.1160044,2,2,4,5,2,7,5,0.321105,0.324345,0,No
17174,authoritative,6,13.30477271,6,9.028038815,9.027988815,36,120.1160044,5,5,10,5,5,10,4,0.387543,0.404081,0,No
17224,attribution,6,13.30477271,6,9.028038815,9.027988815,36,120.1160044,3,4,7,3,4,7,5,0.37164,0.386215,0,No
17309,assess,6,13.30477271,6,9.028038815,9.027988815,36,120.1160044,1,3,4,5,6,11,5,0.404342,0.421936,0,No
17311,assent,6,13.30477271,6,9.028038815,9.027988815,36,120.1160044,4,5,9,6,5,11,4,0.404858,0.422263,0,No
17364,artichoke,6,13.30477271,6,9.028038815,9.027988815,36,120.1160044,5,3,8,6,3,9,4,0.406322,0.423868,0,No
17439,argentinian,6,13.30477271,6,9.028038815,9.027988815,36,120.1160044,3,3,6,4,3,7,5,0.329736,0.333883,0,No
17507,appreciate,6,13.30477271,6,9.028038815,9.027988815,36,120.1160044,3,6,9,5,6,11,4,0.413275,0.43068,0,No
17557,aphrodisiac,6,13.30477271,6,9.028038815,9.027988815,36,120.1160044,2,5,7,4,5,9,4,0.405357,0.422957,0,No
17609,anthropomorphic,6,13.30477271,6,9.028038815,9.027988815,36,120.1160044,2,5,7,3,5,8,5,0.332192,0.337205,0,No
17763,amphetamine,6,13.30477271,6,9.028038815,9.027988815,36,120.1160044,6,4,10,6,5,11,4,0.422895,0.439571,0,No
17952,aleutian,6,13.30477271,6,9.028038815,9.027988815,36,120.1160044,2,1,3,6,1,7,5,0.321984,0.325052,0,No
18150,ado,6,13.30477271,6,9.028038815,9.027988815,36,120.1160044,4,4,8,4,6,10,5,0.334074,0.33927,0,No
18151,admitting,6,13.30477271,6,9.028038815,9.027988815,36,120.1160044,4,3,7,5,6,11,5,0.342353,0.350044,0,No
18156,admiration,6,13.30477271,6,9.028038815,9.027988815,36,120.1160044,5,4,9,5,6,11,5,0.362066,0.37491,0,No
18228,acknowledge,6,13.30477271,6,9.028038815,9.027988815,36,120.1160044,1,5,6,6,5,11,4,0.423247,0.439914,0,No
18245,accuse,6,13.30477271,6,9.028038815,9.027988815,36,120.1160044,2,4,6,6,5,11,5,0.384537,0.400792,0,No
18259,accomplice,6,13.30477271,6,9.028038815,9.027988815,36,120.1160044,4,4,8,4,4,8,5,0.392149,0.409244,0,No
18293,abusive,6,13.30477271,6,9.028038815,9.027988815,36,120.1160044,4,5,9,4,5,9,5,0.360178,0.372999,0,No
18301,abstain,6,13.30477271,6,9.028038815,9.027988815,36,120.1160044,4,1,5,5,6,11,5,0.341779,0.349674,0,No
381,whitlock,10,12.79394708,4,9.433503923,9.433473923,40,120.69175,3,8,11,6,8,14,4,0.400483,0.418188,0,No
704,vixen,10,12.79394708,4,9.433503923,9.433473923,40,120.69175,8,6,14,10,8,18,4,0.416984,0.434069,0,No
920,vat,10,12.79394708,4,9.433503923,9.433473923,40,120.69175,3,4,7,3,6,9,5,0.396688,0.413899,0,No
1236,tuba,10,12.79394708,4,9.433503923,9.433473923,40,120.69175,6,6,12,9,7,16,5,0.35237,0.363037,0,No
1383,transposition,10,12.79394708,4,9.433503923,9.433473923,40,120.69175,9,7,16,9,7,16,5,0.369297,0.383905,0,No
2907,soybean,10,12.79394708,4,9.433503923,9.433473923,40,120.69175,7,7,14,9,8,17,4,0.400573,0.417991,0,No
5689,pizzicato,10,12.79394708,4,9.433503923,9.433473923,40,120.69175,5,7,12,6,7,13,4,0.422623,0.439454,0,No
6112,pavlov,10,12.79394708,4,9.433503923,9.433473923,40,120.69175,7,7,14,9,8,17,5,0.352133,0.362695,0,No
8838,lear,10,12.79394708,4,9.433503923,9.433473923,40,120.69175,6,6,12,9,7,16,4,0.416094,0.43337,0,No
11379,gilligan,10,12.79394708,4,9.433503923,9.433473923,40,120.69175,7,7,14,8,10,18,5,0.374541,0.389698,0,No
11387,gila,10,12.79394708,4,9.433503923,9.433473923,40,120.69175,2,2,4,9,9,18,5,0.32806,0.332252,0,No
11780,frazier,10,12.79394708,4,9.433503923,9.433473923,40,120.69175,9,9,18,9,9,18,4,0.376399,0.391912,0,No
14231,crocus,10,12.79394708,4,9.433503923,9.433473923,40,120.69175,3,4,7,7,4,11,5,0.337863,0.344281,0,No
4868,quinine,14,12.45747485,3,9.721185996,9.721165996,42,121.10143,12,8,20,12,11,23,5,0.381332,0.397538,0,No
10154,hypothalamus,14,12.45747485,3,9.721185996,9.721165996,42,121.10143,3,6,9,14,10,24,4,0.429328,0.445477,0,No
15986,bujumbura,14,12.45747485,3,9.721185996,9.721165996,42,121.10143,8,10,18,9,13,22,4,0.42052,0.437539,0,No
230,woodbury,7,13.15062203,5,9.210360372,9.210320372,35,121.121968,5,4,9,6,6,12,5,0.351818,0.362073,0,No
500,weaponry,7,13.15062203,5,9.210360372,9.210320372,35,121.121968,5,4,9,7,6,13,4,0.412718,0.429952,0,No
811,viaduct,7,13.15062203,5,9.210360372,9.210320372,35,121.121968,4,5,9,5,6,11,4,0.392261,0.409235,0,No
837,vertebra,7,13.15062203,5,9.210360372,9.210320372,35,121.121968,3,6,9,4,6,10,4,0.426225,0.442806,0,No
957,valkyrie,7,13.15062203,5,9.210360372,9.210320372,35,121.121968,2,5,7,5,6,11,4,0.424188,0.440778,0,No
995,ut,7,13.15062203,5,9.210360372,9.210320372,35,121.121968,6,5,11,6,5,11,5,0.376887,0.392381,0,No
1436,tramp,7,13.15062203,5,9.210360372,9.210320372,35,121.121968,3,5,8,7,5,12,4,0.413603,0.430933,0,No
2908,soya,7,13.15062203,5,9.210360372,9.210320372,35,121.121968,2,3,5,3,5,8,5,0.321209,0.324647,0,No
3105,smithfield,7,13.15062203,5,9.210360372,9.210320372,35,121.121968,4,6,10,4,7,11,4,0.410893,0.4283,0,No
3143,sloane,7,13.15062203,5,9.210360372,9.210320372,35,121.121968,5,6,11,6,6,12,5,0.349773,0.359793,0,No
3158,slick,7,13.15062203,5,9.210360372,9.210320372,35,121.121968,4,4,8,4,4,8,5,0.345619,0.354746,0,No
3173,slay,7,13.15062203,5,9.210360372,9.210320372,35,121.121968,4,4,8,6,6,12,4,0.405542,0.423136,0,No
3200,skye,7,13.15062203,5,9.210360372,9.210320372,35,121.121968,5,4,9,5,5,10,4,0.426072,0.442492,0,No
3471,shelton,7,13.15062203,5,9.210360372,9.210320372,35,121.121968,5,6,11,5,7,12,5,0.350512,0.360619,0,No
3671,seismology,7,13.15062203,5,9.210360372,9.210320372,35,121.121968,4,5,9,4,6,10,5,0.388416,0.405253,0,No
3883,scarface,7,13.15062203,5,9.210360372,9.210320372,35,121.121968,2,5,7,4,7,11,4,0.426246,0.442665,0,No
3994,sanford,7,13.15062203,5,9.210360372,9.210320372,35,121.121968,3,5,8,3,7,10,4,0.390235,0.407052,0,No
4959,pyongyang,7,13.15062203,5,9.210360372,9.210320372,35,121.121968,6,5,11,6,6,12,4,0.410513,0.427915,0,No
5166,propellant,7,13.15062203,5,9.210360372,9.210320372,35,121.121968,5,7,12,5,7,12,4,0.423652,0.440487,0,No
5642,platte,7,13.15062203,5,9.210360372,9.210320372,35,121.121968,3,2,5,7,7,14,5,0.330984,0.335764,0,No
5989,pepsico,7,13.15062203,5,9.210360372,9.210320372,35,121.121968,5,5,10,7,5,12,5,0.399069,0.416725,0,No
6530,optimism,7,13.15062203,5,9.210360372,9.210320372,35,121.121968,7,3,10,7,5,12,5,0.357825,0.369718,0,No
6531,optimal,7,13.15062203,5,9.210360372,9.210320372,35,121.121968,4,6,10,5,6,11,5,0.323039,0.326374,0,No
6543,oppenheimer,7,13.15062203,5,9.210360372,9.210320372,35,121.121968,4,4,8,7,4,11,4,0.389592,0.406728,0,No
6828,nostradamus,7,13.15062203,5,9.210360372,9.210320372,35,121.121968,7,4,11,7,4,11,5,0.348428,0.357643,0,No
7417,monrovia,7,13.15062203,5,9.210360372,9.210320372,35,121.121968,6,5,11,6,6,12,4,0.407769,0.425244,0,No
7609,millet,7,13.15062203,5,9.210360372,9.210320372,35,121.121968,5,3,8,6,3,9,4,0.416651,0.433703,0,No
7858,medford,7,13.15062203,5,9.210360372,9.210320372,35,121.121968,7,5,12,7,6,13,4,0.407086,0.424624,0,No
8066,marmalade,7,13.15062203,5,9.210360372,9.210320372,35,121.121968,5,5,10,5,6,11,4,0.425265,0.44197,0,No
8250,mahayana,7,13.15062203,5,9.210360372,9.210320372,35,121.121968,4,3,7,4,5,9,5,0.324551,0.328125,0,No
8784,lemuel,7,13.15062203,5,9.210360372,9.210320372,35,121.121968,5,3,8,5,3,8,5,0.318661,0.322512,0,No
8861,lax,7,13.15062203,5,9.210360372,9.210320372,35,121.121968,5,3,8,5,4,9,5,0.347548,0.356833,0,No
8988,lakeside,7,13.15062203,5,9.210360372,9.210320372,35,121.121968,5,4,9,5,5,10,5,0.350035,0.360098,0,No
9062,krakatoa,7,13.15062203,5,9.210360372,9.210320372,35,121.121968,4,5,9,7,5,12,5,0.338701,0.345473,0,No
9413,jingle,7,13.15062203,5,9.210360372,9.210320372,35,121.121968,3,3,6,4,4,8,5,0.329736,0.334173,0,No
10385,homestead,7,13.15062203,5,9.210360372,9.210320372,35,121.121968,4,6,10,6,6,12,5,0.348804,0.358464,0,No
10408,holm,7,13.15062203,5,9.210360372,9.210320372,35,121.121968,2,3,5,6,3,9,5,0.350257,0.360089,0,No
10520,hickey,7,13.15062203,5,9.210360372,9.210320372,35,121.121968,4,7,11,5,7,12,4,0.390398,0.407545,0,No
10633,helm,7,13.15062203,5,9.210360372,9.210320372,35,121.121968,4,4,8,7,4,11,4,0.423016,0.439679,0,No
10803,harem,7,13.15062203,5,9.210360372,9.210320372,35,121.121968,5,3,8,7,4,11,4,0.414733,0.432295,0,No
11147,grasshopper,7,13.15062203,5,9.210360372,9.210320372,35,121.121968,3,4,7,6,4,10,5,0.324527,0.328071,0,No
11426,germantown,7,13.15062203,5,9.210360372,9.210320372,35,121.121968,6,5,11,6,5,11,5,0.370198,0.384703,0,No
13031,edwardian,7,13.15062203,5,9.210360372,9.210320372,35,121.121968,3,4,7,7,6,13,5,0.328436,0.332149,0,No
13339,dorado,7,13.15062203,5,9.210360372,9.210320372,35,121.121968,1,6,7,7,6,13,4,0.413218,0.43068,0,No
13683,despot,7,13.15062203,5,9.210360372,9.210320372,35,121.121968,4,5,9,6,6,12,4,0.425653,0.442266,0,No
14036,dahomey,7,13.15062203,5,9.210360372,9.210320372,35,121.121968,4,4,8,7,6,13,5,0.363899,0.377109,0,No
14070,cymbal,7,13.15062203,5,9.210360372,9.210320372,35,121.121968,3,4,7,6,5,11,4,0.399734,0.417023,0,No
14197,crumb,7,13.15062203,5,9.210360372,9.210320372,35,121.121968,2,4,6,3,5,8,5,0.3794,0.395279,0,No
14214,crouch,7,13.15062203,5,9.210360372,9.210320372,35,121.121968,6,6,12,6,6,12,5,0.374707,0.3899,0,No
14999,clove,7,13.15062203,5,9.210360372,9.210320372,35,121.121968,4,4,8,6,4,10,5,0.349704,0.359507,0,No
15097,clandestine,7,13.15062203,5,9.210360372,9.210320372,35,121.121968,7,4,11,7,4,11,5,0.355717,0.367566,0,No
15249,chinook,7,13.15062203,5,9.210360372,9.210320372,35,121.121968,4,3,7,7,6,13,5,0.347215,0.35643,0,No
15455,centigrade,7,13.15062203,5,9.210360372,9.210320372,35,121.121968,3,7,10,4,7,11,4,0.37462,0.389828,0,No
15508,caustic,7,13.15062203,5,9.210360372,9.210320372,35,121.121968,7,3,10,7,5,12,5,0.384271,0.400477,0,No
15535,catechism,7,13.15062203,5,9.210360372,9.210320372,35,121.121968,3,2,5,6,7,13,5,0.378817,0.394627,0,No
15634,caricature,7,13.15062203,5,9.210360372,9.210320372,35,121.121968,5,4,9,6,5,11,4,0.419318,0.436431,0,No
15696,caper,7,13.15062203,5,9.210360372,9.210320372,35,121.121968,4,5,9,4,6,10,4,0.400032,0.417657,0,No
15932,burlesque,7,13.15062203,5,9.210360372,9.210320372,35,121.121968,4,5,9,5,5,10,4,0.416592,0.433694,0,No
15939,burglar,7,13.15062203,5,9.210360372,9.210320372,35,121.121968,5,4,9,7,5,12,5,0.392027,0.409035,0,No
15947,bureaucracy,7,13.15062203,5,9.210360372,9.210320372,35,121.121968,6,3,9,6,4,10,4,0.387771,0.404836,0,No
15966,bump,7,13.15062203,5,9.210360372,9.210320372,35,121.121968,4,5,9,5,7,12,4,0.417779,0.434905,0,No
16600,bicarbonate,7,13.15062203,5,9.210360372,9.210320372,35,121.121968,2,6,8,5,6,11,4,0.406993,0.424399,0,No
16783,beeswax,7,13.15062203,5,9.210360372,9.210320372,35,121.121968,3,4,7,3,4,7,4,0.425857,0.442294,0,No
16818,beau,7,13.15062203,5,9.210360372,9.210320372,35,121.121968,6,1,7,6,1,7,5,0.35519,0.366885,0,No
17118,awful,7,13.15062203,5,9.210360372,9.210320372,35,121.121968,3,5,8,6,5,11,5,0.350686,0.360866,0,No
17515,appleton,7,13.15062203,5,9.210360372,9.210320372,35,121.121968,6,6,12,6,6,12,5,0.334004,0.339074,0,No
17805,amen,7,13.15062203,5,9.210360372,9.210320372,35,121.121968,3,6,9,4,6,10,4,0.433099,0.448829,0,No
18059,agave,7,13.15062203,5,9.210360372,9.210320372,35,121.121968,2,6,8,2,6,8,4,0.390733,0.407597,0,No
18097,afar,7,13.15062203,5,9.210360372,9.210320372,35,121.121968,3,5,8,6,6,12,5,0.353599,0.364549,0,No
1504,torrent,9,12.8993076,4,9.433503923,9.433473923,36,121.6856688,5,4,9,5,4,9,4,0.388961,0.405611,0,No
2073,taiga,9,12.8993076,4,9.433503923,9.433473923,36,121.6856688,6,5,11,8,6,14,4,0.405283,0.422868,0,No
3151,sling,9,12.8993076,4,9.433503923,9.433473923,36,121.6856688,4,5,9,9,6,15,5,0.372944,0.38798,0,No
3215,skillet,9,12.8993076,4,9.433503923,9.433473923,36,121.6856688,8,5,13,8,6,14,4,0.419864,0.436858,0,No
4237,rosary,9,12.8993076,4,9.433503923,9.433473923,36,121.6856688,2,6,8,9,7,16,4,0.441534,0.456261,0,No
4584,reliant,9,12.8993076,4,9.433503923,9.433473923,36,121.6856688,5,3,8,8,5,13,5,0.327213,0.330947,0,No
4617,regatta,9,12.8993076,4,9.433503923,9.433473923,36,121.6856688,4,5,9,7,8,15,5,0.354071,0.365049,0,No
5759,pilate,9,12.8993076,4,9.433503923,9.433473923,36,121.6856688,4,6,10,4,7,11,5,0.381808,0.39801,0,No
5863,pharmacology,9,12.8993076,4,9.433503923,9.433473923,36,121.6856688,5,5,10,7,7,14,4,0.390286,0.407094,0,No
6070,pedagogy,9,12.8993076,4,9.433503923,9.433473923,36,121.6856688,7,7,14,7,8,15,4,0.424513,0.44128,0,No
6318,pancake,9,12.8993076,4,9.433503923,9.433473923,36,121.6856688,4,6,10,7,8,15,5,0.370956,0.38559,0,No
7488,modesty,9,12.8993076,4,9.433503923,9.433473923,36,121.6856688,4,6,10,6,8,14,5,0.382013,0.398186,0,No
7834,meier,9,12.8993076,4,9.433503923,9.433473923,36,121.6856688,3,6,9,6,9,15,5,0.372209,0.386966,0,No
7859,medea,9,12.8993076,4,9.433503923,9.433473923,36,121.6856688,7,5,12,8,5,13,5,0.331726,0.337252,0,No
7895,mckee,9,12.8993076,4,9.433503923,9.433473923,36,121.6856688,4,5,9,6,6,12,5,0.348551,0.358148,0,No
9330,jug,9,12.8993076,4,9.433503923,9.433473923,36,121.6856688,5,7,12,9,7,16,4,0.407198,0.424746,0,No
10209,hush,9,12.8993076,4,9.433503923,9.433473923,36,121.6856688,3,6,9,8,9,17,4,0.402298,0.420014,0,No
10384,homework,9,12.8993076,4,9.433503923,9.433473923,36,121.6856688,6,4,10,9,8,17,4,0.400546,0.417859,0,No
11582,galois,9,12.8993076,4,9.433503923,9.433473923,36,121.6856688,5,6,11,5,7,12,5,0.362969,0.376526,0,No
11680,fulcrum,9,12.8993076,4,9.433503923,9.433473923,36,121.6856688,5,4,9,8,7,15,5,0.350263,0.360305,0,No
11688,fuchsia,9,12.8993076,4,9.433503923,9.433473923,36,121.6856688,6,4,10,6,4,10,5,0.347323,0.356704,0,No
12089,fissure,9,12.8993076,4,9.433503923,9.433473923,36,121.6856688,3,6,9,4,6,10,4,0.421629,0.438454,0,No
13040,edmonds,9,12.8993076,4,9.433503923,9.433473923,36,121.6856688,7,5,12,7,6,13,5,0.356661,0.368321,0,No
14122,curium,9,12.8993076,4,9.433503923,9.433473923,36,121.6856688,6,5,11,6,8,14,5,0.352126,0.362659,0,No
14404,cossack,9,12.8993076,4,9.433503923,9.433473923,36,121.6856688,5,4,9,7,5,12,5,0.329454,0.333417,0,No
16071,brontosaurus,9,12.8993076,4,9.433503923,9.433473923,36,121.6856688,6,4,10,6,8,14,5,0.351993,0.362495,0,No
16124,bridle,9,12.8993076,4,9.433503923,9.433473923,36,121.6856688,4,8,12,8,8,16,4,0.398076,0.415385,0,No
16217,bragg,9,12.8993076,4,9.433503923,9.433473923,36,121.6856688,3,5,8,8,8,16,5,0.350984,0.361201,0,No
16218,brae,9,12.8993076,4,9.433503923,9.433473923,36,121.6856688,1,5,6,1,7,8,4,0.415384,0.432666,0,No
16255,bourgeoisie,9,12.8993076,4,9.433503923,9.433473923,36,121.6856688,7,7,14,8,8,16,4,0.409085,0.426647,0,No
16650,bertie,9,12.8993076,4,9.433503923,9.433473923,36,121.6856688,7,2,9,7,8,15,5,0.326161,0.32998,0,No
16976,bangui,9,12.8993076,4,9.433503923,9.433473923,36,121.6856688,6,5,11,7,7,14,4,0.431719,0.44759,0,No
6785,nucleolus,13,12.53158282,3,9.721185996,9.721165996,39,121.8218474,4,5,9,13,7,20,5,0.39546,0.412716,0,No
8790,leitmotif,13,12.53158282,3,9.721185996,9.721165996,39,121.8218474,3,6,9,13,11,24,4,0.39863,0.416178,0,No
14327,cowpox,13,12.53158282,3,9.721185996,9.721165996,39,121.8218474,9,6,15,10,7,17,4,0.418192,0.435215,0,No
17001,balsam,13,12.53158282,3,9.721185996,9.721165996,39,121.8218474,6,1,7,9,13,22,5,0.32281,0.326129,0,No
13901,dec,6,13.30477271,8,9.210360372,9.210320372,48,122.5417513,3,4,7,3,4,7,5,0.370941,0.385621,0,No
107,yeah,6,13.30477271,5,9.210360372,9.210320372,30,122.5417513,5,4,9,5,4,9,5,0.354658,0.365365,0,No
136,xerox,6,13.30477271,5,9.210360372,9.210320372,30,122.5417513,4,5,9,5,5,10,5,0.369905,0.384337,0,No
358,widen,6,13.30477271,5,9.210360372,9.210320372,30,122.5417513,4,6,10,4,6,10,4,0.43348,0.449162,0,No
581,ware,6,13.30477271,5,9.210360372,9.210320372,30,122.5417513,2,4,6,2,5,7,4,0.398773,0.416408,0,No
755,violate,6,13.30477271,5,9.210360372,9.210320372,30,122.5417513,4,3,7,5,6,11,4,0.407198,0.424849,0,No
990,utica,6,13.30477271,5,9.210360372,9.210320372,30,122.5417513,4,4,8,6,6,12,4,0.399941,0.417615,0,No
1001,usher,6,13.30477271,5,9.210360372,9.210320372,30,122.5417513,5,3,8,5,4,9,4,0.388263,0.404836,0,No
1029,urbana,6,13.30477271,5,9.210360372,9.210320372,30,122.5417513,4,4,8,5,6,11,5,0.348312,0.357857,0,No
1042,upstate,6,13.30477271,5,9.210360372,9.210320372,30,122.5417513,2,4,6,4,6,10,5,0.337369,0.34372,0,No
1090,unanimous,6,13.30477271,5,9.210360372,9.210320372,30,122.5417513,4,2,6,6,6,12,5,0.320687,0.323978,0,No
1232,tubular,6,13.30477271,5,9.210360372,9.210320372,30,122.5417513,4,0,4,5,0,5,0,0,0,0,No
1744,thirst,6,13.30477271,5,9.210360372,9.210320372,30,122.5417513,3,2,5,3,4,7,4,0.412334,0.429539,0,No
1837,testicle,6,13.30477271,5,9.210360372,9.210320372,30,122.5417513,4,3,7,6,5,11,5,0.365435,0.378987,0,No
1922,telegraphy,6,13.30477271,5,9.210360372,9.210320372,30,122.5417513,2,4,6,2,4,6,5,0.39796,0.41519,0,No
2074,tahoe,6,13.30477271,5,9.210360372,9.210320372,30,122.5417513,2,5,7,6,6,12,4,0.408962,0.426469,0,No
2407,stylish,6,13.30477271,5,9.210360372,9.210320372,30,122.5417513,4,4,8,6,5,11,5,0.326167,0.330042,0,No
2741,spur,6,13.30477271,5,9.210360372,9.210320372,30,122.5417513,3,5,8,6,6,12,5,0.361631,0.37462,0,No
2945,sorghum,6,13.30477271,5,9.210360372,9.210320372,30,122.5417513,5,5,10,5,5,10,4,0.3924,0.409362,0,No
3185,slap,6,13.30477271,5,9.210360372,9.210320372,30,122.5417513,4,6,10,5,6,11,5,0.365766,0.379375,0,No
3487,sheehan,6,13.30477271,5,9.210360372,9.210320372,30,122.5417513,3,2,5,6,5,11,5,0.321256,0.324502,0,No
3523,sham,6,13.30477271,5,9.210360372,9.210320372,30,122.5417513,3,3,6,3,3,6,5,0.351616,0.362159,0,No
3781,scratchy,6,13.30477271,5,9.210360372,9.210320372,30,122.5417513,4,4,8,5,6,11,5,0.386943,0.403458,0,No
3791,scotty,6,13.30477271,5,9.210360372,9.210320372,30,122.5417513,5,3,8,6,3,9,5,0.316637,0.321003,0,No
3798,scotch,6,13.30477271,5,9.210360372,9.210320372,30,122.5417513,6,2,8,6,2,8,5,0.361211,0.373947,0,No
4153,rune,6,13.30477271,5,9.210360372,9.210320372,30,122.5417513,6,3,9,6,3,9,5,0.323492,0.326757,0,No
4223,rot,6,13.30477271,5,9.210360372,9.210320372,30,122.5417513,5,5,10,6,5,11,4,0.423803,0.440449,0,No
4396,ribose,6,13.30477271,5,9.210360372,9.210320372,30,122.5417513,4,4,8,4,4,8,4,0.417995,0.435098,0,No
4417,rhino,6,13.30477271,5,9.210360372,9.210320372,30,122.5417513,5,4,9,6,4,10,5,0.345969,0.354834,0,No
4988,purge,6,13.30477271,5,9.210360372,9.210320372,30,122.5417513,5,4,9,6,5,11,5,0.394318,0.411544,0,No
5022,pumice,6,13.30477271,5,9.210360372,9.210320372,30,122.5417513,3,5,8,4,6,10,4,0.39125,0.408137,0,No
5315,prentice,6,13.30477271,5,9.210360372,9.210320372,30,122.5417513,3,2,5,3,6,9,5,0.322376,0.325523,0,No
5350,preach,6,13.30477271,5,9.210360372,9.210320372,30,122.5417513,3,5,8,6,5,11,5,0.336359,0.342323,0,No
5496,pomona,6,13.30477271,5,9.210360372,9.210320372,30,122.5417513,3,3,6,5,6,11,5,0.34782,0.35722,0,No
5620,plectrum,6,13.30477271,5,9.210360372,9.210320372,30,122.5417513,3,4,7,6,5,11,4,0.400041,0.41739,0,No
5643,platoon,6,13.30477271,5,9.210360372,9.210320372,30,122.5417513,2,5,7,5,5,10,5,0.384804,0.401106,0,No
5800,phytoplankton,6,13.30477271,5,9.210360372,9.210320372,30,122.5417513,5,4,9,5,4,9,5,0.386185,0.402604,0,No
5868,phalanges,6,13.30477271,5,9.210360372,9.210320372,30,122.5417513,2,3,5,3,3,6,4,0.413506,0.43091,0,No
6535,oppressive,6,13.30477271,5,9.210360372,9.210320372,30,122.5417513,4,3,7,4,3,7,4,0.397924,0.415103,0,No
6560,opacity,6,13.30477271,5,9.210360372,9.210320372,30,122.5417513,4,4,8,5,4,9,5,0.379441,0.395376,0,No
6591,omen,6,13.30477271,5,9.210360372,9.210320372,30,122.5417513,2,6,8,5,6,11,4,0.394134,0.411334,0,No
6676,octavia,6,13.30477271,5,9.210360372,9.210320372,30,122.5417513,4,4,8,5,6,11,5,0.324599,0.328259,0,No
6912,nipple,6,13.30477271,5,9.210360372,9.210320372,30,122.5417513,3,3,6,6,3,9,4,0.425796,0.442219,0,No
7163,nag,6,13.30477271,5,9.210360372,9.210320372,30,122.5417513,3,2,5,4,2,6,5,0.384296,0.400486,0,No
7220,musicology,6,13.30477271,5,9.210360372,9.210320372,30,122.5417513,3,4,7,3,4,7,4,0.391898,0.408789,0,No
7245,mung,6,13.30477271,5,9.210360372,9.210320372,30,122.5417513,5,3,8,6,4,10,5,0.35312,0.363619,0,No
7328,motet,6,13.30477271,5,9.210360372,9.210320372,30,122.5417513,5,4,9,6,5,11,4,0.390398,0.407202,0,No
7652,midget,6,13.30477271,5,9.210360372,9.210320372,30,122.5417513,3,1,4,3,1,4,5,0.375317,0.391855,0,No
7860,medallion,6,13.30477271,5,9.210360372,9.210320372,30,122.5417513,4,5,9,6,6,12,4,0.423985,0.44059,0,No
7908,mcfarland,6,13.30477271,5,9.210360372,9.210320372,30,122.5417513,2,5,7,6,5,11,5,0.348373,0.357913,0,No
8094,marietta,6,13.30477271,5,9.210360372,9.210320372,30,122.5417513,5,5,10,5,5,10,4,0.405561,0.423159,0,No
8109,marcia,6,13.30477271,5,9.210360372,9.210320372,30,122.5417513,3,3,6,4,4,8,5,0.323971,0.327282,0,No
8515,logarithm,6,13.30477271,5,9.210360372,9.210320372,30,122.5417513,5,4,9,6,4,10,5,0.386269,0.402882,0,No
8528,lockwood,6,13.30477271,5,9.210360372,9.210320372,30,122.5417513,3,6,9,4,6,10,5,0.3282,0.332794,0,No
8529,locksmith,6,13.30477271,5,9.210360372,9.210320372,30,122.5417513,2,3,5,6,3,9,4,0.412478,0.429699,0,No
8939,laotian,6,13.30477271,5,9.210360372,9.210320372,30,122.5417513,3,4,7,6,5,11,5,0.331114,0.336452,0,No
9181,keynesian,6,13.30477271,5,9.210360372,9.210320372,30,122.5417513,4,0,4,5,0,5,0,0,0,0,No
9205,kenyon,6,13.30477271,5,9.210360372,9.210320372,30,122.5417513,5,3,8,5,6,11,5,0.338379,0.345032,0,No
9613,ionosphere,6,13.30477271,5,9.210360372,9.210320372,30,122.5417513,2,4,6,5,4,9,5,0.385766,0.402139,0,No
9668,intolerable,6,13.30477271,5,9.210360372,9.210320372,30,122.5417513,2,0,2,6,0,6,0,0,0,0,No
9770,insecticide,6,13.30477271,5,9.210360372,9.210320372,30,122.5417513,1,6,7,6,6,12,4,0.415734,0.433013,0,No
9921,indices,6,13.30477271,5,9.210360372,9.210320372,30,122.5417513,4,4,8,4,4,8,5,0.340691,0.348066,0,No
9946,inconvenient,6,13.30477271,5,9.210360372,9.210320372,30,122.5417513,2,3,5,5,6,11,5,0.378051,0.393801,0,No
9977,incarnate,6,13.30477271,5,9.210360372,9.210320372,30,122.5417513,4,3,7,5,4,9,5,0.390269,0.407195,0,No
10088,ileum,6,13.30477271,5,9.210360372,9.210320372,30,122.5417513,3,5,8,6,5,11,4,0.416094,0.433351,0,No
10237,hump,6,13.30477271,5,9.210360372,9.210320372,30,122.5417513,2,5,7,5,5,10,4,0.407142,0.424723,0,No
10333,hormonal,6,13.30477271,5,9.210360372,9.210320372,30,122.5417513,4,2,6,5,2,7,5,0.319751,0.323292,0,No
10495,hillel,6,13.30477271,5,9.210360372,9.210320372,30,122.5417513,3,0,3,3,0,3,0,0,0,0,No
10813,harden,6,13.30477271,5,9.210360372,9.210320372,30,122.5417513,3,3,6,6,5,11,4,0.412287,0.429741,0,No
10933,hackett,6,13.30477271,5,9.210360372,9.210320372,30,122.5417513,5,3,8,6,3,9,5,0.331999,0.337204,0,No
10973,gunther,6,13.30477271,5,9.210360372,9.210320372,30,122.5417513,5,3,8,5,3,8,5,0.359245,0.371649,0,No
11112,greensboro,6,13.30477271,5,9.210360372,9.210320372,30,122.5417513,4,6,10,5,6,11,4,0.39057,0.407423,0,No
11279,gobi,6,13.30477271,5,9.210360372,9.210320372,30,122.5417513,1,1,2,6,6,12,5,0.31613,0.320204,0,No
11366,girdle,6,13.30477271,5,9.210360372,9.210320372,30,122.5417513,4,5,9,5,5,10,5,0.379627,0.395612,0,No
11372,gino,6,13.30477271,5,9.210360372,9.210320372,30,122.5417513,3,1,4,3,1,4,5,0.332161,0.339406,0,No
11394,gifford,6,13.30477271,5,9.210360372,9.210320372,30,122.5417513,3,4,7,6,4,10,5,0.405292,0.422678,0,No
11459,gentile,6,13.30477271,5,9.210360372,9.210320372,30,122.5417513,2,4,6,4,4,8,5,0.36248,0.375294,0,No
11770,freedman,6,13.30477271,5,9.210360372,9.210320372,30,122.5417513,3,5,8,4,5,9,5,0.39057,0.407563,0,No
11934,follicle,6,13.30477271,5,9.210360372,9.210320372,30,122.5417513,3,2,5,4,2,6,5,0.33825,0.344999,0,No
12192,fiasco,6,13.30477271,5,9.210360372,9.210320372,30,122.5417513,3,5,8,4,5,9,4,0.409906,0.427422,0,No
12205,festive,6,13.30477271,5,9.210360372,9.210320372,30,122.5417513,2,4,6,5,5,10,5,0.329063,0.333129,0,No
12411,extrusive,6,13.30477271,5,9.210360372,9.210320372,30,122.5417513,4,1,5,5,1,6,5,0.297386,0.30344,0,No
12471,expense,6,13.30477271,5,9.210360372,9.210320372,30,122.5417513,2,3,5,4,5,9,5,0.382334,0.398532,0,No
12551,ewe,6,13.30477271,5,9.210360372,9.210320372,30,122.5417513,5,5,10,5,6,11,4,0.391164,0.408038,0,No
12670,eskimo,6,13.30477271,5,9.210360372,9.210320372,30,122.5417513,5,4,9,6,4,10,5,0.352279,0.362934,0,No
12843,emulate,6,13.30477271,5,9.210360372,9.210320372,30,122.5417513,3,4,7,6,5,11,4,0.402654,0.420347,0,No
12857,emmett,6,13.30477271,5,9.210360372,9.210320372,30,122.5417513,1,5,6,1,6,7,5,0.352202,0.362678,0,No
12966,electrician,6,13.30477271,5,9.210360372,9.210320372,30,122.5417513,3,5,8,6,6,12,4,0.391155,0.408043,0,No
13109,earnest,6,13.30477271,5,9.210360372,9.210320372,30,122.5417513,5,5,10,6,5,11,4,0.41002,0.42753,0,No
13344,doorway,6,13.30477271,5,9.210360372,9.210320372,30,122.5417513,3,4,7,6,5,11,5,0.366166,0.38002,0,No
13547,dime,6,13.30477271,5,9.210360372,9.210320372,30,122.5417513,2,4,6,5,4,9,4,0.407068,0.424633,0,No
13620,dialectic,6,13.30477271,5,9.210360372,9.210320372,30,122.5417513,6,6,12,6,6,12,5,0.384595,0.401139,0,No
13671,detergent,6,13.30477271,5,9.210360372,9.210320372,30,122.5417513,5,4,9,6,4,10,5,0.35338,0.364379,0,No
13802,delilah,6,13.30477271,5,9.210360372,9.210320372,30,122.5417513,2,6,8,5,6,11,4,0.425051,0.4416,0,No
14086,cuzco,6,13.30477271,5,9.210360372,9.210320372,30,122.5417513,2,4,6,6,4,10,5,0.361889,0.374865,0,No
14153,culprit,6,13.30477271,5,9.210360372,9.210320372,30,122.5417513,3,5,8,6,5,11,5,0.348599,0.358328,0,No
14185,crux,6,13.30477271,5,9.210360372,9.210320372,30,122.5417513,5,2,7,6,2,8,5,0.349994,0.359746,0,No
14189,crusoe,6,13.30477271,5,9.210360372,9.210320372,30,122.5417513,1,5,6,6,6,12,5,0.406127,0.423757,0,No
14203,crucifix,6,13.30477271,5,9.210360372,9.210320372,30,122.5417513,4,4,8,6,5,11,4,0.427477,0.4439,0,No
14334,coward,6,13.30477271,5,9.210360372,9.210320372,30,122.5417513,3,3,6,6,4,10,5,0.36105,0.373814,0,No
14385,coulter,6,13.30477271,5,9.210360372,9.210320372,30,122.5417513,4,5,9,4,5,9,5,0.350727,0.360938,0,No
14473,corbett,6,13.30477271,5,9.210360372,9.210320372,30,122.5417513,5,4,9,6,4,10,5,0.39137,0.408214,0,No
14513,convey,6,13.30477271,5,9.210360372,9.210320372,30,122.5417513,3,4,7,6,5,11,5,0.399482,0.41719,0,No
14597,constraint,6,13.30477271,5,9.210360372,9.210320372,30,122.5417513,5,3,8,6,4,10,5,0.398299,0.416068,0,No
15095,clap,6,13.30477271,5,9.210360372,9.210320372,30,122.5417513,4,4,8,6,4,10,5,0.384896,0.401162,0,No
15291,chesterton,6,13.30477271,5,9.210360372,9.210320372,30,122.5417513,5,3,8,5,3,8,5,0.324593,0.327825,0,No
15449,centrist,6,13.30477271,5,9.210360372,9.210320372,30,122.5417513,4,4,8,6,4,10,5,0.384862,0.401153,0,No
15569,casket,6,13.30477271,5,9.210360372,9.210320372,30,122.5417513,2,4,6,4,4,8,4,0.395442,0.412578,0,No
15635,caribou,6,13.30477271,5,9.210360372,9.210320372,30,122.5417513,5,5,10,5,5,10,5,0.396865,0.414049,0,No
15674,carapace,6,13.30477271,5,9.210360372,9.210320372,30,122.5417513,3,4,7,4,6,10,4,0.425816,0.442257,0,No
15745,canaveral,6,13.30477271,5,9.210360372,9.210320372,30,122.5417513,2,5,7,6,6,12,5,0.365834,0.379339,0,No
15761,camino,6,13.30477271,5,9.210360372,9.210320372,30,122.5417513,4,4,8,5,5,10,5,0.347086,0.356397,0,No
15888,butterfield,6,13.30477271,5,9.210360372,9.210320372,30,122.5417513,5,4,9,5,5,10,5,0.330534,0.335039,0,No
15965,bumpy,6,13.30477271,5,9.210360372,9.210320372,30,122.5417513,6,4,10,6,5,11,5,0.394958,0.412082,0,No
16068,brood,6,13.30477271,5,9.210360372,9.210320372,30,122.5417513,2,4,6,2,4,6,5,0.349388,0.359183,0,No
16077,bromide,6,13.30477271,5,9.210360372,9.210320372,30,122.5417513,3,3,6,4,4,8,5,0.305525,0.310824,0,No
16132,bridal,6,13.30477271,5,9.210360372,9.210320372,30,122.5417513,3,4,7,5,5,10,5,0.320566,0.324037,0,No
16143,breve,6,13.30477271,5,9.210360372,9.210320372,30,122.5417513,3,3,6,4,3,7,5,0.38728,0.403791,0,No
16393,bode,6,13.30477271,5,9.210360372,9.210320372,30,122.5417513,3,5,8,3,6,9,5,0.351714,0.362056,0,No
16450,blond,6,13.30477271,5,9.210360372,9.210320372,30,122.5417513,6,1,7,6,2,8,5,0.321082,0.324371,0,No
16615,beware,6,13.30477271,5,9.210360372,9.210320372,30,122.5417513,3,3,6,4,6,10,4,0.41918,0.436276,0,No
16640,bess,6,13.30477271,5,9.210360372,9.210320372,30,122.5417513,3,6,9,5,6,11,5,0.337177,0.343366,0,No
16649,bertram,6,13.30477271,5,9.210360372,9.210320372,30,122.5417513,4,4,8,4,4,8,5,0.34795,0.357558,0,No
16734,bellingham,6,13.30477271,5,9.210360372,9.210320372,30,122.5417513,5,3,8,6,4,10,5,0.361211,0.37398,0,No
16772,beggar,6,13.30477271,5,9.210360372,9.210320372,30,122.5417513,5,6,11,6,6,12,5,0.33599,0.342243,0,No
16894,baseline,6,13.30477271,5,9.210360372,9.210320372,30,122.5417513,3,4,7,4,4,8,4,0.389755,0.406503,0,No
16904,bartlett,6,13.30477271,5,9.210360372,9.210320372,30,122.5417513,6,4,10,6,4,10,5,0.328856,0.332863,0,No
16956,barbaric,6,13.30477271,5,9.210360372,9.210320372,30,122.5417513,4,4,8,6,5,11,4,0.41038,0.427896,0,No
16986,bandit,6,13.30477271,5,9.210360372,9.210320372,30,122.5417513,6,5,11,6,6,12,4,0.390278,0.407094,0,No
17017,balfour,6,13.30477271,5,9.210360372,9.210320372,30,122.5417513,4,3,7,5,4,9,5,0.321652,0.325129,0,No
17279,astrophysicist,6,13.30477271,5,9.210360372,9.210320372,30,122.5417513,4,6,10,5,6,11,4,0.392244,0.40923,0,No
17379,arrowhead,6,13.30477271,5,9.210360372,9.210320372,30,122.5417513,5,5,10,6,6,12,5,0.361837,0.374579,0,No
17494,aptitude,6,13.30477271,5,9.210360372,9.210320372,30,122.5417513,4,4,8,6,5,11,5,0.35766,0.369516,0,No
17759,amplify,6,13.30477271,5,9.210360372,9.210320372,30,122.5417513,3,4,7,5,4,9,4,0.408595,0.426234,0,No
17850,alsatian,6,13.30477271,5,9.210360372,9.210320372,30,122.5417513,3,4,7,3,5,8,4,0.389815,0.406578,0,No
18005,airy,6,13.30477271,5,9.210360372,9.210320372,30,122.5417513,3,5,8,4,5,9,5,0.344065,0.352192,0,No
18007,airtight,6,13.30477271,5,9.210360372,9.210320372,30,122.5417513,3,5,8,3,5,8,5,0.407619,0.425241,0,No
18029,aiken,6,13.30477271,5,9.210360372,9.210320372,30,122.5417513,4,4,8,6,4,10,5,0.329736,0.334039,0,No
18243,acetaminophen,6,13.30477271,5,9.210360372,9.210320372,30,122.5417513,3,4,7,3,4,7,4,0.396237,0.413385,0,No
18258,accomplish,6,13.30477271,5,9.210360372,9.210320372,30,122.5417513,3,4,7,6,6,12,4,0.392036,0.409578,0,No
18363,aba,6,13.30477271,5,9.210360372,9.210320372,30,122.5417513,3,2,5,3,3,6,5,0.323858,0.327226,0,No
16529,bissau,5,13.30477271,5,9.210360372,9.210320372,25,122.5417513,3,4,7,4,4,8,5,0.348914,0.358633,0,No
3134,slough,5,13.30477271,4,9.210360372,9.210320372,20,122.5417513,4,2,6,4,3,7,5,0.315607,0.319669,0,No
4016,sana,3,13.30477271,3,9.210360372,9.210320372,9,122.5417513,2,1,3,2,1,3,5,0.384229,0.400392,0,No
141,wysiwyg,12,12.61162553,3,9.721185996,9.721165996,36,122.5999575,6,6,12,6,9,15,5,0.383855,0.400333,0,No
1180,turnpike,12,12.61162553,3,9.721185996,9.721165996,36,122.5999575,5,8,13,12,10,22,5,0.374723,0.390003,0,No
2599,stegosaurus,12,12.61162553,3,9.721185996,9.721165996,36,122.5999575,5,5,10,7,5,12,4,0.397008,0.414225,0,No
12876,emery,12,12.61162553,3,9.721185996,9.721165996,36,122.5999575,7,8,15,7,11,18,4,0.405719,0.423258,0,No
15860,cabal,12,12.61162553,3,9.721185996,9.721165996,36,122.5999575,5,7,12,12,9,21,5,0.378607,0.394413,0,No
17068,backlash,12,12.61162553,3,9.721185996,9.721165996,36,122.5999575,7,6,13,8,7,15,4,0.40496,0.422497,0,No
288,winslow,8,13.01709064,4,9.433503923,9.433473923,32,122.7967756,6,6,12,7,6,13,4,0.405811,0.423394,0,No
600,walrus,8,13.01709064,4,9.433503923,9.433473923,32,122.7967756,3,5,8,7,5,12,4,0.415024,0.432337,0,No
1083,unicorn,8,13.01709064,4,9.433503923,9.433473923,32,122.7967756,4,5,9,6,6,12,5,0.385163,0.401723,0,No
1638,tilde,8,13.01709064,4,9.433503923,9.433473923,32,122.7967756,4,6,10,7,6,13,5,0.35405,0.365279,0,No
2019,tantalus,8,13.01709064,4,9.433503923,9.433473923,32,122.7967756,4,3,7,5,4,9,5,0.39715,0.414335,0,No
2496,straighten,8,13.01709064,4,9.433503923,9.433473923,32,122.7967756,3,5,8,5,8,13,4,0.42852,0.444736,0,No
2979,somerville,8,13.01709064,4,9.433503923,9.433473923,32,122.7967756,5,6,11,5,8,13,5,0.387627,0.404233,0,No
3196,skyline,8,13.01709064,4,9.433503923,9.433473923,32,122.7967756,4,7,11,5,7,12,4,0.414191,0.431539,0,No
3850,schnabel,8,13.01709064,4,9.433503923,9.433473923,32,122.7967756,3,5,8,3,7,10,5,0.386496,0.402979,0,No
4065,salami,8,13.01709064,4,9.433503923,9.433473923,32,122.7967756,5,8,13,6,8,14,5,0.357156,0.369025,0,No
4144,rupee,8,13.01709064,4,9.433503923,9.433473923,32,122.7967756,2,6,8,5,8,13,4,0.390072,0.406888,0,No
4825,radian,8,13.01709064,4,9.433503923,9.433473923,32,122.7967756,5,4,9,7,7,14,5,0.356317,0.367671,0,No
6446,osmosis,8,13.01709064,4,9.433503923,9.433473923,32,122.7967756,4,3,7,5,7,12,4,0.425806,0.442229,0,No
6507,ordeal,8,13.01709064,4,9.433503923,9.433473923,32,122.7967756,6,3,9,8,4,12,5,0.386311,0.40274,0,No
6563,ontology,8,13.01709064,4,9.433503923,9.433473923,32,122.7967756,4,4,8,4,5,9,5,0.349422,0.359204,0,No
6737,obelisk,8,13.01709064,4,9.433503923,9.433473923,32,122.7967756,5,6,11,8,8,16,4,0.417092,0.434285,0,No
6858,norma,8,13.01709064,4,9.433503923,9.433473923,32,122.7967756,6,4,10,6,5,11,5,0.385422,0.401768,0,No
6886,nod,8,13.01709064,4,9.433503923,9.433473923,32,122.7967756,4,6,10,7,6,13,5,0.409802,0.427203,0,No
7147,nanking,8,13.01709064,4,9.433503923,9.433473923,32,122.7967756,2,4,6,6,7,13,5,0.40484,0.422241,0,No
7248,munch,8,13.01709064,4,9.433503923,9.433473923,32,122.7967756,2,4,6,2,4,6,4,0.385841,0.402733,0,No
7377,moran,8,13.01709064,4,9.433503923,9.433473923,32,122.7967756,5,6,11,8,6,14,5,0.402764,0.420166,0,No
8173,manatee,8,13.01709064,4,9.433503923,9.433473923,32,122.7967756,4,4,8,5,4,9,5,0.328042,0.332225,0,No
8190,malthus,8,13.01709064,4,9.433503923,9.433473923,32,122.7967756,7,7,14,8,8,16,5,0.349223,0.359028,0,No
9268,kampuchea,8,13.01709064,4,9.433503923,9.433473923,32,122.7967756,3,6,9,7,6,13,5,0.35611,0.367601,0,No
10295,hourglass,8,13.01709064,4,9.433503923,9.433473923,32,122.7967756,5,3,8,8,6,14,5,0.398183,0.41595,0,No
10374,homophobia,8,13.01709064,4,9.433503923,9.433473923,32,122.7967756,4,7,11,5,8,13,4,0.393775,0.410859,0,No
10429,hodgkin,8,13.01709064,4,9.433503923,9.433473923,32,122.7967756,6,3,9,7,7,14,5,0.362947,0.375968,0,No
10874,hammerhead,8,13.01709064,4,9.433503923,9.433473923,32,122.7967756,4,2,6,7,2,9,5,0.338095,0.344535,0,No
11218,gorky,8,13.01709064,4,9.433503923,9.433473923,32,122.7967756,3,4,7,4,5,9,5,0.345498,0.353749,0,No
11623,gadget,8,13.01709064,4,9.433503923,9.433473923,32,122.7967756,5,7,12,7,8,15,5,0.37321,0.388282,0,No
11950,foe,8,13.01709064,4,9.433503923,9.433473923,32,122.7967756,3,5,8,6,7,13,5,0.385573,0.402094,0,No
12032,fleece,8,13.01709064,4,9.433503923,9.433473923,32,122.7967756,1,5,6,8,6,14,4,0.396157,0.413343,0,No
12144,filth,8,13.01709064,4,9.433503923,9.433473923,32,122.7967756,3,6,9,6,7,13,4,0.402198,0.419563,0,No
12320,farina,8,13.01709064,4,9.433503923,9.433473923,32,122.7967756,6,5,11,6,7,13,4,0.415695,0.43298,0,No
14066,cyprian,8,13.01709064,4,9.433503923,9.433473923,32,122.7967756,5,5,10,7,5,12,5,0.345001,0.353642,0,No
14953,cockatoo,8,13.01709064,4,9.433503923,9.433473923,32,122.7967756,6,5,11,7,7,14,4,0.40775,0.425281,0,No
14957,cochlea,8,13.01709064,4,9.433503923,9.433473923,32,122.7967756,2,6,8,8,8,16,4,0.406965,0.424568,0,No
15033,climatology,8,13.01709064,4,9.433503923,9.433473923,32,122.7967756,3,6,9,5,6,11,4,0.40717,0.424568,0,No
15574,cashew,8,13.01709064,4,9.433503923,9.433473923,32,122.7967756,3,4,7,6,4,10,5,0.352917,0.363739,0,No
15786,calumet,8,13.01709064,4,9.433503923,9.433473923,32,122.7967756,5,4,9,6,7,13,5,0.352091,0.362619,0,No
15851,caching,8,13.01709064,4,9.433503923,9.433473923,32,122.7967756,6,6,12,6,7,13,4,0.400068,0.417432,0,No
16050,browse,8,13.01709064,4,9.433503923,9.433473923,32,122.7967756,2,4,6,8,4,12,4,0.419874,0.437046,0,No
16303,boreal,8,13.01709064,4,9.433503923,9.433473923,32,122.7967756,6,2,8,6,4,10,5,0.322675,0.326,0,No
16321,boon,8,13.01709064,4,9.433503923,9.433473923,32,122.7967756,5,7,12,6,8,14,5,0.388119,0.404862,0,No
16907,barter,8,13.01709064,4,9.433503923,9.433473923,32,122.7967756,6,4,10,6,7,13,5,0.372631,0.387545,0,No
17003,balm,8,13.01709064,4,9.433503923,9.433473923,32,122.7967756,4,3,7,8,5,13,5,0.349319,0.359239,0,No
17015,balinese,8,13.01709064,4,9.433503923,9.433473923,32,122.7967756,5,3,8,6,8,14,5,0.384512,0.400749,0,No
17519,applaud,8,13.01709064,4,9.433503923,9.433473923,32,122.7967756,7,5,12,7,5,12,5,0.349298,0.35891,0,No
18099,aesop,8,13.01709064,4,9.433503923,9.433473923,32,122.7967756,5,5,10,5,5,10,4,0.410741,0.428314,0,No
18251,accretion,8,13.01709064,4,9.433503923,9.433473923,32,122.7967756,7,3,10,8,6,14,5,0.320328,0.323784,0,No
1667,thymus,11,12.6986369,3,9.721185996,9.721165996,33,123.4458112,5,5,10,11,9,20,4,0.405654,0.423263,0,No
8421,lucid,11,12.6986369,3,9.721185996,9.721165996,33,123.4458112,7,1,8,10,3,13,5,0.320017,0.323344,0,No
15896,butane,11,12.6986369,3,9.721185996,9.721165996,33,123.4458112,5,5,10,6,10,16,5,0.373517,0.388548,0,No
15908,bushnell,11,12.6986369,3,9.721185996,9.721165996,33,123.4458112,8,7,15,9,10,19,5,0.35679,0.368366,0,No
17859,alpaca,11,12.6986369,3,9.721185996,9.721165996,33,123.4458112,6,6,12,10,8,18,4,0.41515,0.432436,0,No
697,vogel,7,13.15062203,4,9.433503923,9.433473923,28,124.0564445,6,6,12,7,6,13,5,0.359587,0.371682,0,No
1171,tuscarora,7,13.15062203,4,9.433503923,9.433473923,28,124.0564445,4,3,7,6,4,10,5,0.328436,0.332168,0,No
1317,triennial,7,13.15062203,4,9.433503923,9.433473923,28,124.0564445,4,3,7,7,6,13,5,0.328795,0.332852,0,No
1890,tenacious,7,13.15062203,4,9.433503923,9.433473923,28,124.0564445,4,3,7,4,7,11,5,0.325479,0.329368,0,No
2154,syllogism,7,13.15062203,4,9.433503923,9.433473923,28,124.0564445,4,6,10,5,7,12,5,0.367424,0.381333,0,No
2474,streak,7,13.15062203,4,9.433503923,9.433473923,28,124.0564445,5,4,9,5,7,12,5,0.396254,0.41358,0,No
2901,spade,7,13.15062203,4,9.433503923,9.433473923,28,124.0564445,3,3,6,7,5,12,4,0.390372,0.407155,0,No
3074,sniff,7,13.15062203,4,9.433503923,9.433473923,28,124.0564445,3,4,7,7,5,12,4,0.405719,0.423295,0,No
3090,snafu,7,13.15062203,4,9.433503923,9.433473923,28,124.0564445,6,5,11,6,6,12,5,0.366726,0.380715,0,No
3179,slaughterhouse,7,13.15062203,4,9.433503923,9.433473923,28,124.0564445,4,6,10,7,6,13,5,0.348996,0.358766,0,No
4425,rhesus,7,13.15062203,4,9.433503923,9.433473923,28,124.0564445,2,5,7,4,5,9,5,0.348216,0.357854,0,No
4931,quadrivium,7,13.15062203,4,9.433503923,9.433473923,28,124.0564445,2,5,7,7,5,12,5,0.330589,0.335273,0,No
5004,pup,7,13.15062203,4,9.433503923,9.433473923,28,124.0564445,3,5,8,4,6,10,4,0.426902,0.443506,0,No
5231,procyon,7,13.15062203,4,9.433503923,9.433473923,28,124.0564445,4,0,4,7,0,7,0,0,0,0,No
5763,piggy,7,13.15062203,4,9.433503923,9.433473923,28,124.0564445,4,4,8,6,5,11,5,0.365887,0.379488,0,No
5944,permafrost,7,13.15062203,4,9.433503923,9.433473923,28,124.0564445,6,6,12,6,6,12,4,0.426943,0.443299,0,No
6199,partisan,7,13.15062203,4,9.433503923,9.433473923,28,124.0564445,4,2,6,6,3,9,5,0.326125,0.329918,0,No
6262,parakeet,7,13.15062203,4,9.433503923,9.433473923,28,124.0564445,3,3,6,5,4,9,5,0.352818,0.363429,0,No
6341,paleozoic,7,13.15062203,4,9.433503923,9.433473923,28,124.0564445,3,3,6,5,4,9,5,0.324154,0.328049,0,No
6500,oregano,7,13.15062203,4,9.433503923,9.433473923,28,124.0564445,3,4,7,4,6,10,4,0.39977,0.417099,0,No
6836,norwalk,7,13.15062203,4,9.433503923,9.433473923,28,124.0564445,4,5,9,5,6,11,5,0.34877,0.358539,0,No
6903,nitrogenous,7,13.15062203,4,9.433503923,9.433473923,28,124.0564445,4,2,6,6,7,13,5,0.320867,0.324343,0,No
7183,myopia,7,13.15062203,4,9.433503923,9.433473923,28,124.0564445,5,5,10,5,6,11,5,0.33845,0.34551,0,No
7485,modulate,7,13.15062203,4,9.433503923,9.433473923,28,124.0564445,5,3,8,5,5,10,5,0.359718,0.372208,0,No
7703,methanol,7,13.15062203,4,9.433503923,9.433473923,28,124.0564445,6,5,11,7,6,13,4,0.404139,0.421558,0,No
7806,meltdown,7,13.15062203,4,9.433503923,9.433473923,28,124.0564445,4,3,7,7,4,11,5,0.361204,0.373985,0,No
8102,margarine,7,13.15062203,4,9.433503923,9.433473923,28,124.0564445,4,4,8,5,6,11,4,0.405589,0.423169,0,No
8348,lynchburg,7,13.15062203,4,9.433503923,9.433473923,28,124.0564445,6,4,10,7,7,14,5,0.347174,0.35645,0,No
8478,loon,7,13.15062203,4,9.433503923,9.433473923,28,124.0564445,4,4,8,5,5,10,5,0.367265,0.381302,0,No
8513,loge,7,13.15062203,4,9.433503923,9.433473923,28,124.0564445,5,5,10,5,6,11,5,0.371842,0.386633,0,No
8593,lise,7,13.15062203,4,9.433503923,9.433473923,28,124.0564445,5,2,7,5,2,7,5,0.321489,0.324794,0,No
9269,kampala,7,13.15062203,4,9.433503923,9.433473923,28,124.0564445,7,6,13,7,6,13,4,0.426215,0.442656,0,No
9281,kabuki,7,13.15062203,4,9.433503923,9.433473923,28,124.0564445,5,3,8,6,7,13,5,0.362747,0.375715,0,No
9506,jacky,7,13.15062203,4,9.433503923,9.433473923,28,124.0564445,5,3,8,5,3,8,5,0.38442,0.400623,0,No
9939,incubus,7,13.15062203,4,9.433503923,9.433473923,28,124.0564445,5,5,10,7,6,13,5,0.350035,0.359814,0,No
11109,greer,7,13.15062203,4,9.433503923,9.433473923,28,124.0564445,5,3,8,6,7,13,5,0.331231,0.336001,0,No
11213,gossip,7,13.15062203,4,9.433503923,9.433473923,28,124.0564445,4,3,7,4,6,10,5,0.38467,0.400928,0,No
11450,geodesic,7,13.15062203,4,9.433503923,9.433473923,28,124.0564445,5,3,8,7,4,11,5,0.366635,0.380564,0,No
12535,excelsior,7,13.15062203,4,9.433503923,9.433473923,28,124.0564445,3,3,6,3,5,8,5,0.376232,0.392695,0,No
13225,drugstore,7,13.15062203,4,9.433503923,9.433473923,28,124.0564445,5,5,10,6,7,13,5,0.378599,0.394454,0,No
13885,decibel,7,13.15062203,4,9.433503923,9.433473923,28,124.0564445,4,5,9,6,5,11,4,0.399662,0.417005,0,No
14082,cyclades,7,13.15062203,4,9.433503923,9.433473923,28,124.0564445,3,2,5,6,4,10,4,0.405154,0.422704,0,No
14410,cosine,7,13.15062203,4,9.433503923,9.433473923,28,124.0564445,4,4,8,7,6,13,5,0.350291,0.360117,0,No
15177,chrysanthemum,7,13.15062203,4,9.433503923,9.433473923,28,124.0564445,5,4,9,5,4,9,4,0.408557,0.42614,0,No
16300,boredom,7,13.15062203,4,9.433503923,9.433473923,28,124.0564445,5,5,10,5,7,12,4,0.429775,0.446027,0,No
17487,aquifer,7,13.15062203,4,9.433503923,9.433473923,28,124.0564445,4,5,9,7,5,12,4,0.407413,0.42499,0,No
18008,airstrip,7,13.15062203,4,9.433503923,9.433473923,28,124.0564445,6,6,12,6,7,13,4,0.368156,0.382241,0,No
18229,ackley,7,13.15062203,4,9.433503923,9.433473923,28,124.0564445,5,4,9,5,5,10,5,0.363088,0.376091,0,No
18360,abalone,7,13.15062203,4,9.433503923,9.433473923,28,124.0564445,6,5,11,6,5,11,5,0.358107,0.370008,0,No
18365,aarhus,7,13.15062203,4,9.433503923,9.433473923,28,124.0564445,5,4,9,6,5,11,5,0.34628,0.355361,0,No
23,zimmerman,5,13.48709426,5,9.210360372,9.210320372,25,124.2209985,3,4,7,3,4,7,5,0.345801,0.354294,0,No
31,zeroes,5,13.48709426,5,9.210360372,9.210320372,25,124.2209985,5,3,8,5,4,9,5,0.382499,0.398716,0,No
329,wilkins,5,13.48709426,5,9.210360372,9.210320372,25,124.2209985,4,5,9,5,5,10,5,0.387323,0.403871,0,No
444,westerly,5,13.48709426,5,9.210360372,9.210320372,25,124.2209985,4,4,8,5,4,9,5,0.379068,0.394936,0,No
562,wary,5,13.48709426,5,9.210360372,9.210320372,25,124.2209985,5,1,6,5,3,8,5,0.378607,0.394397,0,No
706,viviparous,5,13.48709426,5,9.210360372,9.210320372,25,124.2209985,5,4,9,5,4,9,5,0.384612,0.400871,0,No
860,verge,5,13.48709426,5,9.210360372,9.210320372,25,124.2209985,1,1,2,5,4,9,5,0.378607,0.394397,0,No
877,ventral,5,13.48709426,5,9.210360372,9.210320372,25,124.2209985,2,4,6,3,4,7,5,0.397363,0.414575,0,No
1052,uplift,5,13.48709426,5,9.210360372,9.210320372,25,124.2209985,3,3,6,4,3,7,4,0.417867,0.435065,0,No
1144,twine,5,13.48709426,5,9.210360372,9.210320372,25,124.2209985,4,5,9,5,5,10,5,0.385682,0.40205,0,No
1226,tuff,5,13.48709426,5,9.210360372,9.210320372,25,124.2209985,5,4,9,5,4,9,4,0.387247,0.403738,0,No
1283,trivial,5,13.48709426,5,9.210360372,9.210320372,25,124.2209985,4,4,8,5,4,9,5,0.328929,0.334188,0,No
1287,triumphal,5,13.48709426,5,9.210360372,9.210320372,25,124.2209985,4,1,5,5,2,7,5,0.308799,0.313688,0,No
1329,tribesmen,5,13.48709426,5,9.210360372,9.210320372,25,124.2209985,2,3,5,2,3,5,5,0.330485,0.335564,0,No
1363,treacherous,5,13.48709426,5,9.210360372,9.210320372,25,124.2209985,4,4,8,4,4,8,5,0.386825,0.403317,0,No
1479,tow,5,13.48709426,5,9.210360372,9.210320372,25,124.2209985,2,3,5,5,5,10,5,0.410637,0.428194,0,No
1492,toss,5,13.48709426,5,9.210360372,9.210320372,25,124.2209985,4,5,9,5,5,10,5,0.401797,0.419332,0,No
1688,throughput,5,13.48709426,5,9.210360372,9.210320372,25,124.2209985,3,4,7,3,4,7,4,0.424269,0.440844,0,No
1696,thrive,5,13.48709426,5,9.210360372,9.210320372,25,124.2209985,3,3,6,5,4,9,5,0.364797,0.378308,0,No
1841,tess,5,13.48709426,5,9.210360372,9.210320372,25,124.2209985,4,3,7,4,3,7,5,0.378753,0.394603,0,No
1859,termite,5,13.48709426,5,9.210360372,9.210320372,25,124.2209985,3,2,5,3,2,5,5,0.321599,0.324923,0,No
1873,tentacle,5,13.48709426,5,9.210360372,9.210320372,25,124.2209985,5,2,7,5,2,7,5,0.345619,0.354526,0,No
1955,teammate,5,13.48709426,5,9.210360372,9.210320372,25,124.2209985,3,5,8,3,5,8,5,0.396981,0.414232,0,No
2035,tanaka,5,13.48709426,5,9.210360372,9.210320372,25,124.2209985,1,4,5,1,4,5,5,0.406397,0.42395,0,No
2110,systemic,5,13.48709426,5,9.210360372,9.210320372,25,124.2209985,4,1,5,5,1,6,6,0.266904,0.271873,0,No
2135,synchronous,5,13.48709426,5,9.210360372,9.210320372,25,124.2209985,3,5,8,5,5,10,5,0.355546,0.367402,0,No
2157,syllabic,5,13.48709426,5,9.210360372,9.210320372,25,124.2209985,4,1,5,4,1,5,5,0.384229,0.400392,0,No
2181,swimsuit,5,13.48709426,5,9.210360372,9.210320372,25,124.2209985,3,4,7,4,4,8,4,0.389644,0.406808,0,No
2187,sweeten,5,13.48709426,5,9.210360372,9.210320372,25,124.2209985,1,3,4,5,5,10,5,0.385397,0.401702,0,No
2235,suspend,5,13.48709426,5,9.210360372,9.210320372,25,124.2209985,2,3,5,4,3,7,5,0.414249,0.431949,0,No
2384,subterranean,5,13.48709426,5,9.210360372,9.210320372,25,124.2209985,2,2,4,3,2,5,5,0.360991,0.373694,0,No
2495,straightforward,5,13.48709426,5,9.210360372,9.210320372,25,124.2209985,2,4,6,4,4,8,5,0.325015,0.328328,0,No
2545,stint,5,13.48709426,5,9.210360372,9.210320372,25,124.2209985,5,3,8,5,5,10,5,0.352734,0.363236,0,No
2643,starve,5,13.48709426,5,9.210360372,9.210320372,25,124.2209985,3,4,7,5,5,10,4,0.414027,0.431422,0,No
2655,stardom,5,13.48709426,5,9.210360372,9.210320372,25,124.2209985,2,4,6,2,4,6,5,0.372326,0.38709,0,No
2669,standoff,5,13.48709426,5,9.210360372,9.210320372,25,124.2209985,3,3,6,4,3,7,5,0.407142,0.424513,0,No
2693,staircase,5,13.48709426,5,9.210360372,9.210320372,25,124.2209985,4,5,9,4,5,9,5,0.346923,0.355947,0,No
2719,squire,5,13.48709426,5,9.210360372,9.210320372,25,124.2209985,4,5,9,5,5,10,4,0.400438,0.418075,0,No
2748,sprout,5,13.48709426,5,9.210360372,9.210320372,25,124.2209985,3,4,7,4,4,8,5,0.339745,0.346661,0,No
2797,splendid,5,13.48709426,5,9.210360372,9.210320372,25,124.2209985,4,1,5,5,1,6,6,0.283848,0.290104,0,No
2824,spiky,5,13.48709426,5,9.210360372,9.210320372,25,124.2209985,4,4,8,4,4,8,5,0.324332,0.328019,0,No
2885,spartan,5,13.48709426,5,9.210360372,9.210320372,25,124.2209985,3,3,6,5,3,8,5,0.346388,0.355455,0,No
3048,soc,5,13.48709426,5,9.210360372,9.210320372,25,124.2209985,2,5,7,2,5,7,4,0.412881,0.430131,0,No
3084,snapshot,5,13.48709426,5,9.210360372,9.210320372,25,124.2209985,2,4,6,4,4,8,5,0.380107,0.396101,0,No
3109,smelly,5,13.48709426,5,9.210360372,9.210320372,25,124.2209985,5,5,10,5,5,10,5,0.326714,0.330302,0,No
3157,slid,5,13.48709426,5,9.210360372,9.210320372,25,124.2209985,3,5,8,4,5,9,5,0.3362,0.342095,0,No
3162,slept,5,13.48709426,5,9.210360372,9.210320372,25,124.2209985,3,4,7,4,5,9,5,0.368393,0.382558,0,No
3251,sinus,5,13.48709426,5,9.210360372,9.210320372,25,124.2209985,2,2,4,2,2,4,5,0.36662,0.380527,0,No
3363,sic,5,13.48709426,5,9.210360372,9.210320372,25,124.2209985,1,2,3,1,4,5,5,0.375476,0.392038,0,No
3416,shortcut,5,13.48709426,5,9.210360372,9.210320372,25,124.2209985,2,5,7,5,5,10,5,0.347718,0.357187,0,No
3520,shameful,5,13.48709426,5,9.210360372,9.210320372,25,124.2209985,5,5,10,5,5,10,4,0.38902,0.405714,0,No
3627,sensual,5,13.48709426,5,9.210360372,9.210320372,25,124.2209985,1,3,4,1,4,5,5,0.375492,0.392061,0,No
3783,scrape,5,13.48709426,5,9.210360372,9.210320372,25,124.2209985,4,2,6,5,2,7,5,0.365894,0.379478,0,No
3787,scramble,5,13.48709426,5,9.210360372,9.210320372,25,124.2209985,2,2,4,5,4,9,5,0.345653,0.354392,0,No
3878,scarves,5,13.48709426,5,9.210360372,9.210320372,25,124.2209985,2,3,5,4,4,8,5,0.387771,0.404331,0,No
3946,satisfactory,5,13.48709426,5,9.210360372,9.210320372,25,124.2209985,3,5,8,5,5,10,5,0.325617,0.329065,0,No
4087,sag,5,13.48709426,5,9.210360372,9.210320372,25,124.2209985,5,2,7,5,3,8,5,0.384354,0.400547,0,No
4124,ruthless,5,13.48709426,5,9.210360372,9.210320372,25,124.2209985,4,3,7,5,3,8,5,0.359267,0.371673,0,No
4150,runny,5,13.48709426,5,9.210360372,9.210320372,25,124.2209985,4,4,8,5,5,10,5,0.394695,0.411805,0,No
4312,roadway,5,13.48709426,5,9.210360372,9.210320372,25,124.2209985,4,5,9,5,5,10,5,0.386606,0.403303,0,No
4342,ripen,5,13.48709426,5,9.210360372,9.210320372,25,124.2209985,3,4,7,5,4,9,5,0.334369,0.340173,0,No
4434,revolve,5,13.48709426,5,9.210360372,9.210320372,25,124.2209985,3,1,4,4,5,9,5,0.325187,0.32871,0,No
4458,retrieve,5,13.48709426,5,9.210360372,9.210320372,25,124.2209985,2,3,5,5,3,8,5,0.379416,0.39613,0,No
4609,registrar,5,13.48709426,5,9.210360372,9.210320372,25,124.2209985,4,4,8,4,5,9,5,0.396237,0.413401,0,No
4725,rave,5,13.48709426,5,9.210360372,9.210320372,25,124.2209985,5,4,9,5,4,9,5,0.397034,0.414256,0,No
4980,purse,5,13.48709426,5,9.210360372,9.210320372,25,124.2209985,5,3,8,5,3,8,5,0.359609,0.372348,0,No
5016,pundit,5,13.48709426,5,9.210360372,9.210320372,25,124.2209985,4,4,8,4,4,8,4,0.388561,0.405184,0,No
5061,psychotherapist,5,13.48709426,5,9.210360372,9.210320372,25,124.2209985,3,2,5,4,3,7,5,0.38564,0.401951,0,No
5167,propel,5,13.48709426,5,9.210360372,9.210320372,25,124.2209985,3,2,5,5,3,8,4,0.399312,0.416925,0,No
5169,propagate,5,13.48709426,5,9.210360372,9.210320372,25,124.2209985,2,3,5,4,3,7,5,0.401388,0.419124,0,No
5419,postcard,5,13.48709426,5,9.210360372,9.210320372,25,124.2209985,4,4,8,4,4,8,5,0.385263,0.402408,0,No
5596,plump,5,13.48709426,5,9.210360372,9.210320372,25,124.2209985,2,4,6,2,4,6,5,0.345902,0.354698,0,No
5627,plea,5,13.48709426,5,9.210360372,9.210320372,25,124.2209985,1,3,4,5,5,10,5,0.350977,0.361035,0,No
5666,planetoid,5,13.48709426,5,9.210360372,9.210320372,25,124.2209985,4,5,9,5,5,10,4,0.412564,0.430013,0,No
5724,piotr,5,13.48709426,5,9.210360372,9.210320372,25,124.2209985,5,1,6,5,1,6,5,0.310506,0.315179,0,No
5918,persist,5,13.48709426,5,9.210360372,9.210320372,25,124.2209985,2,5,7,2,5,7,4,0.426594,0.442994,0,No
5977,percival,5,13.48709426,5,9.210360372,9.210320372,25,124.2209985,4,5,9,4,5,9,5,0.328607,0.332636,0,No
6052,peking,5,13.48709426,5,9.210360372,9.210320372,25,124.2209985,4,2,6,4,2,6,5,0.332484,0.337239,0,No
6154,pathogenic,5,13.48709426,5,9.210360372,9.210320372,25,124.2209985,4,3,7,4,5,9,5,0.355924,0.367773,0,No
6237,parenthesis,5,13.48709426,5,9.210360372,9.210320372,25,124.2209985,2,2,4,5,4,9,5,0.341116,0.34864,0,No
6240,parentage,5,13.48709426,5,9.210360372,9.210320372,25,124.2209985,4,5,9,4,5,9,5,0.388493,0.405134,0,No
6267,paraffin,5,13.48709426,5,9.210360372,9.210320372,25,124.2209985,5,3,8,5,5,10,5,0.375643,0.392221,0,No
6301,panoramic,5,13.48709426,5,9.210360372,9.210320372,25,124.2209985,2,4,6,2,4,6,5,0.326245,0.329909,0,No
6517,oratory,5,13.48709426,5,9.210360372,9.210320372,25,124.2209985,3,3,6,3,4,7,5,0.391906,0.409015,0,No
6568,onset,5,13.48709426,5,9.210360372,9.210320372,25,124.2209985,2,1,3,4,5,9,5,0.378607,0.394397,0,No
6628,oily,5,13.48709426,5,9.210360372,9.210320372,25,124.2209985,4,5,9,4,5,9,5,0.35915,0.371649,0,No
6645,offshoot,5,13.48709426,5,9.210360372,9.210320372,25,124.2209985,3,3,6,4,4,8,4,0.419308,0.436421,0,No
6657,offend,5,13.48709426,5,9.210360372,9.210320372,25,124.2209985,4,3,7,5,4,9,4,0.400041,0.417657,0,No
6765,nurture,5,13.48709426,5,9.210360372,9.210320372,25,124.2209985,3,4,7,5,5,10,5,0.398809,0.416556,0,No
6778,nuisance,5,13.48709426,5,9.210360372,9.210320372,25,124.2209985,1,4,5,5,5,10,5,0.361469,0.374339,0,No
6821,noteworthy,5,13.48709426,5,9.210360372,9.210320372,25,124.2209985,3,2,5,4,2,6,5,0.325283,0.328602,0,No
6824,notch,5,13.48709426,5,9.210360372,9.210320372,25,124.2209985,3,3,6,3,3,6,5,0.361623,0.374473,0,No
6997,neva,5,13.48709426,5,9.210360372,9.210320372,25,124.2209985,1,2,3,4,3,7,5,0.332136,0.337228,0,No
7087,nd,5,13.48709426,5,9.210360372,9.210320372,25,124.2209985,3,5,8,3,5,8,5,0.345055,0.353634,0,No
7189,mycorrhiza,5,13.48709426,5,9.210360372,9.210320372,25,124.2209985,2,4,6,2,4,6,5,0.370059,0.384506,0,No
7457,moluccas,5,13.48709426,5,9.210360372,9.210320372,25,124.2209985,2,4,6,5,4,9,5,0.395883,0.413021,0,No
7542,miscellaneous,5,13.48709426,5,9.210360372,9.210320372,25,124.2209985,3,3,6,3,3,6,5,0.324973,0.329399,0,No
7548,miraculous,5,13.48709426,5,9.210360372,9.210320372,25,124.2209985,4,2,6,5,2,7,5,0.338941,0.345753,0,No
7797,memorandum,5,13.48709426,5,9.210360372,9.210320372,25,124.2209985,4,4,8,4,4,8,5,0.395848,0.413135,0,No
7799,memorabilia,5,13.48709426,5,9.210360372,9.210320372,25,124.2209985,3,4,7,3,4,7,5,0.393235,0.410214,0,No
7933,mba,5,13.48709426,5,9.210360372,9.210320372,25,124.2209985,4,3,7,5,3,8,5,0.389695,0.406439,0,No
7970,matte,5,13.48709426,5,9.210360372,9.210320372,25,124.2209985,1,3,4,3,3,6,5,0.394835,0.411936,0,No
8062,marque,5,13.48709426,5,9.210360372,9.210320372,25,124.2209985,5,3,8,5,3,8,5,0.322687,0.326076,0,No
8141,manley,5,13.48709426,5,9.210360372,9.210320372,25,124.2209985,3,2,5,5,3,8,5,0.321332,0.324641,0,No
8206,malice,5,13.48709426,5,9.210360372,9.210320372,25,124.2209985,3,3,6,4,3,7,4,0.422442,0.439135,0,No
8221,malagasy,5,13.48709426,5,9.210360372,9.210320372,25,124.2209985,4,2,6,4,2,6,5,0.395557,0.412641,0,No
8226,makeshift,5,13.48709426,5,9.210360372,9.210320372,25,124.2209985,4,0,4,5,0,5,0,0,0,0,No
8244,maier,5,13.48709426,5,9.210360372,9.210320372,25,124.2209985,2,5,7,2,5,7,5,0.348209,0.357336,0,No
8426,lubricate,5,13.48709426,5,9.210360372,9.210320372,25,124.2209985,4,4,8,5,5,10,4,0.398693,0.416371,0,No
8475,loosen,5,13.48709426,5,9.210360372,9.210320372,25,124.2209985,3,4,7,5,5,10,4,0.407254,0.424924,0,No
8521,loeb,5,13.48709426,5,9.210360372,9.210320372,25,124.2209985,3,2,5,3,2,5,5,0.326798,0.330342,0,No
8558,liz,5,13.48709426,5,9.210360372,9.210320372,25,124.2209985,4,2,6,4,2,6,5,0.314678,0.318814,0,No
8639,lind,5,13.48709426,5,9.210360372,9.210320372,25,124.2209985,3,4,7,4,4,8,4,0.422925,0.439604,0,No
8669,lighthearted,5,13.48709426,5,9.210360372,9.210320372,25,124.2209985,4,4,8,5,5,10,5,0.384921,0.401209,0,No
8710,libel,5,13.48709426,5,9.210360372,9.210320372,25,124.2209985,4,4,8,4,4,8,5,0.385004,0.401299,0,No
8728,levin,5,13.48709426,5,9.210360372,9.210320372,25,124.2209985,5,4,9,5,4,9,5,0.38734,0.403895,0,No
8729,leviathan,5,13.48709426,5,9.210360372,9.210320372,25,124.2209985,1,4,5,1,4,5,5,0.325551,0.329203,0,No
8821,leech,5,13.48709426,5,9.210360372,9.210320372,25,124.2209985,4,3,7,4,3,7,5,0.398576,0.416321,0,No
8912,lasso,5,13.48709426,5,9.210360372,9.210320372,25,124.2209985,2,4,6,2,4,6,4,0.387686,0.404738,0,No
8925,larkin,5,13.48709426,5,9.210360372,9.210320372,25,124.2209985,4,5,9,5,5,10,5,0.384937,0.401247,0,No
9054,krieger,5,13.48709426,5,9.210360372,9.210320372,25,124.2209985,2,4,6,3,5,8,5,0.36152,0.374365,0,No
9091,knott,5,13.48709426,5,9.210360372,9.210320372,25,124.2209985,5,4,9,5,5,10,5,0.378148,0.394797,0,No
9313,jumbo,5,13.48709426,5,9.210360372,9.210320372,25,124.2209985,4,2,6,5,3,8,5,0.375381,0.391944,0,No
9410,jive,5,13.48709426,5,9.210360372,9.210320372,25,124.2209985,4,1,5,5,1,6,5,0.324178,0.327665,0,No
9481,janitor,5,13.48709426,5,9.210360372,9.210320372,25,124.2209985,2,3,5,3,5,8,5,0.355625,0.367407,0,No
9631,investor,5,13.48709426,5,9.210360372,9.210320372,25,124.2209985,2,3,5,4,3,7,5,0.404876,0.42225,0,No
9670,intimidate,5,13.48709426,5,9.210360372,9.210320372,25,124.2209985,2,3,5,5,4,9,5,0.360309,0.372931,0,No
9701,interceptor,5,13.48709426,5,9.210360372,9.210320372,25,124.2209985,3,5,8,4,5,9,5,0.360485,0.37294,0,No
9711,intelligible,5,13.48709426,5,9.210360372,9.210320372,25,124.2209985,1,3,4,1,3,4,5,0.384979,0.401252,0,No
9801,initiate,5,13.48709426,5,9.210360372,9.210320372,25,124.2209985,2,3,5,3,4,7,5,0.399132,0.416856,0,No
9860,inferred,5,13.48709426,5,9.210360372,9.210320372,25,124.2209985,4,4,8,5,5,10,5,0.366893,0.380562,0,No
9865,inference,5,13.48709426,5,9.210360372,9.210320372,25,124.2209985,3,4,7,4,4,8,5,0.38467,0.400942,0,No
9891,ineffective,5,13.48709426,5,9.210360372,9.210320372,25,124.2209985,3,5,8,3,5,8,4,0.430275,0.446308,0,No
9898,inductee,5,13.48709426,5,9.210360372,9.210320372,25,124.2209985,3,5,8,5,5,10,5,0.396679,0.413871,0,No
9906,indo,5,13.48709426,5,9.210360372,9.210320372,25,124.2209985,4,4,8,5,4,9,5,0.328801,0.332734,0,No
10019,impractical,5,13.48709426,5,9.210360372,9.210320372,25,124.2209985,5,4,9,5,4,9,5,0.334476,0.339992,0,No
10022,impose,5,13.48709426,5,9.210360372,9.210320372,25,124.2209985,4,2,6,4,5,9,5,0.377922,0.394355,0,No
10214,hurry,5,13.48709426,5,9.210360372,9.210320372,25,124.2209985,5,5,10,5,5,10,5,0.334565,0.340297,0,No
10246,humble,5,13.48709426,5,9.210360372,9.210320372,25,124.2209985,5,3,8,5,4,9,5,0.38452,0.400754,0,No
10451,histrionic,5,13.48709426,5,9.210360372,9.210320372,25,124.2209985,4,2,6,4,2,6,5,0.384637,0.400862,0,No
10532,hexagonal,5,13.48709426,5,9.210360372,9.210320372,25,124.2209985,3,3,6,5,3,8,5,0.321128,0.324468,0,No
10581,heritable,5,13.48709426,5,9.210360372,9.210320372,25,124.2209985,4,3,7,5,3,8,5,0.385556,0.401895,0,No
10618,hen,5,13.48709426,5,9.210360372,9.210320372,25,124.2209985,3,5,8,3,5,8,4,0.414472,0.431666,0,No
10636,hellfire,5,13.48709426,5,9.210360372,9.210320372,25,124.2209985,4,2,6,5,3,8,5,0.324551,0.327835,0,No
10687,heartland,5,13.48709426,5,9.210360372,9.210320372,25,124.2209985,3,3,6,3,3,6,5,0.37902,0.394885,0,No
10722,haze,5,13.48709426,5,9.210360372,9.210320372,25,124.2209985,2,3,5,4,3,7,4,0.425806,0.442229,0,No
10825,hap,5,13.48709426,5,9.210360372,9.210320372,25,124.2209985,1,1,2,2,4,6,5,0.306136,0.311405,0,No
10889,hallucinogenic,5,13.48709426,5,9.210360372,9.210320372,25,124.2209985,2,2,4,3,3,6,5,0.322681,0.326295,0,No
10928,haddock,5,13.48709426,5,9.210360372,9.210320372,25,124.2209985,4,5,9,5,5,10,4,0.422764,0.439487,0,No
11348,glamorous,5,13.48709426,5,9.210360372,9.210320372,25,124.2209985,3,3,6,3,3,6,5,0.389029,0.406092,0,No
11395,gideon,5,13.48709426,5,9.210360372,9.210320372,25,124.2209985,3,2,5,3,2,5,5,0.36102,0.373722,0,No
11474,generosity,5,13.48709426,5,9.210360372,9.210320372,25,124.2209985,4,3,7,4,5,9,4,0.429027,0.445149,0,No
11540,garth,5,13.48709426,5,9.210360372,9.210320372,25,124.2209985,1,1,2,1,1,2,5,0.304817,0.310278,0,No
11590,galley,5,13.48709426,5,9.210360372,9.210320372,25,124.2209985,3,3,6,5,4,9,5,0.336295,0.342384,0,No
11593,gallant,5,13.48709426,5,9.210360372,9.210320372,25,124.2209985,4,4,8,5,4,9,5,0.347221,0.35646,0,No
11664,fundraising,5,13.48709426,5,9.210360372,9.210320372,25,124.2209985,4,3,7,4,3,7,5,0.355646,0.36743,0,No
11767,freeing,5,13.48709426,5,9.210360372,9.210320372,25,124.2209985,4,2,6,4,5,9,5,0.413931,0.431649,0,No
11857,forte,5,13.48709426,5,9.210360372,9.210320372,25,124.2209985,3,2,5,3,3,6,5,0.34655,0.35574,0,No
11893,fordham,5,13.48709426,5,9.210360372,9.210320372,25,124.2209985,4,0,4,4,0,4,0,0,0,0,No
11912,footnote,5,13.48709426,5,9.210360372,9.210320372,25,124.2209985,2,3,5,5,4,9,4,0.410409,0.427934,0,No
11937,folksinger,5,13.48709426,5,9.210360372,9.210320372,25,124.2209985,4,5,9,5,5,10,5,0.37108,0.385802,0,No
11989,flounder,5,13.48709426,5,9.210360372,9.210320372,25,124.2209985,4,5,9,4,5,9,4,0.394204,0.411719,0,No
12001,flop,5,13.48709426,5,9.210360372,9.210320372,25,124.2209985,4,4,8,4,5,9,4,0.408304,0.425676,0,No
12050,flashback,5,13.48709426,5,9.210360372,9.210320372,25,124.2209985,4,5,9,5,5,10,5,0.351609,0.361936,0,No
12058,flanagan,5,13.48709426,5,9.210360372,9.210320372,25,124.2209985,3,3,6,3,3,6,5,0.323445,0.326943,0,No
12172,fiery,5,13.48709426,5,9.210360372,9.210320372,25,124.2209985,5,2,7,5,2,7,5,0.332012,0.337077,0,No
12399,eyewitness,5,13.48709426,5,9.210360372,9.210320372,25,124.2209985,4,1,5,5,1,6,5,0.324902,0.329008,0,No
12481,expansive,5,13.48709426,5,9.210360372,9.210320372,25,124.2209985,5,3,8,5,3,8,5,0.323634,0.327096,0,No
12514,excursion,5,13.48709426,5,9.210360372,9.210320372,25,124.2209985,4,4,8,5,5,10,5,0.348558,0.358178,0,No
12525,excite,5,13.48709426,5,9.210360372,9.210320372,25,124.2209985,2,4,6,5,4,9,5,0.414066,0.431813,0,No
12532,excerpt,5,13.48709426,5,9.210360372,9.210320372,25,124.2209985,2,2,4,3,5,8,5,0.354432,0.365494,0,No
12558,evident,5,13.48709426,5,9.210360372,9.210320372,25,124.2209985,5,4,9,5,4,9,5,0.372435,0.387109,0,No
12631,ethic,5,13.48709426,5,9.210360372,9.210320372,25,124.2209985,5,4,9,5,4,9,5,0.38569,0.402068,0,No
12663,esquire,5,13.48709426,5,9.210360372,9.210320372,25,124.2209985,4,4,8,4,5,9,4,0.387373,0.403902,0,No
12787,entirety,5,13.48709426,5,9.210360372,9.210320372,25,124.2209985,3,2,5,5,5,10,5,0.379465,0.395368,0,No
12790,enthusiast,5,13.48709426,5,9.210360372,9.210320372,25,124.2209985,4,4,8,4,4,8,5,0.386059,0.402467,0,No
12808,englishmen,5,13.48709426,5,9.210360372,9.210320372,25,124.2209985,3,2,5,4,3,7,5,0.398219,0.415993,0,No
12826,endothermic,5,13.48709426,5,9.210360372,9.210320372,25,124.2209985,4,0,4,5,0,5,0,0,0,0,No
12831,endgame,5,13.48709426,5,9.210360372,9.210320372,25,124.2209985,3,4,7,4,4,8,4,0.405626,0.42322,0,No
12964,electro,5,13.48709426,5,9.210360372,9.210320372,25,124.2209985,2,2,4,2,2,4,5,0.324012,0.327365,0,No
13036,edna,5,13.48709426,5,9.210360372,9.210320372,25,124.2209985,5,2,7,5,2,7,5,0.302381,0.308088,0,No
13130,dyeing,5,13.48709426,5,9.210360372,9.210320372,25,124.2209985,4,3,7,5,3,8,5,0.327467,0.331503,0,No
13142,dutchman,5,13.48709426,5,9.210360372,9.210320372,25,124.2209985,1,4,5,3,4,7,5,0.329198,0.333147,0,No
13466,disruptive,5,13.48709426,5,9.210360372,9.210320372,25,124.2209985,4,5,9,4,5,9,5,0.357753,0.370184,0,No
13538,dinah,5,13.48709426,5,9.210360372,9.210320372,25,124.2209985,2,2,4,2,4,6,5,0.322452,0.325824,0,No
13664,detritus,5,13.48709426,5,9.210360372,9.210320372,25,124.2209985,3,2,5,3,2,5,5,0.384962,0.401214,0,No
13737,depart,5,13.48709426,5,9.210360372,9.210320372,25,124.2209985,4,4,8,4,5,9,4,0.376033,0.391494,0,No
13887,decent,5,13.48709426,5,9.210360372,9.210320372,25,124.2209985,2,1,3,3,1,4,5,0.321984,0.325052,0,No
13946,daydream,5,13.48709426,5,9.210360372,9.210320372,25,124.2209985,3,2,5,3,2,5,5,0.355447,0.367167,0,No
14151,cultivar,5,13.48709426,5,9.210360372,9.210320372,25,124.2209985,2,3,5,3,3,6,5,0.381643,0.397758,0,No
14192,crunchy,5,13.48709426,5,9.210360372,9.210320372,25,124.2209985,3,3,6,4,3,7,5,0.384254,0.400458,0,No
14245,crisp,5,13.48709426,5,9.210360372,9.210320372,25,124.2209985,4,4,8,5,4,9,5,0.338585,0.345122,0,No
14259,cretan,5,13.48709426,5,9.210360372,9.210320372,25,124.2209985,3,5,8,5,5,10,5,0.384387,0.400641,0,No
14351,courtier,5,13.48709426,5,9.210360372,9.210320372,25,124.2209985,5,2,7,5,2,7,5,0.378809,0.394627,0,No
14411,cosgrove,5,13.48709426,5,9.210360372,9.210320372,25,124.2209985,5,4,9,5,5,10,5,0.400185,0.417814,0,No
14563,contingent,5,13.48709426,5,9.210360372,9.210320372,25,124.2209985,5,3,8,5,5,10,5,0.381373,0.397486,0,No
14658,congregate,5,13.48709426,5,9.210360372,9.210320372,25,124.2209985,2,4,6,2,5,7,5,0.378043,0.393811,0,No
14660,conglomerate,5,13.48709426,5,9.210360372,9.210320372,25,124.2209985,4,4,8,5,4,9,5,0.379636,0.39554,0,No
14668,confucian,5,13.48709426,5,9.210360372,9.210320372,25,124.2209985,3,4,7,3,5,8,5,0.341031,0.348279,0,No
14673,conform,5,13.48709426,5,9.210360372,9.210320372,25,124.2209985,4,1,5,5,5,10,5,0.359165,0.371513,0,No
14891,colleague,5,13.48709426,5,9.210360372,9.210320372,25,124.2209985,2,2,4,5,2,7,5,0.378623,0.394434,0,No
14898,collage,5,13.48709426,5,9.210360372,9.210320372,25,124.2209985,3,4,7,3,4,7,4,0.3902,0.406991,0,No
14972,coates,5,13.48709426,5,9.210360372,9.210320372,25,124.2209985,3,3,6,3,3,6,5,0.351463,0.36184,0,No
15107,clad,5,13.48709426,5,9.210360372,9.210320372,25,124.2209985,3,1,4,4,4,8,5,0.360829,0.373487,0,No
15135,circuitry,5,13.48709426,5,9.210360372,9.210320372,25,124.2209985,3,3,6,3,3,6,5,0.388102,0.404901,0,No
15238,chivalrous,5,13.48709426,5,9.210360372,9.210320372,25,124.2209985,4,5,9,5,5,10,5,0.387949,0.404561,0,No
15242,chisholm,5,13.48709426,5,9.210360372,9.210320372,25,124.2209985,3,4,7,5,4,9,5,0.347269,0.356558,0,No
15258,chimney,5,13.48709426,5,9.210360372,9.210320372,25,124.2209985,3,4,7,5,4,9,5,0.364415,0.377994,0,No
15386,chandigarh,5,13.48709426,5,9.210360372,9.210320372,25,124.2209985,3,3,6,3,3,6,4,0.403212,0.420817,0,No
15396,champ,5,13.48709426,5,9.210360372,9.210320372,25,124.2209985,1,3,4,5,5,10,5,0.333703,0.338898,0,No
15422,cetacean,5,13.48709426,5,9.210360372,9.210320372,25,124.2209985,5,4,9,5,4,9,5,0.36369,0.376828,0,No
15428,cervix,5,13.48709426,5,9.210360372,9.210320372,25,124.2209985,2,4,6,5,4,9,4,0.425969,0.442398,0,No
15482,celebes,5,13.48709426,5,9.210360372,9.210320372,25,124.2209985,3,3,6,4,5,9,5,0.347725,0.357108,0,No
15496,caviar,5,13.48709426,5,9.210360372,9.210320372,25,124.2209985,4,4,8,4,4,8,4,0.392287,0.409221,0,No
15533,cater,5,13.48709426,5,9.210360372,9.210320372,25,124.2209985,3,2,5,3,5,8,5,0.359237,0.371621,0,No
15536,catchy,5,13.48709426,5,9.210360372,9.210320372,25,124.2209985,4,2,6,4,2,6,5,0.33038,0.334766,0,No
15553,casualty,5,13.48709426,5,9.210360372,9.210320372,25,124.2209985,4,4,8,5,4,9,5,0.384962,0.401266,0,No
15568,cassandra,5,13.48709426,5,9.210360372,9.210320372,25,124.2209985,4,4,8,4,4,8,4,0.408746,0.426356,0,No
15637,carib,5,13.48709426,5,9.210360372,9.210320372,25,124.2209985,4,4,8,5,4,9,5,0.337055,0.343516,0,No
15675,caramel,5,13.48709426,5,9.210360372,9.210320372,25,124.2209985,3,5,8,3,5,8,4,0.428168,0.444416,0,No
15683,captaincy,5,13.48709426,5,9.210360372,9.210320372,25,124.2209985,2,4,6,5,5,10,5,0.381029,0.397152,0,No
15688,caprice,5,13.48709426,5,9.210360372,9.210320372,25,124.2209985,2,3,5,2,3,5,5,0.351805,0.361905,0,No
15697,capella,5,13.48709426,5,9.210360372,9.210320372,25,124.2209985,3,4,7,3,4,7,5,0.362361,0.375388,0,No
15971,bully,5,13.48709426,5,9.210360372,9.210320372,25,124.2209985,5,4,9,5,4,9,5,0.347868,0.357345,0,No
16231,bp,5,13.48709426,5,9.210360372,9.210320372,25,124.2209985,2,3,5,2,3,5,5,0.363437,0.376612,0,No
16283,bossy,5,13.48709426,5,9.210360372,9.210320372,25,124.2209985,5,4,9,5,5,10,4,0.395248,0.412371,0,No
16349,bondage,5,13.48709426,5,9.210360372,9.210320372,25,124.2209985,5,5,10,5,5,10,4,0.403689,0.421263,0,No
16384,boeotia,5,13.48709426,5,9.210360372,9.210320372,25,124.2209985,3,4,7,4,5,9,5,0.390673,0.407477,0,No
16478,bleak,5,13.48709426,5,9.210360372,9.210320372,25,124.2209985,5,3,8,5,5,10,5,0.330479,0.335852,0,No
16490,bland,5,13.48709426,5,9.210360372,9.210320372,25,124.2209985,4,4,8,4,4,8,5,0.339381,0.346145,0,No
16546,birdie,5,13.48709426,5,9.210360372,9.210320372,25,124.2209985,3,5,8,4,5,9,4,0.400392,0.418042,0,No
16556,biota,5,13.48709426,5,9.210360372,9.210320372,25,124.2209985,2,3,5,3,4,7,4,0.40868,0.426211,0,No
16588,bighorn,5,13.48709426,5,9.210360372,9.210320372,25,124.2209985,1,4,5,4,5,9,5,0.341024,0.348408,0,No
16750,belfry,5,13.48709426,5,9.210360372,9.210320372,25,124.2209985,5,5,10,5,5,10,4,0.420769,0.437614,0,No
16867,bathtub,5,13.48709426,5,9.210360372,9.210320372,25,124.2209985,2,4,6,5,4,9,4,0.398935,0.416469,0,No
16898,basaltic,5,13.48709426,5,9.210360372,9.210320372,25,124.2209985,4,2,6,4,5,9,5,0.324195,0.327628,0,No
16945,barefoot,5,13.48709426,5,9.210360372,9.210320372,25,124.2209985,3,4,7,3,4,7,5,0.39739,0.414603,0,No
17025,balboa,5,13.48709426,5,9.210360372,9.210320372,25,124.2209985,4,5,9,5,5,10,5,0.401543,0.41942,0,No
17067,backpack,5,13.48709426,5,9.210360372,9.210320372,25,124.2209985,2,3,5,5,5,10,4,0.423197,0.43983,0,No
17098,az,5,13.48709426,5,9.210360372,9.210320372,25,124.2209985,1,2,3,2,2,4,5,0.301268,0.306994,0,No
17165,autocratic,5,13.48709426,5,9.210360372,9.210320372,25,124.2209985,3,3,6,4,3,7,5,0.384437,0.400665,0,No
17269,atalanta,5,13.48709426,5,9.210360372,9.210320372,25,124.2209985,3,4,7,3,4,7,5,0.405181,0.422959,0,No
17355,artistry,5,13.48709426,5,9.210360372,9.210320372,25,124.2209985,4,3,7,4,3,7,5,0.365488,0.37918,0,No
17390,arouse,5,13.48709426,5,9.210360372,9.210320372,25,124.2209985,3,4,7,4,4,8,5,0.395724,0.412899,0,No
17449,arden,5,13.48709426,5,9.210360372,9.210320372,25,124.2209985,5,4,9,5,4,9,5,0.384412,0.400651,0,No
17513,applicable,5,13.48709426,5,9.210360372,9.210320372,25,124.2209985,4,3,7,4,5,9,4,0.410418,0.427943,0,No
17543,apostate,5,13.48709426,5,9.210360372,9.210320372,25,124.2209985,1,4,5,4,4,8,4,0.40718,0.424591,0,No
17601,antigone,5,13.48709426,5,9.210360372,9.210320372,25,124.2209985,4,4,8,4,4,8,5,0.351672,0.361766,0,No
17634,anselm,5,13.48709426,5,9.210360372,9.210320372,25,124.2209985,3,3,6,3,4,7,5,0.379165,0.395044,0,No
17675,animism,5,13.48709426,5,9.210360372,9.210320372,25,124.2209985,5,3,8,5,3,8,4,0.407657,0.425225,0,No
17732,anatole,5,13.48709426,5,9.210360372,9.210320372,25,124.2209985,3,1,4,3,2,5,5,0.3282,0.332025,0,No
17835,alum,5,13.48709426,5,9.210360372,9.210320372,25,124.2209985,4,3,7,4,3,7,4,0.404019,0.421385,0,No
18088,affirmation,5,13.48709426,5,9.210360372,9.210320372,25,124.2209985,3,3,6,4,5,9,5,0.412277,0.429593,0,No
18104,aerodynamic,5,13.48709426,5,9.210360372,9.210320372,25,124.2209985,4,3,7,4,3,7,5,0.319573,0.323057,0,No
18170,adhesion,5,13.48709426,5,9.210360372,9.210320372,25,124.2209985,5,3,8,5,4,9,5,0.396175,0.413307,0,No
1945,technetium,10,12.79394708,3,9.721185996,9.721165996,30,124.3723392,7,6,13,9,8,17,5,0.371609,0.386332,0,No
3503,sharpe,10,12.79394708,3,9.721185996,9.721165996,30,124.3723392,6,8,14,6,8,14,5,0.354928,0.366185,0,No
3955,saskatoon,10,12.79394708,3,9.721185996,9.721165996,30,124.3723392,5,6,11,6,7,13,4,0.415471,0.432774,0,No
6453,oscilloscope,10,12.79394708,3,9.721185996,9.721165996,30,124.3723392,3,4,7,4,4,8,4,0.399186,0.416507,0,No
6968,niacin,10,12.79394708,3,9.721185996,9.721165996,30,124.3723392,2,8,10,7,10,17,4,0.409661,0.427107,0,No
8697,libreville,10,12.79394708,3,9.721185996,9.721165996,30,124.3723392,6,6,12,9,9,18,4,0.409888,0.427352,0,No
11849,fortran,10,12.79394708,3,9.721185996,9.721165996,30,124.3723392,8,7,15,9,8,17,4,0.426461,0.442886,0,No
14156,cue,10,12.79394708,3,9.721185996,9.721165996,30,124.3723392,5,2,7,10,7,17,5,0.398201,0.415946,0,No
14721,conch,10,12.79394708,3,9.721185996,9.721165996,30,124.3723392,7,6,13,8,6,14,4,0.402061,0.419427,0,No
17829,alveoli,10,12.79394708,3,9.721185996,9.721165996,30,124.3723392,3,9,12,9,10,19,4,0.410713,0.428258,0,No
16532,bismuth,16,12.32394346,2,10.1266511,10.1266411,32,124.8002756,8,5,13,12,13,25,5,0.348736,0.358436,0,No
664,vorticity,9,12.8993076,3,9.721185996,9.721165996,27,125.3965684,4,5,9,7,8,15,4,0.432455,0.448247,0,No
3372,shuttlecock,9,12.8993076,3,9.721185996,9.721165996,27,125.3965684,4,5,9,9,8,17,5,0.353944,0.364963,0,No
3752,scylla,9,12.8993076,3,9.721185996,9.721165996,27,125.3965684,8,6,14,8,8,16,4,0.387644,0.404221,0,No
4845,rabat,9,12.8993076,3,9.721185996,9.721165996,27,125.3965684,5,5,10,6,6,12,4,0.422673,0.439388,0,No
5006,punt,9,12.8993076,3,9.721185996,9.721165996,27,125.3965684,8,5,13,9,8,17,4,0.420172,0.437351,0,No
8043,marten,9,12.8993076,3,9.721185996,9.721165996,27,125.3965684,4,5,9,4,6,10,5,0.338353,0.3448,0,No
8444,lourdes,9,12.8993076,3,9.721185996,9.721165996,27,125.3965684,7,5,12,9,8,17,4,0.401352,0.418728,0,No
9132,kirchner,9,12.8993076,3,9.721185996,9.721165996,27,125.3965684,3,7,10,4,9,13,5,0.363132,0.376136,0,No
9968,incidental,9,12.8993076,3,9.721185996,9.721165996,27,125.3965684,7,2,9,7,9,16,5,0.330972,0.335344,0,No
11797,francium,9,12.8993076,3,9.721185996,9.721165996,27,125.3965684,7,4,11,7,7,14,5,0.352335,0.362969,0,No
12105,firework,9,12.8993076,3,9.721185996,9.721165996,27,125.3965684,3,2,5,6,3,9,5,0.345875,0.354817,0,No
14458,cornea,9,12.8993076,3,9.721185996,9.721165996,27,125.3965684,1,6,7,9,7,16,4,0.403707,0.421112,0,No
15991,bugle,9,12.8993076,3,9.721185996,9.721165996,27,125.3965684,3,2,5,9,6,15,5,0.355283,0.367007,0,No
16191,bratwurst,9,12.8993076,3,9.721185996,9.721165996,27,125.3965684,5,3,8,6,7,13,4,0.389481,0.406602,0,No
17429,argus,9,12.8993076,3,9.721185996,9.721165996,27,125.3965684,4,2,6,6,7,13,5,0.349973,0.359699,0,No
17897,allentown,9,12.8993076,3,9.721185996,9.721165996,27,125.3965684,6,4,10,8,7,15,5,0.35717,0.368831,0,No
7038,neodymium,15,12.38848198,2,10.1266511,10.1266411,30,125.4538347,12,6,18,15,12,27,5,0.351686,0.362337,0,No
243,wolverine,6,13.30477271,4,9.433503923,9.433473923,24,125.5106255,3,4,7,5,4,9,4,0.427663,0.443947,0,No
275,wisp,6,13.30477271,4,9.433503923,9.433473923,24,125.5106255,2,5,7,5,5,10,4,0.390647,0.4077,0,No
299,winery,6,13.30477271,4,9.433503923,9.433473923,24,125.5106255,3,4,7,5,6,11,4,0.390905,0.407761,0,No
970,vagrant,6,13.30477271,4,9.433503923,9.433473923,24,125.5106255,3,3,6,5,4,9,5,0.384971,0.401514,0,No
1170,tusk,6,13.30477271,4,9.433503923,9.433473923,24,125.5106255,5,5,10,5,6,11,5,0.342948,0.350568,0,No
1201,tuple,6,13.30477271,4,9.433503923,9.433473923,24,125.5106255,2,4,6,4,4,8,4,0.412066,0.42938,0,No
1298,tripe,6,13.30477271,4,9.433503923,9.433473923,24,125.5106255,6,3,9,6,4,10,4,0.405246,0.422817,0,No
1456,tradeoff,6,13.30477271,4,9.433503923,9.433473923,24,125.5106255,3,6,9,6,6,12,5,0.371982,0.38693,0,No
1610,tirana,6,13.30477271,4,9.433503923,9.433473923,24,125.5106255,5,4,9,5,4,9,4,0.392131,0.409066,0,No
1743,thirsty,6,13.30477271,4,9.433503923,9.433473923,24,125.5106255,6,6,12,6,6,12,5,0.342201,0.349941,0,No
1852,terrapin,6,13.30477271,4,9.433503923,9.433473923,24,125.5106255,3,5,8,3,5,8,4,0.425826,0.442285,0,No
2105,tabernacle,6,13.30477271,4,9.433503923,9.433473923,24,125.5106255,1,5,6,6,6,12,5,0.372952,0.387881,0,No
2265,surah,6,13.30477271,4,9.433503923,9.433473923,24,125.5106255,5,1,6,5,3,8,5,0.345599,0.354479,0,No
2342,suitcase,6,13.30477271,4,9.433503923,9.433473923,24,125.5106255,6,5,11,6,6,12,5,0.363236,0.376274,0,No
2379,suburbia,6,13.30477271,4,9.433503923,9.433473923,24,125.5106255,1,6,7,6,6,12,4,0.410191,0.42761,0,No
2535,stockbroker,6,13.30477271,4,9.433503923,9.433473923,24,125.5106255,2,5,7,6,6,12,4,0.418932,0.435896,0,No
2556,stillwater,6,13.30477271,4,9.433503923,9.433473923,24,125.5106255,4,4,8,4,6,10,4,0.405468,0.423051,0,No
2684,stall,6,13.30477271,4,9.433503923,9.433473923,24,125.5106255,5,4,9,6,5,11,5,0.366083,0.379839,0,No
3061,snowstorm,6,13.30477271,4,9.433503923,9.433473923,24,125.5106255,4,3,7,4,3,7,5,0.381348,0.397434,0,No
3261,singleton,6,13.30477271,4,9.433503923,9.433473923,24,125.5106255,4,5,9,6,5,11,5,0.338656,0.345277,0,No
3899,scalp,6,13.30477271,4,9.433503923,9.433473923,24,125.5106255,5,3,8,6,4,10,5,0.347663,0.357068,0,No
4040,salton,6,13.30477271,4,9.433503923,9.433473923,24,125.5106255,3,2,5,5,5,10,5,0.327491,0.331273,0,No
4197,rowe,6,13.30477271,4,9.433503923,9.433473923,24,125.5106255,3,4,7,5,4,9,5,0.385581,0.401918,0,No
4211,roundabout,6,13.30477271,4,9.433503923,9.433473923,24,125.5106255,4,5,9,5,5,10,4,0.42352,0.440168,0,No
4414,rho,6,13.30477271,4,9.433503923,9.433473923,24,125.5106255,2,4,6,2,4,6,4,0.3902,0.406986,0,No
4442,reversal,6,13.30477271,4,9.433503923,9.433473923,24,125.5106255,3,2,5,4,5,9,5,0.378882,0.39473,0,No
4683,recherche,6,13.30477271,4,9.433503923,9.433473923,24,125.5106255,2,3,5,6,3,9,5,0.398192,0.415983,0,No
4869,quince,6,13.30477271,4,9.433503923,9.433473923,24,125.5106255,4,5,9,5,6,11,4,0.405302,0.422901,0,No
5088,provost,6,13.30477271,4,9.433503923,9.433473923,24,125.5106255,2,4,6,6,5,11,5,0.370152,0.384623,0,No
5105,protractor,6,13.30477271,4,9.433503923,9.433473923,24,125.5106255,3,4,7,6,5,11,4,0.404167,0.42177,0,No
5148,proprioception,6,13.30477271,4,9.433503923,9.433473923,24,125.5106255,4,4,8,4,5,9,4,0.406676,0.424248,0,No
5453,porridge,6,13.30477271,4,9.433503923,9.433473923,24,125.5106255,5,4,9,5,4,9,5,0.366855,0.380844,0,No
5460,porcupine,6,13.30477271,4,9.433503923,9.433473923,24,125.5106255,5,4,9,6,5,11,5,0.349072,0.358863,0,No
5702,pitman,6,13.30477271,4,9.433503923,9.433473923,24,125.5106255,5,2,7,6,3,9,5,0.331497,0.336025,0,No
5895,pestle,6,13.30477271,4,9.433503923,9.433473923,24,125.5106255,2,5,7,6,6,12,4,0.424158,0.440769,0,No
6337,palindrome,6,13.30477271,4,9.433503923,9.433473923,24,125.5106255,2,5,7,4,5,9,5,0.385447,0.402033,0,No
6462,orthopedic,6,13.30477271,4,9.433503923,9.433473923,24,125.5106255,5,3,8,5,4,9,5,0.322722,0.32587,0,No
6770,numismatic,6,13.30477271,4,9.433503923,9.433473923,24,125.5106255,3,1,4,3,3,6,5,0.323104,0.326216,0,No
7001,neuter,6,13.30477271,4,9.433503923,9.433473923,24,125.5106255,4,4,8,5,4,9,5,0.346219,0.355112,0,No
7057,needham,6,13.30477271,4,9.433503923,9.433473923,24,125.5106255,4,5,9,5,6,11,5,0.390785,0.407622,0,No
7313,moulton,6,13.30477271,4,9.433503923,9.433473923,24,125.5106255,5,3,8,5,5,10,5,0.348373,0.358075,0,No
7376,moratorium,6,13.30477271,4,9.433503923,9.433473923,24,125.5106255,4,4,8,6,6,12,5,0.346787,0.355587,0,No
7566,minoan,6,13.30477271,4,9.433503923,9.433473923,24,125.5106255,3,2,5,6,2,8,5,0.384262,0.400449,0,No
7728,messianic,6,13.30477271,4,9.433503923,9.433473923,24,125.5106255,3,2,5,4,2,6,5,0.321722,0.325833,0,No
7779,menopause,6,13.30477271,4,9.433503923,9.433473923,24,125.5106255,3,3,6,4,3,7,5,0.368309,0.382621,0,No
7875,meager,6,13.30477271,4,9.433503923,9.433473923,24,125.5106255,4,5,9,6,6,12,5,0.367037,0.381057,0,No
7904,mcgowan,6,13.30477271,4,9.433503923,9.433473923,24,125.5106255,5,2,7,6,3,9,5,0.385305,0.401599,0,No
7952,maximal,6,13.30477271,4,9.433503923,9.433473923,24,125.5106255,3,4,7,5,4,9,5,0.326816,0.330588,0,No
8106,marcy,6,13.30477271,4,9.433503923,9.433473923,24,125.5106255,4,2,6,4,3,7,5,0.360873,0.373557,0,No
8544,loaves,6,13.30477271,4,9.433503923,9.433473923,24,125.5106255,2,4,6,3,5,8,4,0.421559,0.438529,0,No
8569,littoral,6,13.30477271,4,9.433503923,9.433473923,24,125.5106255,3,2,5,5,4,9,5,0.323569,0.326819,0,No
8778,lengthen,6,13.30477271,4,9.433503923,9.433473923,24,125.5106255,2,4,6,4,4,8,4,0.400636,0.418268,0,No
8841,leander,6,13.30477271,4,9.433503923,9.433473923,24,125.5106255,4,4,8,4,6,10,5,0.384379,0.400618,0,No
8907,latent,6,13.30477271,4,9.433503923,9.433473923,24,125.5106255,5,3,8,6,3,9,5,0.384379,0.400594,0,No
9109,klux,6,13.30477271,4,9.433503923,9.433473923,24,125.5106255,1,1,2,6,6,12,6,0.260313,0.264247,0,No
9128,kirkpatrick,6,13.30477271,4,9.433503923,9.433473923,24,125.5106255,3,3,6,4,5,9,5,0.384271,0.400477,0,No
9356,journeyman,6,13.30477271,4,9.433503923,9.433473923,24,125.5106255,4,5,9,6,5,11,5,0.360127,0.372535,0,No
9390,johanson,6,13.30477271,4,9.433503923,9.433473923,24,125.5106255,2,3,5,2,4,6,5,0.384979,0.401256,0,No
10040,impedance,6,13.30477271,4,9.433503923,9.433473923,24,125.5106255,4,3,7,4,4,8,5,0.385079,0.401591,0,No
10080,illiteracy,6,13.30477271,4,9.433503923,9.433473923,24,125.5106255,4,3,7,4,5,9,5,0.34672,0.355859,0,No
10165,hyper,6,13.30477271,4,9.433503923,9.433473923,24,125.5106255,4,3,7,5,6,11,5,0.32308,0.326381,0,No
10236,humpback,6,13.30477271,4,9.433503923,9.433473923,24,125.5106255,4,1,5,4,3,7,5,0.314717,0.3188,0,No
10611,hendrick,6,13.30477271,4,9.433503923,9.433473923,24,125.5106255,4,2,6,4,3,7,5,0.340449,0.3478,0,No
10662,hegemony,6,13.30477271,4,9.433503923,9.433473923,24,125.5106255,1,4,5,1,5,6,5,0.360046,0.37237,0,No
10785,harrington,6,13.30477271,4,9.433503923,9.433473923,24,125.5106255,4,3,7,4,4,8,5,0.347317,0.356577,0,No
11134,gravy,6,13.30477271,4,9.433503923,9.433473923,24,125.5106255,4,3,7,4,6,10,5,0.352622,0.363354,0,No
11227,gordian,6,13.30477271,4,9.433503923,9.433473923,24,125.5106255,5,3,8,6,6,12,5,0.329828,0.333929,0,No
11606,galactose,6,13.30477271,4,9.433503923,9.433473923,24,125.5106255,3,4,7,5,6,11,4,0.388212,0.404799,0,No
11871,formaldehyde,6,13.30477271,4,9.433503923,9.433473923,24,125.5106255,4,6,10,4,6,10,5,0.38226,0.398519,0,No
12204,fetal,6,13.30477271,4,9.433503923,9.433473923,24,125.5106255,2,3,5,4,4,8,5,0.325587,0.328865,0,No
12247,feline,6,13.30477271,4,9.433503923,9.433473923,24,125.5106255,6,5,11,6,5,11,4,0.424838,0.441524,0,No
12347,falmouth,6,13.30477271,4,9.433503923,9.433473923,24,125.5106255,4,6,10,4,6,10,5,0.370724,0.385318,0,No
12637,ethane,6,13.30477271,4,9.433503923,9.433473923,24,125.5106255,4,3,7,4,5,9,4,0.390261,0.407038,0,No
13358,donnelly,6,13.30477271,4,9.433503923,9.433473923,24,125.5106255,2,6,8,2,6,8,4,0.400122,0.417465,0,No
13520,diphthong,6,13.30477271,4,9.433503923,9.433473923,24,125.5106255,1,4,5,5,4,9,4,0.422502,0.439351,0,No
14206,crt,6,13.30477271,4,9.433503923,9.433473923,24,125.5106255,4,3,7,5,3,8,5,0.340638,0.34806,0,No
14234,crockett,6,13.30477271,4,9.433503923,9.433473923,24,125.5106255,2,1,3,6,1,7,5,0.384237,0.400402,0,No
14297,crass,6,13.30477271,4,9.433503923,9.433473923,24,125.5106255,5,5,10,5,5,10,5,0.341044,0.348265,0,No
14571,contention,6,13.30477271,4,9.433503923,9.433473923,24,125.5106255,4,5,9,5,6,11,4,0.392435,0.40939,0,No
14724,concertmaster,6,13.30477271,4,9.433503923,9.433473923,24,125.5106255,2,3,5,4,4,8,5,0.392704,0.409826,0,No
14725,concerti,6,13.30477271,4,9.433503923,9.433473923,24,125.5106255,4,0,4,5,0,5,0,0,0,0,No
15019,cloaca,6,13.30477271,4,9.433503923,9.433473923,24,125.5106255,2,5,7,6,6,12,4,0.406211,0.42377,0,No
15049,clemson,6,13.30477271,4,9.433503923,9.433473923,24,125.5106255,4,2,6,4,2,6,5,0.323994,0.327669,0,No
15111,civet,6,13.30477271,4,9.433503923,9.433473923,24,125.5106255,3,5,8,3,5,8,5,0.343692,0.352001,0,No
15225,choirmaster,6,13.30477271,4,9.433503923,9.433473923,24,125.5106255,5,3,8,6,6,12,5,0.396919,0.414101,0,No
15390,chancel,6,13.30477271,4,9.433503923,9.433473923,24,125.5106255,6,4,10,6,5,11,5,0.347977,0.357516,0,No
15410,chairperson,6,13.30477271,4,9.433503923,9.433473923,24,125.5106255,3,4,7,3,6,9,4,0.412574,0.430023,0,No
15689,capo,6,13.30477271,4,9.433503923,9.433473923,24,125.5106255,0,4,4,0,5,5,5,0.329712,0.334238,0,No
15702,capacitance,6,13.30477271,4,9.433503923,9.433473923,24,125.5106255,4,2,6,5,2,7,5,0.384287,0.400477,0,No
16125,bridgewater,6,13.30477271,4,9.433503923,9.433473923,24,125.5106255,4,5,9,4,6,10,5,0.349477,0.359394,0,No
16270,boucher,6,13.30477271,4,9.433503923,9.433473923,24,125.5106255,3,4,7,5,4,9,5,0.327927,0.331666,0,No
16699,benign,6,13.30477271,4,9.433503923,9.433473923,24,125.5106255,6,3,9,6,4,10,5,0.349099,0.358882,0,No
16759,behold,6,13.30477271,4,9.433503923,9.433473923,24,125.5106255,6,6,12,6,6,12,4,0.411722,0.429225,0,No
17037,bailiff,6,13.30477271,4,9.433503923,9.433473923,24,125.5106255,3,4,7,5,5,10,4,0.41832,0.435478,0,No
17167,autocracy,6,13.30477271,4,9.433503923,9.433473923,24,125.5106255,2,5,7,3,5,8,4,0.439109,0.454054,0,No
17212,audit,6,13.30477271,4,9.433503923,9.433473923,24,125.5106255,4,5,9,5,5,10,5,0.354594,0.365861,0,No
17546,apology,6,13.30477271,4,9.433503923,9.433473923,24,125.5106255,3,5,8,5,5,10,4,0.403753,0.421328,0,No
17570,aorta,6,13.30477271,4,9.433503923,9.433473923,24,125.5106255,2,4,6,6,5,11,4,0.405913,0.423478,0,No
18018,airlift,6,13.30477271,4,9.433503923,9.433473923,24,125.5106255,4,4,8,4,5,9,5,0.349953,0.359851,0,No
18162,adjutant,6,13.30477271,4,9.433503923,9.433473923,24,125.5106255,4,4,8,5,6,11,4,0.416954,0.434013,0,No
18207,actinolite,6,13.30477271,4,9.433503923,9.433473923,24,125.5106255,2,3,5,4,4,8,5,0.345909,0.354901,0,No
18225,acorn,6,13.30477271,4,9.433503923,9.433473923,24,125.5106255,5,4,9,5,4,9,5,0.347391,0.356807,0,No
18261,accompanist,6,13.30477271,4,9.433503923,9.433473923,24,125.5106255,3,5,8,6,6,12,5,0.386917,0.403984,0,No
948,vanadium,14,12.45747485,2,10.1266511,10.1266411,28,126.1525014,9,4,13,10,11,21,5,0.373871,0.388947,0,No
1631,timbre,8,13.01709064,3,9.721185996,9.721165996,24,126.5415592,5,5,10,5,7,12,4,0.406229,0.423826,0,No
2286,superlative,8,13.01709064,3,9.721185996,9.721165996,24,126.5415592,5,4,9,8,6,14,5,0.370005,0.384454,0,No
2510,stork,8,13.01709064,3,9.721185996,9.721165996,24,126.5415592,5,6,11,6,6,12,4,0.402855,0.420239,0,No
3744,seaborg,8,13.01709064,3,9.721185996,9.721165996,24,126.5415592,7,4,11,8,5,13,5,0.368768,0.38291,0,No
4421,rheumatic,8,13.01709064,3,9.721185996,9.721165996,24,126.5415592,7,2,9,8,5,13,5,0.321728,0.325026,0,No
4908,quart,8,13.01709064,3,9.721185996,9.721165996,24,126.5415592,4,5,9,7,7,14,4,0.39201,0.408925,0,No
6327,palomar,8,13.01709064,3,9.721185996,9.721165996,24,126.5415592,4,3,7,6,7,13,5,0.346395,0.355493,0,No
6447,osmium,8,13.01709064,3,9.721185996,9.721165996,24,126.5415592,8,4,12,8,7,15,4,0.409264,0.426751,0,No
7128,nashua,8,13.01709064,3,9.721185996,9.721165996,24,126.5415592,5,4,9,7,6,13,5,0.351818,0.362124,0,No
8022,maseru,8,13.01709064,3,9.721185996,9.721165996,24,126.5415592,7,6,13,7,7,14,5,0.369882,0.384318,0,No
9265,kankakee,8,13.01709064,3,9.721185996,9.721165996,24,126.5415592,6,6,12,7,8,15,4,0.408953,0.426436,0,No
9453,jejunum,8,13.01709064,3,9.721185996,9.721165996,24,126.5415592,3,5,8,8,7,15,4,0.438545,0.453571,0,No
10363,honeycomb,8,13.01709064,3,9.721185996,9.721165996,24,126.5415592,3,7,10,8,7,15,4,0.41156,0.429018,0,No
10499,hildebrand,8,13.01709064,3,9.721185996,9.721165996,24,126.5415592,6,6,12,7,7,14,5,0.365796,0.37953,0,No
10540,heuristic,8,13.01709064,3,9.721185996,9.721165996,24,126.5415592,1,5,6,6,7,13,5,0.361734,0.374354,0,No
11069,griswold,8,13.01709064,3,9.721185996,9.721165996,24,126.5415592,5,6,11,6,7,13,5,0.353507,0.364486,0,No
11158,granule,8,13.01709064,3,9.721185996,9.721165996,24,126.5415592,4,6,10,4,8,12,4,0.390321,0.40763,0,No
14089,cuttlebone,8,13.01709064,3,9.721185996,9.721165996,24,126.5415592,5,5,10,8,8,16,5,0.389447,0.40638,0,No
14300,cranston,8,13.01709064,3,9.721185996,9.721165996,24,126.5415592,4,6,10,4,7,11,5,0.383631,0.399958,0,No
14847,combinatorial,8,13.01709064,3,9.721185996,9.721165996,24,126.5415592,5,1,6,7,5,12,5,0.325193,0.328627,0,No
14911,coincident,8,13.01709064,3,9.721185996,9.721165996,24,126.5415592,3,3,6,5,8,13,5,0.352706,0.363334,0,No
14992,cluj,8,13.01709064,3,9.721185996,9.721165996,24,126.5415592,4,2,6,7,8,15,5,0.34731,0.356572,0,No
15187,chromatography,8,13.01709064,3,9.721185996,9.721165996,24,126.5415592,3,5,8,5,7,12,5,0.350977,0.361286,0,No
15891,butte,8,13.01709064,3,9.721185996,9.721165996,24,126.5415592,4,4,8,5,8,13,5,0.370956,0.385515,0,No
17173,autism,8,13.01709064,3,9.721185996,9.721165996,24,126.5415592,5,5,10,5,5,10,5,0.395442,0.412603,0,No
17328,askew,8,13.01709064,3,9.721185996,9.721165996,24,126.5415592,7,3,10,7,4,11,5,0.341037,0.348119,0,No
17641,anomie,8,13.01709064,3,9.721185996,9.721165996,24,126.5415592,5,7,12,6,7,13,4,0.410229,0.427746,0,No
18290,abyss,8,13.01709064,3,9.721185996,9.721165996,24,126.5415592,5,4,9,5,4,9,5,0.35717,0.368713,0,No
807,vibrato,13,12.53158282,2,10.1266511,10.1266411,26,126.902967,11,8,19,12,11,23,4,0.41671,0.433882,0,No
6005,pentatonic,13,12.53158282,2,10.1266511,10.1266411,26,126.902967,6,3,9,11,8,19,5,0.355539,0.367336,0,No
13,zomba,5,13.48709426,4,9.433503923,9.433473923,20,127.2305567,4,3,7,4,3,7,5,0.361358,0.374119,0,No
179,wove,5,13.48709426,4,9.433503923,9.433473923,20,127.2305567,4,3,7,4,3,7,5,0.340292,0.347561,0,No
457,welt,5,13.48709426,4,9.433503923,9.433473923,20,127.2305567,1,5,6,2,5,7,4,0.416661,0.433858,0,No
480,weep,5,13.48709426,4,9.433503923,9.433473923,20,127.2305567,4,4,8,4,4,8,5,0.345512,0.354281,0,No
553,wasteland,5,13.48709426,4,9.433503923,9.433473923,20,127.2305567,2,5,7,2,5,7,4,0.38996,0.406747,0,No
817,veterinarian,5,13.48709426,4,9.433503923,9.433473923,20,127.2305567,1,5,6,5,5,10,5,0.386395,0.403111,0,No
822,vestigial,5,13.48709426,4,9.433503923,9.433473923,20,127.2305567,3,2,5,5,3,8,5,0.321663,0.324937,0,No
963,valery,5,13.48709426,4,9.433503923,9.433473923,20,127.2305567,4,0,4,4,0,4,0,0,0,0,No
1038,uptown,5,13.48709426,4,9.433503923,9.433473923,20,127.2305567,4,0,4,4,0,4,0,0,0,0,No
1044,upsilon,5,13.48709426,4,9.433503923,9.433473923,20,127.2305567,3,3,6,3,3,6,5,0.384687,0.400932,0,No
1202,tupelo,5,13.48709426,4,9.433503923,9.433473923,20,127.2305567,3,3,6,3,3,6,5,0.34676,0.35592,0,No
1238,tty,5,13.48709426,4,9.433503923,9.433473923,20,127.2305567,1,5,6,2,5,7,4,0.409188,0.426553,0,No
1241,tsarina,5,13.48709426,4,9.433503923,9.433473923,20,127.2305567,3,2,5,5,4,9,5,0.384271,0.400458,0,No
1249,truss,5,13.48709426,4,9.433503923,9.433473923,20,127.2305567,2,4,6,3,4,7,5,0.34947,0.359291,0,No
1267,troublesome,5,13.48709426,4,9.433503923,9.433473923,20,127.2305567,2,4,6,4,4,8,5,0.33167,0.336778,0,No
1272,tropopause,5,13.48709426,4,9.433503923,9.433473923,20,127.2305567,1,4,5,5,5,10,4,0.416182,0.433422,0,No
1393,transmutation,5,13.48709426,4,9.433503923,9.433473923,20,127.2305567,3,3,6,4,5,9,4,0.408275,0.425629,0,No
1440,traitor,5,13.48709426,4,9.433503923,9.433473923,20,127.2305567,4,4,8,5,4,9,5,0.396928,0.41411,0,No
1682,thug,5,13.48709426,4,9.433503923,9.433473923,20,127.2305567,2,4,6,4,4,8,5,0.348537,0.358049,0,No
1723,thoroughbred,5,13.48709426,4,9.433503923,9.433473923,20,127.2305567,4,3,7,5,3,8,5,0.350845,0.360983,0,No
2001,tariff,5,13.48709426,4,9.433503923,9.433473923,20,127.2305567,3,4,7,5,4,9,5,0.390321,0.407263,0,No
2283,superstitious,5,13.48709426,4,9.433503923,9.433473923,20,127.2305567,1,4,5,2,4,6,5,0.337876,0.344231,0,No
2437,strung,5,13.48709426,4,9.433503923,9.433473923,20,127.2305567,4,3,7,5,5,10,5,0.388459,0.405078,0,No
2531,stoic,5,13.48709426,4,9.433503923,9.433473923,20,127.2305567,3,3,6,4,3,7,5,0.326143,0.329541,0,No
2726,squaw,5,13.48709426,4,9.433503923,9.433473923,20,127.2305567,4,2,6,4,5,9,5,0.323221,0.326821,0,No
2781,spoof,5,13.48709426,4,9.433503923,9.433473923,20,127.2305567,4,4,8,4,5,9,5,0.333829,0.339063,0,No
3007,solidify,5,13.48709426,4,9.433503923,9.433473923,20,127.2305567,4,2,6,4,3,7,5,0.336053,0.342111,0,No
3050,sober,5,13.48709426,4,9.433503923,9.433473923,20,127.2305567,5,4,9,5,4,9,5,0.384537,0.400796,0,No
3096,smudge,5,13.48709426,4,9.433503923,9.433473923,20,127.2305567,3,4,7,3,4,7,5,0.363735,0.377088,0,No
3194,slack,5,13.48709426,4,9.433503923,9.433473923,20,127.2305567,4,5,9,4,5,9,4,0.411952,0.429408,0,No
3327,signify,5,13.48709426,4,9.433503923,9.433473923,20,127.2305567,2,3,5,5,4,9,5,0.399428,0.417199,0,No
3374,shutout,5,13.48709426,4,9.433503923,9.433473923,20,127.2305567,3,4,7,5,4,9,4,0.416739,0.433802,0,No
3395,shrapnel,5,13.48709426,4,9.433503923,9.433473923,20,127.2305567,4,4,8,4,4,8,5,0.382961,0.399301,0,No
3518,shamrock,5,13.48709426,4,9.433503923,9.433473923,20,127.2305567,4,3,7,4,3,7,5,0.415753,0.43333,0,No
3605,sera,5,13.48709426,4,9.433503923,9.433473923,20,127.2305567,2,2,4,2,2,4,5,0.329467,0.333476,0,No
3751,scythe,5,13.48709426,4,9.433503923,9.433473923,20,127.2305567,3,3,6,4,4,8,5,0.385205,0.401505,0,No
3894,scandalous,5,13.48709426,4,9.433503923,9.433473923,20,127.2305567,4,3,7,4,3,7,5,0.342558,0.350536,0,No
3897,scam,5,13.48709426,4,9.433503923,9.433473923,20,127.2305567,4,1,5,5,1,6,6,0.25923,0.263031,0,No
3935,sauerkraut,5,13.48709426,4,9.433503923,9.433473923,20,127.2305567,3,4,7,5,5,10,4,0.40128,0.418652,0,No
4014,sanborn,5,13.48709426,4,9.433503923,9.433473923,20,127.2305567,4,4,8,4,4,8,5,0.349278,0.35915,0,No
4210,roundhouse,5,13.48709426,4,9.433503923,9.433473923,20,127.2305567,4,2,6,4,3,7,5,0.325146,0.328947,0,No
4228,rosette,5,13.48709426,4,9.433503923,9.433473923,20,127.2305567,4,4,8,5,5,10,5,0.359558,0.372201,0,No
4233,rosen,5,13.48709426,4,9.433503923,9.433473923,20,127.2305567,2,2,4,2,2,4,5,0.320531,0.32392,0,No
4244,roost,5,13.48709426,4,9.433503923,9.433473923,20,127.2305567,3,2,5,3,5,8,5,0.360925,0.373628,0,No
4460,retribution,5,13.48709426,4,9.433503923,9.433473923,20,127.2305567,4,1,5,4,1,5,5,0.326479,0.32972,0,No
4478,resultant,5,13.48709426,4,9.433503923,9.433473923,20,127.2305567,1,3,4,5,3,8,5,0.322599,0.32608,0,No
4555,render,5,13.48709426,4,9.433503923,9.433473923,20,127.2305567,3,3,6,5,4,9,5,0.398648,0.416401,0,No
4653,redmond,5,13.48709426,4,9.433503923,9.433473923,20,127.2305567,4,5,9,5,5,10,5,0.349663,0.359568,0,No
4728,rattlesnake,5,13.48709426,4,9.433503923,9.433473923,20,127.2305567,3,4,7,4,5,9,4,0.407853,0.425309,0,No
4746,raptor,5,13.48709426,4,9.433503923,9.433473923,20,127.2305567,2,4,6,2,4,6,5,0.373022,0.387994,0,No
4759,rangeland,5,13.48709426,4,9.433503923,9.433473923,20,127.2305567,3,4,7,4,5,9,5,0.35656,0.368208,0,No
4915,quarantine,5,13.48709426,4,9.433503923,9.433473923,20,127.2305567,4,3,7,4,4,8,5,0.385029,0.401317,0,No
5043,puddle,5,13.48709426,4,9.433503923,9.433473923,20,127.2305567,1,4,5,5,5,10,4,0.408379,0.425751,0,No
5475,poop,5,13.48709426,4,9.433503923,9.433473923,20,127.2305567,1,3,4,1,3,4,4,0.429027,0.445149,0,No
5727,pinwheel,5,13.48709426,4,9.433503923,9.433473923,20,127.2305567,4,3,7,4,5,9,5,0.328024,0.332145,0,No
5768,pierson,5,13.48709426,4,9.433503923,9.433473923,20,127.2305567,3,5,8,3,5,8,4,0.400781,0.418122,0,No
5810,phyllis,5,13.48709426,4,9.433503923,9.433473923,20,127.2305567,2,2,4,2,2,4,5,0.346179,0.355159,0,No
5874,pew,5,13.48709426,4,9.433503923,9.433473923,20,127.2305567,4,4,8,4,4,8,5,0.346293,0.355328,0,No
5899,pessimism,5,13.48709426,4,9.433503923,9.433473923,20,127.2305567,3,3,6,3,4,7,5,0.345855,0.354779,0,No
5938,permissive,5,13.48709426,4,9.433503923,9.433473923,20,127.2305567,4,1,5,5,1,6,5,0.322798,0.326179,0,No
6176,pastel,5,13.48709426,4,9.433503923,9.433473923,20,127.2305567,4,3,7,4,3,7,5,0.398335,0.416124,0,No
6338,palette,5,13.48709426,4,9.433503923,9.433473923,20,127.2305567,1,2,3,3,3,6,5,0.34566,0.354582,0,No
6528,optimum,5,13.48709426,4,9.433503923,9.433473923,20,127.2305567,4,4,8,4,5,9,5,0.351296,0.361443,0,No
6529,optimist,5,13.48709426,4,9.433503923,9.433473923,20,127.2305567,2,5,7,5,5,10,5,0.37256,0.387473,0,No
6615,oldsmobile,5,13.48709426,4,9.433503923,9.433473923,20,127.2305567,3,3,6,4,3,7,5,0.345707,0.354657,0,No
6999,neutrino,5,13.48709426,4,9.433503923,9.433473923,20,127.2305567,3,4,7,5,4,9,5,0.385071,0.401378,0,No
7264,mull,5,13.48709426,4,9.433503923,9.433473923,20,127.2305567,4,4,8,5,4,9,4,0.408313,0.425685,0,No
7284,muck,5,13.48709426,4,9.433503923,9.433473923,20,127.2305567,1,4,5,4,4,8,5,0.337863,0.345093,0,No
7380,moraine,5,13.48709426,4,9.433503923,9.433473923,20,127.2305567,5,5,10,5,5,10,4,0.402617,0.420183,0,No
7444,monash,5,13.48709426,4,9.433503923,9.433473923,20,127.2305567,4,2,6,5,3,8,5,0.319131,0.322778,0,No
7482,modulo,5,13.48709426,4,9.433503923,9.433473923,20,127.2305567,3,1,4,4,4,8,5,0.319994,0.3234,0,No
7514,mitten,5,13.48709426,4,9.433503923,9.433473923,20,127.2305567,2,2,4,3,3,6,4,0.38772,0.404771,0,No
7587,mindanao,5,13.48709426,4,9.433503923,9.433473923,20,127.2305567,4,4,8,4,5,9,5,0.370337,0.384945,0,No
7665,micron,5,13.48709426,4,9.433503923,9.433473923,20,127.2305567,3,4,7,4,4,8,5,0.349815,0.35969,0,No
7831,meistersinger,5,13.48709426,4,9.433503923,9.433473923,20,127.2305567,2,3,5,5,4,9,5,0.340071,0.347126,0,No
7923,mcclain,5,13.48709426,4,9.433503923,9.433473923,20,127.2305567,5,2,7,5,4,9,5,0.328357,0.332784,0,No
8179,mana,5,13.48709426,4,9.433503923,9.433473923,20,127.2305567,2,4,6,3,4,7,4,0.402873,0.420404,0,No
8292,madman,5,13.48709426,4,9.433503923,9.433473923,20,127.2305567,2,2,4,5,2,7,4,0.406127,0.423676,0,No
8464,lorry,5,13.48709426,4,9.433503923,9.433473923,20,127.2305567,4,4,8,5,5,10,5,0.410153,0.427785,0,No
8577,lithography,5,13.48709426,4,9.433503923,9.433473923,20,127.2305567,3,4,7,4,4,8,5,0.341234,0.34844,0,No
8602,lipscomb,5,13.48709426,4,9.433503923,9.433473923,20,127.2305567,3,4,7,3,4,7,4,0.405431,0.423004,0,No
8612,linseed,5,13.48709426,4,9.433503923,9.433473923,20,127.2305567,5,2,7,5,3,8,5,0.321611,0.325042,0,No
8621,lingerie,5,13.48709426,4,9.433503923,9.433473923,20,127.2305567,5,4,9,5,4,9,4,0.424117,0.440703,0,No
9136,kiosk,5,13.48709426,4,9.433503923,9.433473923,20,127.2305567,4,3,7,4,3,7,4,0.413372,0.430567,0,No
9178,keyword,5,13.48709426,4,9.433503923,9.433473923,20,127.2305567,3,4,7,3,5,8,5,0.39598,0.413129,0,No
9184,keyes,5,13.48709426,4,9.433503923,9.433473923,20,127.2305567,5,4,9,5,5,10,5,0.361955,0.374881,0,No
9445,jeopardy,5,13.48709426,4,9.433503923,9.433473923,20,127.2305567,4,3,7,5,3,8,5,0.385121,0.401406,0,No
9513,jackass,5,13.48709426,4,9.433503923,9.433473923,20,127.2305567,4,4,8,4,4,8,5,0.331856,0.336819,0,No
9566,irvin,5,13.48709426,4,9.433503923,9.433473923,20,127.2305567,4,3,7,5,3,8,5,0.378728,0.395118,0,No
9594,irishman,5,13.48709426,4,9.433503923,9.433473923,20,127.2305567,4,3,7,5,3,8,5,0.38908,0.406481,0,No
9787,innkeeper,5,13.48709426,4,9.433503923,9.433473923,20,127.2305567,3,5,8,4,5,9,4,0.433215,0.449092,0,No
9928,indestructible,5,13.48709426,4,9.433503923,9.433473923,20,127.2305567,4,5,9,4,5,9,5,0.387797,0.404411,0,No
10178,hydrostatic,5,13.48709426,4,9.433503923,9.433473923,20,127.2305567,5,4,9,5,5,10,5,0.32185,0.325342,0,No
10271,huber,5,13.48709426,4,9.433503923,9.433473923,20,127.2305567,2,3,5,2,3,5,5,0.326179,0.330032,0,No
10360,honeysuckle,5,13.48709426,4,9.433503923,9.433473923,20,127.2305567,3,5,8,4,5,9,5,0.34328,0.351406,0,No
10372,homozygous,5,13.48709426,4,9.433503923,9.433473923,20,127.2305567,5,4,9,5,4,9,4,0.407816,0.425277,0,No
10537,hewlett,5,13.48709426,4,9.433503923,9.433473923,20,127.2305567,2,3,5,2,5,7,5,0.384637,0.40089,0,No
10600,heraclitus,5,13.48709426,4,9.433503923,9.433473923,20,127.2305567,2,5,7,3,5,8,4,0.414211,0.431445,0,No
10709,headroom,5,13.48709426,4,9.433503923,9.433473923,20,127.2305567,1,5,6,5,5,10,5,0.378139,0.394562,0,No
10817,harcourt,5,13.48709426,4,9.433503923,9.433473923,20,127.2305567,3,5,8,3,5,8,5,0.350063,0.360157,0,No
10926,hadley,5,13.48709426,4,9.433503923,9.433473923,20,127.2305567,4,2,6,5,2,7,5,0.361601,0.374398,0,No
10963,gusty,5,13.48709426,4,9.433503923,9.433473923,20,127.2305567,1,0,1,4,0,4,0,0,0,0,No
11001,guinevere,5,13.48709426,4,9.433503923,9.433473923,20,127.2305567,3,5,8,5,5,10,4,0.41316,0.43061,0,No
11038,grudge,5,13.48709426,4,9.433503923,9.433473923,20,127.2305567,4,4,8,5,5,10,4,0.424067,0.440661,0,No
11221,gorgon,5,13.48709426,4,9.433503923,9.433473923,20,127.2305567,3,3,6,5,4,9,5,0.323145,0.32642,0,No
11247,gondola,5,13.48709426,4,9.433503923,9.433473923,20,127.2305567,3,5,8,4,5,9,4,0.420431,0.437581,0,No
11369,ginseng,5,13.48709426,4,9.433503923,9.433473923,20,127.2305567,3,2,5,3,2,5,5,0.346084,0.355056,0,No
11465,genitive,5,13.48709426,4,9.433503923,9.433473923,20,127.2305567,2,3,5,5,5,10,5,0.378817,0.394659,0,No
11612,gainesville,5,13.48709426,4,9.433503923,9.433473923,20,127.2305567,3,2,5,5,5,10,5,0.346625,0.355826,0,No
11736,fridge,5,13.48709426,4,9.433503923,9.433473923,20,127.2305567,2,4,6,5,5,10,4,0.408492,0.426136,0,No
11742,freya,5,13.48709426,4,9.433503923,9.433473923,20,127.2305567,5,3,8,5,3,8,5,0.356833,0.368979,0,No
11757,frenchmen,5,13.48709426,4,9.433503923,9.433473923,20,127.2305567,5,4,9,5,5,10,5,0.396069,0.413218,0,No
12020,flick,5,13.48709426,4,9.433503923,9.433473923,20,127.2305567,5,5,10,5,5,10,4,0.418113,0.435328,0,No
12039,flaw,5,13.48709426,4,9.433503923,9.433473923,20,127.2305567,5,3,8,5,5,10,5,0.367325,0.381192,0,No
12044,flatten,5,13.48709426,4,9.433503923,9.433473923,20,127.2305567,3,3,6,5,4,9,5,0.339388,0.346975,0,No
12156,filamentous,5,13.48709426,4,9.433503923,9.433473923,20,127.2305567,5,3,8,5,3,8,5,0.384279,0.400486,0,No
12281,fayetteville,5,13.48709426,4,9.433503923,9.433473923,20,127.2305567,3,4,7,4,4,8,5,0.351282,0.36142,0,No
12464,expiration,5,13.48709426,4,9.433503923,9.433473923,20,127.2305567,5,3,8,5,5,10,5,0.32585,0.329508,0,No
12666,esposito,5,13.48709426,4,9.433503923,9.433473923,20,127.2305567,4,4,8,5,4,9,4,0.385372,0.401691,0,No
12756,epileptic,5,13.48709426,4,9.433503923,9.433473923,20,127.2305567,3,3,6,4,4,8,5,0.33425,0.339687,0,No
12825,endpoint,5,13.48709426,4,9.433503923,9.433473923,20,127.2305567,4,2,6,4,3,7,5,0.380034,0.395993,0,No
12921,elliptic,5,13.48709426,4,9.433503923,9.433473923,20,127.2305567,4,3,7,5,3,8,5,0.319607,0.322971,0,No
12924,ellipsis,5,13.48709426,4,9.433503923,9.433473923,20,127.2305567,3,3,6,5,4,9,5,0.368515,0.382823,0,No
13078,eccles,5,13.48709426,4,9.433503923,9.433473923,20,127.2305567,4,2,6,5,2,7,5,0.395557,0.412641,0,No
13181,dummy,5,13.48709426,4,9.433503923,9.433473923,20,127.2305567,4,3,7,4,4,8,5,0.342023,0.349795,0,No
13203,duckling,5,13.48709426,4,9.433503923,9.433473923,20,127.2305567,3,5,8,5,5,10,4,0.394993,0.412118,0,No
13462,dissident,5,13.48709426,4,9.433503923,9.433473923,20,127.2305567,2,3,5,4,4,8,4,0.389892,0.406639,0,No
13650,devoid,5,13.48709426,4,9.433503923,9.433473923,20,127.2305567,3,2,5,3,5,8,5,0.37923,0.395082,0,No
13688,despair,5,13.48709426,4,9.433503923,9.433473923,20,127.2305567,4,4,8,5,4,9,4,0.422482,0.439191,0,No
13740,deodorant,5,13.48709426,4,9.433503923,9.433473923,20,127.2305567,3,5,8,3,5,8,5,0.362332,0.375311,0,No
13795,deliverance,5,13.48709426,4,9.433503923,9.433473923,20,127.2305567,3,5,8,3,5,8,5,0.348455,0.358178,0,No
13826,degradation,5,13.48709426,4,9.433503923,9.433473923,20,127.2305567,3,3,6,3,5,8,5,0.385715,0.402288,0,No
13827,degenerate,5,13.48709426,4,9.433503923,9.433473923,20,127.2305567,4,3,7,4,3,7,5,0.326359,0.330062,0,No
13828,degas,5,13.48709426,4,9.433503923,9.433473923,20,127.2305567,2,3,5,2,5,7,5,0.384862,0.40113,0,No
13894,decca,5,13.48709426,4,9.433503923,9.433473923,20,127.2305567,4,2,6,4,2,6,5,0.365345,0.378812,0,No
13941,daze,5,13.48709426,4,9.433503923,9.433473923,20,127.2305567,2,4,6,3,5,8,4,0.423955,0.440703,0,No
14040,dagger,5,13.48709426,4,9.433503923,9.433473923,20,127.2305567,2,5,7,2,5,7,4,0.418705,0.435764,0,No
14043,daemon,5,13.48709426,4,9.433503923,9.433473923,20,127.2305567,3,4,7,3,5,8,5,0.364902,0.378292,0,No
14143,cumin,5,13.48709426,4,9.433503923,9.433473923,20,127.2305567,2,3,5,2,3,5,4,0.389789,0.406526,0,No
14275,credo,5,13.48709426,4,9.433503923,9.433473923,20,127.2305567,4,3,7,4,4,8,5,0.358367,0.370385,0,No
14331,cowherd,5,13.48709426,4,9.433503923,9.433473923,20,127.2305567,3,4,7,4,4,8,5,0.379904,0.396627,0,No
14487,copernican,5,13.48709426,4,9.433503923,9.433473923,20,127.2305567,2,3,5,5,4,9,5,0.327262,0.331102,0,No
14507,convoy,5,13.48709426,4,9.433503923,9.433473923,20,127.2305567,4,3,7,4,5,9,5,0.381964,0.398099,0,No
14963,cobol,5,13.48709426,4,9.433503923,9.433473923,20,127.2305567,4,4,8,5,5,10,5,0.329981,0.334466,0,No
15100,clamp,5,13.48709426,4,9.433503923,9.433473923,20,127.2305567,3,3,6,4,3,7,5,0.347296,0.356648,0,No
15115,citron,5,13.48709426,4,9.433503923,9.433473923,20,127.2305567,4,5,9,5,5,10,5,0.358708,0.371212,0,No
15211,chordata,5,13.48709426,4,9.433503923,9.433473923,20,127.2305567,3,1,4,3,1,4,5,0.345599,0.354479,0,No
15230,chloroplast,5,13.48709426,4,9.433503923,9.433473923,20,127.2305567,3,3,6,4,3,7,4,0.387746,0.404818,0,No
15252,chinchilla,5,13.48709426,4,9.433503923,9.433473923,20,127.2305567,1,3,4,3,3,6,5,0.370113,0.384677,0,No
15625,carlyle,5,13.48709426,4,9.433503923,9.433473923,20,127.2305567,3,5,8,4,5,9,4,0.400023,0.417338,0,No
15722,cannonball,5,13.48709426,4,9.433503923,9.433473923,20,127.2305567,3,4,7,5,4,9,4,0.402544,0.420112,0,No
15878,buzzing,5,13.48709426,4,9.433503923,9.433473923,20,127.2305567,4,3,7,5,4,9,5,0.346557,0.355297,0,No
15931,burley,5,13.48709426,4,9.433503923,9.433473923,20,127.2305567,4,5,9,4,5,9,5,0.355269,0.366589,0,No
15953,buoy,5,13.48709426,4,9.433503923,9.433473923,20,127.2305567,2,2,4,4,3,7,5,0.369689,0.384037,0,No
16032,bryce,5,13.48709426,4,9.433503923,9.433473923,20,127.2305567,2,3,5,2,3,5,5,0.340077,0.347027,0,No
16227,bracket,5,13.48709426,4,9.433503923,9.433473923,20,127.2305567,4,4,8,5,4,9,5,0.336327,0.342516,0,No
16281,boswell,5,13.48709426,4,9.433503923,9.433473923,20,127.2305567,2,5,7,5,5,10,5,0.398022,0.415687,0,No
16314,bootstrap,5,13.48709426,4,9.433503923,9.433473923,20,127.2305567,5,3,8,5,3,8,5,0.353359,0.364077,0,No
16346,bong,5,13.48709426,4,9.433503923,9.433473923,20,127.2305567,1,4,5,3,4,7,5,0.39561,0.412767,0,No
16347,bonfire,5,13.48709426,4,9.433503923,9.433473923,20,127.2305567,4,3,7,5,5,10,5,0.39106,0.408138,0,No
16387,bodybuilding,5,13.48709426,4,9.433503923,9.433473923,20,127.2305567,4,2,6,4,2,6,5,0.329259,0.333837,0,No
16388,bodybuilder,5,13.48709426,4,9.433503923,9.433473923,20,127.2305567,3,2,5,3,4,7,5,0.384404,0.400604,0,No
16394,bock,5,13.48709426,4,9.433503923,9.433473923,20,127.2305567,4,3,7,4,4,8,5,0.357307,0.36885,0,No
16682,beret,5,13.48709426,4,9.433503923,9.433473923,20,127.2305567,4,3,7,5,3,8,4,0.389918,0.406667,0,No
16787,beehive,5,13.48709426,4,9.433503923,9.433473923,20,127.2305567,3,4,7,5,4,9,5,0.386345,0.402986,0,No
16835,bead,5,13.48709426,4,9.433503923,9.433473923,20,127.2305567,4,3,7,4,3,7,5,0.353873,0.364748,0,No
17288,astoria,5,13.48709426,4,9.433503923,9.433473923,20,127.2305567,3,2,5,4,3,7,5,0.345855,0.354784,0,No
17473,arboretum,5,13.48709426,4,9.433503923,9.433473923,20,127.2305567,4,2,6,4,5,9,5,0.376615,0.393249,0,No
17584,antonym,5,13.48709426,4,9.433503923,9.433473923,20,127.2305567,3,3,6,4,5,9,4,0.413227,0.43061,0,No
17655,annoy,5,13.48709426,4,9.433503923,9.433473923,20,127.2305567,1,5,6,4,5,9,4,0.401134,0.418817,0,No
17822,amarillo,5,13.48709426,4,9.433503923,9.433473923,20,127.2305567,4,3,7,4,4,8,5,0.346388,0.355441,0,No
17854,alphanumeric,5,13.48709426,4,9.433503923,9.433473923,20,127.2305567,3,2,5,4,4,8,5,0.322166,0.325425,0,No
18003,aitken,5,13.48709426,4,9.433503923,9.433473923,20,127.2305567,3,3,6,5,5,10,5,0.350499,0.360361,0,No
18046,agony,5,13.48709426,4,9.433503923,9.433473923,20,127.2305567,4,3,7,5,4,9,5,0.384662,0.400904,0,No
18108,aeolian,5,13.48709426,4,9.433503923,9.433473923,20,127.2305567,4,2,6,5,2,7,5,0.355233,0.366956,0,No
18356,abbe,5,13.48709426,4,9.433503923,9.433473923,20,127.2305567,3,3,6,4,3,7,5,0.324818,0.328412,0,No
3016,solder,12,12.61162553,2,10.1266511,10.1266411,24,127.7135316,4,8,12,10,11,21,4,0.428675,0.444933,0,No
7361,morpheme,12,12.61162553,2,10.1266511,10.1266411,24,127.7135316,5,9,14,12,11,23,4,0.411636,0.429173,0,No
17228,attlee,12,12.61162553,2,10.1266511,10.1266411,24,127.7135316,7,8,15,10,9,19,4,0.402837,0.42045,0,No
137,xenophobia,7,13.15062203,3,9.721185996,9.721165996,21,127.8396427,3,5,8,3,5,8,5,0.352994,0.363952,0,No
161,wristband,7,13.15062203,3,9.721185996,9.721165996,21,127.8396427,4,5,9,5,6,11,5,0.371375,0.386137,0,No
249,wolcott,7,13.15062203,3,9.721185996,9.721165996,21,127.8396427,2,4,6,2,4,6,5,0.340136,0.347107,0,No
1021,urinal,7,13.15062203,3,9.721185996,9.721165996,21,127.8396427,6,5,11,6,5,11,5,0.345875,0.354896,0,No
1164,tuttle,7,13.15062203,3,9.721185996,9.721165996,21,127.8396427,4,4,8,6,6,12,4,0.420391,0.437534,0,No
1391,transonic,7,13.15062203,3,9.721185996,9.721165996,21,127.8396427,4,2,6,4,2,6,5,0.320271,0.323694,0,No
1915,telephoto,7,13.15062203,3,9.721185996,9.721165996,21,127.8396427,5,1,6,6,3,9,5,0.318724,0.322146,0,No
1916,telephony,7,13.15062203,3,9.721185996,9.721165996,21,127.8396427,6,4,10,6,5,11,5,0.384712,0.400975,0,No
3128,slug,7,13.15062203,3,9.721185996,9.721165996,21,127.8396427,5,5,10,6,7,13,4,0.389738,0.40693,0,No
3306,silo,7,13.15062203,3,9.721185996,9.721165996,21,127.8396427,4,5,9,7,5,12,5,0.35097,0.360967,0,No
3356,sidecar,7,13.15062203,3,9.721185996,9.721165996,21,127.8396427,5,3,8,7,3,10,5,0.350984,0.36127,0,No
3519,shampoo,7,13.15062203,3,9.721185996,9.721165996,21,127.8396427,7,5,12,7,6,13,4,0.394221,0.411305,0,No
3736,seam,7,13.15062203,3,9.721185996,9.721165996,21,127.8396427,4,5,9,6,5,11,4,0.423379,0.440032,0,No
4755,rankine,7,13.15062203,3,9.721185996,9.721165996,21,127.8396427,3,5,8,5,7,12,4,0.412651,0.430117,0,No
4889,query,7,13.15062203,3,9.721185996,9.721165996,21,127.8396427,4,3,7,5,7,12,5,0.370183,0.384623,0,No
5038,pug,7,13.15062203,3,9.721185996,9.721165996,21,127.8396427,3,5,8,7,5,12,5,0.354864,0.366019,0,No
5523,polonium,7,13.15062203,3,9.721185996,9.721165996,21,127.8396427,5,5,10,5,7,12,4,0.42055,0.437698,0,No
5680,plagiarism,7,13.15062203,3,9.721185996,9.721165996,21,127.8396427,5,5,10,6,5,11,5,0.370438,0.385085,0,No
6277,papyri,7,13.15062203,3,9.721185996,9.721165996,21,127.8396427,2,7,9,4,7,11,5,0.383258,0.399695,0,No
6309,pane,7,13.15062203,3,9.721185996,9.721165996,21,127.8396427,6,2,8,6,2,8,5,0.379611,0.395528,0,No
6333,palladium,7,13.15062203,3,9.721185996,9.721165996,21,127.8396427,5,5,10,5,7,12,4,0.391621,0.408536,0,No
6902,nitrous,7,13.15062203,3,9.721185996,9.721165996,21,127.8396427,3,2,5,3,7,10,5,0.355254,0.366989,0,No
7159,naiad,7,13.15062203,3,9.721185996,9.721165996,21,127.8396427,4,7,11,5,7,12,5,0.37084,0.385483,0,No
7552,minutemen,7,13.15062203,3,9.721185996,9.721165996,21,127.8396427,3,5,8,6,6,12,4,0.40108,0.418657,0,No
8279,magellanic,7,13.15062203,3,9.721185996,9.721165996,21,127.8396427,3,1,4,7,6,13,5,0.317999,0.321587,0,No
8699,librettist,7,13.15062203,3,9.721185996,9.721165996,21,127.8396427,5,7,12,7,7,14,4,0.405107,0.422694,0,No
8766,lentil,7,13.15062203,3,9.721185996,9.721165996,21,127.8396427,4,3,7,4,7,11,5,0.355226,0.36697,0,No
8936,laplace,7,13.15062203,3,9.721185996,9.721165996,21,127.8396427,4,3,7,7,6,13,5,0.331993,0.336617,0,No
9159,kilimanjaro,7,13.15062203,3,9.721185996,9.721165996,21,127.8396427,6,3,9,6,5,11,4,0.399159,0.41646,0,No
10457,histogram,7,13.15062203,3,9.721185996,9.721165996,21,127.8396427,3,3,6,7,7,14,4,0.413227,0.43061,0,No
10699,healy,7,13.15062203,3,9.721185996,9.721165996,21,127.8396427,5,5,10,5,5,10,5,0.331974,0.336589,0,No
11604,galatea,7,13.15062203,3,9.721185996,9.721165996,21,127.8396427,5,6,11,5,6,11,5,0.364954,0.378562,0,No
11772,fredericton,7,13.15062203,3,9.721185996,9.721165996,21,127.8396427,6,5,11,7,7,14,5,0.357631,0.369249,0,No
12054,flannel,7,13.15062203,3,9.721185996,9.721165996,21,127.8396427,4,4,8,5,4,9,4,0.409916,0.427337,0,No
12900,elysian,7,13.15062203,3,9.721185996,9.721165996,21,127.8396427,5,2,7,5,5,10,5,0.325796,0.329289,0,No
13609,diaper,7,13.15062203,3,9.721185996,9.721165996,21,127.8396427,4,4,8,6,4,10,4,0.415121,0.432469,0,No
13672,deter,7,13.15062203,3,9.721185996,9.721165996,21,127.8396427,2,3,5,3,3,6,5,0.339726,0.346659,0,No
14050,dachshund,7,13.15062203,3,9.721185996,9.721165996,21,127.8396427,4,3,7,6,4,10,4,0.390183,0.406954,0,No
14125,curio,7,13.15062203,3,9.721185996,9.721165996,21,127.8396427,3,5,8,3,6,9,4,0.390158,0.407414,0,No
14162,cubit,7,13.15062203,3,9.721185996,9.721165996,21,127.8396427,4,5,9,6,6,12,5,0.390974,0.408021,0,No
14276,creditor,7,13.15062203,3,9.721185996,9.721165996,21,127.8396427,2,5,7,6,6,12,4,0.417415,0.434614,0,No
14985,clytemnestra,7,13.15062203,3,9.721185996,9.721165996,21,127.8396427,4,5,9,6,5,11,5,0.350008,0.359702,0,No
15144,cinnabar,7,13.15062203,3,9.721185996,9.721165996,21,127.8396427,5,4,9,5,6,11,4,0.390458,0.407268,0,No
15443,cerebellum,7,13.15062203,3,9.721185996,9.721165996,21,127.8396427,3,6,9,7,6,13,4,0.400609,0.417981,0,No
15494,cayley,7,13.15062203,3,9.721185996,9.721165996,21,127.8396427,1,5,6,7,5,12,4,0.42599,0.442435,0,No
15593,cartel,7,13.15062203,3,9.721185996,9.721165996,21,127.8396427,4,5,9,6,6,12,4,0.405774,0.423371,0,No
15630,carlin,7,13.15062203,3,9.721185996,9.721165996,21,127.8396427,2,6,8,3,6,9,5,0.389721,0.406505,0,No
15882,buxtehude,7,13.15062203,3,9.721185996,9.721165996,21,127.8396427,5,6,11,6,7,13,4,0.40852,0.425953,0,No
16001,budweiser,7,13.15062203,3,9.721185996,9.721165996,21,127.8396427,6,5,11,6,5,11,5,0.349154,0.358707,0,No
16345,bongo,7,13.15062203,3,9.721185996,9.721165996,21,127.8396427,4,4,8,4,4,8,4,0.398451,0.415822,0,No
16527,bitch,7,13.15062203,3,9.721185996,9.721165996,21,127.8396427,6,5,11,7,6,13,4,0.40851,0.42607,0,No
16921,barrack,7,13.15062203,3,9.721185996,9.721165996,21,127.8396427,3,4,7,4,4,8,5,0.349539,0.359661,0,No
16987,bandage,7,13.15062203,3,9.721185996,9.721165996,21,127.8396427,3,5,8,7,7,14,5,0.375953,0.391346,0,No
17188,aurochs,7,13.15062203,3,9.721185996,9.721165996,21,127.8396427,4,4,8,5,6,11,5,0.365759,0.379543,0,No
5825,phosgene,11,12.6986369,2,10.1266511,10.1266411,22,128.5946654,9,2,11,9,4,13,5,0.352566,0.363265,0,No
7778,menorca,11,12.6986369,2,10.1266511,10.1266411,22,128.5946654,5,6,11,6,9,15,5,0.35331,0.364113,0,No
13752,denotation,11,12.6986369,2,10.1266511,10.1266411,22,128.5946654,7,9,16,9,10,19,4,0.419358,0.436445,0,No
15437,cerise,11,12.6986369,2,10.1266511,10.1266411,22,128.5946654,4,8,12,8,10,18,4,0.42056,0.437562,0,No
17544,apostasy,11,12.6986369,2,10.1266511,10.1266411,22,128.5946654,7,9,16,9,9,18,4,0.40177,0.419202,0,No
105,yearbook,4,13.71023782,4,9.433503923,9.433473923,16,129.3355822,2,3,5,3,3,6,5,0.348066,0.357535,0,No
124,yam,4,13.71023782,4,9.433503923,9.433473923,16,129.3355822,2,4,6,2,4,6,5,0.37285,0.38774,0,No
228,woodcut,4,13.71023782,4,9.433503923,9.433473923,16,129.3355822,3,2,5,3,2,5,5,0.395557,0.412641,0,No
294,winifred,4,13.71023782,4,9.433503923,9.433473923,16,129.3355822,3,2,5,3,3,6,5,0.384304,0.400496,0,No
338,wildflower,4,13.71023782,4,9.433503923,9.433473923,16,129.3355822,2,3,5,2,3,5,5,0.353176,0.363722,0,No
348,wiggle,4,13.71023782,4,9.433503923,9.433473923,16,129.3355822,3,3,6,3,3,6,5,0.335051,0.340751,0,No
350,wig,4,13.71023782,4,9.433503923,9.433473923,16,129.3355822,4,4,8,4,4,8,5,0.36155,0.374304,0,No
356,widget,4,13.71023782,4,9.433503923,9.433473923,16,129.3355822,3,3,6,3,4,7,5,0.355219,0.366961,0,No
360,wicket,4,13.71023782,4,9.433503923,9.433473923,16,129.3355822,4,2,6,4,2,6,5,0.319907,0.323351,0,No
410,wherein,4,13.71023782,4,9.433503923,9.433473923,16,129.3355822,3,3,6,3,3,6,5,0.401125,0.418927,0,No
416,whence,4,13.71023782,4,9.433503923,9.433473923,16,129.3355822,2,3,5,2,4,6,5,0.401125,0.418945,0,No
426,whatsoever,4,13.71023782,4,9.433503923,9.433473923,16,129.3355822,3,3,6,3,3,6,5,0.359645,0.37211,0,No
430,wharton,4,13.71023782,4,9.433503923,9.433473923,16,129.3355822,4,3,7,4,4,8,5,0.350651,0.360783,0,No
434,whack,4,13.71023782,4,9.433503923,9.433473923,16,129.3355822,3,4,7,4,4,8,5,0.332977,0.338295,0,No
467,weld,4,13.71023782,4,9.433503923,9.433473923,16,129.3355822,3,2,5,4,2,6,4,0.400971,0.418634,0,No
708,vivian,4,13.71023782,4,9.433503923,9.433473923,16,129.3355822,3,2,5,3,2,5,5,0.32403,0.327244,0,No
784,viet,4,13.71023782,4,9.433503923,9.433473923,16,129.3355822,2,0,2,3,0,3,0,0,0,0,No
896,velvety,4,13.71023782,4,9.433503923,9.433473923,16,129.3355822,4,4,8,4,4,8,5,0.396183,0.413326,0,No
915,vaughn,4,13.71023782,4,9.433503923,9.433473923,16,129.3355822,1,3,4,1,3,4,4,0.41268,0.429887,0,No
943,vanderbilt,4,13.71023782,4,9.433503923,9.433473923,16,129.3355822,2,0,2,3,0,3,0,0,0,0,No
956,valletta,4,13.71023782,4,9.433503923,9.433473923,16,129.3355822,3,3,6,3,3,6,5,0.348845,0.358549,0,No
958,validate,4,13.71023782,4,9.433503923,9.433473923,16,129.3355822,2,4,6,4,4,8,4,0.415812,0.4333,0,No
992,uterine,4,13.71023782,4,9.433503923,9.433473923,16,129.3355822,3,1,4,4,1,5,5,0.319872,0.323278,0,No
1005,usda,4,13.71023782,4,9.433503923,9.433473923,16,129.3355822,4,2,6,4,2,6,4,0.389755,0.406475,0,No
1056,uphill,4,13.71023782,4,9.433503923,9.433473923,16,129.3355822,3,3,6,3,3,6,5,0.398917,0.416706,0,No
1058,upheaval,4,13.71023782,4,9.433503923,9.433473923,16,129.3355822,2,3,5,3,3,6,5,0.36381,0.377069,0,No
1074,unison,4,13.71023782,4,9.433503923,9.433473923,16,129.3355822,3,4,7,4,4,8,5,0.352966,0.363534,0,No
1079,unilateral,4,13.71023782,4,9.433503923,9.433473923,16,129.3355822,3,1,4,3,1,4,5,0.312843,0.317116,0,No
1167,tutelage,4,13.71023782,4,9.433503923,9.433473923,16,129.3355822,1,1,2,4,4,8,5,0.378607,0.394397,0,No
1208,tung,4,13.71023782,4,9.433503923,9.433473923,16,129.3355822,3,2,5,3,2,5,5,0.404821,0.422175,0,No
1428,transatlantic,4,13.71023782,4,9.433503923,9.433473923,16,129.3355822,2,3,5,3,3,6,5,0.320421,0.323905,0,No
1432,tranquillity,4,13.71023782,4,9.433503923,9.433473923,16,129.3355822,1,3,4,4,3,7,5,0.386446,0.402852,0,No
1602,tithe,4,13.71023782,4,9.433503923,9.433473923,16,129.3355822,2,4,6,2,4,6,5,0.369535,0.384015,0,No
1628,timetable,4,13.71023782,4,9.433503923,9.433473923,16,129.3355822,3,3,6,3,3,6,5,0.340331,0.347314,0,No
1698,thrill,4,13.71023782,4,9.433503923,9.433473923,16,129.3355822,3,4,7,4,4,8,5,0.379969,0.395955,0,No
1724,thorough,4,13.71023782,4,9.433503923,9.433473923,16,129.3355822,1,2,3,3,2,5,5,0.316259,0.320538,0,No
1773,therein,4,13.71023782,4,9.433503923,9.433473923,16,129.3355822,2,4,6,2,4,6,5,0.385799,0.402172,0,No
1872,tentative,4,13.71023782,4,9.433503923,9.433473923,16,129.3355822,1,1,2,4,4,8,5,0.320219,0.323691,0,No
1951,teardrop,4,13.71023782,4,9.433503923,9.433473923,16,129.3355822,3,3,6,4,3,7,5,0.398487,0.41626,0,No
2196,sweater,4,13.71023782,4,9.433503923,9.433473923,16,129.3355822,2,2,4,2,2,4,5,0.354092,0.365058,0,No
2279,supplementary,4,13.71023782,4,9.433503923,9.433473923,16,129.3355822,4,4,8,4,4,8,5,0.39863,0.416424,0,No
2294,suny,4,13.71023782,4,9.433503923,9.433473923,16,129.3355822,3,3,6,3,3,6,5,0.400673,0.41841,0,No
2309,sunfish,4,13.71023782,4,9.433503923,9.433473923,16,129.3355822,2,3,5,4,4,8,5,0.3988,0.416518,0,No
2311,sundown,4,13.71023782,4,9.433503923,9.433473923,16,129.3355822,3,4,7,3,4,7,5,0.353528,0.364349,0,No
2346,suggestive,4,13.71023782,4,9.433503923,9.433473923,16,129.3355822,2,2,4,3,3,6,5,0.388391,0.405141,0,No
2367,suction,4,13.71023782,4,9.433503923,9.433473923,16,129.3355822,2,3,5,3,4,7,5,0.339336,0.34627,0,No
2395,submitting,4,13.71023782,4,9.433503923,9.433473923,16,129.3355822,1,3,4,1,4,5,5,0.414501,0.432208,0,No
2506,storyboard,4,13.71023782,4,9.433503923,9.433473923,16,129.3355822,3,0,3,3,0,3,0,0,0,0,No
2514,stopwatch,4,13.71023782,4,9.433503923,9.433473923,16,129.3355822,2,3,5,4,3,7,5,0.370499,0.385081,0,No
2577,sternberg,4,13.71023782,4,9.433503923,9.433473923,16,129.3355822,1,1,2,2,2,4,5,0.384237,0.400402,0,No
2620,stead,4,13.71023782,4,9.433503923,9.433473923,16,129.3355822,3,3,6,3,3,6,5,0.388416,0.405188,0,No
2680,stamina,4,13.71023782,4,9.433503923,9.433473923,16,129.3355822,2,3,5,3,4,7,5,0.385196,0.401486,0,No
2753,springtime,4,13.71023782,4,9.433503923,9.433473923,16,129.3355822,4,3,7,4,3,7,5,0.383814,0.400227,0,No
2803,spitfire,4,13.71023782,4,9.433503923,9.433473923,16,129.3355822,0,3,3,0,3,3,5,0.413954,0.43169,0,No
2852,speculate,4,13.71023782,4,9.433503923,9.433473923,16,129.3355822,3,3,6,4,4,8,5,0.365849,0.379684,0,No
2857,spectroscope,4,13.71023782,4,9.433503923,9.433473923,16,129.3355822,4,2,6,4,3,7,5,0.365345,0.378812,0,No
2889,sparky,4,13.71023782,4,9.433503923,9.433473923,16,129.3355822,3,3,6,3,3,6,5,0.346131,0.354961,0,No
2896,spaniard,4,13.71023782,4,9.433503923,9.433473923,16,129.3355822,2,2,4,3,2,5,5,0.316242,0.320333,0,No
3013,solemn,4,13.71023782,4,9.433503923,9.433473923,16,129.3355822,2,2,4,4,3,7,5,0.32096,0.324162,0,No
3027,soften,4,13.71023782,4,9.433503923,9.433473923,16,129.3355822,1,3,4,4,3,7,5,0.399042,0.416833,0,No
3081,snatch,4,13.71023782,4,9.433503923,9.433473923,16,129.3355822,2,2,4,4,2,6,5,0.346889,0.356009,0,No
3117,smack,4,13.71023782,4,9.433503923,9.433473923,16,129.3355822,3,4,7,4,4,8,4,0.402426,0.419981,0,No
3142,slocum,4,13.71023782,4,9.433503923,9.433473923,16,129.3355822,3,3,6,3,3,6,5,0.341595,0.349093,0,No
3195,slab,4,13.71023782,4,9.433503923,9.433473923,16,129.3355822,3,3,6,3,3,6,4,0.406946,0.424309,0,No
3292,simla,4,13.71023782,4,9.433503923,9.433473923,16,129.3355822,2,3,5,4,3,7,5,0.346347,0.355328,0,No
3308,sill,4,13.71023782,4,9.433503923,9.433473923,16,129.3355822,1,2,3,1,2,3,4,0.422432,0.439107,0,No
3352,sideshow,4,13.71023782,4,9.433503923,9.433473923,16,129.3355822,1,2,3,1,2,3,5,0.350035,0.359802,0,No
3530,shakespearean,4,13.71023782,4,9.433503923,9.433473923,16,129.3355822,4,4,8,4,4,8,5,0.384587,0.400843,0,No
3586,serpentine,4,13.71023782,4,9.433503923,9.433473923,16,129.3355822,3,2,5,3,2,5,5,0.356074,0.36789,0,No
3623,sentient,4,13.71023782,4,9.433503923,9.433473923,16,129.3355822,3,1,4,4,1,5,5,0.32146,0.324954,0,No
3634,senora,4,13.71023782,4,9.433503923,9.433473923,16,129.3355822,1,3,4,1,4,5,5,0.325187,0.328992,0,No
3655,selwyn,4,13.71023782,4,9.433503923,9.433473923,16,129.3355822,2,2,4,4,4,8,5,0.325509,0.329279,0,No
3689,sedition,4,13.71023782,4,9.433503923,9.433473923,16,129.3355822,3,2,5,4,2,6,5,0.327093,0.330395,0,No
3714,secede,4,13.71023782,4,9.433503923,9.433473923,16,129.3355822,2,2,4,4,4,8,5,0.341839,0.349777,0,No
3766,scriptwriter,4,13.71023782,4,9.433503923,9.433473923,16,129.3355822,3,4,7,3,4,7,5,0.385188,0.401514,0,No
3801,scorpio,4,13.71023782,4,9.433503923,9.433473923,16,129.3355822,2,4,6,2,4,6,4,0.401407,0.419047,0,No
3841,schoolgirl,4,13.71023782,4,9.433503923,9.433473923,16,129.3355822,4,1,5,4,1,5,5,0.32199,0.325331,0,No
3865,schelling,4,13.71023782,4,9.433503923,9.433473923,16,129.3355822,4,3,7,4,3,7,5,0.352804,0.363243,0,No
3875,scavenge,4,13.71023782,4,9.433503923,9.433473923,16,129.3355822,2,1,3,4,3,7,5,0.343985,0.352404,0,No
3880,scarp,4,13.71023782,4,9.433503923,9.433473923,16,129.3355822,3,3,6,3,3,6,5,0.353113,0.363824,0,No
3940,satyr,4,13.71023782,4,9.433503923,9.433473923,16,129.3355822,4,1,5,4,1,5,5,0.324433,0.327703,0,No
3954,sassafras,4,13.71023782,4,9.433503923,9.433473923,16,129.3355822,4,4,8,4,4,8,5,0.388807,0.405472,0,No
4004,sanderson,4,13.71023782,4,9.433503923,9.433473923,16,129.3355822,3,4,7,4,4,8,5,0.414617,0.432316,0,No
4094,sadler,4,13.71023782,4,9.433503923,9.433473923,16,129.3355822,3,2,5,4,2,6,5,0.333189,0.338011,0,No
4143,rupture,4,13.71023782,4,9.433503923,9.433473923,16,129.3355822,4,4,8,4,4,8,5,0.399024,0.416809,0,No
4238,rosalie,4,13.71023782,4,9.433503923,9.433473923,16,129.3355822,2,4,6,2,4,6,5,0.34603,0.355051,0,No
4286,rococo,4,13.71023782,4,9.433503923,9.433473923,16,129.3355822,3,4,7,4,4,8,5,0.326509,0.330173,0,No
4330,ritz,4,13.71023782,4,9.433503923,9.433473923,16,129.3355822,2,3,5,2,4,6,5,0.337042,0.343173,0,No
4397,ribonucleic,4,13.71023782,4,9.433503923,9.433473923,16,129.3355822,4,1,5,4,4,8,5,0.318238,0.321893,0,No
4428,rhenish,4,13.71023782,4,9.433503923,9.433473923,16,129.3355822,4,2,6,4,2,6,5,0.321209,0.324542,0,No
4459,retrieval,4,13.71023782,4,9.433503923,9.433473923,16,129.3355822,3,3,6,4,3,7,4,0.422452,0.439144,0,No
4546,renown,4,13.71023782,4,9.433503923,9.433473923,16,129.3355822,3,4,7,3,4,7,4,0.359995,0.372373,0,No
4554,rendezvous,4,13.71023782,4,9.433503923,9.433473923,16,129.3355822,3,4,7,3,4,7,5,0.399006,0.416739,0,No
4590,reinhold,4,13.71023782,4,9.433503923,9.433473923,16,129.3355822,3,0,3,4,0,4,0,0,0,0,No
4598,regurgitate,4,13.71023782,4,9.433503923,9.433473923,16,129.3355822,3,3,6,3,4,7,5,0.376248,0.392752,0,No
4604,regret,4,13.71023782,4,9.433503923,9.433473923,16,129.3355822,3,3,6,3,3,6,4,0.413632,0.430999,0,No
4619,regalia,4,13.71023782,4,9.433503923,9.433473923,16,129.3355822,3,2,5,4,3,7,5,0.384121,0.400592,0,No
4662,rectory,4,13.71023782,4,9.433503923,9.433473923,16,129.3355822,2,4,6,2,4,6,5,0.390957,0.407932,0,No
4685,recess,4,13.71023782,4,9.433503923,9.433473923,16,129.3355822,4,4,8,4,4,8,5,0.398612,0.416363,0,No
4687,receptive,4,13.71023782,4,9.433503923,9.433473923,16,129.3355822,2,3,5,2,4,6,5,0.336123,0.342388,0,No
4814,radiotherapy,4,13.71023782,4,9.433503923,9.433473923,16,129.3355822,1,3,4,2,4,6,5,0.39553,0.412655,0,No
4817,radiology,4,13.71023782,4,9.433503923,9.433473923,16,129.3355822,3,3,6,3,3,6,5,0.398299,0.416072,0,No
4818,radiocarbon,4,13.71023782,4,9.433503923,9.433473923,16,129.3355822,3,0,3,3,0,3,0,0,0,0,No
4836,racetrack,4,13.71023782,4,9.433503923,9.433473923,16,129.3355822,3,4,7,4,4,8,5,0.336544,0.342621,0,No
4856,quitting,4,13.71023782,4,9.433503923,9.433473923,16,129.3355822,3,4,7,3,4,7,5,0.345041,0.353613,0,No
4862,quirinal,4,13.71023782,4,9.433503923,9.433473923,16,129.3355822,2,2,4,4,2,6,5,0.324065,0.327259,0,No
4864,quintus,4,13.71023782,4,9.433503923,9.433473923,16,129.3355822,4,0,4,4,0,4,0,0,0,0,No
4898,quaternary,4,13.71023782,4,9.433503923,9.433473923,16,129.3355822,2,2,4,3,3,6,5,0.323333,0.32652,0,No
4968,putnam,4,13.71023782,4,9.433503923,9.433473923,16,129.3355822,4,1,5,4,1,5,5,0.325677,0.329423,0,No
5011,punitive,4,13.71023782,4,9.433503923,9.433473923,16,129.3355822,3,1,4,4,1,5,5,0.360829,0.373487,0,No
5039,puffy,4,13.71023782,4,9.433503923,9.433473923,16,129.3355822,4,1,5,4,1,5,5,0.375317,0.391855,0,No
5040,puff,4,13.71023782,4,9.433503923,9.433473923,16,129.3355822,4,4,8,4,4,8,5,0.398702,0.416448,0,No
5131,prosper,4,13.71023782,4,9.433503923,9.433473923,16,129.3355822,3,1,4,3,1,4,5,0.331367,0.336589,0,No
5149,proprietor,4,13.71023782,4,9.433503923,9.433473923,16,129.3355822,2,3,5,3,4,7,5,0.388408,0.405178,0,No
5157,prophetic,4,13.71023782,4,9.433503923,9.433473923,16,129.3355822,4,2,6,4,2,6,5,0.324421,0.327876,0,No
5223,profane,4,13.71023782,4,9.433503923,9.433473923,16,129.3355822,4,2,6,4,3,7,5,0.361373,0.374163,0,No
5282,priestess,4,13.71023782,4,9.433503923,9.433473923,16,129.3355822,3,4,7,4,4,8,5,0.377633,0.393172,0,No
5314,prep,4,13.71023782,4,9.433503923,9.433473923,16,129.3355822,3,3,6,3,3,6,5,0.347452,0.356506,0,No
5325,preferring,4,13.71023782,4,9.433503923,9.433473923,16,129.3355822,3,3,6,3,3,6,5,0.335627,0.341574,0,No
5334,predictor,4,13.71023782,4,9.433503923,9.433473923,16,129.3355822,3,4,7,4,4,8,4,0.426799,0.443266,0,No
5364,prado,4,13.71023782,4,9.433503923,9.433473923,16,129.3355822,3,4,7,4,4,8,5,0.361867,0.374811,0,No
5395,potent,4,13.71023782,4,9.433503923,9.433473923,16,129.3355822,3,0,3,4,0,4,0,0,0,0,No
5433,posh,4,13.71023782,4,9.433503923,9.433473923,16,129.3355822,2,3,5,2,4,6,5,0.324107,0.327355,0,No
5468,populace,4,13.71023782,4,9.433503923,9.433473923,16,129.3355822,3,3,6,4,3,7,5,0.393522,0.41065,0,No
5494,pompadour,4,13.71023782,4,9.433503923,9.433473923,16,129.3355822,1,4,5,4,4,8,5,0.398747,0.416504,0,No
5668,planetarium,4,13.71023782,4,9.433503923,9.433473923,16,129.3355822,2,3,5,2,3,5,5,0.346503,0.355601,0,No
5693,pivotal,4,13.71023782,4,9.433503923,9.433473923,16,129.3355822,1,2,3,4,4,8,5,0.323622,0.326806,0,No
5712,piss,4,13.71023782,4,9.433503923,9.433473923,16,129.3355822,3,3,6,3,3,6,5,0.355717,0.367527,0,No
5722,pip,4,13.71023782,4,9.433503923,9.433473923,16,129.3355822,3,4,7,3,4,7,5,0.359376,0.371657,0,No
5754,pillage,4,13.71023782,4,9.433503923,9.433473923,16,129.3355822,2,4,6,4,4,8,4,0.399357,0.417005,0,No
5819,phosphorous,4,13.71023782,4,9.433503923,9.433473923,16,129.3355822,4,3,7,4,3,7,5,0.386261,0.402683,0,No
5885,petite,4,13.71023782,4,9.433503923,9.433473923,16,129.3355822,3,1,4,3,1,4,5,0.32146,0.324954,0,No
5949,periwinkle,4,13.71023782,4,9.433503923,9.433473923,16,129.3355822,3,2,5,4,3,7,5,0.385389,0.401707,0,No
5993,pepperoni,4,13.71023782,4,9.433503923,9.433473923,16,129.3355822,3,2,5,3,2,5,5,0.34568,0.354577,0,No
5999,peony,4,13.71023782,4,9.433503923,9.433473923,16,129.3355822,3,3,6,3,3,6,5,0.356826,0.36878,0,No
6065,pediatrician,4,13.71023782,4,9.433503923,9.433473923,16,129.3355822,1,4,5,2,4,6,5,0.326383,0.330757,0,No
6142,patrician,4,13.71023782,4,9.433503923,9.433473923,16,129.3355822,2,3,5,3,3,6,5,0.349305,0.359025,0,No
6161,pater,4,13.71023782,4,9.433503923,9.433473923,16,129.3355822,3,0,3,3,0,3,0,0,0,0,No
6187,passageway,4,13.71023782,4,9.433503923,9.433473923,16,129.3355822,4,3,7,4,4,8,4,0.412469,0.42991,0,No
6312,pandemonium,4,13.71023782,4,9.433503923,9.433473923,16,129.3355822,2,4,6,4,4,8,5,0.326323,0.330029,0,No
6326,palsy,4,13.71023782,4,9.433503923,9.433473923,16,129.3355822,1,2,3,4,2,6,5,0.327177,0.330641,0,No
6335,pall,4,13.71023782,4,9.433503923,9.433473923,16,129.3355822,3,1,4,4,3,7,5,0.316745,0.320458,0,No
6409,oviparous,4,13.71023782,4,9.433503923,9.433473923,16,129.3355822,3,3,6,4,3,7,5,0.328996,0.332758,0,No
6412,overt,4,13.71023782,4,9.433503923,9.433473923,16,129.3355822,3,1,4,4,1,5,5,0.31805,0.32196,0,No
6452,osgood,4,13.71023782,4,9.433503923,9.433473923,16,129.3355822,4,4,8,4,4,8,5,0.339252,0.345922,0,No
6551,operant,4,13.71023782,4,9.433503923,9.433473923,16,129.3355822,2,0,2,2,0,2,0,0,0,0,No
6639,oftentimes,4,13.71023782,4,9.433503923,9.433473923,16,129.3355822,3,2,5,4,2,6,5,0.398112,0.41588,0,No
6727,oblique,4,13.71023782,4,9.433503923,9.433473923,16,129.3355822,2,2,4,2,2,4,5,0.318855,0.322307,0,No
6730,oblate,4,13.71023782,4,9.433503923,9.433473923,16,129.3355822,1,1,2,4,4,8,6,0.270216,0.275537,0,No
6736,oberlin,4,13.71023782,4,9.433503923,9.433473923,16,129.3355822,3,2,5,4,4,8,5,0.329186,0.333173,0,No
6738,obedient,4,13.71023782,4,9.433503923,9.433473923,16,129.3355822,3,3,6,3,4,7,5,0.384504,0.400721,0,No
6931,nighttime,4,13.71023782,4,9.433503923,9.433473923,16,129.3355822,1,3,4,1,3,4,5,0.324444,0.327751,0,No
7051,negligible,4,13.71023782,4,9.433503923,9.433473923,16,129.3355822,3,3,6,4,3,7,5,0.323386,0.326642,0,No
7053,neglect,4,13.71023782,4,9.433503923,9.433473923,16,129.3355822,2,2,4,2,2,4,4,0.386437,0.402813,0,No
7105,navajo,4,13.71023782,4,9.433503923,9.433473923,16,129.3355822,3,3,6,4,3,7,4,0.389986,0.406738,0,No
7135,narragansett,4,13.71023782,4,9.433503923,9.433473923,16,129.3355822,3,2,5,3,4,7,5,0.327594,0.331225,0,No
7156,naive,4,13.71023782,4,9.433503923,9.433473923,16,129.3355822,4,3,7,4,3,7,5,0.402563,0.420302,0,No
7164,nadir,4,13.71023782,4,9.433503923,9.433473923,16,129.3355822,2,1,3,2,4,6,5,0.310397,0.315107,0,No
7253,multitude,4,13.71023782,4,9.433503923,9.433473923,16,129.3355822,2,2,4,4,4,8,5,0.381816,0.397958,0,No
7254,multiplicity,4,13.71023782,4,9.433503923,9.433473923,16,129.3355822,4,3,7,4,3,7,5,0.345357,0.354108,0,No
7262,mulligan,4,13.71023782,4,9.433503923,9.433473923,16,129.3355822,3,3,6,4,3,7,5,0.327691,0.331381,0,No
7269,mukden,4,13.71023782,4,9.433503923,9.433473923,16,129.3355822,3,3,6,3,4,7,5,0.398648,0.41641,0,No
7292,mozzarella,4,13.71023782,4,9.433503923,9.433473923,16,129.3355822,4,3,7,4,4,8,4,0.393444,0.410446,0,No
7300,mouthful,4,13.71023782,4,9.433503923,9.433473923,16,129.3355822,3,2,5,4,4,8,5,0.40483,0.422185,0,No
7320,motley,4,13.71023782,4,9.433503923,9.433473923,16,129.3355822,1,2,3,1,2,3,5,0.323622,0.327135,0,No
7325,motherland,4,13.71023782,4,9.433503923,9.433473923,16,129.3355822,1,2,3,3,2,5,5,0.384962,0.401214,0,No
7647,midst,4,13.71023782,4,9.433503923,9.433473923,16,129.3355822,1,1,2,4,4,8,5,0.378607,0.394397,0,No
7663,microscopy,4,13.71023782,4,9.433503923,9.433473923,16,129.3355822,2,3,5,3,3,6,4,0.405598,0.42315,0,No
7666,microbial,4,13.71023782,4,9.433503923,9.433473923,16,129.3355822,3,1,4,3,1,4,5,0.325581,0.328889,0,No
7669,micky,4,13.71023782,4,9.433503923,9.433473923,16,129.3355822,3,1,4,3,1,4,5,0.317538,0.321326,0,No
7673,michelin,4,13.71023782,4,9.433503923,9.433473923,16,129.3355822,2,1,3,3,2,5,5,0.319786,0.323148,0,No
7679,mica,4,13.71023782,4,9.433503923,9.433473923,16,129.3355822,3,3,6,3,4,7,5,0.39063,0.407416,0,No
7742,merriment,4,13.71023782,4,9.433503923,9.433473923,16,129.3355822,2,2,4,4,3,7,5,0.41003,0.427626,0,No
7761,merciful,4,13.71023782,4,9.433503923,9.433473923,16,129.3355822,4,3,7,4,3,7,5,0.385439,0.401763,0,No
7787,mendelian,4,13.71023782,4,9.433503923,9.433473923,16,129.3355822,3,2,5,3,4,7,5,0.319849,0.323279,0,No
7828,melancholy,4,13.71023782,4,9.433503923,9.433473923,16,129.3355822,3,3,6,3,3,6,5,0.394642,0.41173,0,No
7848,meditate,4,13.71023782,4,9.433503923,9.433473923,16,129.3355822,3,3,6,3,3,6,5,0.373556,0.388578,0,No
7916,mccullough,4,13.71023782,4,9.433503923,9.433473923,16,129.3355822,3,3,6,3,3,6,5,0.361241,0.374027,0,No
7920,mcconnell,4,13.71023782,4,9.433503923,9.433473923,16,129.3355822,1,1,2,3,1,4,5,0.315652,0.319636,0,No
7930,mccabe,4,13.71023782,4,9.433503923,9.433473923,16,129.3355822,4,2,6,4,4,8,5,0.384337,0.400533,0,No
7983,mathias,4,13.71023782,4,9.433503923,9.433473923,16,129.3355822,2,1,3,2,1,3,5,0.29374,0.299896,0,No
8040,martian,4,13.71023782,4,9.433503923,9.433473923,16,129.3355822,3,0,3,4,0,4,0,0,0,0,No
8078,marjorie,4,13.71023782,4,9.433503923,9.433473923,16,129.3355822,2,3,5,3,3,6,4,0.422542,0.439229,0,No
8111,marcello,4,13.71023782,4,9.433503923,9.433473923,16,129.3355822,3,0,3,3,0,3,0,0,0,0,No
8135,manpower,4,13.71023782,4,9.433503923,9.433473923,16,129.3355822,2,4,6,3,4,7,5,0.359114,0.37155,0,No
8162,maneuver,4,13.71023782,4,9.433503923,9.433473923,16,129.3355822,2,3,5,3,3,6,5,0.369305,0.383506,0,No
8237,mainframe,4,13.71023782,4,9.433503923,9.433473923,16,129.3355822,4,1,5,4,1,5,5,0.333854,0.3397,0,No
8353,lyman,4,13.71023782,4,9.433503923,9.433473923,16,129.3355822,2,3,5,3,4,7,5,0.323528,0.326794,0,No
8362,luxurious,4,13.71023782,4,9.433503923,9.433473923,16,129.3355822,3,4,7,4,4,8,5,0.384437,0.400684,0,No
8457,lotte,4,13.71023782,4,9.433503923,9.433473923,16,129.3355822,4,0,4,4,0,4,0,0,0,0,No
8473,loot,4,13.71023782,4,9.433503923,9.433473923,16,129.3355822,4,3,7,4,4,8,4,0.400998,0.418624,0,No
8494,lonesome,4,13.71023782,4,9.433503923,9.433473923,16,129.3355822,3,3,6,3,3,6,5,0.328351,0.332339,0,No
8508,login,4,13.71023782,4,9.433503923,9.433473923,16,129.3355822,3,2,5,3,2,5,5,0.384279,0.400468,0,No
8963,landlady,4,13.71023782,4,9.433503923,9.433473923,16,129.3355822,4,1,5,4,1,5,5,0.384237,0.400402,0,No
8975,lampoon,4,13.71023782,4,9.433503923,9.433473923,16,129.3355822,1,2,3,1,2,3,5,0.322687,0.32628,0,No
9026,labial,4,13.71023782,4,9.433503923,9.433473923,16,129.3355822,4,0,4,4,0,4,0,0,0,0,No
9046,ks,4,13.71023782,4,9.433503923,9.433473923,16,129.3355822,4,4,8,4,4,8,5,0.351018,0.361234,0,No
9073,kola,4,13.71023782,4,9.433503923,9.433473923,16,129.3355822,2,2,4,4,3,7,5,0.320502,0.323919,0,No
9129,kirkland,4,13.71023782,4,9.433503923,9.433473923,16,129.3355822,3,3,6,3,3,6,5,0.377745,0.394301,0,No
9138,kinney,4,13.71023782,4,9.433503923,9.433473923,16,129.3355822,3,2,5,4,2,6,5,0.384262,0.400449,0,No
9156,kimball,4,13.71023782,4,9.433503923,9.433473923,16,129.3355822,4,3,7,4,3,7,4,0.390501,0.407306,0,No
9189,kettering,4,13.71023782,4,9.433503923,9.433473923,16,129.3355822,1,3,4,2,3,5,5,0.328218,0.331938,0,No
9378,jolly,4,13.71023782,4,9.433503923,9.433473923,16,129.3355822,2,3,5,2,3,5,5,0.324824,0.328584,0,No
9504,jacobean,4,13.71023782,4,9.433503923,9.433473923,16,129.3355822,2,2,4,2,2,4,5,0.319349,0.322959,0,No
9573,irreversible,4,13.71023782,4,9.433503923,9.433473923,16,129.3355822,2,3,5,4,3,7,5,0.326816,0.330442,0,No
9623,involuntary,4,13.71023782,4,9.433503923,9.433473923,16,129.3355822,4,2,6,4,3,7,5,0.318341,0.321864,0,No
9654,intrusion,4,13.71023782,4,9.433503923,9.433473923,16,129.3355822,2,3,5,2,3,5,4,0.408285,0.425638,0,No
9708,intensify,4,13.71023782,4,9.433503923,9.433473923,16,129.3355822,1,3,4,3,4,7,4,0.413179,0.430581,0,No
9721,intangible,4,13.71023782,4,9.433503923,9.433473923,16,129.3355822,3,2,5,4,3,7,5,0.323693,0.326977,0,No
9729,insulate,4,13.71023782,4,9.433503923,9.433473923,16,129.3355822,2,2,4,4,3,7,4,0.398747,0.416376,0,No
9815,inhale,4,13.71023782,4,9.433503923,9.433473923,16,129.3355822,4,3,7,4,4,8,4,0.422542,0.439229,0,No
9821,ingestion,4,13.71023782,4,9.433503923,9.433473923,16,129.3355822,1,2,3,2,4,6,5,0.378995,0.394819,0,No
9876,infamy,4,13.71023782,4,9.433503923,9.433473923,16,129.3355822,2,3,5,3,4,7,5,0.369859,0.38412,0,No
9927,indeterminate,4,13.71023782,4,9.433503923,9.433473923,16,129.3355822,3,3,6,3,3,6,5,0.355724,0.367547,0,No
9973,inception,4,13.71023782,4,9.433503923,9.433473923,16,129.3355822,2,3,5,3,4,7,4,0.423389,0.440163,0,No
10012,imprison,4,13.71023782,4,9.433503923,9.433473923,16,129.3355822,3,4,7,4,4,8,5,0.336761,0.342959,0,No
10041,impeach,4,13.71023782,4,9.433503923,9.433473923,16,129.3355822,4,4,8,4,4,8,4,0.400356,0.417958,0,No
10044,impart,4,13.71023782,4,9.433503923,9.433473923,16,129.3355822,3,3,6,4,4,8,5,0.377818,0.394564,0,No
10202,hutchinson,4,13.71023782,4,9.433503923,9.433473923,16,129.3355822,4,2,6,4,3,7,4,0.405163,0.422713,0,No
10206,huston,4,13.71023782,4,9.433503923,9.433473923,16,129.3355822,0,4,4,0,4,4,4,0.410403,0.427863,0,No
10207,hustle,4,13.71023782,4,9.433503923,9.433473923,16,129.3355822,2,3,5,3,3,6,5,0.378922,0.394782,0,No
10219,hurdle,4,13.71023782,4,9.433503923,9.433473923,16,129.3355822,1,1,2,3,3,6,5,0.321314,0.324719,0,No
10220,hurd,4,13.71023782,4,9.433503923,9.433473923,16,129.3355822,4,3,7,4,3,7,5,0.363207,0.376374,0,No
10241,humility,4,13.71023782,4,9.433503923,9.433473923,16,129.3355822,4,3,7,4,3,7,5,0.358056,0.370128,0,No
10244,humerus,4,13.71023782,4,9.433503923,9.433473923,16,129.3355822,3,3,6,3,3,6,4,0.417828,0.435022,0,No
10259,hugging,4,13.71023782,4,9.433503923,9.433473923,16,129.3355822,3,4,7,4,4,8,5,0.396839,0.414016,0,No
10284,hover,4,13.71023782,4,9.433503923,9.433473923,16,129.3355822,4,4,8,4,4,8,5,0.363802,0.377135,0,No
10378,homologous,4,13.71023782,4,9.433503923,9.433473923,16,129.3355822,3,2,5,3,2,5,5,0.337279,0.344622,0,No
10386,homesick,4,13.71023782,4,9.433503923,9.433473923,16,129.3355822,3,1,4,3,2,5,5,0.384237,0.400402,0,No
10389,homemade,4,13.71023782,4,9.433503923,9.433473923,16,129.3355822,3,2,5,3,2,5,5,0.384354,0.400552,0,No
10443,hoard,4,13.71023782,4,9.433503923,9.433473923,16,129.3355822,3,2,5,4,3,7,5,0.378672,0.394481,0,No
10570,hernandez,4,13.71023782,4,9.433503923,9.433473923,16,129.3355822,1,4,5,1,4,5,5,0.388884,0.405542,0,No
10595,herbicide,4,13.71023782,4,9.433503923,9.433473923,16,129.3355822,2,2,4,4,2,6,5,0.354092,0.365058,0,No
10707,headstone,4,13.71023782,4,9.433503923,9.433473923,16,129.3355822,2,2,4,4,2,6,5,0.326371,0.329907,0,No
10714,headline,4,13.71023782,4,9.433503923,9.433473923,16,129.3355822,3,2,5,3,2,5,4,0.405163,0.422713,0,No
10716,headdress,4,13.71023782,4,9.433503923,9.433473923,16,129.3355822,3,3,6,4,3,7,4,0.417838,0.435032,0,No
10942,haas,4,13.71023782,4,9.433503923,9.433473923,16,129.3355822,2,3,5,4,3,7,5,0.384579,0.400815,0,No
11008,guildhall,4,13.71023782,4,9.433503923,9.433473923,16,129.3355822,2,2,4,4,4,8,5,0.359951,0.372462,0,No
11034,grumpy,4,13.71023782,4,9.433503923,9.433473923,16,129.3355822,4,3,7,4,3,7,5,0.331701,0.336127,0,No
11037,gruesome,4,13.71023782,4,9.433503923,9.433473923,16,129.3355822,3,3,6,3,3,6,5,0.326792,0.330311,0,No
11042,growl,4,13.71023782,4,9.433503923,9.433473923,16,129.3355822,4,2,6,4,2,6,5,0.355219,0.366937,0,No
11056,grotesque,4,13.71023782,4,9.433503923,9.433473923,16,129.3355822,4,4,8,4,4,8,5,0.39838,0.416147,0,No
11080,grimaldi,4,13.71023782,4,9.433503923,9.433473923,16,129.3355822,1,3,4,1,3,4,5,0.318495,0.323195,0,No
11120,greenberg,4,13.71023782,4,9.433503923,9.433473923,16,129.3355822,4,3,7,4,3,7,5,0.385238,0.401543,0,No
11300,gluttony,4,13.71023782,4,9.433503923,9.433473923,16,129.3355822,3,4,7,3,4,7,4,0.389806,0.406569,0,No
11326,glimpse,4,13.71023782,4,9.433503923,9.433473923,16,129.3355822,2,1,3,3,4,7,5,0.378607,0.394397,0,No
11419,gestalt,4,13.71023782,4,9.433503923,9.433473923,16,129.3355822,2,2,4,3,2,5,5,0.326269,0.329663,0,No
11449,geodetic,4,13.71023782,4,9.433503923,9.433473923,16,129.3355822,0,2,2,0,2,2,5,0.384301,0.400492,0,No
11492,geiger,4,13.71023782,4,9.433503923,9.433473923,16,129.3355822,3,2,5,3,2,5,5,0.327165,0.331771,0,No
11509,gaussian,4,13.71023782,4,9.433503923,9.433473923,16,129.3355822,1,4,5,2,4,6,5,0.322716,0.326214,0,No
11580,galvanic,4,13.71023782,4,9.433503923,9.433473923,16,129.3355822,2,2,4,2,3,5,5,0.32533,0.329111,0,No
11611,gait,4,13.71023782,4,9.433503923,9.433473923,16,129.3355822,1,4,5,1,4,5,4,0.387078,0.403541,0,No
11636,futile,4,13.71023782,4,9.433503923,9.433473923,16,129.3355822,2,2,4,3,2,5,5,0.319343,0.322831,0,No
11694,fruitful,4,13.71023782,4,9.433503923,9.433473923,16,129.3355822,4,2,6,4,2,6,5,0.322435,0.325751,0,No
11699,froze,4,13.71023782,4,9.433503923,9.433473923,16,129.3355822,3,4,7,3,4,7,4,0.421269,0.438248,0,No
11703,frostbite,4,13.71023782,4,9.433503923,9.433473923,16,129.3355822,4,3,7,4,3,7,5,0.340155,0.34711,0,No
11883,forgery,4,13.71023782,4,9.433503923,9.433473923,16,129.3355822,3,3,6,3,3,6,5,0.41394,0.431677,0,No
11904,foraminifera,4,13.71023782,4,9.433503923,9.433473923,16,129.3355822,2,2,4,2,2,4,5,0.325086,0.32869,0,No
11918,footbridge,4,13.71023782,4,9.433503923,9.433473923,16,129.3355822,3,3,6,4,3,7,5,0.364879,0.378471,0,No
11935,folktale,4,13.71023782,4,9.433503923,9.433473923,16,129.3355822,3,2,5,4,2,6,5,0.380661,0.396683,0,No
11987,flourish,4,13.71023782,4,9.433503923,9.433473923,16,129.3355822,3,3,6,4,3,7,4,0.407133,0.424572,0,No
12023,flex,4,13.71023782,4,9.433503923,9.433473923,16,129.3355822,1,4,5,1,4,5,5,0.37504,0.390202,0,No
12079,fixture,4,13.71023782,4,9.433503923,9.433473923,16,129.3355822,4,4,8,4,4,8,5,0.391707,0.408737,0,No
12106,firewood,4,13.71023782,4,9.433503923,9.433473923,16,129.3355822,4,3,7,4,3,7,5,0.323917,0.328011,0,No
12137,financier,4,13.71023782,4,9.433503923,9.433473923,16,129.3355822,4,3,7,4,3,7,5,0.33146,0.336251,0,No
12267,feathery,4,13.71023782,4,9.433503923,9.433473923,16,129.3355822,4,1,5,4,1,5,5,0.305999,0.31116,0,No
12335,fanatic,4,13.71023782,4,9.433503923,9.433473923,16,129.3355822,1,2,3,1,2,3,4,0.389755,0.406475,0,No
12480,expatriate,4,13.71023782,4,9.433503923,9.433473923,16,129.3355822,2,1,3,2,1,3,5,0.322916,0.326389,0,No
12486,exothermic,4,13.71023782,4,9.433503923,9.433473923,16,129.3355822,3,0,3,4,0,4,0,0,0,0,No
12493,existential,4,13.71023782,4,9.433503923,9.433473923,16,129.3355822,3,3,6,4,3,7,5,0.323245,0.326489,0,No
12538,excelled,4,13.71023782,4,9.433503923,9.433473923,16,129.3355822,2,2,4,3,4,7,5,0.363512,0.376745,0,No
12789,enthusiastic,4,13.71023782,4,9.433503923,9.433473923,16,129.3355822,2,1,3,3,1,4,6,0.277959,0.283901,0,No
12847,emporium,4,13.71023782,4,9.433503923,9.433473923,16,129.3355822,3,3,6,3,3,6,4,0.417828,0.434999,0,No
12873,emigrate,4,13.71023782,4,9.433503923,9.433473923,16,129.3355822,1,2,3,3,4,7,5,0.35947,0.371884,0,No
12888,embodiment,4,13.71023782,4,9.433503923,9.433473923,16,129.3355822,2,2,4,2,4,6,5,0.378728,0.394551,0,No
12889,emblematic,4,13.71023782,4,9.433503923,9.433473923,16,129.3355822,4,2,6,4,2,6,5,0.378664,0.394476,0,No
12937,elisha,4,13.71023782,4,9.433503923,9.433473923,16,129.3355822,3,3,6,3,3,6,5,0.318546,0.322464,0,No
13014,egan,4,13.71023782,4,9.433503923,9.433473923,16,129.3355822,3,2,5,3,2,5,5,0.350443,0.360239,0,No
13160,duplicate,4,13.71023782,4,9.433503923,9.433473923,16,129.3355822,2,2,4,2,3,5,5,0.378793,0.394617,0,No
13171,dung,4,13.71023782,4,9.433503923,9.433473923,16,129.3355822,3,4,7,4,4,8,5,0.390974,0.4078,0,No
13186,duluth,4,13.71023782,4,9.433503923,9.433473923,16,129.3355822,2,2,4,3,3,6,5,0.375627,0.392155,0,No
13253,dreamy,4,13.71023782,4,9.433503923,9.433473923,16,129.3355822,3,3,6,3,3,6,5,0.325295,0.328657,0,No
13279,dragging,4,13.71023782,4,9.433503923,9.433473923,16,129.3355822,3,2,5,3,3,6,5,0.387416,0.403918,0,No
13452,distort,4,13.71023782,4,9.433503923,9.433473923,16,129.3355822,3,4,7,3,4,7,4,0.428303,0.444693,0,No
13455,distillery,4,13.71023782,4,9.433503923,9.433473923,16,129.3355822,2,4,6,2,4,6,4,0.390896,0.407752,0,No
13497,disciplinary,4,13.71023782,4,9.433503923,9.433473923,16,129.3355822,4,0,4,4,0,4,0,0,0,0,No
13593,dictatorial,4,13.71023782,4,9.433503923,9.433473923,16,129.3355822,2,2,4,2,2,4,5,0.324705,0.328257,0,No
13646,devote,4,13.71023782,4,9.433503923,9.433473923,16,129.3355822,1,4,5,2,4,6,5,0.380792,0.397712,0,No
13693,designate,4,13.71023782,4,9.433503923,9.433473923,16,129.3355822,3,4,7,4,4,8,4,0.401307,0.418929,0,No
13702,descendent,4,13.71023782,4,9.433503923,9.433473923,16,129.3355822,4,3,7,4,4,8,4,0.41837,0.43552,0,No
13728,depose,4,13.71023782,4,9.433503923,9.433473923,16,129.3355822,2,3,5,3,3,6,5,0.336646,0.343346,0,No
13739,deoxyribonucleic,4,13.71023782,4,9.433503923,9.433473923,16,129.3355822,2,1,3,2,4,6,5,0.318244,0.321897,0,No
13770,demolish,4,13.71023782,4,9.433503923,9.433473923,16,129.3355822,2,2,4,3,2,5,4,0.400248,0.417826,0,No
13843,deficient,4,13.71023782,4,9.433503923,9.433473923,16,129.3355822,4,2,6,4,2,6,5,0.41003,0.427626,0,No
13859,dedicate,4,13.71023782,4,9.433503923,9.433473923,16,129.3355822,2,3,5,3,4,7,5,0.400646,0.418434,0,No
13906,debugging,4,13.71023782,4,9.433503923,9.433473923,16,129.3355822,3,1,4,4,1,5,5,0.345599,0.354479,0,No
14041,daffy,4,13.71023782,4,9.433503923,9.433473923,16,129.3355822,2,1,3,2,4,6,5,0.31545,0.319467,0,No
14047,dada,4,13.71023782,4,9.433503923,9.433473923,16,129.3355822,2,3,5,2,3,5,5,0.331565,0.336103,0,No
14288,craze,4,13.71023782,4,9.433503923,9.433473923,16,129.3355822,4,4,8,4,4,8,4,0.434711,0.450233,0,No
14414,corvus,4,13.71023782,4,9.433503923,9.433473923,16,129.3355822,4,2,6,4,2,6,5,0.339031,0.34595,0,No
14457,cornelia,4,13.71023782,4,9.433503923,9.433473923,16,129.3355822,2,3,5,2,3,5,5,0.316773,0.320732,0,No
14555,contour,4,13.71023782,4,9.433503923,9.433473923,16,129.3355822,2,2,4,2,2,4,5,0.378979,0.3948,0,No
14590,consular,4,13.71023782,4,9.433503923,9.433473923,16,129.3355822,3,2,5,3,2,5,5,0.384271,0.400458,0,No
14612,consolidate,4,13.71023782,4,9.433503923,9.433473923,16,129.3355822,2,4,6,3,4,7,5,0.399896,0.417692,0,No
14618,conserve,4,13.71023782,4,9.433503923,9.433473923,16,129.3355822,2,3,5,4,3,7,5,0.398335,0.416096,0,No
14623,consequent,4,13.71023782,4,9.433503923,9.433473923,16,129.3355822,2,3,5,3,3,6,5,0.360324,0.372912,0,No
14670,confront,4,13.71023782,4,9.433503923,9.433473923,16,129.3355822,2,2,4,4,2,6,5,0.33585,0.342753,0,No
14682,confident,4,13.71023782,4,9.433503923,9.433473923,16,129.3355822,4,3,7,4,4,8,4,0.389379,0.406066,0,No
14739,compute,4,13.71023782,4,9.433503923,9.433473923,16,129.3355822,1,4,5,4,4,8,4,0.410969,0.42845,0,No
14762,comply,4,13.71023782,4,9.433503923,9.433473923,16,129.3355822,3,2,5,4,4,8,5,0.346808,0.355844,0,No
14768,compliant,4,13.71023782,4,9.433503923,9.433473923,16,129.3355822,2,2,4,2,3,5,5,0.388331,0.404923,0,No
14786,compensate,4,13.71023782,4,9.433503923,9.433473923,16,129.3355822,1,2,3,4,4,8,5,0.350893,0.361042,0,No
14925,cognate,4,13.71023782,4,9.433503923,9.433473923,16,129.3355822,4,3,7,4,3,7,5,0.350015,0.360085,0,No
14991,clump,4,13.71023782,4,9.433503923,9.433473923,16,129.3355822,2,2,4,4,4,8,5,0.382953,0.399188,0,No
15099,clamshell,4,13.71023782,4,9.433503923,9.433473923,16,129.3355822,4,3,7,4,4,8,5,0.323198,0.326421,0,No
15116,citroen,4,13.71023782,4,9.433503923,9.433473923,16,129.3355822,2,3,5,4,3,7,5,0.332684,0.338056,0,No
15169,chunk,4,13.71023782,4,9.433503923,9.433473923,16,129.3355822,2,4,6,2,4,6,5,0.380767,0.396795,0,No
15210,chordate,4,13.71023782,4,9.433503923,9.433473923,16,129.3355822,4,3,7,4,3,7,5,0.346179,0.354966,0,No
15239,chiton,4,13.71023782,4,9.433503923,9.433473923,16,129.3355822,3,2,5,4,2,6,5,0.386244,0.402646,0,No
15243,chisel,4,13.71023782,4,9.433503923,9.433473923,16,129.3355822,4,3,7,4,3,7,4,0.389755,0.406494,0,No
15286,chevy,4,13.71023782,4,9.433503923,9.433473923,16,129.3355822,3,3,6,3,4,7,5,0.345828,0.354788,0,No
15767,cameraman,4,13.71023782,4,9.433503923,9.433473923,16,129.3355822,4,4,8,4,4,8,5,0.384862,0.401148,0,No
15886,butterscotch,4,13.71023782,4,9.433503923,9.433473923,16,129.3355822,4,3,7,4,4,8,5,0.398103,0.415889,0,No
15998,buff,4,13.71023782,4,9.433503923,9.433473923,16,129.3355822,2,3,5,3,3,6,5,0.359354,0.37179,0,No
16022,buchenwald,4,13.71023782,4,9.433503923,9.433473923,16,129.3355822,4,1,5,4,1,5,5,0.360822,0.373478,0,No
16102,bristle,4,13.71023782,4,9.433503923,9.433473923,16,129.3355822,3,3,6,3,3,6,5,0.39829,0.416058,0,No
16146,brethren,4,13.71023782,4,9.433503923,9.433473923,16,129.3355822,2,4,6,4,4,8,4,0.413035,0.430253,0,No
16205,bramble,4,13.71023782,4,9.433503923,9.433473923,16,129.3355822,3,3,6,3,3,6,5,0.361704,0.3746,0,No
16229,bracelet,4,13.71023782,4,9.433503923,9.433473923,16,129.3355822,4,3,7,4,4,8,4,0.415743,0.433027,0,No
16253,bout,4,13.71023782,4,9.433503923,9.433473923,16,129.3355822,2,4,6,2,4,6,4,0.402016,0.419629,0,No
16313,booty,4,13.71023782,4,9.433503923,9.433473923,16,129.3355822,3,3,6,4,3,7,5,0.324753,0.32809,0,No
16329,bookshelf,4,13.71023782,4,9.433503923,9.433473923,16,129.3355822,3,4,7,3,4,7,5,0.34628,0.355333,0,No
16342,bonnet,4,13.71023782,4,9.433503923,9.433473923,16,129.3355822,4,3,7,4,3,7,5,0.386977,0.403458,0,No
16354,bona,4,13.71023782,4,9.433503923,9.433473923,16,129.3355822,3,1,4,3,1,4,5,0.378607,0.394397,0,No
16416,blurry,4,13.71023782,4,9.433503923,9.433473923,16,129.3355822,3,3,6,3,3,6,5,0.350277,0.360131,0,No
16444,bloodshed,4,13.71023782,4,9.433503923,9.433473923,16,129.3355822,3,3,6,3,3,6,4,0.422542,0.439229,0,No
16447,bloodbath,4,13.71023782,4,9.433503923,9.433473923,16,129.3355822,1,1,2,4,1,5,5,0.398076,0.415824,0,No
16507,blackjack,4,13.71023782,4,9.433503923,9.433473923,16,129.3355822,3,3,6,3,3,6,5,0.384279,0.400486,0,No
16652,berth,4,13.71023782,4,9.433503923,9.433473923,16,129.3355822,2,4,6,4,4,8,5,0.325611,0.329184,0,No
16688,benz,4,13.71023782,4,9.433503923,9.433473923,16,129.3355822,1,3,4,3,3,6,5,0.384412,0.400637,0,No
16702,benevolent,4,13.71023782,4,9.433503923,9.433473923,16,129.3355822,3,2,5,4,2,6,5,0.325128,0.328539,0,No
16739,bellatrix,4,13.71023782,4,9.433503923,9.433473923,16,129.3355822,4,0,4,4,0,4,0,0,0,0,No
16761,behead,4,13.71023782,4,9.433503923,9.433473923,16,129.3355822,2,2,4,3,2,5,5,0.39821,0.415983,0,No
16870,bathe,4,13.71023782,4,9.433503923,9.433473923,16,129.3355822,1,2,3,2,4,6,5,0.41003,0.427626,0,No
16887,basilisk,4,13.71023782,4,9.433503923,9.433473923,16,129.3355822,4,3,7,4,3,7,5,0.330374,0.334767,0,No
16918,barre,4,13.71023782,4,9.433503923,9.433473923,16,129.3355822,3,3,6,3,3,6,5,0.329027,0.333058,0,No
16932,barnett,4,13.71023782,4,9.433503923,9.433473923,16,129.3355822,2,3,5,2,3,5,5,0.343765,0.352024,0,No
16948,barclay,4,13.71023782,4,9.433503923,9.433473923,16,129.3355822,3,3,6,4,4,8,5,0.372693,0.387561,0,No
16963,baptiste,4,13.71023782,4,9.433503923,9.433473923,16,129.3355822,1,4,5,4,4,8,5,0.32995,0.334071,0,No
17045,baggy,4,13.71023782,4,9.433503923,9.433473923,16,129.3355822,2,1,3,3,1,4,5,0.384229,0.400392,0,No
17081,baccalaureate,4,13.71023782,4,9.433503923,9.433473923,16,129.3355822,0,1,1,0,2,2,5,0.297707,0.303632,0,No
17097,azalea,4,13.71023782,4,9.433503923,9.433473923,16,129.3355822,2,3,5,2,3,5,4,0.387746,0.404818,0,No
17177,authenticate,4,13.71023782,4,9.433503923,9.433473923,16,129.3355822,2,2,4,3,3,6,5,0.39889,0.416645,0,No
17247,atonal,4,13.71023782,4,9.433503923,9.433473923,16,129.3355822,4,3,7,4,4,8,5,0.333177,0.338379,0,No
17271,asynchronous,4,13.71023782,4,9.433503923,9.433473923,16,129.3355822,4,2,6,4,3,7,5,0.321221,0.324682,0,No
17292,asterisk,4,13.71023782,4,9.433503923,9.433473923,16,129.3355822,3,3,6,4,3,7,5,0.373831,0.388811,0,No
17348,ascend,4,13.71023782,4,9.433503923,9.433473923,16,129.3355822,3,3,6,4,4,8,4,0.429962,0.445989,0,No
17371,artemisia,4,13.71023782,4,9.433503923,9.433473923,16,129.3355822,4,1,5,4,1,5,5,0.325784,0.329217,0,No
17516,appleby,4,13.71023782,4,9.433503923,9.433473923,16,129.3355822,2,2,4,2,2,4,5,0.398326,0.416054,0,No
17528,appease,4,13.71023782,4,9.433503923,9.433473923,16,129.3355822,2,2,4,4,2,6,5,0.39889,0.416645,0,No
17539,apothecary,4,13.71023782,4,9.433503923,9.433473923,16,129.3355822,3,3,6,4,4,8,5,0.386269,0.402693,0,No
17551,apocryphal,4,13.71023782,4,9.433503923,9.433473923,16,129.3355822,4,3,7,4,4,8,4,0.401053,0.41869,0,No
17705,anecdotal,4,13.71023782,4,9.433503923,9.433473923,16,129.3355822,2,1,3,3,1,4,5,0.324824,0.328028,0,No
17754,amuse,4,13.71023782,4,9.433503923,9.433473923,16,129.3355822,2,1,3,4,2,6,5,0.321349,0.324693,0,No
17788,ammeter,4,13.71023782,4,9.433503923,9.433473923,16,129.3355822,2,4,6,4,4,8,5,0.350672,0.36083,0,No
17790,amity,4,13.71023782,4,9.433503923,9.433473923,16,129.3355822,3,2,5,4,2,6,5,0.384337,0.400533,0,No
17793,amidst,4,13.71023782,4,9.433503923,9.433473923,16,129.3355822,3,2,5,3,3,6,5,0.398594,0.416326,0,No
17837,altruism,4,13.71023782,4,9.433503923,9.433473923,16,129.3355822,2,3,5,2,3,5,5,0.350727,0.360629,0,No
17847,altair,4,13.71023782,4,9.433503923,9.433473923,16,129.3355822,3,1,4,3,2,5,5,0.398076,0.415824,0,No
17924,alia,4,13.71023782,4,9.433503923,9.433473923,16,129.3355822,2,3,5,3,3,6,5,0.385196,0.4015,0,No
17927,algorithmic,4,13.71023782,4,9.433503923,9.433473923,16,129.3355822,3,2,5,4,2,6,5,0.322927,0.326097,0,No
17954,aleph,4,13.71023782,4,9.433503923,9.433473923,16,129.3355822,3,3,6,3,3,6,4,0.392218,0.409108,0,No
17981,albeit,4,13.71023782,4,9.433503923,9.433473923,16,129.3355822,3,2,5,3,2,5,5,0.41003,0.427626,0,No
18000,akin,4,13.71023782,4,9.433503923,9.433473923,16,129.3355822,3,2,5,3,3,6,5,0.371352,0.386029,0,No
18073,afrikaner,4,13.71023782,4,9.433503923,9.433473923,16,129.3355822,2,4,6,4,4,8,5,0.334294,0.339959,0,No
18087,affix,4,13.71023782,4,9.433503923,9.433473923,16,129.3355822,3,4,7,4,4,8,4,0.389413,0.406498,0,No
18094,affectionate,4,13.71023782,4,9.433503923,9.433473923,16,129.3355822,3,1,4,3,3,6,5,0.384229,0.400392,0,No
18121,advert,4,13.71023782,4,9.433503923,9.433473923,16,129.3355822,2,3,5,2,3,5,5,0.348948,0.358511,0,No
18134,adrift,4,13.71023782,4,9.433503923,9.433473923,16,129.3355822,2,3,5,2,4,6,5,0.372162,0.386895,0,No
18164,adjunct,4,13.71023782,4,9.433503923,9.433473923,16,129.3355822,2,2,4,4,4,8,5,0.359361,0.371762,0,No
18172,adhere,4,13.71023782,4,9.433503923,9.433473923,16,129.3355822,3,2,5,3,4,7,5,0.359194,0.37157,0,No
18187,addict,4,13.71023782,4,9.433503923,9.433473923,16,129.3355822,3,3,6,4,4,8,5,0.352216,0.362396,0,No
18192,adamson,4,13.71023782,4,9.433503923,9.433473923,16,129.3355822,4,2,6,4,2,6,5,0.384612,0.400838,0,No
18250,accumulate,4,13.71023782,4,9.433503923,9.433473923,16,129.3355822,3,3,6,4,3,7,5,0.362524,0.375595,0,No
18289,abyssinia,4,13.71023782,4,9.433503923,9.433473923,16,129.3355822,2,3,5,2,4,6,5,0.410039,0.427654,0,No
18304,absorbent,4,13.71023782,4,9.433503923,9.433473923,16,129.3355822,2,3,5,4,3,7,5,0.384937,0.401214,0,No
18332,abner,4,13.71023782,4,9.433503923,9.433473923,16,129.3355822,2,3,5,2,4,6,5,0.398272,0.416054,0,No
125,yalta,6,13.30477271,3,9.721185996,9.721165996,18,129.3381701,3,4,7,6,6,12,5,0.33981,0.346638,0,No
396,whirl,6,13.30477271,3,9.721185996,9.721165996,18,129.3381701,4,4,8,6,5,11,5,0.386034,0.402693,0,No
976,vacuole,6,13.30477271,3,9.721185996,9.721165996,18,129.3381701,2,3,5,6,4,10,4,0.392287,0.409202,0,No
996,usury,6,13.30477271,3,9.721185996,9.721165996,18,129.3381701,3,4,7,3,6,9,4,0.414259,0.431534,0,No
1658,tick,6,13.30477271,3,9.721185996,9.721165996,18,129.3381701,5,2,7,5,4,9,5,0.350312,0.36015,0,No
2058,talisman,6,13.30477271,3,9.721185996,9.721165996,18,129.3381701,3,4,7,6,6,12,5,0.396281,0.413642,0,No
2538,stochastic,6,13.30477271,3,9.721185996,9.721165996,18,129.3381701,2,2,4,3,3,6,5,0.319452,0.322753,0,No
2893,spar,6,13.30477271,3,9.721185996,9.721165996,18,129.3381701,5,3,8,5,3,8,5,0.339148,0.34583,0,No
3058,snuff,6,13.30477271,3,9.721185996,9.721165996,18,129.3381701,4,6,10,4,6,10,5,0.353845,0.364941,0,No
3104,smithson,6,13.30477271,3,9.721185996,9.721165996,18,129.3381701,5,3,8,5,3,8,5,0.328917,0.333696,0,No
3286,simpleton,6,13.30477271,3,9.721185996,9.721165996,18,129.3381701,4,5,9,4,5,9,4,0.380596,0.397212,0,No
3346,siegel,6,13.30477271,3,9.721185996,9.721165996,18,129.3381701,3,4,7,3,4,7,5,0.38467,0.400942,0,No
3480,sheik,6,13.30477271,3,9.721185996,9.721165996,18,129.3381701,5,2,7,5,2,7,5,0.363348,0.376382,0,No
3576,servo,6,13.30477271,3,9.721185996,9.721165996,18,129.3381701,2,3,5,6,5,11,5,0.369451,0.383893,0,No
3599,serene,6,13.30477271,3,9.721185996,9.721165996,18,129.3381701,3,0,3,6,0,6,0,0,0,0,No
4660,recursion,6,13.30477271,3,9.721185996,9.721165996,18,129.3381701,3,5,8,3,5,8,4,0.393034,0.410399,0,No
4813,radish,6,13.30477271,3,9.721185996,9.721165996,18,129.3381701,5,3,8,6,3,9,5,0.349464,0.359549,0,No
5787,picket,6,13.30477271,3,9.721185996,9.721165996,18,129.3381701,4,2,6,6,5,11,5,0.323675,0.32697,0,No
5854,phenomenology,6,13.30477271,3,9.721185996,9.721165996,18,129.3381701,4,4,8,4,5,9,5,0.385481,0.402047,0,No
6013,penrose,6,13.30477271,3,9.721185996,9.721165996,18,129.3381701,3,4,7,5,4,9,4,0.389935,0.406705,0,No
6118,paulson,6,13.30477271,3,9.721185996,9.721165996,18,129.3381701,5,6,11,6,6,12,5,0.357984,0.369798,0,No
6605,olin,6,13.30477271,3,9.721185996,9.721165996,18,129.3381701,4,3,7,4,3,7,4,0.391051,0.407897,0,No
6743,oases,6,13.30477271,3,9.721185996,9.721165996,18,129.3381701,6,6,12,6,6,12,5,0.381054,0.397157,0,No
7146,nanosecond,6,13.30477271,3,9.721185996,9.721165996,18,129.3381701,5,4,9,6,4,10,4,0.393784,0.410808,0,No
7232,muscat,6,13.30477271,3,9.721185996,9.721165996,18,129.3381701,5,5,10,6,5,11,5,0.399968,0.417692,0,No
7603,millipede,6,13.30477271,3,9.721185996,9.721165996,18,129.3381701,4,5,9,6,5,11,4,0.404231,0.421845,0,No
7621,militarism,6,13.30477271,3,9.721185996,9.721165996,18,129.3381701,3,4,7,3,6,9,4,0.43085,0.446811,0,No
8131,mantis,6,13.30477271,3,9.721185996,9.721165996,18,129.3381701,4,4,8,4,4,8,5,0.352188,0.362455,0,No
8262,magneto,6,13.30477271,3,9.721185996,9.721165996,18,129.3381701,4,5,9,5,5,10,4,0.400754,0.418296,0,No
8443,louse,6,13.30477271,3,9.721185996,9.721165996,18,129.3381701,4,5,9,6,5,11,4,0.387763,0.404803,0,No
8571,littleton,6,13.30477271,3,9.721185996,9.721165996,18,129.3381701,6,4,10,6,5,11,5,0.349367,0.359173,0,No
8733,levee,6,13.30477271,3,9.721185996,9.721165996,18,129.3381701,4,4,8,5,4,9,5,0.389072,0.406519,0,No
8930,lares,6,13.30477271,3,9.721185996,9.721165996,18,129.3381701,2,4,6,4,4,8,4,0.383739,0.400517,0,No
9289,justine,6,13.30477271,3,9.721185996,9.721165996,18,129.3381701,4,2,6,4,2,6,5,0.357235,0.369,0,No
9379,jolla,6,13.30477271,3,9.721185996,9.721165996,18,129.3381701,1,4,5,6,6,12,5,0.349891,0.359683,0,No
9425,jewell,6,13.30477271,3,9.721185996,9.721165996,18,129.3381701,3,3,6,5,6,11,5,0.347086,0.356338,0,No
9679,interstitial,6,13.30477271,3,9.721185996,9.721165996,18,129.3381701,5,2,7,5,4,9,5,0.326966,0.330534,0,No
9792,inman,6,13.30477271,3,9.721185996,9.721165996,18,129.3381701,4,3,7,4,3,7,5,0.330343,0.334498,0,No
10141,ibex,6,13.30477271,3,9.721185996,9.721165996,18,129.3381701,2,2,4,2,2,4,5,0.36662,0.380527,0,No
11376,gina,6,13.30477271,3,9.721185996,9.721165996,18,129.3381701,6,4,10,6,4,10,5,0.388561,0.405209,0,No
11647,furrow,6,13.30477271,3,9.721185996,9.721165996,18,129.3381701,3,5,8,3,5,8,4,0.424584,0.441163,0,No
12223,fermion,6,13.30477271,3,9.721185996,9.721165996,18,129.3381701,3,5,8,6,5,11,5,0.378882,0.394714,0,No
12401,eyepiece,6,13.30477271,3,9.721185996,9.721165996,18,129.3381701,3,4,7,4,5,9,4,0.435714,0.451101,0,No
12547,exaggerate,6,13.30477271,3,9.721185996,9.721165996,18,129.3381701,4,5,9,6,5,11,4,0.41586,0.433201,0,No
12574,evensong,6,13.30477271,3,9.721185996,9.721165996,18,129.3381701,3,4,7,3,5,8,5,0.411436,0.428992,0,No
12923,ellipsoid,6,13.30477271,3,9.721185996,9.721165996,18,129.3381701,2,3,5,5,4,9,5,0.368141,0.382325,0,No
13100,earthworm,6,13.30477271,3,9.721185996,9.721165996,18,129.3381701,4,5,9,5,6,11,5,0.371282,0.385952,0,No
13107,earring,6,13.30477271,3,9.721185996,9.721165996,18,129.3381701,2,3,5,6,3,9,4,0.360734,0.373242,0,No
13403,dodecahedron,6,13.30477271,3,9.721185996,9.721165996,18,129.3381701,3,5,8,5,5,10,5,0.373132,0.38806,0,No
14261,crestview,6,13.30477271,3,9.721185996,9.721165996,18,129.3381701,2,3,5,3,4,7,5,0.347582,0.357079,0,No
14589,consulate,6,13.30477271,3,9.721185996,9.721165996,18,129.3381701,4,5,9,5,5,10,5,0.372357,0.387173,0,No
14604,conspire,6,13.30477271,3,9.721185996,9.721165996,18,129.3381701,4,3,7,4,6,10,5,0.347446,0.356821,0,No
14647,conjugate,6,13.30477271,3,9.721185996,9.721165996,18,129.3381701,4,2,6,4,5,9,5,0.320821,0.324138,0,No
14705,condensate,6,13.30477271,3,9.721185996,9.721165996,18,129.3381701,4,4,8,6,4,10,5,0.356546,0.367983,0,No
15022,clique,6,13.30477271,3,9.721185996,9.721165996,18,129.3381701,3,5,8,6,6,12,5,0.371305,0.386029,0,No
15269,chiffon,6,13.30477271,3,9.721185996,9.721165996,18,129.3381701,5,3,8,5,5,10,5,0.388357,0.40497,0,No
15300,chert,6,13.30477271,3,9.721185996,9.721165996,18,129.3381701,3,4,7,4,6,10,5,0.371539,0.386297,0,No
16038,brusque,6,13.30477271,3,9.721185996,9.721165996,18,129.3381701,2,4,6,2,4,6,5,0.349835,0.360014,0,No
16045,bruise,6,13.30477271,3,9.721185996,9.721165996,18,129.3381701,3,6,9,6,6,12,4,0.406043,0.423605,0,No
16252,boutique,6,13.30477271,3,9.721185996,9.721165996,18,129.3381701,4,4,8,5,5,10,4,0.400275,0.417577,0,No
17408,armadillo,6,13.30477271,3,9.721185996,9.721165996,18,129.3381701,4,5,9,6,5,11,4,0.426614,0.443008,0,No
17497,apron,6,13.30477271,3,9.721185996,9.721165996,18,129.3381701,4,3,7,6,5,11,4,0.411465,0.428835,0,No
17787,ammo,6,13.30477271,3,9.721185996,9.721165996,18,129.3381701,3,5,8,4,5,9,4,0.419745,0.436792,0,No
18006,airway,6,13.30477271,3,9.721185996,9.721165996,18,129.3381701,4,3,7,5,4,9,5,0.385497,0.401848,0,No
2895,spaniel,5,13.30477271,3,9.721185996,9.721165996,15,129.3381701,2,3,5,2,4,6,4,0.389866,0.406616,0,No
2404,styrene,10,12.79394708,2,10.1266511,10.1266411,20,129.5598384,4,5,9,5,9,14,5,0.359085,0.371568,0,No
5413,postfix,10,12.79394708,2,10.1266511,10.1266411,20,129.5598384,7,1,8,8,1,9,5,0.345599,0.354479,0,No
5870,phage,10,12.79394708,2,10.1266511,10.1266411,20,129.5598384,5,6,11,9,6,15,4,0.401734,0.419291,0,No
6008,pentagram,10,12.79394708,2,10.1266511,10.1266411,20,129.5598384,3,8,11,8,9,17,4,0.411579,0.429051,0,No
6863,nora,10,12.79394708,2,10.1266511,10.1266411,20,129.5598384,5,8,13,6,8,14,5,0.369944,0.384492,0,No
13140,dutton,10,12.79394708,2,10.1266511,10.1266411,20,129.5598384,5,4,9,6,4,10,5,0.410675,0.42825,0,No
14652,congruent,10,12.79394708,2,10.1266511,10.1266411,20,129.5598384,2,5,7,8,7,15,5,0.361741,0.374701,0,No
14876,colloquy,10,12.79394708,2,10.1266511,10.1266411,20,129.5598384,9,6,15,9,8,17,5,0.370476,0.385132,0,No
366,whorl,9,12.8993076,2,10.1266511,10.1266411,18,130.6267875,5,6,11,7,7,14,5,0.394739,0.411969,0,No
432,wham,9,12.8993076,2,10.1266511,10.1266411,18,130.6267875,6,7,13,7,7,14,5,0.37376,0.388717,0,No
2166,swordfish,9,12.8993076,2,10.1266511,10.1266411,18,130.6267875,4,3,7,6,6,12,5,0.356367,0.367953,0,No
3102,smog,9,12.8993076,2,10.1266511,10.1266411,18,130.6267875,6,5,11,6,7,13,4,0.399437,0.417023,0,No
3849,schnapps,9,12.8993076,2,10.1266511,10.1266411,18,130.6267875,5,5,10,7,8,15,5,0.35434,0.365518,0,No
6811,nouakchott,9,12.8993076,2,10.1266511,10.1266411,18,130.6267875,7,6,13,7,8,15,5,0.35286,0.36352,0,No
8344,lyra,9,12.8993076,2,10.1266511,10.1266411,18,130.6267875,7,7,14,8,7,15,4,0.378704,0.394475,0,No
9897,inductor,9,12.8993076,2,10.1266511,10.1266411,18,130.6267875,3,6,9,9,7,16,4,0.403139,0.420554,0,No
10668,hedonism,9,12.8993076,2,10.1266511,10.1266411,18,130.6267875,8,6,14,9,9,18,5,0.361402,0.37425,0,No
13169,dunham,9,12.8993076,2,10.1266511,10.1266411,18,130.6267875,7,7,14,9,8,17,5,0.339025,0.34572,0,No
13916,debby,9,12.8993076,2,10.1266511,10.1266411,18,130.6267875,5,2,7,6,4,10,5,0.363713,0.377023,0,No
16421,blum,9,12.8993076,2,10.1266511,10.1266411,18,130.6267875,6,6,12,6,7,13,5,0.365254,0.378718,0,No
16928,barometer,9,12.8993076,2,10.1266511,10.1266411,18,130.6267875,4,5,9,7,7,14,4,0.427004,0.443351,0,No
17216,audacity,9,12.8993076,2,10.1266511,10.1266411,18,130.6267875,5,5,10,5,6,11,4,0.407591,0.425051,0,No
17884,allspice,9,12.8993076,2,10.1266511,10.1266411,18,130.6267875,3,6,9,3,7,10,4,0.403514,0.420953,0,No
5,zoroaster,5,13.48709426,3,9.721185996,9.721165996,15,131.1105519,3,5,8,3,5,8,4,0.411198,0.428675,0,No
29,zest,5,13.48709426,3,9.721185996,9.721165996,15,131.1105519,3,5,8,3,5,8,4,0.390922,0.407775,0,No
69,yost,5,13.48709426,3,9.721185996,9.721165996,15,131.1105519,5,5,10,5,5,10,4,0.390046,0.406841,0,No
82,yoghurt,5,13.48709426,3,9.721185996,9.721165996,15,131.1105519,3,4,7,3,5,8,5,0.346469,0.355624,0,No
185,worthington,5,13.48709426,3,9.721185996,9.721165996,15,131.1105519,2,3,5,3,3,6,5,0.34693,0.356195,0,No
258,witt,5,13.48709426,3,9.721185996,9.721165996,15,131.1105519,2,4,6,4,5,9,5,0.349161,0.359054,0,No
361,wick,5,13.48709426,3,9.721185996,9.721165996,15,131.1105519,4,3,7,5,4,9,5,0.346848,0.356056,0,No
378,whittaker,5,13.48709426,3,9.721185996,9.721165996,15,131.1105519,3,1,4,5,1,6,5,0.398076,0.415824,0,No
772,vikram,5,13.48709426,3,9.721185996,9.721165996,15,131.1105519,3,2,5,5,2,7,5,0.384279,0.400468,0,No
900,vella,5,13.48709426,3,9.721185996,9.721165996,15,131.1105519,1,3,4,5,4,9,5,0.348626,0.358183,0,No
1247,trustee,5,13.48709426,3,9.721185996,9.721165996,15,131.1105519,2,2,4,4,4,8,5,0.388391,0.405141,0,No
1377,trapezium,5,13.48709426,3,9.721185996,9.721165996,15,131.1105519,2,3,5,3,4,7,5,0.371842,0.386536,0,No
1477,towel,5,13.48709426,3,9.721185996,9.721165996,15,131.1105519,3,4,7,4,4,8,4,0.399267,0.416592,0,No
2479,stratus,5,13.48709426,3,9.721185996,9.721165996,15,131.1105519,2,2,4,2,2,4,5,0.332571,0.337703,0,No
2649,starling,5,13.48709426,3,9.721185996,9.721165996,15,131.1105519,1,4,5,1,4,5,4,0.412718,0.429943,0,No
2667,stanhope,5,13.48709426,3,9.721185996,9.721165996,15,131.1105519,4,4,8,4,5,9,4,0.396599,0.413784,0,No
2910,sow,5,13.48709426,3,9.721185996,9.721165996,15,131.1105519,4,3,7,5,3,8,5,0.327812,0.331691,0,No
2944,sorority,5,13.48709426,3,9.721185996,9.721165996,15,131.1105519,4,4,8,5,4,9,4,0.402882,0.420436,0,No
2950,sora,5,13.48709426,3,9.721185996,9.721165996,15,131.1105519,2,3,5,2,4,6,5,0.384287,0.400477,0,No
2974,sommerfeld,5,13.48709426,3,9.721185996,9.721165996,15,131.1105519,3,2,5,4,3,7,5,0.337427,0.343671,0,No
3035,socratic,5,13.48709426,3,9.721185996,9.721165996,15,131.1105519,3,3,6,5,5,10,5,0.321617,0.324805,0,No
3310,silkworm,5,13.48709426,3,9.721185996,9.721165996,15,131.1105519,4,1,5,5,1,6,5,0.398067,0.415814,0,No
3539,shady,5,13.48709426,3,9.721185996,9.721165996,15,131.1105519,2,1,3,4,1,5,5,0.345599,0.354479,0,No
3615,septa,5,13.48709426,3,9.721185996,9.721165996,15,131.1105519,3,2,5,3,2,5,5,0.369405,0.383823,0,No
3770,scripps,5,13.48709426,3,9.721185996,9.721165996,15,131.1105519,4,3,7,4,4,8,5,0.325474,0.329041,0,No
3812,sclerotic,5,13.48709426,3,9.721185996,9.721165996,15,131.1105519,3,1,4,3,1,4,5,0.316028,0.320143,0,No
3958,sash,5,13.48709426,3,9.721185996,9.721165996,15,131.1105519,4,4,8,5,4,9,5,0.361822,0.374551,0,No
4139,rushmore,5,13.48709426,3,9.721185996,9.721165996,15,131.1105519,2,4,6,5,5,10,4,0.420122,0.437285,0,No
4220,rotc,5,13.48709426,3,9.721185996,9.721165996,15,131.1105519,5,4,9,5,4,9,5,0.368423,0.382572,0,No
4247,roommate,5,13.48709426,3,9.721185996,9.721165996,15,131.1105519,3,3,6,5,3,8,5,0.357515,0.369338,0,No
4303,roberta,5,13.48709426,3,9.721185996,9.721165996,15,131.1105519,4,3,7,4,5,9,5,0.30419,0.309762,0,No
4385,rickets,5,13.48709426,3,9.721185996,9.721165996,15,131.1105519,4,4,8,4,4,8,5,0.374731,0.389928,0,No
4409,rhodium,5,13.48709426,3,9.721185996,9.721165996,15,131.1105519,3,2,5,3,4,7,4,0.405154,0.422704,0,No
4545,rensselaer,5,13.48709426,3,9.721185996,9.721165996,15,131.1105519,4,4,8,4,5,9,5,0.347663,0.357089,0,No
4626,refrain,5,13.48709426,3,9.721185996,9.721165996,15,131.1105519,3,3,6,4,4,8,4,0.419983,0.436985,0,No
4644,reedy,5,13.48709426,3,9.721185996,9.721165996,15,131.1105519,5,1,6,5,4,9,5,0.320473,0.324064,0,No
4651,redstone,5,13.48709426,3,9.721185996,9.721165996,15,131.1105519,4,3,7,5,5,10,5,0.360983,0.373703,0,No
5084,prudential,5,13.48709426,3,9.721185996,9.721165996,15,131.1105519,3,1,4,5,3,8,5,0.305641,0.310924,0,No
5178,pronghorn,5,13.48709426,3,9.721185996,9.721165996,15,131.1105519,1,3,4,4,3,7,5,0.337049,0.343544,0,No
5222,profess,5,13.48709426,3,9.721185996,9.721165996,15,131.1105519,2,4,6,2,4,6,5,0.419894,0.437071,0,No
5232,proctor,5,13.48709426,3,9.721185996,9.721165996,15,131.1105519,3,3,6,3,3,6,5,0.315995,0.320417,0,No
5262,priori,5,13.48709426,3,9.721185996,9.721165996,15,131.1105519,1,3,4,3,3,6,5,0.326473,0.330034,0,No
5425,possessor,5,13.48709426,3,9.721185996,9.721165996,15,131.1105519,2,1,3,4,2,6,5,0.378607,0.394397,0,No
5889,petersen,5,13.48709426,3,9.721185996,9.721165996,15,131.1105519,4,3,7,5,3,8,5,0.351095,0.361098,0,No
6214,parsifal,5,13.48709426,3,9.721185996,9.721165996,15,131.1105519,3,4,7,3,5,8,5,0.370183,0.38467,0,No
6292,paoli,5,13.48709426,3,9.721185996,9.721165996,15,131.1105519,1,3,4,1,3,4,5,0.36268,0.375715,0,No
6408,ovipositor,5,13.48709426,3,9.721185996,9.721165996,15,131.1105519,4,4,8,5,5,10,5,0.376727,0.392304,0,No
6627,ojibwa,5,13.48709426,3,9.721185996,9.721165996,15,131.1105519,3,5,8,4,5,9,5,0.386488,0.402965,0,No
6741,oat,5,13.48709426,3,9.721185996,9.721165996,15,131.1105519,4,4,8,4,4,8,5,0.355318,0.367097,0,No
7033,neoprene,5,13.48709426,3,9.721185996,9.721165996,15,131.1105519,3,4,7,3,4,7,5,0.355112,0.366457,0,No
7120,natchez,5,13.48709426,3,9.721185996,9.721165996,15,131.1105519,4,4,8,4,5,9,5,0.33471,0.340415,0,No
7132,narwhal,5,13.48709426,3,9.721185996,9.721165996,15,131.1105519,4,4,8,5,4,9,4,0.41768,0.434839,0,No
7272,mug,5,13.48709426,3,9.721185996,9.721165996,15,131.1105519,2,4,6,5,5,10,5,0.385556,0.402113,0,No
7515,mitt,5,13.48709426,3,9.721185996,9.721165996,15,131.1105519,4,2,6,4,2,6,5,0.350409,0.360486,0,No
7630,milch,5,13.48709426,3,9.721185996,9.721165996,15,131.1105519,2,2,4,5,2,7,5,0.398094,0.415861,0,No
7751,meringue,5,13.48709426,3,9.721185996,9.721165996,15,131.1105519,4,5,9,5,5,10,4,0.409311,0.42676,0,No
7903,mcgrath,5,13.48709426,3,9.721185996,9.721165996,15,131.1105519,4,4,8,5,4,9,5,0.337311,0.343096,0,No
8053,marseilles,5,13.48709426,3,9.721185996,9.721165996,15,131.1105519,3,5,8,4,5,9,4,0.409557,0.427103,0,No
8336,mabel,5,13.48709426,3,9.721185996,9.721165996,15,131.1105519,2,1,3,2,1,3,5,0.336021,0.342018,0,No
8461,lossy,5,13.48709426,3,9.721185996,9.721165996,15,131.1105519,2,2,4,4,3,7,5,0.322669,0.325996,0,No
8606,lioness,5,13.48709426,3,9.721185996,9.721165996,15,131.1105519,2,2,4,5,4,9,5,0.394633,0.411702,0,No
8874,lavatory,5,13.48709426,3,9.721185996,9.721165996,15,131.1105519,3,2,5,4,4,8,5,0.361388,0.374191,0,No
9110,kline,5,13.48709426,3,9.721185996,9.721165996,15,131.1105519,1,3,4,4,3,7,5,0.390638,0.407425,0,No
9461,jeannie,5,13.48709426,3,9.721185996,9.721165996,15,131.1105519,2,4,6,2,4,6,5,0.35343,0.363966,0,No
9656,introversion,5,13.48709426,3,9.721185996,9.721165996,15,131.1105519,4,3,7,4,5,9,5,0.390931,0.407735,0,No
9848,infix,5,13.48709426,3,9.721185996,9.721165996,15,131.1105519,3,1,4,3,1,4,6,0.264857,0.269486,0,No
10104,idolatry,5,13.48709426,3,9.721185996,9.721165996,15,131.1105519,5,3,8,5,4,9,5,0.353106,0.363753,0,No
10153,hypothermia,5,13.48709426,3,9.721185996,9.721165996,15,131.1105519,5,3,8,5,3,8,5,0.365044,0.378581,0,No
10190,hydro,5,13.48709426,3,9.721185996,9.721165996,15,131.1105519,4,4,8,5,4,9,5,0.361233,0.374027,0,No
10191,hydride,5,13.48709426,3,9.721185996,9.721165996,15,131.1105519,3,3,6,5,4,9,5,0.385054,0.401563,0,No
10431,hodge,5,13.48709426,3,9.721185996,9.721165996,15,131.1105519,4,4,8,4,4,8,4,0.401697,0.419253,0,No
10456,histology,5,13.48709426,3,9.721185996,9.721165996,15,131.1105519,4,4,8,4,5,9,4,0.38811,0.405226,0,No
10519,hickman,5,13.48709426,3,9.721185996,9.721165996,15,131.1105519,3,5,8,3,5,8,5,0.348394,0.358056,0,No
10619,hempstead,5,13.48709426,3,9.721185996,9.721165996,15,131.1105519,1,4,5,1,4,5,4,0.408633,0.42607,0,No
10624,hematite,5,13.48709426,3,9.721185996,9.721165996,15,131.1105519,2,4,6,2,5,7,4,0.409283,0.426873,0,No
10698,heap,5,13.48709426,3,9.721185996,9.721165996,15,131.1105519,2,4,6,4,4,8,5,0.386395,0.403047,0,No
11192,grad,5,13.48709426,3,9.721185996,9.721165996,15,131.1105519,1,3,4,2,3,5,5,0.33823,0.344605,0,No
11302,glutinous,5,13.48709426,3,9.721185996,9.721165996,15,131.1105519,4,1,5,4,5,9,5,0.314349,0.318635,0,No
11728,fright,5,13.48709426,3,9.721185996,9.721165996,15,131.1105519,4,2,6,4,5,9,5,0.322904,0.326247,0,No
12680,erskine,5,13.48709426,3,9.721185996,9.721165996,15,131.1105519,3,2,5,4,3,7,5,0.324997,0.328749,0,No
12697,erlenmeyer,5,13.48709426,3,9.721185996,9.721165996,15,131.1105519,5,2,7,5,3,8,5,0.295614,0.301714,0,No
13070,eclectic,5,13.48709426,3,9.721185996,9.721165996,15,131.1105519,2,1,3,3,4,7,5,0.320496,0.323727,0,No
13155,durango,5,13.48709426,3,9.721185996,9.721165996,15,131.1105519,2,3,5,2,4,6,5,0.371057,0.385799,0,No
13485,dishwasher,5,13.48709426,3,9.721185996,9.721165996,15,131.1105519,5,4,9,5,4,9,5,0.384812,0.401087,0,No
13541,dimorphism,5,13.48709426,3,9.721185996,9.721165996,15,131.1105519,1,2,3,5,5,10,5,0.345787,0.354723,0,No
13759,dendrite,5,13.48709426,3,9.721185996,9.721165996,15,131.1105519,2,4,6,4,4,8,4,0.424442,0.441008,0,No
13953,davison,5,13.48709426,3,9.721185996,9.721165996,15,131.1105519,4,5,9,5,5,10,5,0.333527,0.338511,0,No
14034,daimler,5,13.48709426,3,9.721185996,9.721165996,15,131.1105519,3,2,5,3,2,5,5,0.398085,0.415852,0,No
14092,cutoff,5,13.48709426,3,9.721185996,9.721165996,15,131.1105519,3,2,5,5,2,7,5,0.37864,0.394453,0,No
14289,crayon,5,13.48709426,3,9.721185996,9.721165996,15,131.1105519,4,3,7,4,3,7,5,0.340749,0.347986,0,No
14301,crankshaft,5,13.48709426,3,9.721185996,9.721165996,15,131.1105519,3,3,6,5,4,9,5,0.324036,0.327308,0,No
14422,corset,5,13.48709426,3,9.721185996,9.721165996,15,131.1105519,3,3,6,4,4,8,5,0.351262,0.361589,0,No
14566,contiguous,5,13.48709426,3,9.721185996,9.721165996,15,131.1105519,1,1,2,4,1,5,5,0.359172,0.371523,0,No
14701,condominium,5,13.48709426,3,9.721185996,9.721165996,15,131.1105519,3,3,6,5,3,8,5,0.395751,0.413074,0,No
14982,coachman,5,13.48709426,3,9.721185996,9.721165996,15,131.1105519,3,2,5,4,2,6,5,0.329846,0.334102,0,No
15321,checksum,5,13.48709426,3,9.721185996,9.721165996,15,131.1105519,2,2,4,4,2,6,5,0.352566,0.363265,0,No
15421,cetera,5,13.48709426,3,9.721185996,9.721165996,15,131.1105519,1,4,5,5,4,9,5,0.353599,0.364248,0,No
15451,centrifuge,5,13.48709426,3,9.721185996,9.721165996,15,131.1105519,2,4,6,5,5,10,4,0.415666,0.432919,0,No
15543,catapult,5,13.48709426,3,9.721185996,9.721165996,15,131.1105519,2,3,5,5,4,9,5,0.354566,0.365669,0,No
15572,cashmere,5,13.48709426,3,9.721185996,9.721165996,15,131.1105519,3,3,6,3,5,8,5,0.347058,0.356356,0,No
15713,canteen,5,13.48709426,3,9.721185996,9.721165996,15,131.1105519,3,5,8,5,5,10,5,0.340547,0.348062,0,No
15728,canister,5,13.48709426,3,9.721185996,9.721165996,15,131.1105519,2,4,6,5,4,9,4,0.417808,0.434947,0,No
15779,cam,5,13.48709426,3,9.721185996,9.721165996,15,131.1105519,3,3,6,5,4,9,4,0.431625,0.447674,0,No
15967,bumblebee,5,13.48709426,3,9.721185996,9.721165996,15,131.1105519,3,1,4,5,4,9,5,0.314907,0.318912,0,No
16174,breakaway,5,13.48709426,3,9.721185996,9.721165996,15,131.1105519,4,4,8,4,4,8,4,0.390158,0.406954,0,No
16333,bookcase,5,13.48709426,3,9.721185996,9.721165996,15,131.1105519,2,4,6,3,4,7,5,0.371088,0.385855,0,No
16397,bobcat,5,13.48709426,3,9.721185996,9.721165996,15,131.1105519,4,4,8,5,4,9,5,0.385422,0.401763,0,No
16426,bluebird,5,13.48709426,3,9.721185996,9.721165996,15,131.1105519,5,2,7,5,2,7,5,0.375683,0.392235,0,No
16459,blob,5,13.48709426,3,9.721185996,9.721165996,15,131.1105519,3,1,4,5,1,6,5,0.347133,0.356191,0,No
16684,berea,5,13.48709426,3,9.721185996,9.721165996,15,131.1105519,4,4,8,4,4,8,5,0.348113,0.357657,0,No
17009,ballast,5,13.48709426,3,9.721185996,9.721165996,15,131.1105519,4,3,7,5,3,8,5,0.349808,0.359737,0,No
17163,automata,5,13.48709426,3,9.721185996,9.721165996,15,131.1105519,4,2,6,4,3,7,5,0.345949,0.354906,0,No
17182,austral,5,13.48709426,3,9.721185996,9.721165996,15,131.1105519,4,2,6,4,3,7,5,0.323823,0.327222,0,No
17554,apical,5,13.48709426,3,9.721185996,9.721165996,15,131.1105519,3,1,4,4,1,5,5,0.320479,0.323847,0,No
17674,animist,5,13.48709426,3,9.721185996,9.721165996,15,131.1105519,4,3,7,4,3,7,5,0.339096,0.345988,0,No
17703,anemone,5,13.48709426,3,9.721185996,9.721165996,15,131.1105519,3,4,7,5,4,9,5,0.336754,0.343806,0,No
17723,anchovy,5,13.48709426,3,9.721185996,9.721165996,15,131.1105519,2,3,5,5,3,8,5,0.349388,0.359469,0,No
341,wildebeest,8,13.01709064,2,10.1266511,10.1266411,16,131.8195353,7,7,14,7,8,15,5,0.399204,0.41657,0,No
632,wahl,8,13.01709064,2,10.1266511,10.1266411,16,131.8195353,2,6,8,8,8,16,5,0.388927,0.405632,0,No
2170,switzer,8,13.01709064,2,10.1266511,10.1266411,16,131.8195353,4,8,12,6,8,14,5,0.355938,0.367253,0,No
2179,swine,8,13.01709064,2,10.1266511,10.1266411,16,131.8195353,6,2,8,6,8,14,5,0.311678,0.316231,0,No
4605,regression,8,13.01709064,2,10.1266511,10.1266411,16,131.8195353,4,4,8,5,7,12,5,0.349553,0.359704,0,No
6243,pardon,8,13.01709064,2,10.1266511,10.1266411,16,131.8195353,4,4,8,7,5,12,4,0.410153,0.427614,0,No
7593,mimicry,8,13.01709064,2,10.1266511,10.1266411,16,131.8195353,8,4,12,8,6,14,4,0.395618,0.412742,0,No
9611,iota,8,13.01709064,2,10.1266511,10.1266411,16,131.8195353,4,5,9,5,5,10,4,0.390218,0.407024,0,No
13640,dewar,8,13.01709064,2,10.1266511,10.1266411,16,131.8195353,5,6,11,7,7,14,5,0.341352,0.348838,0,No
1588,toccata,7,13.15062203,2,10.1266511,10.1266411,14,133.1717611,6,4,10,7,6,13,4,0.392999,0.410005,0,No
2039,tammany,7,13.15062203,2,10.1266511,10.1266411,14,133.1717611,4,2,6,4,6,10,5,0.326173,0.329583,0,No
2955,sophism,7,13.15062203,2,10.1266511,10.1266411,14,133.1717611,6,4,10,6,5,11,4,0.392305,0.409249,0,No
4374,ridgway,7,13.15062203,2,10.1266511,10.1266411,14,133.1717611,6,5,11,7,5,12,5,0.356661,0.368264,0,No
4406,rhombus,7,13.15062203,2,10.1266511,10.1266411,14,133.1717611,3,4,7,7,6,13,5,0.360163,0.37252,0,No
8147,manifold,7,13.15062203,2,10.1266511,10.1266411,14,133.1717611,4,5,9,7,6,13,5,0.37192,0.386794,0,No
9509,jackman,7,13.15062203,2,10.1266511,10.1266411,14,133.1717611,6,5,11,6,5,11,5,0.344948,0.353317,0,No
11504,gavotte,7,13.15062203,2,10.1266511,10.1266411,14,133.1717611,3,5,8,7,5,12,4,0.406294,0.423831,0,No
16506,blackmail,7,13.15062203,2,10.1266511,10.1266411,14,133.1717611,6,5,11,6,5,11,4,0.374644,0.389786,0,No
18208,actinium,7,13.15062203,2,10.1266511,10.1266411,14,133.1717611,5,5,10,5,7,12,4,0.391707,0.408639,0,No
18338,abide,7,13.15062203,2,10.1266511,10.1266411,14,133.1717611,6,3,9,6,7,13,5,0.359085,0.371188,0,No
18361,abacus,7,13.15062203,2,10.1266511,10.1266411,14,133.1717611,5,4,9,7,6,13,5,0.355006,0.366072,0,No
6685,oct,4,13.71023782,9,9.721185996,9.721165996,36,133.2797719,2,2,4,3,2,5,5,0.345364,0.353976,0,No
30,zeroth,4,13.71023782,3,9.721185996,9.721165996,12,133.2797719,1,1,2,3,4,7,5,0.323941,0.327144,0,No
57,yucatan,4,13.71023782,3,9.721185996,9.721165996,12,133.2797719,2,2,4,3,3,6,5,0.322951,0.32638,0,No
144,wyman,4,13.71023782,3,9.721185996,9.721165996,12,133.2797719,2,2,4,4,2,6,5,0.361042,0.373769,0,No
204,workman,4,13.71023782,3,9.721185996,9.721165996,12,133.2797719,2,4,6,3,4,7,5,0.395927,0.413073,0,No
328,wilkinson,4,13.71023782,3,9.721185996,9.721165996,12,133.2797719,3,2,5,3,3,6,5,0.341405,0.348488,0,No
393,whisk,4,13.71023782,3,9.721185996,9.721165996,12,133.2797719,1,2,3,2,4,6,5,0.355219,0.366937,0,No
423,wheelbarrow,4,13.71023782,3,9.721185996,9.721165996,12,133.2797719,2,3,5,4,4,8,5,0.369751,0.384259,0,No
453,wept,4,13.71023782,3,9.721185996,9.721165996,12,133.2797719,2,2,4,3,2,5,5,0.328655,0.333575,0,No
726,visionary,4,13.71023782,3,9.721185996,9.721165996,12,133.2797719,3,2,5,3,2,5,5,0.384362,0.400557,0,No
785,vientiane,4,13.71023782,3,9.721185996,9.721165996,12,133.2797719,2,2,4,3,2,5,5,0.345653,0.354573,0,No
824,vestal,4,13.71023782,3,9.721185996,9.721165996,12,133.2797719,2,1,3,4,3,7,5,0.307755,0.312853,0,No
987,utmost,4,13.71023782,3,9.721185996,9.721165996,12,133.2797719,3,2,5,4,3,7,5,0.344018,0.352469,0,No
1000,usps,4,13.71023782,3,9.721185996,9.721165996,12,133.2797719,2,3,5,3,3,6,4,0.40218,0.419728,0,No
1050,uppermost,4,13.71023782,3,9.721185996,9.721165996,12,133.2797719,2,3,5,3,4,7,5,0.346071,0.355084,0,No
1100,ultimatum,4,13.71023782,3,9.721185996,9.721165996,12,133.2797719,4,3,7,4,3,7,4,0.396839,0.414033,0,No
1140,twitch,4,13.71023782,3,9.721185996,9.721165996,12,133.2797719,2,1,3,3,1,4,5,0.328412,0.333573,0,No
1179,turntable,4,13.71023782,3,9.721185996,9.721165996,12,133.2797719,2,2,4,4,2,6,4,0.400239,0.417817,0,No
1188,turmeric,4,13.71023782,3,9.721185996,9.721165996,12,133.2797719,4,2,6,4,3,7,5,0.345599,0.354479,0,No
1319,tricky,4,13.71023782,3,9.721185996,9.721165996,12,133.2797719,4,1,5,4,1,5,5,0.315837,0.319775,0,No
1322,trickery,4,13.71023782,3,9.721185996,9.721165996,12,133.2797719,3,3,6,4,3,7,4,0.399761,0.417056,0,No
1366,travertine,4,13.71023782,3,9.721185996,9.721165996,12,133.2797719,4,3,7,4,3,7,5,0.369458,0.383907,0,No
1384,transpose,4,13.71023782,3,9.721185996,9.721165996,12,133.2797719,4,3,7,4,3,7,5,0.336997,0.342965,0,No
1618,tingle,4,13.71023782,3,9.721185996,9.721165996,12,133.2797719,2,3,5,2,4,6,5,0.333214,0.338236,0,No
1929,tegucigalpa,4,13.71023782,3,9.721185996,9.721165996,12,133.2797719,2,4,6,3,4,7,5,0.371057,0.385675,0,No
1936,tee,4,13.71023782,3,9.721185996,9.721165996,12,133.2797719,3,3,6,3,4,7,5,0.385004,0.401275,0,No
1965,taxonomist,4,13.71023782,3,9.721185996,9.721165996,12,133.2797719,2,2,4,4,2,6,5,0.359681,0.372175,0,No
1968,taxidermy,4,13.71023782,3,9.721185996,9.721165996,12,133.2797719,3,3,6,3,3,6,5,0.364011,0.377341,0,No
2011,taper,4,13.71023782,3,9.721185996,9.721165996,12,133.2797719,3,3,6,3,3,6,4,0.388697,0.405818,0,No
2122,syntactic,4,13.71023782,3,9.721185996,9.721165996,12,133.2797719,4,2,6,4,2,6,5,0.320427,0.323629,0,No
2195,sweatshop,4,13.71023782,3,9.721185996,9.721165996,12,133.2797719,4,2,6,4,2,6,5,0.353043,0.363659,0,No
2458,stride,4,13.71023782,3,9.721185996,9.721165996,12,133.2797719,4,3,7,4,3,7,5,0.350118,0.359906,0,No
2642,stash,4,13.71023782,3,9.721185996,9.721165996,12,133.2797719,1,3,4,3,3,6,5,0.380417,0.396456,0,No
2687,staley,4,13.71023782,3,9.721185996,9.721165996,12,133.2797719,1,4,5,1,4,5,5,0.379449,0.395359,0,No
2729,squat,4,13.71023782,3,9.721185996,9.721165996,12,133.2797719,2,3,5,3,3,6,5,0.345963,0.355047,0,No
2740,spurge,4,13.71023782,3,9.721185996,9.721165996,12,133.2797719,2,2,4,3,3,6,5,0.325862,0.329259,0,No
2823,spill,4,13.71023782,3,9.721185996,9.721165996,12,133.2797719,3,2,5,4,3,7,5,0.378115,0.39385,0,No
2972,sonar,4,13.71023782,3,9.721185996,9.721165996,12,133.2797719,2,3,5,2,3,5,5,0.337767,0.344444,0,No
3003,solitude,4,13.71023782,3,9.721185996,9.721165996,12,133.2797719,2,3,5,3,4,7,4,0.405246,0.422817,0,No
3063,snowflake,4,13.71023782,3,9.721185996,9.721165996,12,133.2797719,2,2,4,3,2,5,5,0.320496,0.323695,0,No
3130,slowdown,4,13.71023782,3,9.721185996,9.721165996,12,133.2797719,1,4,5,2,4,6,5,0.425143,0.441977,0,No
3294,simile,4,13.71023782,3,9.721185996,9.721165996,12,133.2797719,1,3,4,4,4,8,4,0.39707,0.414479,0,No
3418,shortcake,4,13.71023782,3,9.721185996,9.721165996,12,133.2797719,1,4,5,4,4,8,5,0.36533,0.37879,0,No
3543,shad,4,13.71023782,3,9.721185996,9.721165996,12,133.2797719,1,2,3,2,2,4,5,0.320375,0.32367,0,No
3622,sentiment,4,13.71023782,3,9.721185996,9.721165996,12,133.2797719,3,3,6,4,3,7,5,0.371881,0.386583,0,No
3666,selector,4,13.71023782,3,9.721185996,9.721165996,12,133.2797719,4,3,7,4,3,7,5,0.357364,0.368959,0,No
3815,scion,4,13.71023782,3,9.721185996,9.721165996,12,133.2797719,3,2,5,3,3,6,4,0.389755,0.406475,0,No
3856,schizophrenic,4,13.71023782,3,9.721185996,9.721165996,12,133.2797719,4,4,8,4,4,8,4,0.424016,0.4406,0,No
3990,sanitarium,4,13.71023782,3,9.721185996,9.721165996,12,133.2797719,3,4,7,4,4,8,5,0.376384,0.39175,0,No
4079,sago,4,13.71023782,3,9.721185996,9.721165996,12,133.2797719,2,2,4,2,4,6,5,0.319377,0.322979,0,No
4230,rosenthal,4,13.71023782,3,9.721185996,9.721165996,12,133.2797719,1,3,4,2,3,5,5,0.321477,0.324648,0,No
4252,rooftop,4,13.71023782,3,9.721185996,9.721165996,12,133.2797719,2,4,6,3,4,7,5,0.400519,0.417964,0,No
4363,rigging,4,13.71023782,3,9.721185996,9.721165996,12,133.2797719,1,4,5,2,4,6,5,0.390329,0.407216,0,No
4548,renounce,4,13.71023782,3,9.721185996,9.721165996,12,133.2797719,1,4,5,2,4,6,5,0.398764,0.416537,0,No
4568,remington,4,13.71023782,3,9.721185996,9.721165996,12,133.2797719,3,2,5,3,3,6,5,0.384637,0.400871,0,No
4675,reclamation,4,13.71023782,3,9.721185996,9.721165996,12,133.2797719,3,3,6,4,3,7,5,0.384462,0.400693,0,No
4717,rayleigh,4,13.71023782,3,9.721185996,9.721165996,12,133.2797719,1,2,3,1,2,3,5,0.384379,0.400571,0,No
4761,rang,4,13.71023782,3,9.721185996,9.721165996,12,133.2797719,4,4,8,4,4,8,5,0.38049,0.39747,0,No
4933,quadrilateral,4,13.71023782,3,9.721185996,9.721165996,12,133.2797719,3,4,7,4,4,8,5,0.350998,0.360947,0,No
4986,purine,4,13.71023782,3,9.721185996,9.721165996,12,133.2797719,4,2,6,4,2,6,5,0.355212,0.366932,0,No
4993,purdue,4,13.71023782,3,9.721185996,9.721165996,12,133.2797719,3,0,3,4,0,4,0,0,0,0,No
5027,pulpit,4,13.71023782,3,9.721185996,9.721165996,12,133.2797719,3,4,7,4,4,8,4,0.397167,0.414404,0,No
5097,proverb,4,13.71023782,3,9.721185996,9.721165996,12,133.2797719,2,2,4,4,4,8,5,0.36662,0.380527,0,No
5185,promiscuous,4,13.71023782,3,9.721185996,9.721165996,12,133.2797719,2,1,3,2,1,3,5,0.384237,0.400402,0,No
5198,prokaryote,4,13.71023782,3,9.721185996,9.721165996,12,133.2797719,3,2,5,3,2,5,5,0.355404,0.367125,0,No
5233,procter,4,13.71023782,3,9.721185996,9.721165996,12,133.2797719,3,1,4,3,4,7,5,0.298472,0.304305,0,No
5362,pragmatism,4,13.71023782,3,9.721185996,9.721165996,12,133.2797719,2,1,3,3,2,5,5,0.32681,0.33159,0,No
5521,polygamous,4,13.71023782,3,9.721185996,9.721165996,12,133.2797719,3,4,7,4,4,8,4,0.422593,0.43929,0,No
5767,piety,4,13.71023782,3,9.721185996,9.721165996,12,133.2797719,4,3,7,4,3,7,4,0.392713,0.409686,0,No
5995,peppercorn,4,13.71023782,3,9.721185996,9.721165996,12,133.2797719,2,3,5,4,4,8,4,0.40884,0.426464,0,No
6014,pennyroyal,4,13.71023782,3,9.721185996,9.721165996,12,133.2797719,4,2,6,4,3,7,5,0.359259,0.371649,0,No
6027,penh,4,13.71023782,3,9.721185996,9.721165996,12,133.2797719,0,3,3,0,3,3,5,0.34195,0.349273,0,No
6104,payload,4,13.71023782,3,9.721185996,9.721165996,12,133.2797719,4,4,8,4,4,8,5,0.355269,0.36649,0,No
6116,pauper,4,13.71023782,3,9.721185996,9.721165996,12,133.2797719,2,3,5,4,3,7,5,0.346489,0.355575,0,No
6144,patrice,4,13.71023782,3,9.721185996,9.721165996,12,133.2797719,4,0,4,4,0,4,0,0,0,0,No
6300,pant,4,13.71023782,3,9.721185996,9.721165996,12,133.2797719,3,3,6,3,3,6,5,0.34599,0.354932,0,No
6330,palmetto,4,13.71023782,3,9.721185996,9.721165996,12,133.2797719,3,3,6,3,3,6,5,0.346645,0.355873,0,No
6445,osmotic,4,13.71023782,3,9.721185996,9.721165996,12,133.2797719,3,1,4,3,4,7,5,0.32034,0.32382,0,No
6457,osborn,4,13.71023782,3,9.721185996,9.721165996,12,133.2797719,3,4,7,4,4,8,5,0.387247,0.403773,0,No
6590,omicron,4,13.71023782,3,9.721185996,9.721165996,12,133.2797719,2,2,4,2,2,4,5,0.395565,0.41265,0,No
6606,oligopoly,4,13.71023782,3,9.721185996,9.721165996,12,133.2797719,3,4,7,4,4,8,4,0.390209,0.40747,0,No
6681,octahedron,4,13.71023782,3,9.721185996,9.721165996,12,133.2797719,3,3,6,3,3,6,5,0.348291,0.357845,0,No
7091,nbs,4,13.71023782,3,9.721185996,9.721165996,12,133.2797719,2,4,6,2,4,6,5,0.372928,0.387825,0,No
7138,narbonne,4,13.71023782,3,9.721185996,9.721165996,12,133.2797719,2,3,5,3,3,6,5,0.387331,0.403857,0,No
7186,myocardial,4,13.71023782,3,9.721185996,9.721165996,12,133.2797719,2,0,2,2,0,2,0,0,0,0,No
7298,mouton,4,13.71023782,3,9.721185996,9.721165996,12,133.2797719,4,3,7,4,4,8,5,0.39889,0.416687,0,No
7580,minesweeper,4,13.71023782,3,9.721185996,9.721165996,12,133.2797719,3,3,6,3,3,6,5,0.346226,0.355261,0,No
7626,mileage,4,13.71023782,3,9.721185996,9.721165996,12,133.2797719,2,3,5,4,4,8,5,0.370044,0.384461,0,No
7640,mig,4,13.71023782,3,9.721185996,9.721165996,12,133.2797719,4,3,7,4,3,7,5,0.336518,0.342887,0,No
7648,midshipman,4,13.71023782,3,9.721185996,9.721165996,12,133.2797719,2,4,6,4,4,8,5,0.390759,0.407599,0,No
7914,mcdermott,4,13.71023782,3,9.721185996,9.721165996,12,133.2797719,4,3,7,4,3,7,5,0.361734,0.374604,0,No
8017,masonic,4,13.71023782,3,9.721185996,9.721165996,12,133.2797719,4,2,6,4,2,6,5,0.322312,0.325426,0,No
8068,marlin,4,13.71023782,3,9.721185996,9.721165996,12,133.2797719,3,3,6,3,3,6,4,0.388025,0.40509,0,No
8081,marital,4,13.71023782,3,9.721185996,9.721165996,12,133.2797719,3,2,5,3,3,6,5,0.317112,0.320853,0,No
8145,manioc,4,13.71023782,3,9.721185996,9.721165996,12,133.2797719,3,4,7,3,4,7,5,0.358223,0.370588,0,No
8153,maniac,4,13.71023782,3,9.721185996,9.721165996,12,133.2797719,4,4,8,4,4,8,5,0.34767,0.357032,0,No
8185,mamma,4,13.71023782,3,9.721185996,9.721165996,12,133.2797719,2,0,2,2,0,2,0,0,0,0,No
8187,maltose,4,13.71023782,3,9.721185996,9.721165996,12,133.2797719,3,4,7,3,4,7,5,0.385564,0.401909,0,No
8259,magnify,4,13.71023782,3,9.721185996,9.721165996,12,133.2797719,2,1,3,3,3,6,5,0.398076,0.415824,0,No
8263,magnetite,4,13.71023782,3,9.721185996,9.721165996,12,133.2797719,3,4,7,3,4,7,5,0.356003,0.36786,0,No
8267,magnesia,4,13.71023782,3,9.721185996,9.721165996,12,133.2797719,4,1,5,4,3,7,5,0.345599,0.354479,0,No
8332,macaque,4,13.71023782,3,9.721185996,9.721165996,12,133.2797719,2,2,4,4,2,6,5,0.319125,0.323072,0,No
8479,loomis,4,13.71023782,3,9.721185996,9.721165996,12,133.2797719,3,3,6,4,4,8,4,0.390003,0.406756,0,No
8501,lollipop,4,13.71023782,3,9.721185996,9.721165996,12,133.2797719,4,4,8,4,4,8,5,0.347677,0.356814,0,No
8672,ligature,4,13.71023782,3,9.721185996,9.721165996,12,133.2797719,2,4,6,4,4,8,5,0.372764,0.387656,0,No
8855,layton,4,13.71023782,3,9.721185996,9.721165996,12,133.2797719,2,4,6,2,4,6,5,0.346862,0.356155,0,No
8901,lathe,4,13.71023782,3,9.721185996,9.721165996,12,133.2797719,2,3,5,2,4,6,5,0.385238,0.401765,0,No
8922,larsen,4,13.71023782,3,9.721185996,9.721165996,12,133.2797719,3,2,5,3,3,6,5,0.32338,0.326731,0,No
8934,laramie,4,13.71023782,3,9.721185996,9.721165996,12,133.2797719,4,4,8,4,4,8,5,0.347779,0.357159,0,No
8977,laminar,4,13.71023782,3,9.721185996,9.721165996,12,133.2797719,2,2,4,3,4,7,5,0.325044,0.328582,0,No
9049,krueger,4,13.71023782,3,9.721185996,9.721165996,12,133.2797719,1,3,4,4,3,7,4,0.403661,0.421197,0,No
9161,kigali,4,13.71023782,3,9.721185996,9.721165996,12,133.2797719,3,1,4,3,3,6,5,0.398076,0.415824,0,No
9347,joyride,4,13.71023782,3,9.721185996,9.721165996,12,133.2797719,2,2,4,2,2,4,5,0.347249,0.35646,0,No
9349,joyful,4,13.71023782,3,9.721185996,9.721165996,12,133.2797719,3,3,6,4,4,8,5,0.330516,0.33516,0,No
9468,jawbone,4,13.71023782,3,9.721185996,9.721165996,12,133.2797719,2,3,5,2,3,5,5,0.366514,0.380238,0,No
9769,insectivore,4,13.71023782,3,9.721185996,9.721165996,12,133.2797719,3,3,6,4,4,8,5,0.357934,0.369802,0,No
9774,inquisitor,4,13.71023782,3,9.721185996,9.721165996,12,133.2797719,3,3,6,3,3,6,4,0.408661,0.426225,0,No
9986,inbred,4,13.71023782,3,9.721185996,9.721165996,12,133.2797719,4,3,7,4,3,7,5,0.339064,0.345936,0,No
10001,impure,4,13.71023782,3,9.721185996,9.721165996,12,133.2797719,3,2,5,3,2,5,5,0.327896,0.332055,0,No
10124,iconography,4,13.71023782,3,9.721185996,9.721165996,12,133.2797719,3,3,6,3,3,6,5,0.357084,0.368887,0,No
10187,hydrochloride,4,13.71023782,3,9.721185996,9.721165996,12,133.2797719,0,3,3,0,4,4,4,0.389888,0.406635,0,No
10346,hoop,4,13.71023782,3,9.721185996,9.721165996,12,133.2797719,3,3,6,4,3,7,5,0.328193,0.33237,0,No
10489,hilt,4,13.71023782,3,9.721185996,9.721165996,12,133.2797719,3,4,7,4,4,8,4,0.395504,0.412629,0,No
10559,herpetology,4,13.71023782,3,9.721185996,9.721165996,12,133.2797719,2,4,6,3,4,7,4,0.406146,0.423723,0,No
10561,heron,4,13.71023782,3,9.721185996,9.721165996,12,133.2797719,3,4,7,4,4,8,5,0.350776,0.360981,0,No
10711,headphone,4,13.71023782,3,9.721185996,9.721165996,12,133.2797719,2,3,5,4,4,8,5,0.388425,0.405045,0,No
10762,hatchet,4,13.71023782,3,9.721185996,9.721165996,12,133.2797719,2,3,5,4,3,7,5,0.345848,0.354803,0,No
10820,harass,4,13.71023782,3,9.721185996,9.721165996,12,133.2797719,2,4,6,3,4,7,4,0.400005,0.417418,0,No
10851,handshake,4,13.71023782,3,9.721185996,9.721165996,12,133.2797719,3,4,7,4,4,8,4,0.391621,0.408883,0,No
10911,haircut,4,13.71023782,3,9.721185996,9.721165996,12,133.2797719,1,3,4,4,4,8,5,0.352889,0.363589,0,No
10935,hacienda,4,13.71023782,3,9.721185996,9.721165996,12,133.2797719,3,1,4,4,2,6,5,0.276052,0.282008,0,No
11015,guggenheim,4,13.71023782,3,9.721185996,9.721165996,12,133.2797719,4,2,6,4,3,7,5,0.32178,0.325191,0,No
11055,groton,4,13.71023782,3,9.721185996,9.721165996,12,133.2797719,3,3,6,3,4,7,5,0.331633,0.336221,0,No
11064,grocer,4,13.71023782,3,9.721185996,9.721165996,12,133.2797719,2,3,5,3,3,6,5,0.378019,0.394642,0,No
11252,goldstein,4,13.71023782,3,9.721185996,9.721165996,12,133.2797719,4,2,6,4,2,6,5,0.333021,0.337865,0,No
11299,glycerin,4,13.71023782,3,9.721185996,9.721165996,12,133.2797719,3,3,6,4,4,8,4,0.389781,0.406522,0,No
11384,gilchrist,4,13.71023782,3,9.721185996,9.721165996,12,133.2797719,4,4,8,4,4,8,5,0.385263,0.40159,0,No
11391,gigahertz,4,13.71023782,3,9.721185996,9.721165996,12,133.2797719,4,2,6,4,2,6,5,0.34733,0.356685,0,No
11434,gerber,4,13.71023782,3,9.721185996,9.721165996,12,133.2797719,2,3,5,2,4,6,5,0.336454,0.342478,0,No
11452,geocentric,4,13.71023782,3,9.721185996,9.721165996,12,133.2797719,4,3,7,4,4,8,5,0.32361,0.326831,0,No
11520,gator,4,13.71023782,3,9.721185996,9.721165996,12,133.2797719,2,2,4,3,2,5,4,0.389764,0.406479,0,No
11782,fraudulent,4,13.71023782,3,9.721185996,9.721165996,12,133.2797719,3,2,5,3,2,5,5,0.345639,0.354549,0,No
11931,folly,4,13.71023782,3,9.721185996,9.721165996,12,133.2797719,2,3,5,2,4,6,4,0.387915,0.404982,0,No
11941,folic,4,13.71023782,3,9.721185996,9.721165996,12,133.2797719,2,1,3,4,4,8,5,0.318238,0.321893,0,No
12011,flo,4,13.71023782,3,9.721185996,9.721165996,12,133.2797719,1,3,4,1,3,4,4,0.390003,0.406766,0,No
12113,fireman,4,13.71023782,3,9.721185996,9.721165996,12,133.2797719,3,3,6,3,3,6,5,0.385481,0.40181,0,No
12622,etruria,4,13.71023782,3,9.721185996,9.721165996,12,133.2797719,3,3,6,4,3,7,5,0.366416,0.380126,0,No
12811,englewood,4,13.71023782,3,9.721185996,9.721165996,12,133.2797719,3,3,6,3,3,6,5,0.350616,0.360598,0,No
12828,endorse,4,13.71023782,3,9.721185996,9.721165996,12,133.2797719,2,3,5,4,3,7,5,0.398648,0.416401,0,No
12856,emory,4,13.71023782,3,9.721185996,9.721165996,12,133.2797719,4,2,6,4,2,6,5,0.324575,0.328279,0,No
12874,emigrant,4,13.71023782,3,9.721185996,9.721165996,12,133.2797719,3,1,4,4,1,5,5,0.326858,0.330739,0,No
12898,emacs,4,13.71023782,3,9.721185996,9.721165996,12,133.2797719,2,4,6,3,4,7,4,0.405607,0.423178,0,No
12918,ellsworth,4,13.71023782,3,9.721185996,9.721165996,12,133.2797719,3,2,5,3,2,5,5,0.347909,0.357464,0,No
12990,eisner,4,13.71023782,3,9.721185996,9.721165996,12,133.2797719,2,4,6,3,4,7,5,0.337324,0.343696,0,No
13011,eggshell,4,13.71023782,3,9.721185996,9.721165996,12,133.2797719,4,3,7,4,4,8,4,0.405255,0.422821,0,No
13012,eggplant,4,13.71023782,3,9.721185996,9.721165996,12,133.2797719,1,2,3,1,4,5,5,0.346753,0.355815,0,No
13020,effie,4,13.71023782,3,9.721185996,9.721165996,12,133.2797719,3,3,6,4,4,8,5,0.384862,0.401125,0,No
13119,dystrophy,4,13.71023782,3,9.721185996,9.721165996,12,133.2797719,1,1,2,4,1,5,5,0.323728,0.327918,0,No
13244,drip,4,13.71023782,3,9.721185996,9.721165996,12,133.2797719,3,2,5,3,2,5,5,0.341957,0.349876,0,No
13284,drab,4,13.71023782,3,9.721185996,9.721165996,12,133.2797719,2,4,6,4,4,8,5,0.361329,0.373936,0,No
13324,dosage,4,13.71023782,3,9.721185996,9.721165996,12,133.2797719,3,2,5,3,4,7,5,0.36662,0.380527,0,No
13405,dod,4,13.71023782,3,9.721185996,9.721165996,12,133.2797719,3,4,7,3,4,7,4,0.417966,0.435088,0,No
13437,diversion,4,13.71023782,3,9.721185996,9.721165996,12,133.2797719,4,2,6,4,3,7,5,0.345801,0.354709,0,No
13461,dissipate,4,13.71023782,3,9.721185996,9.721165996,12,133.2797719,2,2,4,4,2,6,5,0.398237,0.415978,0,No
13504,dis,4,13.71023782,3,9.721185996,9.721165996,12,133.2797719,1,2,3,1,2,3,5,0.384254,0.400439,0,No
13617,dialysis,4,13.71023782,3,9.721185996,9.721165996,12,133.2797719,2,3,5,2,3,5,5,0.366991,0.380992,0,No
13784,delusion,4,13.71023782,3,9.721185996,9.721165996,12,133.2797719,3,2,5,4,3,7,4,0.38772,0.404771,0,No
13928,deane,4,13.71023782,3,9.721185996,9.721165996,12,133.2797719,3,2,5,3,2,5,5,0.3371,0.343215,0,No
14069,cynic,4,13.71023782,3,9.721185996,9.721165996,12,133.2797719,3,3,6,3,3,6,5,0.360763,0.373617,0,No
14140,cumulus,4,13.71023782,3,9.721185996,9.721165996,12,133.2797719,2,1,3,3,1,4,5,0.384237,0.400402,0,No
14179,cryptanalyst,4,13.71023782,3,9.721185996,9.721165996,12,133.2797719,2,2,4,4,3,7,5,0.333014,0.339008,0,No
14194,crumple,4,13.71023782,3,9.721185996,9.721165996,12,133.2797719,2,3,5,3,3,6,5,0.395689,0.412796,0,No
14221,crossbar,4,13.71023782,3,9.721185996,9.721165996,12,133.2797719,1,3,4,4,4,8,4,0.388637,0.405249,0,No
14308,cranberry,4,13.71023782,3,9.721185996,9.721165996,12,133.2797719,4,3,7,4,4,8,5,0.327866,0.332059,0,No
14315,craftsman,4,13.71023782,3,9.721185996,9.721165996,12,133.2797719,2,3,5,2,3,5,5,0.347446,0.356821,0,No
14393,cottonwood,4,13.71023782,3,9.721185996,9.721165996,12,133.2797719,2,4,6,2,4,6,5,0.350783,0.360908,0,No
14417,corundum,4,13.71023782,3,9.721185996,9.721165996,12,133.2797719,3,4,7,3,4,7,4,0.417454,0.434487,0,No
14495,coon,4,13.71023782,3,9.721185996,9.721165996,12,133.2797719,3,1,4,3,1,4,5,0.345599,0.354479,0,No
14505,coo,4,13.71023782,3,9.721185996,9.721165996,12,133.2797719,2,4,6,2,4,6,5,0.358758,0.370792,0,No
14645,conley,4,13.71023782,3,9.721185996,9.721165996,12,133.2797719,3,2,5,4,2,6,5,0.332758,0.337804,0,No
14709,concurrent,4,13.71023782,3,9.721185996,9.721165996,12,133.2797719,4,4,8,4,4,8,5,0.352195,0.362632,0,No
14955,cochrane,4,13.71023782,3,9.721185996,9.721165996,12,133.2797719,4,3,7,4,3,7,5,0.346686,0.355873,0,No
15014,clog,4,13.71023782,3,9.721185996,9.721165996,12,133.2797719,4,4,8,4,4,8,5,0.346964,0.35614,0,No
15121,cite,4,13.71023782,3,9.721185996,9.721165996,12,133.2797719,2,4,6,2,4,6,5,0.330589,0.337647,0,No
15150,cinder,4,13.71023782,3,9.721185996,9.721165996,12,133.2797719,3,3,6,4,3,7,5,0.319579,0.32309,0,No
15161,chute,4,13.71023782,3,9.721185996,9.721165996,12,133.2797719,3,2,5,4,2,6,5,0.400212,0.417922,0,No
15178,chrysalis,4,13.71023782,3,9.721185996,9.721165996,12,133.2797719,2,3,5,4,3,7,4,0.389892,0.406644,0,No
15244,chirp,4,13.71023782,3,9.721185996,9.721165996,12,133.2797719,4,4,8,4,4,8,4,0.390527,0.407339,0,No
15299,cherub,4,13.71023782,3,9.721185996,9.721165996,12,133.2797719,3,3,6,4,3,7,5,0.354276,0.365307,0,No
15325,checkerboard,4,13.71023782,3,9.721185996,9.721165996,12,133.2797719,4,2,6,4,2,6,5,0.345364,0.353975,0,No
15454,centipede,4,13.71023782,3,9.721185996,9.721165996,12,133.2797719,2,2,4,4,3,7,5,0.348715,0.358242,0,No
15475,celia,4,13.71023782,3,9.721185996,9.721165996,12,133.2797719,2,3,5,2,3,5,5,0.363125,0.376276,0,No
15495,cayenne,4,13.71023782,3,9.721185996,9.721165996,12,133.2797719,2,1,3,2,1,3,5,0.304383,0.309727,0,No
15662,carbonyl,4,13.71023782,3,9.721185996,9.721165996,12,133.2797719,3,2,5,3,3,6,5,0.325952,0.329499,0,No
15664,carbonic,4,13.71023782,3,9.721185996,9.721165996,12,133.2797719,4,1,5,4,4,8,5,0.318244,0.321897,0,No
15682,caption,4,13.71023782,3,9.721185996,9.721165996,12,133.2797719,3,4,7,4,4,8,4,0.417769,0.434919,0,No
15738,candela,4,13.71023782,3,9.721185996,9.721165996,12,133.2797719,3,2,5,4,2,6,5,0.345929,0.354873,0,No
15739,cancerous,4,13.71023782,3,9.721185996,9.721165996,12,133.2797719,4,2,6,4,2,6,5,0.324261,0.32763,0,No
15804,calico,4,13.71023782,3,9.721185996,9.721165996,12,133.2797719,4,3,7,4,4,8,5,0.325599,0.329135,0,No
15883,buttress,4,13.71023782,3,9.721185996,9.721165996,12,133.2797719,1,3,4,3,3,6,5,0.349601,0.359676,0,No
16065,brookhaven,4,13.71023782,3,9.721185996,9.721165996,12,133.2797719,3,3,6,4,3,7,5,0.410124,0.427734,0,No
16126,bridgetown,4,13.71023782,3,9.721185996,9.721165996,12,133.2797719,4,3,7,4,4,8,5,0.402417,0.42018,0,No
16149,brenner,4,13.71023782,3,9.721185996,9.721165996,12,133.2797719,3,4,7,4,4,8,5,0.362398,0.37543,0,No
16341,bonneville,4,13.71023782,3,9.721185996,9.721165996,12,133.2797719,3,3,6,4,4,8,5,0.326533,0.330554,0,No
16370,bole,4,13.71023782,3,9.721185996,9.721165996,12,133.2797719,4,3,7,4,3,7,4,0.425796,0.442219,0,No
16457,bloch,4,13.71023782,3,9.721185996,9.721165996,12,133.2797719,3,2,5,3,2,5,5,0.326912,0.330408,0,No
16470,blight,4,13.71023782,3,9.721185996,9.721165996,12,133.2797719,3,4,7,4,4,8,4,0.394248,0.411606,0,No
16505,blackman,4,13.71023782,3,9.721185996,9.721165996,12,133.2797719,0,3,3,0,3,3,5,0.351427,0.361472,0,No
16741,belladonna,4,13.71023782,3,9.721185996,9.721165996,12,133.2797719,3,3,6,3,3,6,5,0.35319,0.363842,0,No
16792,beebe,4,13.71023782,3,9.721185996,9.721165996,12,133.2797719,2,4,6,2,4,6,5,0.348524,0.358192,0,No
16892,basemen,4,13.71023782,3,9.721185996,9.721165996,12,133.2797719,2,3,5,4,3,7,5,0.375436,0.392015,0,No
16996,bam,4,13.71023782,3,9.721185996,9.721165996,12,133.2797719,3,3,6,3,3,6,5,0.384262,0.400449,0,No
17043,bagley,4,13.71023782,3,9.721185996,9.721165996,12,133.2797719,2,3,5,2,3,5,5,0.347977,0.357568,0,No
17124,awaken,4,13.71023782,3,9.721185996,9.721165996,12,133.2797719,1,3,4,3,3,6,5,0.416553,0.434132,0,No
17202,augite,4,13.71023782,3,9.721185996,9.721165996,12,133.2797719,0,2,2,0,3,3,4,0.389751,0.406471,0,No
17257,atkinson,4,13.71023782,3,9.721185996,9.721165996,12,133.2797719,1,3,4,2,3,5,5,0.348079,0.357699,0,No
17287,astral,4,13.71023782,3,9.721185996,9.721165996,12,133.2797719,2,3,5,4,3,7,5,0.325599,0.329163,0,No
17293,asteria,4,13.71023782,3,9.721185996,9.721165996,12,133.2797719,3,1,4,4,1,5,5,0.345599,0.354479,0,No
17351,arum,4,13.71023782,3,9.721185996,9.721165996,12,133.2797719,2,2,4,3,3,6,5,0.337664,0.34411,0,No
17468,arcane,4,13.71023782,3,9.721185996,9.721165996,12,133.2797719,1,1,2,4,1,5,5,0.306973,0.312012,0,No
17469,arcana,4,13.71023782,3,9.721185996,9.721165996,12,133.2797719,2,2,4,4,2,6,5,0.384396,0.400599,0,No
17475,arbitrary,4,13.71023782,3,9.721185996,9.721165996,12,133.2797719,3,1,4,4,2,6,5,0.320647,0.32395,0,No
17532,apparition,4,13.71023782,3,9.721185996,9.721165996,12,133.2797719,4,2,6,4,3,7,5,0.378656,0.394472,0,No
17537,appalachia,4,13.71023782,3,9.721185996,9.721165996,12,133.2797719,3,4,7,3,4,7,4,0.389387,0.406526,0,No
17640,anonymity,4,13.71023782,3,9.721185996,9.721165996,12,133.2797719,1,3,4,2,3,5,5,0.371438,0.386048,0,No
17673,anion,4,13.71023782,3,9.721185996,9.721165996,12,133.2797719,2,3,5,3,3,6,5,0.33618,0.342436,0,No
17746,anagram,4,13.71023782,3,9.721185996,9.721165996,12,133.2797719,1,2,3,4,3,7,5,0.385038,0.401526,0,No
17823,amaranth,4,13.71023782,3,9.721185996,9.721165996,12,133.2797719,2,2,4,3,2,5,5,0.336448,0.342445,0,No
17883,allstate,4,13.71023782,3,9.721185996,9.721165996,12,133.2797719,1,1,2,4,4,8,5,0.320017,0.323239,0,No
17901,allegra,4,13.71023782,3,9.721185996,9.721165996,12,133.2797719,4,2,6,4,2,6,5,0.375539,0.392127,0,No
17974,albright,4,13.71023782,3,9.721185996,9.721165996,12,133.2797719,2,4,6,3,4,7,5,0.365067,0.378633,0,No
17989,alasdair,4,13.71023782,3,9.721185996,9.721165996,12,133.2797719,3,2,5,3,2,5,5,0.325653,0.329326,0,No
18079,afloat,4,13.71023782,3,9.721185996,9.721165996,12,133.2797719,3,3,6,4,4,8,4,0.409132,0.426535,0,No
18284,academician,4,13.71023782,3,9.721185996,9.721165996,12,133.2797719,4,4,8,4,4,8,4,0.409405,0.426943,0,No
18313,abrupt,4,13.71023782,3,9.721185996,9.721165996,12,133.2797719,4,3,7,4,3,7,5,0.319377,0.32293,0,No
18330,abo,4,13.71023782,3,9.721185996,9.721165996,12,133.2797719,3,3,6,4,4,8,5,0.377079,0.393571,0,No
229,woodchuck,6,13.30477271,2,10.1266511,10.1266411,12,134.7327912,1,4,5,5,5,10,5,0.358555,0.371001,0,No
566,wart,6,13.30477271,2,10.1266511,10.1266411,12,134.7327912,3,4,7,6,4,10,4,0.421579,0.438539,0,No
678,volterra,6,13.30477271,2,10.1266511,10.1266411,12,134.7327912,4,5,9,4,6,10,5,0.35369,0.364579,0,No
1185,turnabout,6,13.30477271,2,10.1266511,10.1266411,12,134.7327912,4,3,7,4,3,7,5,0.384371,0.40058,0,No
1301,triode,6,13.30477271,2,10.1266511,10.1266411,12,134.7327912,3,4,7,6,4,10,5,0.384987,0.401552,0,No
1620,tinder,6,13.30477271,2,10.1266511,10.1266411,12,134.7327912,5,5,10,6,6,12,5,0.368041,0.381992,0,No
1831,tetanus,6,13.30477271,2,10.1266511,10.1266411,12,134.7327912,3,4,7,3,4,7,5,0.348948,0.358586,0,No
2763,sprain,6,13.30477271,2,10.1266511,10.1266411,12,134.7327912,3,6,9,5,6,11,5,0.35712,0.368842,0,No
2858,spectrophotometer,6,13.30477271,2,10.1266511,10.1266411,12,134.7327912,5,2,7,6,3,9,4,0.405154,0.422704,0,No
3313,silicosis,6,13.30477271,2,10.1266511,10.1266411,12,134.7327912,5,4,9,5,6,11,4,0.427056,0.443388,0,No
3364,sibyl,6,13.30477271,2,10.1266511,10.1266411,12,134.7327912,2,6,8,2,6,8,4,0.392209,0.409395,0,No
5243,procaine,6,13.30477271,2,10.1266511,10.1266411,12,134.7327912,3,5,8,3,6,9,5,0.353937,0.364917,0,No
7353,morristown,6,13.30477271,2,10.1266511,10.1266411,12,134.7327912,5,5,10,5,6,11,5,0.364355,0.377555,0,No
7455,molybdenum,6,13.30477271,2,10.1266511,10.1266411,12,134.7327912,4,3,7,4,5,9,5,0.352818,0.363429,0,No
7571,mink,6,13.30477271,2,10.1266511,10.1266411,12,134.7327912,5,5,10,6,5,11,4,0.406155,0.423751,0,No
7692,metronome,6,13.30477271,2,10.1266511,10.1266411,12,134.7327912,2,4,6,4,5,9,5,0.372631,0.387595,0,No
8261,magnetron,6,13.30477271,2,10.1266511,10.1266411,12,134.7327912,1,5,6,1,6,7,5,0.354191,0.365157,0,No
8376,lusaka,6,13.30477271,2,10.1266511,10.1266411,12,134.7327912,4,5,9,4,5,9,5,0.351923,0.362328,0,No
8471,lope,6,13.30477271,2,10.1266511,10.1266411,12,134.7327912,3,1,4,3,5,8,5,0.314082,0.319063,0,No
8484,longue,6,13.30477271,2,10.1266511,10.1266411,12,134.7327912,5,0,5,6,0,6,0,0,0,0,No
10147,hysteria,6,13.30477271,2,10.1266511,10.1266411,12,134.7327912,4,5,9,4,6,10,5,0.362199,0.375079,0,No
10423,hoi,6,13.30477271,2,10.1266511,10.1266411,12,134.7327912,0,3,3,0,4,4,5,0.348461,0.357923,0,No
11172,grandeur,6,13.30477271,2,10.1266511,10.1266411,12,134.7327912,4,3,7,5,4,9,5,0.386884,0.403519,0,No
11354,glade,6,13.30477271,2,10.1266511,10.1266411,12,134.7327912,2,4,6,5,6,11,5,0.351742,0.362138,0,No
11373,ginn,6,13.30477271,2,10.1266511,10.1266411,12,134.7327912,3,4,7,5,4,9,4,0.402198,0.419746,0,No
11581,galt,6,13.30477271,2,10.1266511,10.1266411,12,134.7327912,4,5,9,5,5,10,5,0.352889,0.363631,0,No
11671,fume,6,13.30477271,2,10.1266511,10.1266411,12,134.7327912,4,3,7,5,4,9,5,0.338134,0.344614,0,No
12071,flageolet,6,13.30477271,2,10.1266511,10.1266411,12,134.7327912,4,4,8,6,6,12,4,0.390192,0.406982,0,No
12408,exxon,6,13.30477271,2,10.1266511,10.1266411,12,134.7327912,6,4,10,6,5,11,4,0.412776,0.429995,0,No
12602,euphorbia,6,13.30477271,2,10.1266511,10.1266411,12,134.7327912,5,3,8,5,3,8,5,0.351025,0.361105,0,No
13909,debtor,6,13.30477271,2,10.1266511,10.1266411,12,134.7327912,3,4,7,6,4,10,4,0.389935,0.406705,0,No
14044,daedalus,6,13.30477271,2,10.1266511,10.1266411,12,134.7327912,4,5,9,4,5,9,5,0.352188,0.362565,0,No
15275,chickadee,6,13.30477271,2,10.1266511,10.1266411,12,134.7327912,2,3,5,6,5,11,5,0.348332,0.357899,0,No
15379,chantilly,6,13.30477271,2,10.1266511,10.1266411,12,134.7327912,3,5,8,5,5,10,4,0.3915,0.408418,0,No
15714,cantaloupe,6,13.30477271,2,10.1266511,10.1266411,12,134.7327912,3,5,8,5,6,11,4,0.407835,0.42538,0,No
16816,beauregard,6,13.30477271,2,10.1266511,10.1266411,12,134.7327912,5,4,9,5,4,9,4,0.389234,0.406348,0,No
18033,ahmedabad,6,13.30477271,2,10.1266511,10.1266411,12,134.7327912,3,5,8,3,5,8,5,0.360448,0.373108,0,No
15436,cerium,13,12.53158282,1,10.81979828,10.81979828,13,135.5891983,11,5,16,13,13,26,5,0.354375,0.365453,0,No
26,ziegler,3,13.99791989,3,9.721185996,9.721165996,9,136.0763828,2,1,3,2,1,3,5,0.360829,0.373487,0,No
79,yoke,3,13.99791989,3,9.721185996,9.721165996,9,136.0763828,3,2,5,3,3,6,4,0.408351,0.425896,0,No
108,yeager,3,13.99791989,3,9.721185996,9.721165996,9,136.0763828,1,3,4,3,3,6,5,0.377071,0.393611,0,No
113,yarrow,3,13.99791989,3,9.721185996,9.721165996,9,136.0763828,2,3,5,2,3,5,5,0.346665,0.355788,0,No
134,xhosa,3,13.99791989,3,9.721185996,9.721165996,9,136.0763828,1,2,3,1,3,4,5,0.316242,0.320082,0,No
202,workout,3,13.99791989,3,9.721185996,9.721165996,9,136.0763828,2,3,5,2,3,5,5,0.38543,0.401773,0,No
219,woodwork,3,13.99791989,3,9.721185996,9.721165996,9,136.0763828,2,3,5,2,3,5,4,0.387247,0.403733,0,No
284,wintertime,3,13.99791989,3,9.721185996,9.721165996,9,136.0763828,2,2,4,3,2,5,5,0.323327,0.326518,0,No
293,wink,3,13.99791989,3,9.721185996,9.721165996,9,136.0763828,2,3,5,2,3,5,5,0.322125,0.326063,0,No
311,winch,3,13.99791989,3,9.721185996,9.721165996,9,136.0763828,1,2,3,3,3,6,5,0.348537,0.358145,0,No
363,wi,3,13.99791989,3,9.721185996,9.721165996,9,136.0763828,2,3,5,3,3,6,4,0.406462,0.424014,0,No
385,whitehorse,3,13.99791989,3,9.721185996,9.721165996,9,136.0763828,3,3,6,3,3,6,5,0.398738,0.416528,0,No
395,whirlpool,3,13.99791989,3,9.721185996,9.721165996,9,136.0763828,2,2,4,2,2,4,5,0.378696,0.394514,0,No
408,whereupon,3,13.99791989,3,9.721185996,9.721165996,9,136.0763828,2,2,4,2,2,4,4,0.400248,0.417826,0,No
440,westinghouse,3,13.99791989,3,9.721185996,9.721165996,9,136.0763828,3,1,4,3,1,4,5,0.319953,0.324254,0,No
531,waterproof,3,13.99791989,3,9.721185996,9.721165996,9,136.0763828,3,2,5,3,2,5,5,0.332229,0.339495,0,No
631,wail,3,13.99791989,3,9.721185996,9.721165996,9,136.0763828,3,1,4,3,2,5,5,0.345599,0.354479,0,No
642,waddle,3,13.99791989,3,9.721185996,9.721165996,9,136.0763828,3,2,5,3,2,5,5,0.34945,0.359488,0,No
656,vt,3,13.99791989,3,9.721185996,9.721165996,9,136.0763828,3,2,5,3,2,5,5,0.326714,0.331763,0,No
719,vitae,3,13.99791989,3,9.721185996,9.721165996,9,136.0763828,1,3,4,3,3,6,5,0.384704,0.400956,0,No
767,villainous,3,13.99791989,3,9.721185996,9.721165996,9,136.0763828,3,1,4,3,2,5,5,0.327027,0.330665,0,No
777,vigilante,3,13.99791989,3,9.721185996,9.721165996,9,136.0763828,2,2,4,2,2,4,5,0.357508,0.369787,0,No
779,vigil,3,13.99791989,3,9.721185996,9.721165996,9,136.0763828,1,2,3,2,2,4,5,0.380661,0.396711,0,No
797,vicky,3,13.99791989,3,9.721185996,9.721165996,9,136.0763828,3,1,4,3,1,4,5,0.398076,0.415824,0,No
830,vertigo,3,13.99791989,3,9.721185996,9.721165996,9,136.0763828,2,3,5,2,3,5,4,0.41914,0.436252,0,No
882,venison,3,13.99791989,3,9.721185996,9.721165996,9,136.0763828,3,2,5,3,3,6,5,0.342109,0.350036,0,No
893,vendor,3,13.99791989,3,9.721185996,9.721165996,9,136.0763828,2,1,3,2,1,3,5,0.341786,0.349679,0,No
962,valet,3,13.99791989,3,9.721185996,9.721165996,9,136.0763828,2,2,4,3,2,5,5,0.339336,0.345981,0,No
982,utterance,3,13.99791989,3,9.721185996,9.721165996,9,136.0763828,2,2,4,2,2,4,5,0.382953,0.399188,0,No
985,utopian,3,13.99791989,3,9.721185996,9.721165996,9,136.0763828,3,1,4,3,1,4,5,0.295318,0.301468,0,No
993,utensil,3,13.99791989,3,9.721185996,9.721165996,9,136.0763828,1,2,3,1,2,3,5,0.338967,0.345796,0,No
1054,upholstery,3,13.99791989,3,9.721185996,9.721165996,9,136.0763828,1,1,2,1,1,2,5,0.384229,0.400392,0,No
1060,updraft,3,13.99791989,3,9.721185996,9.721165996,9,136.0763828,1,3,4,1,3,4,4,0.415802,0.433093,0,No
1103,ulna,3,13.99791989,3,9.721185996,9.721165996,9,136.0763828,3,3,6,3,3,6,4,0.415753,0.433037,0,No
1148,twig,3,13.99791989,3,9.721185996,9.721165996,9,136.0763828,1,3,4,1,3,4,5,0.347786,0.356861,0,No
1176,turret,3,13.99791989,3,9.721185996,9.721165996,9,136.0763828,2,3,5,3,3,6,5,0.361248,0.374036,0,No
1200,turban,3,13.99791989,3,9.721185996,9.721165996,9,136.0763828,2,3,5,3,3,6,5,0.356417,0.367936,0,No
1225,tuft,3,13.99791989,3,9.721185996,9.721165996,9,136.0763828,3,2,5,3,3,6,5,0.379961,0.395871,0,No
1230,tuck,3,13.99791989,3,9.721185996,9.721165996,9,136.0763828,2,3,5,3,3,6,5,0.395936,0.413058,0,No
1264,trouser,3,13.99791989,3,9.721185996,9.721165996,9,136.0763828,2,3,5,2,3,5,5,0.344218,0.352723,0,No
1270,tropospheric,3,13.99791989,3,9.721185996,9.721165996,9,136.0763828,0,1,1,0,3,3,5,0.31098,0.315539,0,No
1318,trident,3,13.99791989,3,9.721185996,9.721165996,9,136.0763828,2,3,5,2,3,5,5,0.384287,0.400491,0,No
1400,transmissible,3,13.99791989,3,9.721185996,9.721165996,9,136.0763828,1,0,1,1,0,1,0,0,0,0,No
1488,totem,3,13.99791989,3,9.721185996,9.721165996,9,136.0763828,2,1,3,2,1,3,5,0.319763,0.323106,0,No
1503,torrential,3,13.99791989,3,9.721185996,9.721165996,9,136.0763828,2,1,3,2,2,4,5,0.319988,0.323381,0,No
1542,tonnage,3,13.99791989,3,9.721185996,9.721165996,9,136.0763828,2,2,4,3,3,6,5,0.378712,0.394533,0,No
1558,tombstone,3,13.99791989,3,9.721185996,9.721165996,9,136.0763828,3,2,5,3,2,5,4,0.405163,0.422713,0,No
1582,toffee,3,13.99791989,3,9.721185996,9.721165996,9,136.0763828,1,2,3,1,2,3,5,0.345673,0.354587,0,No
1601,titian,3,13.99791989,3,9.721185996,9.721165996,9,136.0763828,1,3,4,1,3,4,5,0.385422,0.401754,0,No
1626,timid,3,13.99791989,3,9.721185996,9.721165996,9,136.0763828,3,2,5,3,2,5,5,0.319033,0.322477,0,No
1686,throwback,3,13.99791989,3,9.721185996,9.721165996,9,136.0763828,0,0,0,0,0,0,0,0,0,0,No
1700,thrift,3,13.99791989,3,9.721185996,9.721165996,9,136.0763828,3,2,5,3,2,5,5,0.320259,0.323684,0,No
1740,thirtieth,3,13.99791989,3,9.721185996,9.721165996,9,136.0763828,1,2,3,3,2,5,5,0.32684,0.330325,0,No
1894,tempt,3,13.99791989,3,9.721185996,9.721165996,9,136.0763828,2,3,5,3,3,6,5,0.333239,0.338379,0,No
1930,teflon,3,13.99791989,3,9.721185996,9.721165996,9,136.0763828,2,3,5,3,3,6,5,0.324415,0.32786,0,No
1958,teak,3,13.99791989,3,9.721185996,9.721165996,9,136.0763828,3,3,6,3,3,6,4,0.422432,0.439125,0,No
2008,tapioca,3,13.99791989,3,9.721185996,9.721165996,9,136.0763828,3,3,6,3,3,6,5,0.344152,0.352676,0,No
2021,tannin,3,13.99791989,3,9.721185996,9.721165996,9,136.0763828,2,3,5,2,3,5,5,0.347025,0.356263,0,No
2049,talmudic,3,13.99791989,3,9.721185996,9.721165996,9,136.0763828,2,3,5,3,3,6,5,0.384287,0.400496,0,No
2051,tally,3,13.99791989,3,9.721185996,9.721165996,9,136.0763828,2,1,3,2,1,3,5,0.319953,0.323257,0,No
2080,tad,3,13.99791989,3,9.721185996,9.721165996,9,136.0763828,1,1,2,1,1,2,5,0.345606,0.354483,0,No
2206,swarthmore,3,13.99791989,3,9.721185996,9.721165996,9,136.0763828,1,1,2,2,3,5,5,0.324527,0.32819,0,No
2220,sw,3,13.99791989,3,9.721185996,9.721165996,9,136.0763828,2,2,4,2,2,4,5,0.384379,0.400576,0,No
2240,susanne,3,13.99791989,3,9.721185996,9.721165996,9,136.0763828,2,0,2,2,0,2,0,0,0,0,No
2349,sugary,3,13.99791989,3,9.721185996,9.721165996,9,136.0763828,2,2,4,3,2,5,5,0.320896,0.324336,0,No
2378,subversive,3,13.99791989,3,9.721185996,9.721165996,9,136.0763828,1,2,3,1,2,3,5,0.398094,0.415861,0,No
2409,stuyvesant,3,13.99791989,3,9.721185996,9.721165996,9,136.0763828,2,1,3,3,1,4,5,0.324908,0.328151,0,No
2432,stubby,3,13.99791989,3,9.721185996,9.721165996,9,136.0763828,3,1,4,3,1,4,5,0.319446,0.322846,0,No
2446,strom,3,13.99791989,3,9.721185996,9.721165996,9,136.0763828,3,0,3,3,0,3,0,0,0,0,No
2481,stratton,3,13.99791989,3,9.721185996,9.721165996,9,136.0763828,3,1,4,3,1,4,5,0.315075,0.319468,0,No
2490,strangle,3,13.99791989,3,9.721185996,9.721165996,9,136.0763828,3,2,5,3,3,6,4,0.400971,0.418554,0,No
2505,storyteller,3,13.99791989,3,9.721185996,9.721165996,9,136.0763828,3,1,4,3,1,4,5,0.323604,0.327285,0,No
2541,stirrup,3,13.99791989,3,9.721185996,9.721165996,9,136.0763828,3,2,5,3,2,5,5,0.369405,0.383823,0,No
2592,stencil,3,13.99791989,3,9.721185996,9.721165996,9,136.0763828,1,3,4,1,3,4,5,0.35955,0.372006,0,No
2606,steely,3,13.99791989,3,9.721185996,9.721165996,9,136.0763828,2,1,3,3,3,6,5,0.29166,0.297952,0,No
2610,stearns,3,13.99791989,3,9.721185996,9.721165996,9,136.0763828,3,3,6,3,3,6,5,0.379149,0.395026,0,No
2619,steadfast,3,13.99791989,3,9.721185996,9.721165996,9,136.0763828,2,2,4,2,2,4,5,0.324569,0.328004,0,No
2634,stationery,3,13.99791989,3,9.721185996,9.721165996,9,136.0763828,3,2,5,3,2,5,5,0.375333,0.391892,0,No
2647,starry,3,13.99791989,3,9.721185996,9.721165996,9,136.0763828,2,2,4,2,2,4,5,0.32213,0.32564,0,No
2650,starlight,3,13.99791989,3,9.721185996,9.721165996,9,136.0763828,1,2,3,1,2,3,5,0.32597,0.329351,0,No
2670,standish,3,13.99791989,3,9.721185996,9.721165996,9,136.0763828,1,2,3,1,3,4,5,0.348448,0.358023,0,No
2698,stagnant,3,13.99791989,3,9.721185996,9.721165996,9,136.0763828,1,2,3,2,2,4,5,0.317913,0.321494,0,No
2761,sprawl,3,13.99791989,3,9.721185996,9.721165996,9,136.0763828,2,3,5,3,3,6,4,0.424858,0.441365,0,No
2764,sprague,3,13.99791989,3,9.721185996,9.721165996,9,136.0763828,2,3,5,3,3,6,5,0.38058,0.396584,0,No
2770,sporty,3,13.99791989,3,9.721185996,9.721165996,9,136.0763828,2,2,4,2,3,5,5,0.327219,0.330748,0,No
2776,sporadic,3,13.99791989,3,9.721185996,9.721165996,9,136.0763828,2,3,5,2,3,5,5,0.324943,0.328409,0,No
2779,spooky,3,13.99791989,3,9.721185996,9.721165996,9,136.0763828,2,2,4,2,2,4,5,0.321355,0.327526,0,No
2793,spoil,3,13.99791989,3,9.721185996,9.721165996,9,136.0763828,3,3,6,3,3,6,5,0.354234,0.365503,0,No
2816,spinnaker,3,13.99791989,3,9.721185996,9.721165996,9,136.0763828,1,3,4,2,3,5,4,0.407217,0.424863,0,No
2822,spilt,3,13.99791989,3,9.721185996,9.721165996,9,136.0763828,3,2,5,3,2,5,5,0.328929,0.333476,0,No
2879,spawn,3,13.99791989,3,9.721185996,9.721165996,9,136.0763828,3,1,4,3,1,4,6,0.284061,0.290299,0,No
2887,sparse,3,13.99791989,3,9.721185996,9.721165996,9,136.0763828,2,0,2,2,0,2,0,0,0,0,No
2989,somber,3,13.99791989,3,9.721185996,9.721165996,9,136.0763828,3,2,5,3,2,5,5,0.384387,0.400585,0,No
3011,solicit,3,13.99791989,3,9.721185996,9.721165996,9,136.0763828,1,2,3,3,2,5,5,0.333803,0.340094,0,No
3019,solace,3,13.99791989,3,9.721185996,9.721165996,9,136.0763828,2,3,5,3,3,6,5,0.348175,0.357449,0,No
3094,smuggle,3,13.99791989,3,9.721185996,9.721165996,9,136.0763828,2,1,3,3,1,4,5,0.299519,0.305346,0,No
3103,smithy,3,13.99791989,3,9.721185996,9.721165996,9,136.0763828,2,3,5,2,3,5,4,0.390802,0.407813,0,No
3145,sliver,3,13.99791989,3,9.721185996,9.721165996,9,136.0763828,3,2,5,3,2,5,5,0.378664,0.394472,0,No
3184,slapstick,3,13.99791989,3,9.721185996,9.721165996,9,136.0763828,2,2,4,2,2,4,5,0.398121,0.415885,0,No
3188,slander,3,13.99791989,3,9.721185996,9.721165996,9,136.0763828,3,3,6,3,3,6,5,0.371975,0.386696,0,No
3192,slag,3,13.99791989,3,9.721185996,9.721165996,9,136.0763828,2,3,5,2,3,5,5,0.385564,0.401895,0,No
3205,skit,3,13.99791989,3,9.721185996,9.721165996,9,136.0763828,1,2,3,2,2,4,5,0.344085,0.352403,0,No
3207,skirmish,3,13.99791989,3,9.721185996,9.721165996,9,136.0763828,3,3,6,3,3,6,5,0.380955,0.397044,0,No
3209,skipjack,3,13.99791989,3,9.721185996,9.721165996,9,136.0763828,2,1,3,2,2,4,5,0.305152,0.310447,0,No
3237,situ,3,13.99791989,3,9.721185996,9.721165996,9,136.0763828,2,2,4,3,2,5,5,0.41002,0.427616,0,No
3272,sinbad,3,13.99791989,3,9.721185996,9.721165996,9,136.0763828,2,3,5,2,3,5,4,0.422462,0.439154,0,No
3296,simian,3,13.99791989,3,9.721185996,9.721165996,9,136.0763828,2,2,4,2,2,4,5,0.32361,0.326891,0,No
3326,signpost,3,13.99791989,3,9.721185996,9.721165996,9,136.0763828,2,3,5,3,3,6,4,0.422915,0.439576,0,No
3370,sial,3,13.99791989,3,9.721185996,9.721165996,9,136.0763828,2,1,3,2,1,3,5,0.308692,0.313582,0,No
3390,shrike,3,13.99791989,3,9.721185996,9.721165996,9,136.0763828,1,2,3,2,2,4,5,0.394633,0.411702,0,No
3393,shreveport,3,13.99791989,3,9.721185996,9.721165996,9,136.0763828,1,1,2,3,2,5,5,0.316107,0.320156,0,No
3396,shrank,3,13.99791989,3,9.721185996,9.721165996,9,136.0763828,1,2,3,1,3,4,5,0.388391,0.405141,0,No
3532,shaken,3,13.99791989,3,9.721185996,9.721165996,9,136.0763828,2,2,4,2,3,5,4,0.389669,0.406371,0,No
3538,shaffer,3,13.99791989,3,9.721185996,9.721165996,9,136.0763828,3,2,5,3,2,5,5,0.353022,0.363436,0,No
3549,sextet,3,13.99791989,3,9.721185996,9.721165996,9,136.0763828,3,2,5,3,2,5,5,0.37569,0.392259,0,No
3577,servitude,3,13.99791989,3,9.721185996,9.721165996,9,136.0763828,3,3,6,3,3,6,5,0.356897,0.368946,0,No
3694,sedentary,3,13.99791989,3,9.721185996,9.721165996,9,136.0763828,1,2,3,1,2,3,5,0.332553,0.337539,0,No
3729,searchlight,3,13.99791989,3,9.721185996,9.721165996,9,136.0763828,1,2,3,1,2,3,5,0.336263,0.342291,0,No
3739,seahorse,3,13.99791989,3,9.721185996,9.721165996,9,136.0763828,2,2,4,2,2,4,5,0.330935,0.336578,0,No
3768,scriptural,3,13.99791989,3,9.721185996,9.721165996,9,136.0763828,2,1,3,2,1,3,5,0.297601,0.30352,0,No
3788,scrabble,3,13.99791989,3,9.721185996,9.721165996,9,136.0763828,3,3,6,3,3,6,4,0.389789,0.406531,0,No
3834,schooner,3,13.99791989,3,9.721185996,9.721165996,9,136.0763828,2,2,4,2,2,4,5,0.375357,0.391921,0,No
3839,schoolmaster,3,13.99791989,3,9.721185996,9.721165996,9,136.0763828,3,2,5,3,2,5,5,0.361263,0.373922,0,No
3842,schoolboy,3,13.99791989,3,9.721185996,9.721165996,9,136.0763828,2,3,5,2,3,5,5,0.384262,0.400468,0,No
3851,schmitt,3,13.99791989,3,9.721185996,9.721165996,9,136.0763828,2,3,5,2,3,5,5,0.326215,0.329732,0,No
3876,scat,3,13.99791989,3,9.721185996,9.721165996,9,136.0763828,2,1,3,3,1,4,5,0.359172,0.371523,0,No
3904,scaffold,3,13.99791989,3,9.721185996,9.721165996,9,136.0763828,1,3,4,2,3,5,5,0.384545,0.400777,0,No
3938,saucepan,3,13.99791989,3,9.721185996,9.721165996,9,136.0763828,2,1,3,2,1,3,5,0.326419,0.330114,0,No
3947,satisfaction,3,13.99791989,3,9.721185996,9.721165996,9,136.0763828,2,2,4,3,2,5,5,0.330079,0.334636,0,No
4059,salesmen,3,13.99791989,3,9.721185996,9.721165996,9,136.0763828,2,2,4,2,2,4,5,0.327473,0.33162,0,No
4100,sacrilege,3,13.99791989,3,9.721185996,9.721165996,9,136.0763828,2,1,3,2,1,3,5,0.360829,0.373487,0,No
4130,rut,3,13.99791989,3,9.721185996,9.721165996,9,136.0763828,2,2,4,2,2,4,5,0.32096,0.324923,0,No
4141,ruse,3,13.99791989,3,9.721185996,9.721165996,9,136.0763828,3,2,5,3,2,5,5,0.346314,0.355371,0,No
4149,runnymede,3,13.99791989,3,9.721185996,9.721165996,9,136.0763828,2,3,5,3,3,6,5,0.384279,0.400486,0,No
4200,rove,3,13.99791989,3,9.721185996,9.721165996,9,136.0763828,1,2,3,1,3,4,5,0.346476,0.355514,0,No
4203,rout,3,13.99791989,3,9.721185996,9.721165996,9,136.0763828,2,3,5,2,3,5,4,0.412488,0.429708,0,No
4206,rouse,3,13.99791989,3,9.721185996,9.721165996,9,136.0763828,3,2,5,3,2,5,5,0.323327,0.32647,0,No
4219,rote,3,13.99791989,3,9.721185996,9.721165996,9,136.0763828,3,0,3,3,0,3,0,0,0,0,No
4323,riverine,3,13.99791989,3,9.721185996,9.721165996,9,136.0763828,1,2,3,1,2,3,5,0.322904,0.32613,0,No
4324,riverfront,3,13.99791989,3,9.721185996,9.721165996,9,136.0763828,2,2,4,2,2,4,5,0.384337,0.400529,0,No
4401,ri,3,13.99791989,3,9.721185996,9.721165996,9,136.0763828,2,2,4,2,2,4,5,0.332734,0.337576,0,No
4413,rhoda,3,13.99791989,3,9.721185996,9.721165996,9,136.0763828,2,2,4,2,3,5,5,0.395565,0.41265,0,No
4441,reversible,3,13.99791989,3,9.721185996,9.721165996,9,136.0763828,3,2,5,3,2,5,5,0.384346,0.400533,0,No
4443,reverie,3,13.99791989,3,9.721185996,9.721165996,9,136.0763828,2,2,4,3,2,5,5,0.360991,0.373703,0,No
4474,resurrect,3,13.99791989,3,9.721185996,9.721165996,9,136.0763828,2,2,4,3,3,6,5,0.39995,0.417706,0,No
4484,restful,3,13.99791989,3,9.721185996,9.721165996,9,136.0763828,3,2,5,3,2,5,5,0.332802,0.338131,0,No
4517,repulsive,3,13.99791989,3,9.721185996,9.721165996,9,136.0763828,3,3,6,3,3,6,5,0.357977,0.37024,0,No
4518,repulsion,3,13.99791989,3,9.721185996,9.721165996,9,136.0763828,3,3,6,3,3,6,5,0.385063,0.401573,0,No
4553,rendition,3,13.99791989,3,9.721185996,9.721165996,9,136.0763828,2,1,3,2,3,5,5,0.378607,0.394397,0,No
4589,reinstate,3,13.99791989,3,9.721185996,9.721165996,9,136.0763828,1,2,3,2,3,5,5,0.398165,0.415927,0,No
4593,reilly,3,13.99791989,3,9.721185996,9.721165996,9,136.0763828,3,2,5,3,2,5,5,0.326653,0.330201,0,No
4636,referenda,3,13.99791989,3,9.721185996,9.721165996,9,136.0763828,3,2,5,3,3,6,5,0.385405,0.401716,0,No
4652,redneck,3,13.99791989,3,9.721185996,9.721165996,9,136.0763828,0,2,2,0,2,2,5,0.322441,0.325683,0,No
4709,reactionary,3,13.99791989,3,9.721185996,9.721165996,9,136.0763828,2,2,4,2,2,4,5,0.384487,0.400693,0,No
4773,rampart,3,13.99791989,3,9.721185996,9.721165996,9,136.0763828,1,3,4,1,3,4,5,0.386951,0.40343,0,No
4792,rainstorm,3,13.99791989,3,9.721185996,9.721165996,9,136.0763828,2,3,5,3,3,6,4,0.390853,0.407686,0,No
4823,radiate,3,13.99791989,3,9.721185996,9.721165996,9,136.0763828,1,3,4,1,3,4,5,0.365857,0.379599,0,No
4824,radiant,3,13.99791989,3,9.721185996,9.721165996,9,136.0763828,3,2,5,3,2,5,5,0.329454,0.333576,0,No
4841,rabid,3,13.99791989,3,9.721185996,9.721165996,9,136.0763828,2,2,4,2,2,4,5,0.355219,0.366942,0,No
4849,quotation,3,13.99791989,3,9.721185996,9.721165996,9,136.0763828,2,2,4,2,2,4,5,0.327552,0.331283,0,No
4866,quint,3,13.99791989,3,9.721185996,9.721165996,9,136.0763828,3,3,6,3,3,6,5,0.410295,0.427903,0,No
4901,quartzite,3,13.99791989,3,9.721185996,9.721165996,9,136.0763828,3,3,6,3,3,6,5,0.348141,0.35755,0,No
4913,quarrel,3,13.99791989,3,9.721185996,9.721165996,9,136.0763828,3,2,5,3,3,6,5,0.347405,0.356553,0,No
4922,qualitative,3,13.99791989,3,9.721185996,9.721165996,9,136.0763828,2,2,4,2,2,4,5,0.384371,0.400571,0,No
4926,quail,3,13.99791989,3,9.721185996,9.721165996,9,136.0763828,3,2,5,3,2,5,5,0.384479,0.400693,0,No
4937,quadrant,3,13.99791989,3,9.721185996,9.721165996,9,136.0763828,3,3,6,3,3,6,5,0.404849,0.422222,0,No
4953,pyrite,3,13.99791989,3,9.721185996,9.721165996,9,136.0763828,3,3,6,3,3,6,5,0.385004,0.40128,0,No
4954,pyrimidine,3,13.99791989,3,9.721185996,9.721165996,9,136.0763828,1,2,3,3,3,6,5,0.33701,0.343014,0,No
4955,pyrex,3,13.99791989,3,9.721185996,9.721165996,9,136.0763828,3,3,6,3,3,6,5,0.385481,0.40182,0,No
5092,proviso,3,13.99791989,3,9.721185996,9.721165996,9,136.0763828,2,2,4,2,3,5,5,0.347378,0.357012,0,No
5132,prospectus,3,13.99791989,3,9.721185996,9.721165996,9,136.0763828,1,3,4,2,3,5,5,0.311181,0.316493,0,No
5133,prospector,3,13.99791989,3,9.721185996,9.721165996,9,136.0763828,3,3,6,3,3,6,5,0.375897,0.392479,0,No
5136,proserpine,3,13.99791989,3,9.721185996,9.721165996,9,136.0763828,3,3,6,3,3,6,5,0.333027,0.338557,0,No
5163,propelling,3,13.99791989,3,9.721185996,9.721165996,9,136.0763828,2,2,4,2,2,4,5,0.377617,0.394097,0,No
5211,programmable,3,13.99791989,3,9.721185996,9.721165996,9,136.0763828,3,2,5,3,2,5,5,0.326756,0.330356,0,No
5257,pritchard,3,13.99791989,3,9.721185996,9.721165996,9,136.0763828,3,2,5,3,2,5,5,0.321663,0.324983,0,No
5275,primeval,3,13.99791989,3,9.721185996,9.721165996,9,136.0763828,1,3,4,2,3,5,5,0.326635,0.330269,0,No
5279,primal,3,13.99791989,3,9.721185996,9.721165996,9,136.0763828,2,2,4,2,2,4,5,0.323752,0.32698,0,No
5304,preside,3,13.99791989,3,9.721185996,9.721165996,9,136.0763828,1,1,2,1,3,4,5,0.326419,0.330114,0,No
5323,prehensile,3,13.99791989,3,9.721185996,9.721165996,9,136.0763828,2,1,3,3,3,6,5,0.319446,0.322846,0,No
5344,precipitate,3,13.99791989,3,9.721185996,9.721165996,9,136.0763828,2,3,5,2,3,5,5,0.404895,0.422264,0,No
5377,powdery,3,13.99791989,3,9.721185996,9.721165996,9,136.0763828,3,2,5,3,2,5,5,0.319849,0.32313,0,No
5387,potts,3,13.99791989,3,9.721185996,9.721165996,9,136.0763828,3,3,6,3,3,6,5,0.375428,0.392005,0,No
5441,portraiture,3,13.99791989,3,9.721185996,9.721165996,9,136.0763828,1,2,3,2,2,4,5,0.398094,0.415861,0,No
5466,populate,3,13.99791989,3,9.721185996,9.721165996,9,136.0763828,3,2,5,3,3,6,5,0.398121,0.415889,0,No
5485,pong,3,13.99791989,3,9.721185996,9.721165996,9,136.0763828,1,3,4,1,3,4,4,0.387788,0.404865,0,No
5541,politburo,3,13.99791989,3,9.721185996,9.721165996,9,136.0763828,2,2,4,3,2,5,5,0.37868,0.394495,0,No
5544,poliomyelitis,3,13.99791989,3,9.721185996,9.721165996,9,136.0763828,3,2,5,3,2,5,5,0.355953,0.367818,0,No
5591,plush,3,13.99791989,3,9.721185996,9.721165996,9,136.0763828,2,1,3,2,1,3,5,0.32078,0.324283,0,No
5622,plebeian,3,13.99791989,3,9.721185996,9.721165996,9,136.0763828,2,2,4,3,3,6,5,0.326762,0.330349,0,No
5640,plausible,3,13.99791989,3,9.721185996,9.721165996,9,136.0763828,3,2,5,3,2,5,5,0.322265,0.325674,0,No
5645,platonism,3,13.99791989,3,9.721185996,9.721165996,9,136.0763828,3,3,6,3,3,6,4,0.390321,0.407109,0,No
5732,pinnate,3,13.99791989,3,9.721185996,9.721165996,9,136.0763828,1,1,2,2,1,3,5,0.398076,0.415824,0,No
5782,picky,3,13.99791989,3,9.721185996,9.721165996,9,136.0763828,3,2,5,3,2,5,5,0.333258,0.338261,0,No
5785,pickford,3,13.99791989,3,9.721185996,9.721165996,9,136.0763828,2,2,4,2,2,4,5,0.386589,0.403026,0,No
5786,pickett,3,13.99791989,3,9.721185996,9.721165996,9,136.0763828,1,3,4,3,3,6,5,0.326978,0.330627,0,No
5846,philanthropy,3,13.99791989,3,9.721185996,9.721165996,9,136.0763828,3,2,5,3,2,5,4,0.412325,0.42953,0,No
5872,pewter,3,13.99791989,3,9.721185996,9.721165996,9,136.0763828,2,3,5,2,3,5,5,0.36291,0.375999,0,No
5911,perspiration,3,13.99791989,3,9.721185996,9.721165996,9,136.0763828,2,3,5,2,3,5,4,0.407217,0.424863,0,No
5950,perish,3,13.99791989,3,9.721185996,9.721165996,9,136.0763828,3,3,6,3,3,6,5,0.346936,0.356184,0,No
5957,peril,3,13.99791989,3,9.721185996,9.721165996,9,136.0763828,3,3,6,3,3,6,5,0.325659,0.329471,0,No
5959,perigee,3,13.99791989,3,9.721185996,9.721165996,9,136.0763828,2,2,4,2,2,4,4,0.388136,0.404686,0,No
5960,peridotite,3,13.99791989,3,9.721185996,9.721165996,9,136.0763828,3,2,5,3,2,5,4,0.38772,0.404771,0,No
6095,peaceable,3,13.99791989,3,9.721185996,9.721165996,9,136.0763828,1,2,3,3,2,5,5,0.330147,0.334194,0,No
6107,pawtucket,3,13.99791989,3,9.721185996,9.721165996,9,136.0763828,2,2,4,3,3,6,5,0.338037,0.344464,0,No
6114,pave,3,13.99791989,3,9.721185996,9.721165996,9,136.0763828,1,2,3,3,2,5,4,0.422432,0.439107,0,No
6131,patsy,3,13.99791989,3,9.721185996,9.721165996,9,136.0763828,3,1,4,3,1,4,5,0.311481,0.316293,0,No
6148,patio,3,13.99791989,3,9.721185996,9.721165996,9,136.0763828,2,3,5,3,3,6,5,0.349773,0.359624,0,No
6274,parabola,3,13.99791989,3,9.721185996,9.721165996,9,136.0763828,2,3,5,3,3,6,5,0.388765,0.406171,0,No
6319,panamanian,3,13.99791989,3,9.721185996,9.721165996,9,136.0763828,3,3,6,3,3,6,5,0.38632,0.40274,0,No
6325,pam,3,13.99791989,3,9.721185996,9.721165996,9,136.0763828,2,1,3,2,1,3,5,0.297556,0.303496,0,No
6369,paddock,3,13.99791989,3,9.721185996,9.721165996,9,136.0763828,2,3,5,2,3,5,5,0.381144,0.39726,0,No
6435,ott,3,13.99791989,3,9.721185996,9.721165996,9,136.0763828,2,2,4,2,2,4,5,0.384279,0.400468,0,No
6442,osteoporosis,3,13.99791989,3,9.721185996,9.721165996,9,136.0763828,2,2,4,2,2,4,5,0.33125,0.336138,0,No
6454,oscillate,3,13.99791989,3,9.721185996,9.721165996,9,136.0763828,3,3,6,3,3,6,5,0.34037,0.347734,0,No
6587,omit,3,13.99791989,3,9.721185996,9.721165996,9,136.0763828,2,3,5,2,3,5,4,0.40379,0.421389,0,No
6599,olson,3,13.99791989,3,9.721185996,9.721165996,9,136.0763828,1,2,3,1,2,3,5,0.320606,0.324081,0,No
6641,oft,3,13.99791989,3,9.721185996,9.721165996,9,136.0763828,2,1,3,3,1,4,5,0.360829,0.373487,0,No
6706,obverse,3,13.99791989,3,9.721185996,9.721165996,9,136.0763828,1,2,3,3,3,6,5,0.384296,0.400482,0,No
6722,oboist,3,13.99791989,3,9.721185996,9.721165996,9,136.0763828,2,3,5,3,3,6,5,0.397915,0.415528,0,No
6728,obligatory,3,13.99791989,3,9.721185996,9.721165996,9,136.0763828,3,2,5,3,2,5,5,0.361395,0.374191,0,No
6757,nutshell,3,13.99791989,3,9.721185996,9.721165996,9,136.0763828,1,3,4,3,3,6,5,0.388884,0.405946,0,No
6772,numerology,3,13.99791989,3,9.721185996,9.721165996,9,136.0763828,0,1,1,0,1,1,5,0.384234,0.400398,0,No
6775,numb,3,13.99791989,3,9.721185996,9.721165996,9,136.0763828,2,3,5,2,3,5,5,0.369605,0.384076,0,No
6794,noxious,3,13.99791989,3,9.721185996,9.721165996,9,136.0763828,2,1,3,2,1,3,5,0.375317,0.391855,0,No
6830,nostalgia,3,13.99791989,3,9.721185996,9.721165996,9,136.0763828,2,3,5,2,3,5,5,0.347418,0.356704,0,No
6844,northland,3,13.99791989,3,9.721185996,9.721165996,9,136.0763828,2,2,4,2,2,4,5,0.345774,0.35468,0,No
6854,normative,3,13.99791989,3,9.721185996,9.721165996,9,136.0763828,3,2,5,3,2,5,4,0.4122,0.429642,0,No
6867,nook,3,13.99791989,3,9.721185996,9.721165996,9,136.0763828,1,2,3,3,3,6,4,0.384529,0.401395,0,No
6905,nitrite,3,13.99791989,3,9.721185996,9.721165996,9,136.0763828,3,3,6,3,3,6,5,0.385246,0.401543,0,No
6909,nit,3,13.99791989,3,9.721185996,9.721165996,9,136.0763828,1,1,2,1,1,2,5,0.298512,0.304342,0,No
6948,nielson,3,13.99791989,3,9.721185996,9.721165996,9,136.0763828,1,2,3,1,2,3,5,0.322628,0.326187,0,No
6976,newsreel,3,13.99791989,3,9.721185996,9.721165996,9,136.0763828,0,3,3,0,3,3,5,0.319344,0.322906,0,No
7155,nakayama,3,13.99791989,3,9.721185996,9.721165996,9,136.0763828,2,2,4,2,2,4,5,0.375365,0.39193,0,No
7179,myrrh,3,13.99791989,3,9.721185996,9.721165996,9,136.0763828,2,2,4,3,3,6,5,0.387754,0.404294,0,No
7180,myron,3,13.99791989,3,9.721185996,9.721165996,9,136.0763828,3,3,6,3,3,6,5,0.321058,0.324617,0,No
7185,myocardium,3,13.99791989,3,9.721185996,9.721165996,9,136.0763828,2,2,4,2,2,4,5,0.331683,0.336302,0,No
7214,muskrat,3,13.99791989,3,9.721185996,9.721165996,9,136.0763828,2,2,4,3,2,5,5,0.342624,0.350716,0,No
7224,mush,3,13.99791989,3,9.721185996,9.721165996,9,136.0763828,1,2,3,1,2,3,5,0.329858,0.333933,0,No
7237,murderous,3,13.99791989,3,9.721185996,9.721165996,9,136.0763828,2,2,4,2,2,4,5,0.384262,0.400449,0,No
7252,mum,3,13.99791989,3,9.721185996,9.721165996,9,136.0763828,2,1,3,2,1,3,5,0.345599,0.354479,0,No
7307,mountainside,3,13.99791989,3,9.721185996,9.721165996,9,136.0763828,1,3,4,2,3,5,5,0.363541,0.376801,0,No
7309,mountaineer,3,13.99791989,3,9.721185996,9.721165996,9,136.0763828,2,1,3,3,2,5,5,0.384237,0.400402,0,No
7329,motel,3,13.99791989,3,9.721185996,9.721165996,9,136.0763828,3,3,6,3,3,6,5,0.356389,0.367983,0,No
7330,mot,3,13.99791989,3,9.721185996,9.721165996,9,136.0763828,2,1,3,2,2,4,5,0.398076,0.415824,0,No
7346,mortem,3,13.99791989,3,9.721185996,9.721165996,9,136.0763828,1,3,4,3,3,6,5,0.325563,0.329144,0,No
7368,moriarty,3,13.99791989,3,9.721185996,9.721165996,9,136.0763828,3,3,6,3,3,6,4,0.411026,0.428497,0,No
7382,moot,3,13.99791989,3,9.721185996,9.721165996,9,136.0763828,3,2,5,3,2,5,5,0.326906,0.331259,0,No
7410,montage,3,13.99791989,3,9.721185996,9.721165996,9,136.0763828,3,2,5,3,2,5,5,0.32737,0.331358,0,No
7415,monsieur,3,13.99791989,3,9.721185996,9.721165996,9,136.0763828,3,3,6,3,3,6,5,0.316372,0.321159,0,No
7425,monolith,3,13.99791989,3,9.721185996,9.721165996,9,136.0763828,1,2,3,1,2,3,5,0.398103,0.41587,0,No
7451,momentous,3,13.99791989,3,9.721185996,9.721165996,9,136.0763828,3,3,6,3,3,6,5,0.322927,0.325989,0,No
7452,momentary,3,13.99791989,3,9.721185996,9.721165996,9,136.0763828,1,1,2,2,2,4,6,0.274651,0.280458,0,No
7510,mn,3,13.99791989,3,9.721185996,9.721165996,9,136.0763828,2,2,4,2,2,4,5,0.332154,0.338228,0,No
7516,mitre,3,13.99791989,3,9.721185996,9.721165996,9,136.0763828,3,3,6,3,3,6,4,0.399725,0.416995,0,No
7577,minima,3,13.99791989,3,9.721185996,9.721165996,9,136.0763828,2,3,5,2,3,5,5,0.355027,0.365976,0,No
7594,mimicking,3,13.99791989,3,9.721185996,9.721165996,9,136.0763828,2,2,4,2,3,5,5,0.413931,0.431649,0,No
7608,millie,3,13.99791989,3,9.721185996,9.721165996,9,136.0763828,1,3,4,2,3,5,4,0.429027,0.445149,0,No
7617,militiamen,3,13.99791989,3,9.721185996,9.721165996,9,136.0763828,2,2,4,2,3,5,5,0.367379,0.381306,0,No
7641,midwife,3,13.99791989,3,9.721185996,9.721165996,9,136.0763828,2,2,4,3,2,5,5,0.356367,0.368325,0,No
7649,midpoint,3,13.99791989,3,9.721185996,9.721165996,9,136.0763828,1,2,3,3,3,6,5,0.379028,0.394899,0,No
7661,midday,3,13.99791989,3,9.721185996,9.721165996,9,136.0763828,3,3,6,3,3,6,5,0.364857,0.378269,0,No
7698,methuselah,3,13.99791989,3,9.721185996,9.721165996,9,136.0763828,1,3,4,2,3,5,4,0.391906,0.408813,0,No
7727,messy,3,13.99791989,3,9.721185996,9.721165996,9,136.0763828,3,3,6,3,3,6,5,0.378825,0.394655,0,No
7801,memento,3,13.99791989,3,9.721185996,9.721165996,9,136.0763828,2,2,4,2,2,4,5,0.394625,0.411692,0,No
7811,melodramatic,3,13.99791989,3,9.721185996,9.721165996,9,136.0763828,3,3,6,3,3,6,5,0.332783,0.337575,0,No
7813,melodious,3,13.99791989,3,9.721185996,9.721165996,9,136.0763828,2,2,4,2,2,4,5,0.332111,0.337217,0,No
7881,mcpherson,3,13.99791989,3,9.721185996,9.721165996,9,136.0763828,2,2,4,2,2,4,5,0.326653,0.330427,0,No
7882,mcneil,3,13.99791989,3,9.721185996,9.721165996,9,136.0763828,2,2,4,2,2,4,5,0.369689,0.384037,0,No
7887,mcleod,3,13.99791989,3,9.721185996,9.721165996,9,136.0763828,2,2,4,2,2,4,5,0.360873,0.373557,0,No
7889,mclaughlin,3,13.99791989,3,9.721185996,9.721165996,9,136.0763828,3,1,4,3,1,4,5,0.308423,0.313327,0,No
7915,mcdaniel,3,13.99791989,3,9.721185996,9.721165996,9,136.0763828,1,2,3,1,2,3,5,0.385038,0.401526,0,No
7982,mathieu,3,13.99791989,3,9.721185996,9.721165996,9,136.0763828,2,2,4,2,2,4,5,0.384396,0.400599,0,No
7985,mathews,3,13.99791989,3,9.721185996,9.721165996,9,136.0763828,1,1,2,1,1,2,5,0.384237,0.400402,0,No
7989,maternity,3,13.99791989,3,9.721185996,9.721165996,9,136.0763828,1,1,2,1,2,3,5,0.321233,0.324339,0,No
8003,mastermind,3,13.99791989,3,9.721185996,9.721165996,9,136.0763828,2,2,4,3,2,5,4,0.417789,0.434971,0,No
8031,marvelous,3,13.99791989,3,9.721185996,9.721165996,9,136.0763828,3,1,4,3,1,4,5,0.311034,0.315624,0,No
8037,martini,3,13.99791989,3,9.721185996,9.721165996,9,136.0763828,2,2,4,2,2,4,5,0.345619,0.354526,0,No
8064,marmot,3,13.99791989,3,9.721185996,9.721165996,9,136.0763828,3,2,5,3,2,5,5,0.398228,0.415988,0,No
8071,marlboro,3,13.99791989,3,9.721185996,9.721165996,9,136.0763828,2,3,5,2,3,5,5,0.330036,0.334386,0,No
8082,marionette,3,13.99791989,3,9.721185996,9.721165996,9,136.0763828,3,2,5,3,2,5,5,0.347806,0.357164,0,No
8099,margo,3,13.99791989,3,9.721185996,9.721165996,9,136.0763828,0,1,1,0,1,1,6,0.267773,0.272881,0,No
8176,managerial,3,13.99791989,3,9.721185996,9.721165996,9,136.0763828,3,2,5,3,2,5,5,0.384329,0.400524,0,No
8205,malicious,3,13.99791989,3,9.721185996,9.721165996,9,136.0763828,3,1,4,3,1,4,5,0.322699,0.325972,0,No
8208,malfunction,3,13.99791989,3,9.721185996,9.721165996,9,136.0763828,3,2,5,3,3,6,5,0.37906,0.394922,0,No
8323,macgregor,3,13.99791989,3,9.721185996,9.721165996,9,136.0763828,1,1,2,1,1,2,5,0.398076,0.415824,0,No
8340,lysergic,3,13.99791989,3,9.721185996,9.721165996,9,136.0763828,0,1,1,0,3,3,5,0.318239,0.321893,0,No
8365,lux,3,13.99791989,3,9.721185996,9.721165996,9,136.0763828,1,1,2,1,2,3,5,0.302366,0.308206,0,No
8383,luncheon,3,13.99791989,3,9.721185996,9.721165996,9,136.0763828,3,3,6,3,3,6,5,0.349898,0.359913,0,No
8397,lumberjack,3,13.99791989,3,9.721185996,9.721165996,9,136.0763828,2,2,4,3,3,6,5,0.345767,0.354709,0,No
8419,lucille,3,13.99791989,3,9.721185996,9.721165996,9,136.0763828,3,3,6,3,3,6,5,0.323764,0.327437,0,No
8467,loren,3,13.99791989,3,9.721185996,9.721165996,9,136.0763828,1,2,3,3,2,5,5,0.336595,0.342881,0,No
8518,lofty,3,13.99791989,3,9.721185996,9.721165996,9,136.0763828,3,1,4,3,1,4,6,0.246009,0.24782,0,No
8538,locale,3,13.99791989,3,9.721185996,9.721165996,9,136.0763828,2,3,5,2,3,5,5,0.410153,0.427762,0,No
8808,legate,3,13.99791989,3,9.721185996,9.721165996,9,136.0763828,1,2,3,1,2,3,5,0.346632,0.355746,0,No
8823,ledge,3,13.99791989,3,9.721185996,9.721165996,9,136.0763828,3,3,6,3,3,6,5,0.401225,0.418983,0,No
8857,laymen,3,13.99791989,3,9.721185996,9.721165996,9,136.0763828,3,3,6,3,3,6,5,0.354906,0.365863,0,No
8872,lavish,3,13.99791989,3,9.721185996,9.721165996,9,136.0763828,2,1,3,2,1,3,5,0.326545,0.330109,0,No
8893,laud,3,13.99791989,3,9.721185996,9.721165996,9,136.0763828,1,2,3,3,2,5,5,0.398129,0.415894,0,No
8913,lass,3,13.99791989,3,9.721185996,9.721165996,9,136.0763828,3,3,6,3,3,6,5,0.379311,0.395207,0,No
8921,larson,3,13.99791989,3,9.721185996,9.721165996,9,136.0763828,2,3,5,2,3,5,5,0.398442,0.416194,0,No
8979,lame,3,13.99791989,3,9.721185996,9.721165996,9,136.0763828,2,3,5,3,3,6,5,0.351074,0.360962,0,No
8992,lain,3,13.99791989,3,9.721185996,9.721165996,9,136.0763828,1,2,3,2,3,5,5,0.361167,0.373919,0,No
9004,ladybug,3,13.99791989,3,9.721185996,9.721165996,9,136.0763828,1,1,2,1,1,2,5,0.336021,0.342018,0,No
9010,lacy,3,13.99791989,3,9.721185996,9.721165996,9,136.0763828,3,1,4,3,1,4,5,0.325688,0.329029,0,No
9051,kristin,3,13.99791989,3,9.721185996,9.721165996,9,136.0763828,1,0,1,1,0,1,0,0,0,0,No
9081,knudsen,3,13.99791989,3,9.721185996,9.721165996,9,136.0763828,1,1,2,3,1,4,5,0.305699,0.31093,0,No
9093,knossos,3,13.99791989,3,9.721185996,9.721165996,9,136.0763828,3,1,4,3,1,4,5,0.398076,0.415824,0,No
9102,knickerbocker,3,13.99791989,3,9.721185996,9.721165996,9,136.0763828,1,3,4,3,3,6,5,0.323646,0.326939,0,No
9104,kneel,3,13.99791989,3,9.721185996,9.721165996,9,136.0763828,1,2,3,3,3,6,5,0.386589,0.403026,0,No
9124,kitakyushu,3,13.99791989,3,9.721185996,9.721165996,9,136.0763828,0,2,2,0,2,2,5,0.323517,0.326844,0,No
9177,khaki,3,13.99791989,3,9.721185996,9.721165996,9,136.0763828,2,2,4,2,2,4,5,0.398085,0.415852,0,No
9191,keto,3,13.99791989,3,9.721185996,9.721165996,9,136.0763828,3,3,6,3,3,6,4,0.412373,0.42983,0,No
9259,kaplan,3,13.99791989,3,9.721185996,9.721165996,9,136.0763828,1,2,3,1,2,3,5,0.350091,0.359859,0,No
9325,jujube,3,13.99791989,3,9.721185996,9.721165996,9,136.0763828,0,3,3,0,3,3,4,0.389888,0.40663,0,No
9337,judicature,3,13.99791989,3,9.721185996,9.721165996,9,136.0763828,1,3,4,3,3,6,5,0.411007,0.428311,0,No
9420,jig,3,13.99791989,3,9.721185996,9.721165996,9,136.0763828,3,3,6,3,3,6,4,0.389781,0.406522,0,No
9460,jed,3,13.99791989,3,9.721185996,9.721165996,9,136.0763828,2,2,4,2,2,4,5,0.326491,0.33025,0,No
9503,jacobi,3,13.99791989,3,9.721185996,9.721165996,9,136.0763828,2,2,4,2,2,4,5,0.332466,0.337746,0,No
9523,ivanhoe,3,13.99791989,3,9.721185996,9.721165996,9,136.0763828,2,2,4,2,2,4,5,0.384329,0.400519,0,No
9545,isomorphic,3,13.99791989,3,9.721185996,9.721165996,9,136.0763828,3,2,5,3,2,5,5,0.357869,0.369698,0,No
9546,isomer,3,13.99791989,3,9.721185996,9.721165996,9,136.0763828,2,3,5,3,3,6,4,0.423399,0.440172,0,No
9570,irritant,3,13.99791989,3,9.721185996,9.721165996,9,136.0763828,2,2,4,2,2,4,5,0.375675,0.391127,0,No
9581,irredentist,3,13.99791989,3,9.721185996,9.721165996,9,136.0763828,2,0,2,2,0,2,0,0,0,0,No
9761,insightful,3,13.99791989,3,9.721185996,9.721165996,9,136.0763828,3,2,5,3,2,5,5,0.322681,0.325744,0,No
9765,inseparable,3,13.99791989,3,9.721185996,9.721165996,9,136.0763828,3,3,6,3,3,6,5,0.384687,0.400932,0,No
9766,insensitive,3,13.99791989,3,9.721185996,9.721165996,9,136.0763828,3,2,5,3,3,6,5,0.394625,0.411692,0,No
9808,inhibitor,3,13.99791989,3,9.721185996,9.721165996,9,136.0763828,3,1,4,3,1,4,5,0.360829,0.373487,0,No
9827,infusion,3,13.99791989,3,9.721185996,9.721165996,9,136.0763828,2,2,4,3,2,5,5,0.379084,0.394936,0,No
9835,informant,3,13.99791989,3,9.721185996,9.721165996,9,136.0763828,2,1,3,2,1,3,5,0.360829,0.373487,0,No
9862,infernal,3,13.99791989,3,9.721185996,9.721165996,9,136.0763828,2,1,3,3,1,4,5,0.321984,0.325099,0,No
9878,infallible,3,13.99791989,3,9.721185996,9.721165996,9,136.0763828,3,3,6,3,3,6,5,0.401098,0.418856,0,No
9947,inconsistent,3,13.99791989,3,9.721185996,9.721165996,9,136.0763828,3,2,5,3,2,5,5,0.386395,0.403331,0,No
9950,inconclusive,3,13.99791989,3,9.721185996,9.721165996,9,136.0763828,3,3,6,3,3,6,4,0.422462,0.439154,0,No
9951,incompressible,3,13.99791989,3,9.721185996,9.721165996,9,136.0763828,1,3,4,1,3,4,5,0.327461,0.33122,0,No
9991,inadequate,3,13.99791989,3,9.721185996,9.721165996,9,136.0763828,2,3,5,2,3,5,5,0.375492,0.392043,0,No
9995,inaction,3,13.99791989,3,9.721185996,9.721165996,9,136.0763828,2,3,5,2,3,5,5,0.361196,0.373956,0,No
10042,impatient,3,13.99791989,3,9.721185996,9.721165996,9,136.0763828,3,3,6,3,3,6,5,0.326647,0.330254,0,No
10066,immaculate,3,13.99791989,3,9.721185996,9.721165996,9,136.0763828,2,1,3,3,3,6,5,0.295471,0.301503,0,No
10123,icosahedron,3,13.99791989,3,9.721185996,9.721165996,9,136.0763828,1,3,4,2,3,5,5,0.35237,0.362889,0,No
10129,iceman,3,13.99791989,3,9.721185996,9.721165996,9,136.0763828,2,3,5,3,3,6,5,0.379109,0.395714,0,No
10204,hutch,3,13.99791989,3,9.721185996,9.721165996,9,136.0763828,2,2,4,2,2,4,5,0.325181,0.328859,0,No
10222,huntley,3,13.99791989,3,9.721185996,9.721165996,9,136.0763828,2,3,5,2,3,5,5,0.330006,0.334108,0,No
10262,huffman,3,13.99791989,3,9.721185996,9.721165996,9,136.0763828,2,2,4,3,2,5,5,0.384554,0.400768,0,No
10326,horowitz,3,13.99791989,3,9.721185996,9.721165996,9,136.0763828,2,3,5,3,3,6,5,0.334691,0.339859,0,No
10364,honeybee,3,13.99791989,3,9.721185996,9.721165996,9,136.0763828,1,3,4,1,3,4,5,0.384712,0.400965,0,No
10375,homonym,3,13.99791989,3,9.721185996,9.721165996,9,136.0763828,2,1,3,2,1,3,5,0.345599,0.354479,0,No
10394,homage,3,13.99791989,3,9.721185996,9.721165996,9,136.0763828,2,2,4,2,2,4,5,0.359245,0.371635,0,No
10396,holyoke,3,13.99791989,3,9.721185996,9.721165996,9,136.0763828,1,1,2,3,3,6,5,0.324527,0.32819,0,No
10494,hillman,3,13.99791989,3,9.721185996,9.721165996,9,136.0763828,3,3,6,3,3,6,5,0.38472,0.400979,0,No
10562,heroism,3,13.99791989,3,9.721185996,9.721165996,9,136.0763828,3,3,6,3,3,6,5,0.380123,0.396165,0,No
10576,hermaphroditic,3,13.99791989,3,9.721185996,9.721165996,9,136.0763828,3,1,4,3,1,4,5,0.321029,0.327198,0,No
10614,henchman,3,13.99791989,3,9.721185996,9.721165996,9,136.0763828,1,2,3,1,2,3,5,0.359245,0.371626,0,No
10670,hedge,3,13.99791989,3,9.721185996,9.721165996,9,136.0763828,2,2,4,3,2,5,5,0.345673,0.354582,0,No
10674,heck,3,13.99791989,3,9.721185996,9.721165996,9,136.0763828,1,2,3,1,2,3,5,0.381217,0.397274,0,No
10807,hardworking,3,13.99791989,3,9.721185996,9.721165996,9,136.0763828,3,1,4,3,1,4,5,0.384229,0.400392,0,No
10831,hanoverian,3,13.99791989,3,9.721185996,9.721165996,9,136.0763828,1,1,2,3,2,5,5,0.323469,0.326843,0,No
10858,handicraft,3,13.99791989,3,9.721185996,9.721165996,9,136.0763828,3,2,5,3,2,5,5,0.369689,0.384037,0,No
10859,handicapped,3,13.99791989,3,9.721185996,9.721165996,9,136.0763828,3,2,5,3,3,6,5,0.356145,0.367975,0,No
10888,hallway,3,13.99791989,3,9.721185996,9.721165996,9,136.0763828,2,2,4,2,3,5,5,0.346733,0.355825,0,No
10940,habib,3,13.99791989,3,9.721185996,9.721165996,9,136.0763828,2,0,2,2,0,2,0,0,0,0,No
10981,gunfire,3,13.99791989,3,9.721185996,9.721165996,9,136.0763828,3,3,6,3,3,6,4,0.427962,0.444191,0,No
11049,groundwork,3,13.99791989,3,9.721185996,9.721165996,9,136.0763828,1,2,3,2,3,5,4,0.388136,0.404686,0,No
11066,grizzly,3,13.99791989,3,9.721185996,9.721165996,9,136.0763828,3,2,5,3,2,5,5,0.318272,0.321862,0,No
11079,grime,3,13.99791989,3,9.721185996,9.721165996,9,136.0763828,3,1,4,3,1,4,5,0.384237,0.400402,0,No
11091,griddle,3,13.99791989,3,9.721185996,9.721165996,9,136.0763828,2,2,4,3,3,6,5,0.378115,0.39385,0,No
11121,greenbelt,3,13.99791989,3,9.721185996,9.721165996,9,136.0763828,3,3,6,3,3,6,5,0.344165,0.352293,0,No
11130,greasy,3,13.99791989,3,9.721185996,9.721165996,9,136.0763828,2,1,3,2,1,3,5,0.311115,0.315746,0,No
11177,granary,3,13.99791989,3,9.721185996,9.721165996,9,136.0763828,3,3,6,3,3,6,5,0.388408,0.405178,0,No
11193,gracious,3,13.99791989,3,9.721185996,9.721165996,9,136.0763828,3,3,6,3,3,6,5,0.398138,0.415922,0,No
11216,gory,3,13.99791989,3,9.721185996,9.721165996,9,136.0763828,2,2,4,2,2,4,5,0.37546,0.392,0,No
11222,gorgeous,3,13.99791989,3,9.721185996,9.721165996,9,136.0763828,2,2,4,2,2,4,5,0.324195,0.328222,0,No
11229,gop,3,13.99791989,3,9.721185996,9.721165996,9,136.0763828,2,2,4,3,3,6,5,0.329546,0.334059,0,No
11237,goodrich,3,13.99791989,3,9.721185996,9.721165996,9,136.0763828,2,3,5,3,3,6,5,0.399204,0.416969,0,No
11239,goode,3,13.99791989,3,9.721185996,9.721165996,9,136.0763828,2,3,5,3,3,6,4,0.400302,0.417873,0,No
11291,gneiss,3,13.99791989,3,9.721185996,9.721165996,9,136.0763828,2,2,4,2,2,4,5,0.345633,0.35454,0,No
11398,gibbs,3,13.99791989,3,9.721185996,9.721165996,9,136.0763828,1,2,3,1,2,3,5,0.329094,0.333828,0,No
11414,getaway,3,13.99791989,3,9.721185996,9.721165996,9,136.0763828,1,2,3,1,2,3,5,0.324148,0.327558,0,No
11436,geraldine,3,13.99791989,3,9.721185996,9.721165996,9,136.0763828,2,1,3,2,1,3,6,0.279499,0.28561,0,No
11587,gallop,3,13.99791989,3,9.721185996,9.721165996,9,136.0763828,3,3,6,3,3,6,5,0.335038,0.340858,0,No
11600,galen,3,13.99791989,3,9.721185996,9.721165996,9,136.0763828,1,1,2,1,1,2,5,0.322212,0.325435,0,No
11603,galatia,3,13.99791989,3,9.721185996,9.721165996,9,136.0763828,2,3,5,3,3,6,5,0.356632,0.368138,0,No
11609,gal,3,13.99791989,3,9.721185996,9.721165996,9,136.0763828,2,3,5,2,3,5,5,0.369166,0.383422,0,No
11624,gad,3,13.99791989,3,9.721185996,9.721165996,9,136.0763828,1,2,3,1,2,3,5,0.324575,0.328127,0,No
11630,gabbro,3,13.99791989,3,9.721185996,9.721165996,9,136.0763828,1,2,3,1,2,3,5,0.395557,0.412641,0,No
11662,funerary,3,13.99791989,3,9.721185996,9.721165996,9,136.0763828,3,0,3,3,0,3,0,0,0,0,No
11665,fundraiser,3,13.99791989,3,9.721185996,9.721165996,9,136.0763828,2,3,5,2,3,5,5,0.33289,0.337983,0,No
11681,fulbright,3,13.99791989,3,9.721185996,9.721165996,9,136.0763828,2,2,4,3,2,5,5,0.31764,0.321306,0,No
11691,frye,3,13.99791989,3,9.721185996,9.721165996,9,136.0763828,3,1,4,3,2,5,5,0.325474,0.328864,0,No
11714,fro,3,13.99791989,3,9.721185996,9.721165996,9,136.0763828,1,3,4,3,3,6,5,0.342525,0.350522,0,No
11756,frenzy,3,13.99791989,3,9.721185996,9.721165996,9,136.0763828,3,1,4,3,2,5,5,0.384237,0.400402,0,No
11765,freemen,3,13.99791989,3,9.721185996,9.721165996,9,136.0763828,2,3,5,2,3,5,5,0.342063,0.349509,0,No
11842,foss,3,13.99791989,3,9.721185996,9.721165996,9,136.0763828,1,1,2,1,1,2,5,0.321192,0.324298,0,No
11850,fortnight,3,13.99791989,3,9.721185996,9.721165996,9,136.0763828,1,1,2,3,1,4,5,0.384237,0.400402,0,No
11860,forsaken,3,13.99791989,3,9.721185996,9.721165996,9,136.0763828,2,2,4,3,2,5,5,0.32223,0.325416,0,No
11869,formatted,3,13.99791989,3,9.721185996,9.721165996,9,136.0763828,2,3,5,2,3,5,5,0.379392,0.395933,0,No
11885,forgave,3,13.99791989,3,9.721185996,9.721165996,9,136.0763828,2,3,5,2,3,5,5,0.385975,0.402341,0,No
11926,fontainebleau,3,13.99791989,3,9.721185996,9.721165996,9,136.0763828,3,2,5,3,2,5,5,0.361948,0.374844,0,No
11936,folksong,3,13.99791989,3,9.721185996,9.721165996,9,136.0763828,3,3,6,3,3,6,4,0.422582,0.439266,0,No
11948,foggy,3,13.99791989,3,9.721185996,9.721165996,9,136.0763828,3,2,5,3,2,5,4,0.386951,0.403376,0,No
11952,focussed,3,13.99791989,3,9.721185996,9.721165996,9,136.0763828,2,1,3,2,3,5,5,0.338011,0.344413,0,No
11969,fluorite,3,13.99791989,3,9.721185996,9.721165996,9,136.0763828,2,3,5,3,3,6,5,0.337664,0.343954,0,No
11985,flowchart,3,13.99791989,3,9.721185996,9.721165996,9,136.0763828,3,2,5,3,2,5,5,0.385196,0.401468,0,No
12015,flintlock,3,13.99791989,3,9.721185996,9.721165996,9,136.0763828,1,2,3,2,2,4,5,0.355233,0.366951,0,No
12017,fling,3,13.99791989,3,9.721185996,9.721165996,9,136.0763828,2,3,5,2,3,5,5,0.346862,0.355732,0,No
12041,flatworm,3,13.99791989,3,9.721185996,9.721165996,9,136.0763828,2,2,4,3,2,5,5,0.400962,0.418762,0,No
12046,flatbed,3,13.99791989,3,9.721185996,9.721165996,9,136.0763828,0,2,2,0,2,2,5,0.352733,0.363043,0,No
12060,flamingo,3,13.99791989,3,9.721185996,9.721165996,9,136.0763828,2,3,5,3,3,6,5,0.330245,0.334653,0,No
12092,fisk,3,13.99791989,3,9.721185996,9.721165996,9,136.0763828,1,1,2,1,1,2,5,0.315528,0.319713,0,No
12101,firsthand,3,13.99791989,3,9.721185996,9.721165996,9,136.0763828,2,2,4,2,2,4,5,0.325509,0.329066,0,No
12131,fingernail,3,13.99791989,3,9.721185996,9.721165996,9,136.0763828,1,2,3,3,2,5,5,0.334912,0.340668,0,No
12177,fiefdom,3,13.99791989,3,9.721185996,9.721165996,9,136.0763828,2,3,5,3,3,6,5,0.387382,0.403976,0,No
12207,fest,3,13.99791989,3,9.721185996,9.721165996,9,136.0763828,1,2,3,1,2,3,5,0.363088,0.376214,0,No
12218,ferocity,3,13.99791989,3,9.721185996,9.721165996,9,136.0763828,3,2,5,3,2,5,5,0.387416,0.403918,0,No
12219,ferocious,3,13.99791989,3,9.721185996,9.721165996,9,136.0763828,3,1,4,3,1,4,5,0.317805,0.321298,0,No
12299,fathom,3,13.99791989,3,9.721185996,9.721165996,9,136.0763828,2,2,4,2,2,4,5,0.345417,0.354155,0,No
12378,factual,3,13.99791989,3,9.721185996,9.721165996,9,136.0763828,3,1,4,3,2,5,5,0.322201,0.325621,0,No
12384,facsimile,3,13.99791989,3,9.721185996,9.721165996,9,136.0763828,3,2,5,3,2,5,5,0.375555,0.392061,0,No
12402,eyelid,3,13.99791989,3,9.721185996,9.721165996,9,136.0763828,3,2,5,3,2,5,5,0.356188,0.36805,0,No
12410,exuberant,3,13.99791989,3,9.721185996,9.721165996,9,136.0763828,3,3,6,3,3,6,5,0.321256,0.324725,0,No
12430,exterminate,3,13.99791989,3,9.721185996,9.721165996,9,136.0763828,1,2,3,2,3,5,4,0.399105,0.416723,0,No
12494,existent,3,13.99791989,3,9.721185996,9.721165996,9,136.0763828,2,3,5,2,3,5,5,0.384437,0.400665,0,No
12504,exert,3,13.99791989,3,9.721185996,9.721165996,9,136.0763828,2,3,5,2,3,5,5,0.376272,0.392752,0,No
12518,excrement,3,13.99791989,3,9.721185996,9.721165996,9,136.0763828,1,3,4,3,3,6,5,0.379952,0.395904,0,No
12646,estuarine,3,13.99791989,3,9.721185996,9.721165996,9,136.0763828,3,1,4,3,1,4,5,0.327697,0.331801,0,No
12652,estes,3,13.99791989,3,9.721185996,9.721165996,9,136.0763828,1,2,3,2,2,4,5,0.310957,0.315651,0,No
12685,errand,3,13.99791989,3,9.721185996,9.721165996,9,136.0763828,3,3,6,3,3,6,5,0.38523,0.401746,0,No
12687,erotica,3,13.99791989,3,9.721185996,9.721165996,9,136.0763828,2,3,5,2,3,5,5,0.380915,0.396989,0,No
12738,eponymous,3,13.99791989,3,9.721185996,9.721165996,9,136.0763828,2,3,5,2,3,5,5,0.330706,0.335074,0,No
12774,envy,3,13.99791989,3,9.721185996,9.721165996,9,136.0763828,3,2,5,3,2,5,5,0.345882,0.354831,0,No
12803,enoch,3,13.99791989,3,9.721185996,9.721165996,9,136.0763828,3,2,5,3,3,6,5,0.331293,0.336271,0,No
12834,encyclopedic,3,13.99791989,3,9.721185996,9.721165996,9,136.0763828,2,2,4,2,2,4,5,0.325378,0.328691,0,No
12842,emulsion,3,13.99791989,3,9.721185996,9.721165996,9,136.0763828,2,3,5,3,3,6,5,0.383184,0.399457,0,No
12895,embarrass,3,13.99791989,3,9.721185996,9.721165996,9,136.0763828,2,3,5,3,3,6,4,0.400438,0.418042,0,No
12912,eloise,3,13.99791989,3,9.721185996,9.721165996,9,136.0763828,1,1,2,1,1,2,5,0.282421,0.288619,0,No
12955,electrophorus,3,13.99791989,3,9.721185996,9.721165996,9,136.0763828,2,1,3,3,1,4,5,0.338882,0.345659,0,No
13022,efficacy,3,13.99791989,3,9.721185996,9.721165996,9,136.0763828,2,2,4,2,3,5,5,0.388391,0.405141,0,No
13048,edifice,3,13.99791989,3,9.721185996,9.721165996,9,136.0763828,3,2,5,3,2,5,5,0.41002,0.427616,0,No
13051,edgy,3,13.99791989,3,9.721185996,9.721165996,9,136.0763828,1,2,3,1,2,3,5,0.360844,0.373524,0,No
13076,echelon,3,13.99791989,3,9.721185996,9.721165996,9,136.0763828,1,2,3,2,2,4,5,0.385196,0.401468,0,No
13077,ecclesiastic,3,13.99791989,3,9.721185996,9.721165996,9,136.0763828,1,3,4,1,3,4,5,0.325982,0.329375,0,No
13083,eavesdropping,3,13.99791989,3,9.721185996,9.721165996,9,136.0763828,2,1,3,2,1,3,5,0.336028,0.342206,0,No
13103,earthen,3,13.99791989,3,9.721185996,9.721165996,9,136.0763828,2,2,4,2,2,4,4,0.422422,0.439097,0,No
13112,eardrum,3,13.99791989,3,9.721185996,9.721165996,9,136.0763828,2,2,4,3,2,5,5,0.336282,0.34252,0,No
13123,dynastic,3,13.99791989,3,9.721185996,9.721165996,9,136.0763828,1,2,3,1,2,3,5,0.32321,0.326484,0,No
13135,dwelt,3,13.99791989,3,9.721185996,9.721165996,9,136.0763828,2,3,5,3,3,6,5,0.369044,0.383238,0,No
13146,dustbin,3,13.99791989,3,9.721185996,9.721165996,9,136.0763828,1,3,4,3,3,6,5,0.389678,0.407092,0,No
13168,dunk,3,13.99791989,3,9.721185996,9.721165996,9,136.0763828,3,2,5,3,2,5,5,0.329675,0.333652,0,No
13179,dumpling,3,13.99791989,3,9.721185996,9.721165996,9,136.0763828,2,2,4,3,3,6,5,0.32012,0.323384,0,No
13217,drupe,3,13.99791989,3,9.721185996,9.721165996,9,136.0763828,2,2,4,3,2,5,5,0.345969,0.354929,0,No
13239,driveway,3,13.99791989,3,9.721185996,9.721165996,9,136.0763828,2,2,4,3,2,5,5,0.378664,0.394467,0,No
13254,dreamt,3,13.99791989,3,9.721185996,9.721165996,9,136.0763828,3,2,5,3,3,6,5,0.379481,0.395368,0,No
13258,dread,3,13.99791989,3,9.721185996,9.721165996,9,136.0763828,2,2,4,2,2,4,5,0.385038,0.401289,0,No
13294,downstairs,3,13.99791989,3,9.721185996,9.721165996,9,136.0763828,2,2,4,2,2,4,5,0.398944,0.416692,0,No
13330,dormouse,3,13.99791989,3,9.721185996,9.721165996,9,136.0763828,3,2,5,3,2,5,5,0.384246,0.40043,0,No
13354,doodle,3,13.99791989,3,9.721185996,9.721165996,9,136.0763828,1,1,2,3,3,6,6,0.268142,0.273177,0,No
13393,dogmatic,3,13.99791989,3,9.721185996,9.721165996,9,136.0763828,2,1,3,3,1,4,5,0.398067,0.415814,0,No
13439,divergent,3,13.99791989,3,9.721185996,9.721165996,9,136.0763828,2,1,3,2,1,3,6,0.277672,0.283696,0,No
13491,discriminate,3,13.99791989,3,9.721185996,9.721165996,9,136.0763828,3,3,6,3,3,6,5,0.358526,0.370813,0,No
13509,directorate,3,13.99791989,3,9.721185996,9.721165996,9,136.0763828,3,2,5,3,3,6,5,0.345444,0.354117,0,No
13531,diocesan,3,13.99791989,3,9.721185996,9.721165996,9,136.0763828,3,1,4,3,1,4,5,0.292371,0.29861,0,No
13596,dickson,3,13.99791989,3,9.721185996,9.721165996,9,136.0763828,2,3,5,2,3,5,5,0.325796,0.329599,0,No
13637,dexterity,3,13.99791989,3,9.721185996,9.721165996,9,136.0763828,3,2,5,3,2,5,5,0.385188,0.401458,0,No
13645,devotee,3,13.99791989,3,9.721185996,9.721165996,9,136.0763828,1,1,2,2,3,5,5,0.378607,0.394397,0,No
13665,detoxify,3,13.99791989,3,9.721185996,9.721165996,9,136.0763828,1,3,4,3,3,6,5,0.331503,0.336096,0,No
13720,deprivation,3,13.99791989,3,9.721185996,9.721165996,9,136.0763828,2,2,4,3,2,5,5,0.384271,0.400453,0,No
13730,deport,3,13.99791989,3,9.721185996,9.721165996,9,136.0763828,2,1,3,2,1,3,5,0.331788,0.336492,0,No
13731,deploy,3,13.99791989,3,9.721185996,9.721165996,9,136.0763828,2,1,3,3,1,4,5,0.375317,0.391855,0,No
13750,denounce,3,13.99791989,3,9.721185996,9.721165996,9,136.0763828,1,2,3,3,3,6,4,0.398863,0.416493,0,No
13777,demigod,3,13.99791989,3,9.721185996,9.721165996,9,136.0763828,2,2,4,2,2,4,5,0.41003,0.427626,0,No
13785,deluge,3,13.99791989,3,9.721185996,9.721165996,9,136.0763828,2,2,4,2,2,4,5,0.40483,0.422185,0,No
13807,delicatessen,3,13.99791989,3,9.721185996,9.721165996,9,136.0763828,3,2,5,3,2,5,5,0.385196,0.401468,0,No
13822,deja,3,13.99791989,3,9.721185996,9.721165996,9,136.0763828,1,1,2,1,1,2,5,0.307803,0.312733,0,No
13829,defy,3,13.99791989,3,9.721185996,9.721165996,9,136.0763828,3,2,5,3,3,6,5,0.399024,0.416795,0,No
13833,deform,3,13.99791989,3,9.721185996,9.721165996,9,136.0763828,2,1,3,3,2,5,5,0.322212,0.32651,0,No
13867,decompression,3,13.99791989,3,9.721185996,9.721165996,9,136.0763828,1,2,3,1,2,3,5,0.345686,0.354601,0,No
13897,decathlon,3,13.99791989,3,9.721185996,9.721165996,9,136.0763828,2,3,5,2,3,5,5,0.386286,0.402679,0,No
13908,debug,3,13.99791989,3,9.721185996,9.721165996,9,136.0763828,3,3,6,3,3,6,4,0.422754,0.439417,0,No
13947,daybreak,3,13.99791989,3,9.721185996,9.721165996,9,136.0763828,0,2,2,0,2,2,4,0.412195,0.429637,0,No
13990,danubian,3,13.99791989,3,9.721185996,9.721165996,9,136.0763828,1,0,1,3,0,3,0,0,0,0,No
13996,danielson,3,13.99791989,3,9.721185996,9.721165996,9,136.0763828,2,1,3,3,2,5,5,0.360829,0.373487,0,No
14056,czarina,3,13.99791989,3,9.721185996,9.721165996,9,136.0763828,2,2,4,2,2,4,5,0.347323,0.356445,0,No
14073,cygnet,3,13.99791989,3,9.721185996,9.721165996,9,136.0763828,2,2,4,2,2,4,5,0.398147,0.415908,0,No
14101,custodian,3,13.99791989,3,9.721185996,9.721165996,9,136.0763828,3,1,4,3,3,6,5,0.378607,0.394397,0,No
14113,cursive,3,13.99791989,3,9.721185996,9.721165996,9,136.0763828,3,2,5,3,2,5,5,0.320138,0.323473,0,No
14119,curran,3,13.99791989,3,9.721185996,9.721165996,9,136.0763828,2,3,5,2,3,5,5,0.384354,0.400571,0,No
14141,cummins,3,13.99791989,3,9.721185996,9.721165996,9,136.0763828,2,3,5,2,3,5,5,0.324884,0.328214,0,No
14193,crunch,3,13.99791989,3,9.721185996,9.721165996,9,136.0763828,3,2,5,3,2,5,5,0.38335,0.40077,0,No
14196,crumble,3,13.99791989,3,9.721185996,9.721165996,9,136.0763828,3,3,6,3,3,6,5,0.385096,0.401388,0,No
14218,crossroad,3,13.99791989,3,9.721185996,9.721165996,9,136.0763828,2,3,5,3,3,6,5,0.346571,0.35589,0,No
14220,crosscut,3,13.99791989,3,9.721185996,9.721165996,9,136.0763828,0,3,3,0,3,3,5,0.347452,0.356598,0,No
14224,crore,3,13.99791989,3,9.721185996,9.721165996,9,136.0763828,2,1,3,3,2,5,5,0.321349,0.324833,0,No
14230,croft,3,13.99791989,3,9.721185996,9.721165996,9,136.0763828,1,2,3,1,2,3,5,0.321768,0.325241,0,No
14265,crepe,3,13.99791989,3,9.721185996,9.721165996,9,136.0763828,3,1,4,3,1,4,5,0.375317,0.391855,0,No
14283,crease,3,13.99791989,3,9.721185996,9.721165996,9,136.0763828,3,2,5,3,2,5,5,0.378011,0.393736,0,No
14335,cowan,3,13.99791989,3,9.721185996,9.721165996,9,136.0763828,1,2,3,1,2,3,5,0.326551,0.330027,0,No
14376,counterbalance,3,13.99791989,3,9.721185996,9.721165996,9,136.0763828,2,3,5,3,3,6,4,0.429962,0.445989,0,No
14378,counteract,3,13.99791989,3,9.721185996,9.721165996,9,136.0763828,1,2,3,2,2,4,5,0.328339,0.333144,0,No
14521,converge,3,13.99791989,3,9.721185996,9.721165996,9,136.0763828,2,3,5,2,3,5,5,0.410086,0.427701,0,No
14547,contradict,3,13.99791989,3,9.721185996,9.721165996,9,136.0763828,2,2,4,2,2,4,5,0.376184,0.39267,0,No
14548,contractual,3,13.99791989,3,9.721185996,9.721165996,9,136.0763828,3,0,3,3,0,3,0,0,0,0,No
14549,contractor,3,13.99791989,3,9.721185996,9.721165996,9,136.0763828,2,3,5,2,3,5,5,0.396821,0.413964,0,No
14553,contrabass,3,13.99791989,3,9.721185996,9.721165996,9,136.0763828,2,2,4,2,2,4,5,0.384321,0.400515,0,No
14554,contraband,3,13.99791989,3,9.721185996,9.721165996,9,136.0763828,3,3,6,3,3,6,5,0.384545,0.400773,0,No
14576,contemporaneous,3,13.99791989,3,9.721185996,9.721165996,9,136.0763828,2,1,3,2,1,3,5,0.345068,0.353675,0,No
14585,consultative,3,13.99791989,3,9.721185996,9.721165996,9,136.0763828,2,2,4,2,3,5,5,0.322775,0.326038,0,No
14595,constrictor,3,13.99791989,3,9.721185996,9.721165996,9,136.0763828,1,3,4,3,3,6,5,0.34912,0.358807,0,No
14614,consolation,3,13.99791989,3,9.721185996,9.721165996,9,136.0763828,2,2,4,2,2,4,5,0.378672,0.39449,0,No
14650,conifer,3,13.99791989,3,9.721185996,9.721165996,9,136.0763828,2,2,4,2,2,4,5,0.327117,0.330577,0,No
14651,conic,3,13.99791989,3,9.721185996,9.721165996,9,136.0763828,2,1,3,2,2,4,5,0.318512,0.322039,0,No
14688,conferred,3,13.99791989,3,9.721185996,9.721165996,9,136.0763828,3,2,5,3,2,5,5,0.364782,0.378271,0,No
14715,conclusive,3,13.99791989,3,9.721185996,9.721165996,9,136.0763828,1,0,1,3,0,3,0,0,0,0,No
14733,conceive,3,13.99791989,3,9.721185996,9.721165996,9,136.0763828,2,2,4,2,2,4,5,0.395565,0.41265,0,No
14738,comrade,3,13.99791989,3,9.721185996,9.721165996,9,136.0763828,1,2,3,1,2,3,5,0.360925,0.373623,0,No
14744,comptroller,3,13.99791989,3,9.721185996,9.721165996,9,136.0763828,3,2,5,3,3,6,5,0.388391,0.405141,0,No
14751,compressible,3,13.99791989,3,9.721185996,9.721165996,9,136.0763828,3,3,6,3,3,6,4,0.399419,0.417047,0,No
14788,compelling,3,13.99791989,3,9.721185996,9.721165996,9,136.0763828,2,3,5,2,3,5,5,0.344773,0.353366,0,No
14894,collarbone,3,13.99791989,3,9.721185996,9.721165996,9,136.0763828,2,2,4,3,3,6,5,0.395565,0.41265,0,No
14930,coffey,3,13.99791989,3,9.721185996,9.721165996,9,136.0763828,1,2,3,3,2,5,5,0.322611,0.325943,0,No
14934,coexist,3,13.99791989,3,9.721185996,9.721165996,9,136.0763828,2,3,5,2,3,5,5,0.36446,0.377984,0,No
14941,codify,3,13.99791989,3,9.721185996,9.721165996,9,136.0763828,1,1,2,3,2,5,5,0.398076,0.415824,0,No
14968,cob,3,13.99791989,3,9.721185996,9.721165996,9,136.0763828,1,2,3,3,2,5,5,0.395565,0.41265,0,No
15013,cloister,3,13.99791989,3,9.721185996,9.721165996,9,136.0763828,2,3,5,2,3,5,5,0.405043,0.422419,0,No
15029,cling,3,13.99791989,3,9.721185996,9.721165996,9,136.0763828,2,2,4,3,3,6,5,0.360083,0.372635,0,No
15052,cleft,3,13.99791989,3,9.721185996,9.721165996,9,136.0763828,1,3,4,1,3,4,5,0.398112,0.415899,0,No
15087,clarify,3,13.99791989,3,9.721185996,9.721165996,9,136.0763828,1,3,4,3,3,6,5,0.414027,0.431757,0,No
15165,churchman,3,13.99791989,3,9.721185996,9.721165996,9,136.0763828,3,2,5,3,2,5,5,0.384554,0.400768,0,No
15219,chondrite,3,13.99791989,3,9.721185996,9.721165996,9,136.0763828,1,2,3,2,2,4,5,0.334017,0.339635,0,No
15273,chickpea,3,13.99791989,3,9.721185996,9.721165996,9,136.0763828,2,3,5,2,3,5,5,0.398103,0.415889,0,No
15287,chevron,3,13.99791989,3,9.721185996,9.721165996,9,136.0763828,1,3,4,1,3,4,5,0.347405,0.356557,0,No
15324,checklist,3,13.99791989,3,9.721185996,9.721165996,9,136.0763828,3,3,6,3,3,6,4,0.417926,0.435116,0,No
15327,cheater,3,13.99791989,3,9.721185996,9.721165996,9,136.0763828,2,3,5,3,3,6,5,0.398747,0.416476,0,No
15340,chaste,3,13.99791989,3,9.721185996,9.721165996,9,136.0763828,1,2,3,1,2,3,4,0.389755,0.406475,0,No
15343,charybdis,3,13.99791989,3,9.721185996,9.721165996,9,136.0763828,3,2,5,3,2,5,5,0.349285,0.359009,0,No
15426,cesium,3,13.99791989,3,9.721185996,9.721165996,9,136.0763828,3,2,5,3,2,5,5,0.346118,0.355129,0,No
15461,censure,3,13.99791989,3,9.721185996,9.721165996,9,136.0763828,2,3,5,2,3,5,5,0.390905,0.407969,0,No
15497,cavern,3,13.99791989,3,9.721185996,9.721165996,9,136.0763828,2,3,5,3,3,6,5,0.395662,0.412772,0,No
15519,catwalk,3,13.99791989,3,9.721185996,9.721165996,9,136.0763828,2,3,5,3,3,6,5,0.356603,0.368531,0,No
15567,cassava,3,13.99791989,3,9.721185996,9.721165996,9,136.0763828,1,3,4,1,3,4,5,0.366627,0.380555,0,No
15607,carpentry,3,13.99791989,3,9.721185996,9.721165996,9,136.0763828,2,2,4,2,3,5,5,0.384337,0.400533,0,No
15611,carousel,3,13.99791989,3,9.721185996,9.721165996,9,136.0763828,2,3,5,2,3,5,5,0.362029,0.374928,0,No
15612,carolyn,3,13.99791989,3,9.721185996,9.721165996,9,136.0763828,3,3,6,3,3,6,5,0.335336,0.342256,0,No
15618,carney,3,13.99791989,3,9.721185996,9.721165996,9,136.0763828,2,1,3,2,1,3,5,0.32034,0.323516,0,No
15621,carnation,3,13.99791989,3,9.721185996,9.721165996,9,136.0763828,3,2,5,3,2,5,5,0.345949,0.354901,0,No
15627,carlson,3,13.99791989,3,9.721185996,9.721165996,9,136.0763828,2,3,5,2,3,5,5,0.341826,0.349773,0,No
15645,carefree,3,13.99791989,3,9.721185996,9.721165996,9,136.0763828,3,3,6,3,3,6,5,0.325414,0.328741,0,No
15648,cardiovascular,3,13.99791989,3,9.721185996,9.721165996,9,136.0763828,2,2,4,3,2,5,5,0.384645,0.400876,0,No
15657,carcinoma,3,13.99791989,3,9.721185996,9.721165996,9,136.0763828,2,2,4,2,2,4,5,0.332273,0.33732,0,No
15670,carbine,3,13.99791989,3,9.721185996,9.721165996,9,136.0763828,2,1,3,3,1,4,5,0.311552,0.31604,0,No
15671,carbide,3,13.99791989,3,9.721185996,9.721165996,9,136.0763828,3,1,4,3,1,4,5,0.304796,0.310094,0,No
15737,candid,3,13.99791989,3,9.721185996,9.721165996,9,136.0763828,2,2,4,2,2,4,5,0.307734,0.312721,0,No
15741,cancelling,3,13.99791989,3,9.721185996,9.721165996,9,136.0763828,3,3,6,3,3,6,5,0.400492,0.418222,0,No
15753,campsite,3,13.99791989,3,9.721185996,9.721165996,9,136.0763828,2,1,3,3,1,4,5,0.360829,0.373487,0,No
15793,calliope,3,13.99791989,3,9.721185996,9.721165996,9,136.0763828,1,1,2,1,2,3,5,0.398076,0.415824,0,No
15795,callahan,3,13.99791989,3,9.721185996,9.721165996,9,136.0763828,3,3,6,3,3,6,5,0.375547,0.392113,0,No
15837,cahill,3,13.99791989,3,9.721185996,9.721165996,9,136.0763828,3,3,6,3,3,6,5,0.384346,0.400561,0,No
15889,butterfat,3,13.99791989,3,9.721185996,9.721165996,9,136.0763828,3,3,6,3,3,6,4,0.389798,0.40654,0,No
15945,bureaucratic,3,13.99791989,3,9.721185996,9.721165996,9,136.0763828,2,3,5,2,3,5,5,0.325838,0.329325,0,No
15959,bungalow,3,13.99791989,3,9.721185996,9.721165996,9,136.0763828,3,3,6,3,3,6,5,0.339427,0.346182,0,No
15984,bulbous,3,13.99791989,3,9.721185996,9.721165996,9,136.0763828,1,2,3,1,2,3,6,0.273185,0.278936,0,No
16062,brookside,3,13.99791989,3,9.721185996,9.721165996,9,136.0763828,2,3,5,2,3,5,5,0.385071,0.401345,0,No
16064,brookline,3,13.99791989,3,9.721185996,9.721165996,9,136.0763828,1,1,2,3,3,6,5,0.318592,0.322359,0,No
16086,broadside,3,13.99791989,3,9.721185996,9.721165996,9,136.0763828,2,3,5,2,3,5,5,0.366499,0.380403,0,No
16130,bridegroom,3,13.99791989,3,9.721185996,9.721165996,9,136.0763828,1,3,4,2,3,5,5,0.386269,0.402693,0,No
16201,brandeis,3,13.99791989,3,9.721185996,9.721165996,9,136.0763828,1,0,1,1,0,1,0,0,0,0,No
16213,braid,3,13.99791989,3,9.721185996,9.721165996,9,136.0763828,3,3,6,3,3,6,4,0.401461,0.419066,0,No
16249,bowdoin,3,13.99791989,3,9.721185996,9.721165996,9,136.0763828,3,2,5,3,3,6,5,0.324961,0.328706,0,No
16292,borosilicate,3,13.99791989,3,9.721185996,9.721165996,9,136.0763828,2,1,3,3,3,6,5,0.319959,0.323377,0,No
16330,bookseller,3,13.99791989,3,9.721185996,9.721165996,9,136.0763828,1,3,4,2,3,5,5,0.395733,0.412847,0,No
16336,booby,3,13.99791989,3,9.721185996,9.721165996,9,136.0763828,0,1,1,0,1,1,5,0.321187,0.324294,0,No
16390,bodleian,3,13.99791989,3,9.721185996,9.721165996,9,136.0763828,1,1,2,3,3,6,5,0.318695,0.322338,0,No
16435,blouse,3,13.99791989,3,9.721185996,9.721165996,9,136.0763828,3,3,6,3,3,6,5,0.371034,0.385775,0,No
16486,blasphemous,3,13.99791989,3,9.721185996,9.721165996,9,136.0763828,1,2,3,1,2,3,5,0.384454,0.400665,0,No
16521,bitwise,3,13.99791989,3,9.721185996,9.721165996,9,136.0763828,2,0,2,3,0,3,0,0,0,0,No
16545,birgit,3,13.99791989,3,9.721185996,9.721165996,9,136.0763828,1,0,1,1,0,1,0,0,0,0,No
16624,betray,3,13.99791989,3,9.721185996,9.721165996,9,136.0763828,2,2,4,3,3,6,5,0.399078,0.416786,0,No
16641,bespoke,3,13.99791989,3,9.721185996,9.721165996,9,136.0763828,1,2,3,1,2,3,5,0.375333,0.391892,0,No
16715,benchmark,3,13.99791989,3,9.721185996,9.721165996,9,136.0763828,2,3,5,3,3,6,4,0.402992,0.42061,0,No
16717,benares,3,13.99791989,3,9.721185996,9.721165996,9,136.0763828,3,2,5,3,2,5,5,0.384304,0.400496,0,No
16721,belvedere,3,13.99791989,3,9.721185996,9.721165996,9,136.0763828,2,1,3,2,2,4,5,0.324527,0.32819,0,No
16794,bedtime,3,13.99791989,3,9.721185996,9.721165996,9,136.0763828,2,3,5,3,3,6,5,0.324943,0.328394,0,No
16913,barrington,3,13.99791989,3,9.721185996,9.721165996,9,136.0763828,0,1,1,0,1,1,5,0.316994,0.320706,0,No
17071,backgammon,3,13.99791989,3,9.721185996,9.721165996,9,136.0763828,2,2,4,2,2,4,5,0.345902,0.354873,0,No
17072,backdrop,3,13.99791989,3,9.721185996,9.721165996,9,136.0763828,2,3,5,3,3,6,5,0.383258,0.399627,0,No
17100,ayers,3,13.99791989,3,9.721185996,9.721165996,9,136.0763828,2,1,3,2,3,5,5,0.324018,0.327394,0,No
17128,avoidance,3,13.99791989,3,9.721185996,9.721165996,9,136.0763828,2,2,4,2,2,4,5,0.381438,0.397561,0,No
17144,aventine,3,13.99791989,3,9.721185996,9.721165996,9,136.0763828,2,3,5,3,3,6,5,0.384396,0.400613,0,No
17145,avenge,3,13.99791989,3,9.721185996,9.721165996,9,136.0763828,1,2,3,3,2,5,5,0.337318,0.344251,0,No
17147,avarice,3,13.99791989,3,9.721185996,9.721165996,9,136.0763828,2,3,5,2,3,5,5,0.356711,0.368824,0,No
17162,automate,3,13.99791989,3,9.721185996,9.721165996,9,136.0763828,2,3,5,3,3,6,5,0.398899,0.416697,0,No
17169,autochthonous,3,13.99791989,3,9.721185996,9.721165996,9,136.0763828,3,1,4,3,1,4,5,0.398067,0.415814,0,No
17172,autistic,3,13.99791989,3,9.721185996,9.721165996,9,136.0763828,3,3,6,3,3,6,5,0.33334,0.338429,0,No
17180,australis,3,13.99791989,3,9.721185996,9.721165996,9,136.0763828,1,3,4,1,3,4,5,0.367113,0.381133,0,No
17210,auditor,3,13.99791989,3,9.721185996,9.721165996,9,136.0763828,2,2,4,2,2,4,5,0.388391,0.405141,0,No
17245,atreus,3,13.99791989,3,9.721185996,9.721165996,9,136.0763828,1,1,2,2,2,4,5,0.378607,0.394397,0,No
17274,asymmetry,3,13.99791989,3,9.721185996,9.721165996,9,136.0763828,3,3,6,3,3,6,5,0.349422,0.35912,0,No
17280,astrophysical,3,13.99791989,3,9.721185996,9.721165996,9,136.0763828,2,1,3,2,2,4,5,0.314266,0.318449,0,No
17305,assimilate,3,13.99791989,3,9.721185996,9.721165996,9,136.0763828,3,2,5,3,2,5,5,0.345889,0.354864,0,No
17308,assessor,3,13.99791989,3,9.721185996,9.721165996,9,136.0763828,3,3,6,3,3,6,5,0.337061,0.343468,0,No
17356,artisan,3,13.99791989,3,9.721185996,9.721165996,9,136.0763828,2,1,3,2,1,3,5,0.384237,0.400402,0,No
17384,arrhenius,3,13.99791989,3,9.721185996,9.721165996,9,136.0763828,1,3,4,1,3,4,4,0.38462,0.401513,0,No
17399,armpit,3,13.99791989,3,9.721185996,9.721165996,9,136.0763828,2,1,3,2,1,3,5,0.320821,0.324166,0,No
17436,argonaut,3,13.99791989,3,9.721185996,9.721165996,9,136.0763828,2,1,3,3,1,4,5,0.311755,0.316861,0,No
17520,appian,3,13.99791989,3,9.721185996,9.721165996,9,136.0763828,1,3,4,1,3,4,4,0.41243,0.429647,0,No
17545,apoplexy,3,13.99791989,3,9.721185996,9.721165996,9,136.0763828,2,2,4,3,2,5,5,0.384579,0.400796,0,No
17565,apathy,3,13.99791989,3,9.721185996,9.721165996,9,136.0763828,3,2,5,3,2,5,5,0.352084,0.362304,0,No
17576,anyhow,3,13.99791989,3,9.721185996,9.721165996,9,136.0763828,3,3,6,3,3,6,5,0.331491,0.336534,0,No
17606,antic,3,13.99791989,3,9.721185996,9.721165996,9,136.0763828,2,3,5,2,3,5,5,0.311837,0.316406,0,No
17633,anselmo,3,13.99791989,3,9.721185996,9.721165996,9,136.0763828,2,1,3,2,1,3,5,0.34998,0.359708,0,No
17637,anorthite,3,13.99791989,3,9.721185996,9.721165996,9,136.0763828,2,0,2,2,0,2,0,0,0,0,No
17646,annum,3,13.99791989,3,9.721185996,9.721165996,9,136.0763828,2,3,5,3,3,6,5,0.410257,0.427856,0,No
17654,annoyance,3,13.99791989,3,9.721185996,9.721165996,9,136.0763828,3,2,5,3,2,5,5,0.357235,0.369,0,No
17660,annex,3,13.99791989,3,9.721185996,9.721165996,9,136.0763828,1,2,3,3,2,5,5,0.398353,0.416101,0,No
17662,annelid,3,13.99791989,3,9.721185996,9.721165996,9,136.0763828,2,1,3,3,1,4,5,0.326479,0.32972,0,No
17665,annalen,3,13.99791989,3,9.721185996,9.721165996,9,136.0763828,1,2,3,1,2,3,5,0.327238,0.331264,0,No
17686,angora,3,13.99791989,3,9.721185996,9.721165996,9,136.0763828,3,2,5,3,2,5,5,0.36662,0.380527,0,No
17699,angelic,3,13.99791989,3,9.721185996,9.721165996,9,136.0763828,2,1,3,2,1,3,5,0.30727,0.312332,0,No
17755,amulet,3,13.99791989,3,9.721185996,9.721165996,9,136.0763828,3,2,5,3,2,5,5,0.342333,0.349997,0,No
17796,ami,3,13.99791989,3,9.721185996,9.721165996,9,136.0763828,2,1,3,2,1,3,5,0.326209,0.329765,0,No
17831,alvarez,3,13.99791989,3,9.721185996,9.721165996,9,136.0763828,1,1,2,2,3,5,5,0.314088,0.319067,0,No
17889,allocate,3,13.99791989,3,9.721185996,9.721165996,9,136.0763828,2,2,4,3,2,5,5,0.329828,0.33414,0,No
17914,alimentary,3,13.99791989,3,9.721185996,9.721165996,9,136.0763828,2,1,3,3,3,6,5,0.318884,0.322363,0,No
17964,alcott,3,13.99791989,3,9.721185996,9.721165996,9,136.0763828,1,1,2,3,1,4,5,0.32004,0.323567,0,No
18013,airmen,3,13.99791989,3,9.721185996,9.721165996,9,136.0763828,1,2,3,2,3,5,4,0.422432,0.439107,0,No
18037,agronomist,3,13.99791989,3,9.721185996,9.721165996,9,136.0763828,2,3,5,2,3,5,5,0.346246,0.355187,0,No
18135,adrienne,3,13.99791989,3,9.721185996,9.721165996,9,136.0763828,2,1,3,2,1,3,5,0.360829,0.373487,0,No
18223,acquaintance,3,13.99791989,3,9.721185996,9.721165996,9,136.0763828,3,3,6,3,3,6,5,0.388944,0.40577,0,No
18238,achaean,3,13.99791989,3,9.721185996,9.721165996,9,136.0763828,1,1,2,3,2,5,5,0.32432,0.327623,0,No
18315,abrasive,3,13.99791989,3,9.721185996,9.721165996,9,136.0763828,3,2,5,3,3,6,5,0.321518,0.324873,0,No
18322,abort,3,13.99791989,3,9.721185996,9.721165996,9,136.0763828,2,3,5,3,3,6,4,0.412421,0.429872,0,No
980,va,5,13.48709426,5,10.1266511,10.1266411,25,136.579098,3,1,4,3,4,7,5,0.345599,0.354479,0,No
646,wac,5,13.48709426,2,10.1266511,10.1266411,10,136.579098,2,4,6,5,4,9,5,0.353493,0.364302,0,No
1218,tulle,5,13.48709426,2,10.1266511,10.1266411,10,136.579098,2,2,4,2,2,4,5,0.395565,0.41265,0,No
1220,tularemia,5,13.48709426,2,10.1266511,10.1266411,10,136.579098,3,5,8,4,5,9,5,0.355233,0.366337,0,No
1806,thayer,5,13.48709426,2,10.1266511,10.1266411,10,136.579098,3,4,7,4,5,9,5,0.384396,0.400618,0,No
2162,sybil,5,13.48709426,2,10.1266511,10.1266411,10,136.579098,3,4,7,3,4,7,4,0.414172,0.431431,0,No
2678,stammer,5,13.48709426,2,10.1266511,10.1266411,10,136.579098,2,5,7,5,5,10,5,0.351547,0.361946,0,No
2688,stalagmite,5,13.48709426,2,10.1266511,10.1266411,10,136.579098,3,4,7,4,4,8,5,0.347902,0.357417,0,No
3171,sledge,5,13.48709426,2,10.1266511,10.1266411,10,136.579098,2,2,4,4,3,7,5,0.335786,0.341881,0,No
4095,sadism,5,13.48709426,2,10.1266511,10.1266411,10,136.579098,2,4,6,2,4,6,4,0.425837,0.442276,0,No
4384,rickshaw,5,13.48709426,2,10.1266511,10.1266411,10,136.579098,3,3,6,3,3,6,4,0.397692,0.415249,0,No
4408,rhododendron,5,13.48709426,2,10.1266511,10.1266411,10,136.579098,5,4,9,5,4,9,5,0.348722,0.358347,0,No
4427,rhenium,5,13.48709426,2,10.1266511,10.1266411,10,136.579098,3,3,6,3,5,8,4,0.389986,0.406747,0,No
4981,purr,5,13.48709426,2,10.1266511,10.1266411,10,136.579098,4,4,8,5,5,10,5,0.36375,0.376907,0,No
5651,platelet,5,13.48709426,2,10.1266511,10.1266411,10,136.579098,4,3,7,5,5,10,5,0.345895,0.354859,0,No
5840,philodendron,5,13.48709426,2,10.1266511,10.1266411,10,136.579098,2,3,5,2,4,6,5,0.350374,0.360239,0,No
6048,pellagra,5,13.48709426,2,10.1266511,10.1266411,10,136.579098,3,3,6,4,4,8,5,0.349718,0.359896,0,No
6152,pathos,5,13.48709426,2,10.1266511,10.1266411,10,136.579098,5,2,7,5,4,9,5,0.385038,0.401526,0,No
6236,pareto,5,13.48709426,2,10.1266511,10.1266411,10,136.579098,2,3,5,2,3,5,5,0.326647,0.330702,0,No
6299,pantheism,5,13.48709426,2,10.1266511,10.1266411,10,136.579098,5,2,7,5,4,9,5,0.345599,0.354479,0,No
6776,nullify,5,13.48709426,2,10.1266511,10.1266411,10,136.579098,1,5,6,5,5,10,4,0.409594,0.427117,0,No
7275,muezzin,5,13.48709426,2,10.1266511,10.1266411,10,136.579098,2,3,5,5,3,8,5,0.385824,0.402404,0,No
7381,mop,5,13.48709426,2,10.1266511,10.1266411,10,136.579098,4,3,7,4,5,9,5,0.352342,0.362824,0,No
7910,mcelroy,5,13.48709426,2,10.1266511,10.1266411,10,136.579098,4,4,8,4,4,8,5,0.362606,0.37564,0,No
7932,mbabane,5,13.48709426,2,10.1266511,10.1266411,10,136.579098,3,4,7,3,5,8,4,0.426215,0.442623,0,No
8019,masochism,5,13.48709426,2,10.1266511,10.1266411,10,136.579098,4,4,8,4,4,8,4,0.408285,0.425718,0,No
8023,maser,5,13.48709426,2,10.1266511,10.1266411,10,136.579098,2,3,5,3,3,6,5,0.366688,0.380626,0,No
8113,marceau,5,13.48709426,2,10.1266511,10.1266411,10,136.579098,2,3,5,5,3,8,5,0.336066,0.342112,0,No
8783,lemur,5,13.48709426,2,10.1266511,10.1266411,10,136.579098,2,2,4,2,2,4,5,0.330756,0.335335,0,No
8865,lawrencium,5,13.48709426,2,10.1266511,10.1266411,10,136.579098,5,3,8,5,4,9,5,0.358324,0.370349,0,No
9271,kamchatka,5,13.48709426,2,10.1266511,10.1266411,10,136.579098,3,3,6,3,4,7,5,0.328905,0.332935,0,No
9556,isinglass,5,13.48709426,2,10.1266511,10.1266411,10,136.579098,4,4,8,4,4,8,4,0.412718,0.429919,0,No
9600,ire,5,13.48709426,2,10.1266511,10.1266411,10,136.579098,2,1,3,4,2,6,5,0.384237,0.400402,0,No
10073,ilyushin,5,13.48709426,2,10.1266511,10.1266411,10,136.579098,1,2,3,1,2,3,5,0.305337,0.310661,0,No
10111,idiocy,5,13.48709426,2,10.1266511,10.1266411,10,136.579098,2,4,6,2,4,6,5,0.348195,0.357723,0,No
10203,hutchins,5,13.48709426,2,10.1266511,10.1266411,10,136.579098,2,3,5,3,4,7,5,0.377874,0.39436,0,No
10646,helical,5,13.48709426,2,10.1266511,10.1266411,10,136.579098,4,2,6,5,2,7,5,0.321617,0.324786,0,No
10819,harbin,5,13.48709426,2,10.1266511,10.1266411,10,136.579098,4,4,8,4,4,8,5,0.338785,0.345289,0,No
10899,halibut,5,13.48709426,2,10.1266511,10.1266411,10,136.579098,5,5,10,5,5,10,5,0.357314,0.369166,0,No
10923,hafnium,5,13.48709426,2,10.1266511,10.1266411,10,136.579098,2,1,3,3,4,7,5,0.345599,0.354479,0,No
11256,goldfinch,5,13.48709426,2,10.1266511,10.1266411,10,136.579098,1,3,4,3,3,6,4,0.424858,0.441365,0,No
11352,gladiolus,5,13.48709426,2,10.1266511,10.1266411,10,136.579098,5,3,8,5,3,8,5,0.342175,0.350177,0,No
11589,gallium,5,13.48709426,2,10.1266511,10.1266411,10,136.579098,4,3,7,4,3,7,5,0.349443,0.359539,0,No
11794,frangipani,5,13.48709426,2,10.1266511,10.1266411,10,136.579098,4,3,7,4,3,7,5,0.355262,0.36649,0,No
12222,fermium,5,13.48709426,2,10.1266511,10.1266411,10,136.579098,3,5,8,3,5,8,5,0.330473,0.336397,0,No
12956,electrophoresis,5,13.48709426,2,10.1266511,10.1266411,10,136.579098,2,2,4,5,2,7,5,0.348825,0.358516,0,No
13231,drosophila,5,13.48709426,2,10.1266511,10.1266411,10,136.579098,3,2,5,3,2,5,5,0.321367,0.324765,0,No
13347,doorman,5,13.48709426,2,10.1266511,10.1266411,10,136.579098,3,4,7,3,4,7,5,0.362717,0.375682,0,No
13606,diatom,5,13.48709426,2,10.1266511,10.1266411,10,136.579098,3,1,4,3,1,4,5,0.329717,0.33456,0,No
13745,dentition,5,13.48709426,2,10.1266511,10.1266411,10,136.579098,2,3,5,2,5,7,5,0.385221,0.401737,0,No
13820,delaney,5,13.48709426,2,10.1266511,10.1266411,10,136.579098,4,4,8,5,5,10,5,0.339323,0.346087,0,No
14370,counterweight,5,13.48709426,2,10.1266511,10.1266411,10,136.579098,4,3,7,5,3,8,5,0.345929,0.354695,0,No
15128,circumstance,5,13.48709426,2,10.1266511,10.1266411,10,136.579098,2,3,5,5,3,8,4,0.405311,0.422868,0,No
15570,cask,5,13.48709426,2,10.1266511,10.1266411,10,136.579098,2,2,4,5,5,10,5,0.378656,0.394472,0,No
16018,buckeye,5,13.48709426,2,10.1266511,10.1266411,10,136.579098,3,3,6,4,5,9,5,0.348161,0.357812,0,No
16098,britannic,5,13.48709426,2,10.1266511,10.1266411,10,136.579098,1,4,5,3,5,8,4,0.412833,0.430211,0,No
16147,brest,5,13.48709426,2,10.1266511,10.1266411,10,136.579098,5,4,9,5,5,10,5,0.347902,0.357375,0,No
16453,blocky,5,13.48709426,2,10.1266511,10.1266411,10,136.579098,3,1,4,3,5,8,5,0.308654,0.313573,0,No
16462,blitzkrieg,5,13.48709426,2,10.1266511,10.1266411,10,136.579098,4,3,7,4,4,8,4,0.407572,0.425014,0,No
17028,baklava,5,13.48709426,2,10.1266511,10.1266411,10,136.579098,5,3,8,5,4,9,5,0.360507,0.373108,0,No
17117,awhile,5,13.48709426,2,10.1266511,10.1266411,10,136.579098,1,5,6,5,5,10,4,0.39388,0.410944,0,No
17196,auk,5,13.48709426,2,10.1266511,10.1266411,10,136.579098,1,4,5,4,5,9,4,0.40356,0.42108,0,No
17230,attire,5,13.48709426,2,10.1266511,10.1266411,10,136.579098,4,4,8,4,4,8,4,0.408013,0.425591,0,No
17295,astatine,5,13.48709426,2,10.1266511,10.1266411,10,136.579098,3,3,6,3,5,8,4,0.390441,0.407226,0,No
17848,alsop,5,13.48709426,2,10.1266511,10.1266411,10,136.579098,5,4,9,5,5,10,5,0.333258,0.338269,0,No
18200,acuity,5,13.48709426,2,10.1266511,10.1266411,10,136.579098,1,4,5,5,4,9,5,0.348688,0.358281,0,No
18296,absurdum,5,13.48709426,2,10.1266511,10.1266411,10,136.579098,2,4,6,5,4,9,5,0.349464,0.359563,0,No
635,waggle,10,12.79394708,1,10.81979828,10.81979828,10,138.4279267,6,3,9,10,9,19,5,0.324385,0.327707,0,No
5515,polyhedra,10,12.79394708,1,10.81979828,10.81979828,10,138.4279267,5,7,12,6,8,14,4,0.441743,0.456326,0,No
19,zircon,4,13.71023782,2,10.1266511,10.1266411,8,138.8387949,1,3,4,1,4,5,5,0.348935,0.358708,0,No
128,yak,4,13.71023782,2,10.1266511,10.1266411,8,138.8387949,3,3,6,3,3,6,5,0.348489,0.358037,0,No
225,woodlawn,4,13.71023782,2,10.1266511,10.1266411,8,138.8387949,1,3,4,2,4,6,5,0.347663,0.357032,0,No
295,wingtip,4,13.71023782,2,10.1266511,10.1266411,8,138.8387949,4,3,7,4,3,7,4,0.395795,0.412925,0,No
313,wily,4,13.71023782,2,10.1266511,10.1266411,8,138.8387949,3,4,7,3,4,7,4,0.389823,0.406587,0,No
389,whitaker,4,13.71023782,2,10.1266511,10.1266411,8,138.8387949,3,2,5,4,2,6,5,0.359747,0.371947,0,No
578,warhead,4,13.71023782,2,10.1266511,10.1266411,8,138.8387949,2,4,6,3,4,7,5,0.363884,0.377214,0,No
1028,urchin,4,13.71023782,2,10.1266511,10.1266411,8,138.8387949,1,3,4,2,4,6,5,0.357156,0.368894,0,No
1580,tog,4,13.71023782,2,10.1266511,10.1266411,8,138.8387949,2,3,5,3,3,6,4,0.399033,0.416667,0,No
1828,tetrahedra,4,13.71023782,2,10.1266511,10.1266411,8,138.8387949,2,3,5,3,3,6,5,0.386286,0.402674,0,No
2020,tantalum,4,13.71023782,2,10.1266511,10.1266411,8,138.8387949,3,3,6,3,3,6,5,0.350429,0.360528,0,No
2210,swank,4,13.71023782,2,10.1266511,10.1266411,8,138.8387949,1,3,4,1,3,4,5,0.386547,0.402993,0,No
2282,supervisory,4,13.71023782,2,10.1266511,10.1266411,8,138.8387949,3,2,5,4,4,8,5,0.323057,0.326155,0,No
2312,sundial,4,13.71023782,2,10.1266511,10.1266411,8,138.8387949,2,3,5,4,3,7,5,0.343068,0.350711,0,No
2450,striptease,4,13.71023782,2,10.1266511,10.1266411,8,138.8387949,4,3,7,4,3,7,4,0.414947,0.432224,0,No
2557,stillbirth,4,13.71023782,2,10.1266511,10.1266411,8,138.8387949,1,2,3,3,2,5,4,0.38772,0.404771,0,No
2859,spectrometer,4,13.71023782,2,10.1266511,10.1266411,8,138.8387949,1,2,3,2,4,6,5,0.345619,0.354526,0,No
3034,sod,4,13.71023782,2,10.1266511,10.1266411,8,138.8387949,3,3,6,3,4,7,4,0.407582,0.425023,0,No
3213,skim,4,13.71023782,2,10.1266511,10.1266411,8,138.8387949,2,1,3,3,4,7,5,0.319821,0.323278,0,No
3489,sheave,4,13.71023782,2,10.1266511,10.1266411,8,138.8387949,1,2,3,2,2,4,5,0.395565,0.41265,0,No
3824,schuyler,4,13.71023782,2,10.1266511,10.1266411,8,138.8387949,2,1,3,2,1,3,5,0.314216,0.318436,0,No
4126,ruthenium,4,13.71023782,2,10.1266511,10.1266411,8,138.8387949,3,2,5,3,4,7,5,0.345848,0.35477,0,No
4194,rowley,4,13.71023782,2,10.1266511,10.1266411,8,138.8387949,3,4,7,3,4,7,5,0.349711,0.359676,0,No
4395,ribosome,4,13.71023782,2,10.1266511,10.1266411,8,138.8387949,3,1,4,4,3,7,5,0.345599,0.354479,0,No
4853,quizzes,4,13.71023782,2,10.1266511,10.1266411,8,138.8387949,1,2,3,1,4,5,5,0.340233,0.347542,0,No
5059,psychotic,4,13.71023782,2,10.1266511,10.1266411,8,138.8387949,2,2,4,2,2,4,5,0.333208,0.338255,0,No
5449,porte,4,13.71023782,2,10.1266511,10.1266411,8,138.8387949,1,3,4,4,4,8,5,0.348729,0.358286,0,No
5533,pollard,4,13.71023782,2,10.1266511,10.1266411,8,138.8387949,2,3,5,4,3,7,5,0.33968,0.346584,0,No
5594,plunge,4,13.71023782,2,10.1266511,10.1266411,8,138.8387949,4,4,8,4,4,8,5,0.340795,0.347896,0,No
5704,pith,4,13.71023782,2,10.1266511,10.1266411,8,138.8387949,2,2,4,3,4,7,5,0.395565,0.41265,0,No
5940,permissible,4,13.71023782,2,10.1266511,10.1266411,8,138.8387949,2,4,6,2,4,6,5,0.369159,0.383497,0,No
6075,pecos,4,13.71023782,2,10.1266511,10.1266411,8,138.8387949,1,2,3,1,4,5,5,0.326659,0.330566,0,No
6229,parke,4,13.71023782,2,10.1266511,10.1266411,8,138.8387949,2,0,2,4,0,4,0,0,0,0,No
6493,orgy,4,13.71023782,2,10.1266511,10.1266411,8,138.8387949,3,3,6,3,4,7,5,0.349271,0.359059,0,No
6544,opossum,4,13.71023782,2,10.1266511,10.1266411,8,138.8387949,3,3,6,4,3,7,5,0.370121,0.384558,0,No
6632,ohmmeter,4,13.71023782,2,10.1266511,10.1266411,8,138.8387949,3,2,5,3,2,5,5,0.384321,0.40051,0,No
6670,oddball,4,13.71023782,2,10.1266511,10.1266411,8,138.8387949,3,2,5,3,2,5,5,0.362546,0.375689,0,No
6923,nimh,4,13.71023782,2,10.1266511,10.1266411,8,138.8387949,2,3,5,4,4,8,4,0.405181,0.422751,0,No
7028,nepotism,4,13.71023782,2,10.1266511,10.1266411,8,138.8387949,4,3,7,4,4,8,5,0.371042,0.385628,0,No
7370,moresby,4,13.71023782,2,10.1266511,10.1266411,8,138.8387949,3,3,6,4,3,7,4,0.406322,0.423868,0,No
7620,militarist,4,13.71023782,2,10.1266511,10.1266411,8,138.8387949,3,2,5,3,2,5,5,0.344012,0.35246,0,No
7672,michelson,4,13.71023782,2,10.1266511,10.1266411,8,138.8387949,4,3,7,4,4,8,5,0.385038,0.401327,0,No
7768,mercantile,4,13.71023782,2,10.1266511,10.1266411,8,138.8387949,2,1,3,4,4,8,5,0.320317,0.323561,0,No
7968,mattress,4,13.71023782,2,10.1266511,10.1266411,8,138.8387949,3,4,7,4,4,8,5,0.387204,0.403721,0,No
8047,marshmallow,4,13.71023782,2,10.1266511,10.1266411,8,138.8387949,4,3,7,4,4,8,4,0.425796,0.442219,0,No
8311,mackinaw,4,13.71023782,2,10.1266511,10.1266411,8,138.8387949,4,3,7,4,4,8,5,0.362347,0.375363,0,No
8369,lutetium,4,13.71023782,2,10.1266511,10.1266411,8,138.8387949,2,4,6,2,4,6,5,0.352776,0.363547,0,No
8690,licorice,4,13.71023782,2,10.1266511,10.1266411,8,138.8387949,2,2,4,2,2,4,5,0.361557,0.374269,0,No
8738,letitia,4,13.71023782,2,10.1266511,10.1266411,8,138.8387949,3,2,5,3,3,6,5,0.320867,0.324847,0,No
8792,leila,4,13.71023782,2,10.1266511,10.1266411,8,138.8387949,4,2,6,4,3,7,5,0.320328,0.323789,0,No
8909,latch,4,13.71023782,2,10.1266511,10.1266411,8,138.8387949,4,4,8,4,4,8,5,0.384854,0.401139,0,No
8928,largemouth,4,13.71023782,2,10.1266511,10.1266411,8,138.8387949,2,2,4,4,4,8,5,0.384329,0.400524,0,No
9025,labium,4,13.71023782,2,10.1266511,10.1266411,8,138.8387949,3,4,7,3,4,7,5,0.384996,0.401284,0,No
9107,knapsack,4,13.71023782,2,10.1266511,10.1266411,8,138.8387949,3,3,6,3,3,6,5,0.332478,0.33797,0,No
9412,jinx,4,13.71023782,2,10.1266511,10.1266411,8,138.8387949,1,2,3,1,2,3,5,0.39855,0.416279,0,No
9493,jaime,4,13.71023782,2,10.1266511,10.1266411,8,138.8387949,3,3,6,3,3,6,5,0.331342,0.33599,0,No
9578,irrelevant,4,13.71023782,2,10.1266511,10.1266411,8,138.8387949,3,3,6,3,3,6,5,0.355219,0.366961,0,No
9783,innuendo,4,13.71023782,2,10.1266511,10.1266411,8,138.8387949,3,4,7,3,4,7,5,0.355674,0.366908,0,No
10056,immigrate,4,13.71023782,2,10.1266511,10.1266411,8,138.8387949,3,3,6,4,3,7,5,0.367234,0.381269,0,No
10218,hurl,4,13.71023782,2,10.1266511,10.1266411,8,138.8387949,4,4,8,4,4,8,5,0.37569,0.391165,0,No
10470,hippocratic,4,13.71023782,2,10.1266511,10.1266411,8,138.8387949,2,1,3,4,4,8,5,0.317487,0.32105,0,No
10524,hiawatha,4,13.71023782,2,10.1266511,10.1266411,8,138.8387949,2,4,6,2,4,6,4,0.391483,0.408376,0,No
11050,groundhog,4,13.71023782,2,10.1266511,10.1266411,8,138.8387949,1,2,3,1,3,4,5,0.346936,0.356054,0,No
11071,grist,4,13.71023782,2,10.1266511,10.1266411,8,138.8387949,3,2,5,3,3,6,5,0.345767,0.35468,0,No
11235,goody,4,13.71023782,2,10.1266511,10.1266411,8,138.8387949,3,3,6,4,3,7,5,0.337844,0.344152,0,No
11248,goliath,4,13.71023782,2,10.1266511,10.1266411,8,138.8387949,2,3,5,2,4,6,4,0.389832,0.406569,0,No
11370,ginsburg,4,13.71023782,2,10.1266511,10.1266411,8,138.8387949,1,4,5,1,4,5,5,0.340194,0.34711,0,No
11405,ghoul,4,13.71023782,2,10.1266511,10.1266411,8,138.8387949,3,2,5,3,4,7,5,0.345828,0.354817,0,No
11462,genotype,4,13.71023782,2,10.1266511,10.1266411,8,138.8387949,2,3,5,4,3,7,4,0.392218,0.409108,0,No
11483,gemsbok,4,13.71023782,2,10.1266511,10.1266411,8,138.8387949,4,3,7,4,3,7,4,0.421439,0.438548,0,No
11615,gaillardia,4,13.71023782,2,10.1266511,10.1266411,8,138.8387949,4,1,5,4,1,5,5,0.287512,0.293781,0,No
11824,fovea,4,13.71023782,2,10.1266511,10.1266411,8,138.8387949,2,2,4,4,2,6,5,0.333121,0.338555,0,No
11922,foolscap,4,13.71023782,2,10.1266511,10.1266411,8,138.8387949,2,3,5,2,4,6,4,0.372115,0.386861,0,No
11962,flycatcher,4,13.71023782,2,10.1266511,10.1266411,8,138.8387949,3,3,6,4,3,7,4,0.388263,0.405339,0,No
12211,ferrous,4,13.71023782,2,10.1266511,10.1266411,8,138.8387949,4,3,7,4,4,8,5,0.349457,0.359544,0,No
12290,faun,4,13.71023782,2,10.1266511,10.1266411,8,138.8387949,2,3,5,3,3,6,5,0.36972,0.384093,0,No
12748,episodic,4,13.71023782,2,10.1266511,10.1266411,8,138.8387949,2,1,3,2,1,3,5,0.326209,0.329765,0,No
12959,electrolytic,4,13.71023782,2,10.1266511,10.1266411,8,138.8387949,2,2,4,4,4,8,5,0.323469,0.32678,0,No
13182,dumbbell,4,13.71023782,2,10.1266511,10.1266411,8,138.8387949,3,1,4,4,4,8,5,0.313755,0.317928,0,No
13353,doolittle,4,13.71023782,2,10.1266511,10.1266411,8,138.8387949,4,2,6,4,2,6,5,0.326563,0.330088,0,No
13566,digamma,4,13.71023782,2,10.1266511,10.1266411,8,138.8387949,2,4,6,2,4,6,5,0.395178,0.412298,0,No
13623,diagramming,4,13.71023782,2,10.1266511,10.1266411,8,138.8387949,4,1,5,4,3,7,5,0.322699,0.325972,0,No
13652,devilish,4,13.71023782,2,10.1266511,10.1266411,8,138.8387949,2,2,4,2,3,5,5,0.398219,0.415969,0,No
14037,dahlia,4,13.71023782,2,10.1266511,10.1266411,8,138.8387949,4,4,8,4,4,8,4,0.407741,0.425277,0,No
14118,currant,4,13.71023782,2,10.1266511,10.1266411,8,138.8387949,2,2,4,2,2,4,5,0.398094,0.415861,0,No
14860,colossi,4,13.71023782,2,10.1266511,10.1266411,8,138.8387949,1,4,5,4,4,8,4,0.419437,0.436548,0,No
15066,clavicle,4,13.71023782,2,10.1266511,10.1266411,8,138.8387949,2,2,4,4,3,7,5,0.36662,0.380527,0,No
15127,circumvent,4,13.71023782,2,10.1266511,10.1266411,8,138.8387949,2,3,5,4,4,8,5,0.39898,0.416748,0,No
15398,chamois,4,13.71023782,2,10.1266511,10.1266411,8,138.8387949,1,2,3,1,2,3,5,0.340201,0.3475,0,No
15450,centripetal,4,13.71023782,2,10.1266511,10.1266411,8,138.8387949,2,1,3,2,4,6,5,0.323445,0.326642,0,No
16523,bitumen,4,13.71023782,2,10.1266511,10.1266411,8,138.8387949,4,3,7,4,3,7,5,0.357235,0.369,0,No
16583,bilabial,4,13.71023782,2,10.1266511,10.1266411,8,138.8387949,2,1,3,2,1,3,5,0.384237,0.400402,0,No
16966,baobab,4,13.71023782,2,10.1266511,10.1266411,8,138.8387949,4,3,7,4,4,8,5,0.345841,0.354793,0,No
16968,banter,4,13.71023782,2,10.1266511,10.1266411,8,138.8387949,2,3,5,2,3,5,5,0.347269,0.356507,0,No
17040,bahama,4,13.71023782,2,10.1266511,10.1266411,8,138.8387949,3,2,5,3,2,5,5,0.323522,0.327235,0,No
17603,antietam,4,13.71023782,2,10.1266511,10.1266411,8,138.8387949,3,3,6,4,3,7,5,0.338153,0.344577,0,No
17678,aniline,4,13.71023782,2,10.1266511,10.1266411,8,138.8387949,3,3,6,3,4,7,5,0.345666,0.354568,0,No
17886,allowance,4,13.71023782,2,10.1266511,10.1266411,8,138.8387949,3,3,6,4,4,8,4,0.408642,0.426136,0,No
17958,aldrich,4,13.71023782,2,10.1266511,10.1266411,8,138.8387949,1,3,4,2,4,6,5,0.379498,0.395425,0,No
15215,chopstick,9,12.8993076,1,10.81979828,10.81979828,9,139.5679062,2,1,3,2,3,5,5,0.315198,0.319342,0,No
6149,patina,8,13.01709064,1,10.81979828,10.81979828,8,140.8422949,6,3,9,8,4,12,5,0.346991,0.356234,0,No
17,zither,3,13.99791989,2,10.1266511,10.1266411,6,141.7520509,2,3,5,3,3,6,5,0.385531,0.401871,0,No
38,zeal,3,13.99791989,2,10.1266511,10.1266411,6,141.7520509,1,3,4,1,3,4,5,0.350409,0.360331,0,No
143,wynn,3,13.99791989,2,10.1266511,10.1266411,6,141.7520509,2,0,2,2,0,2,0,0,0,0,No
163,wrinkle,3,13.99791989,2,10.1266511,10.1266411,6,141.7520509,1,2,3,3,3,6,5,0.361167,0.373919,0,No
184,worthwhile,3,13.99791989,2,10.1266511,10.1266411,6,141.7520509,3,3,6,3,3,6,5,0.360375,0.373006,0,No
188,worshipful,3,13.99791989,2,10.1266511,10.1266411,6,141.7520509,2,2,4,3,3,6,5,0.398442,0.416176,0,No
339,wildfire,3,13.99791989,2,10.1266511,10.1266411,6,141.7520509,2,2,4,2,2,4,5,0.339596,0.346547,0,No
367,whore,3,13.99791989,2,10.1266511,10.1266411,6,141.7520509,1,3,4,1,3,4,5,0.396378,0.413561,0,No
419,whelk,3,13.99791989,2,10.1266511,10.1266411,6,141.7520509,1,1,2,1,1,2,5,0.327999,0.3324,0,No
543,waterbury,3,13.99791989,2,10.1266511,10.1266411,6,141.7520509,3,3,6,3,3,6,5,0.345922,0.354868,0,No
610,walla,3,13.99791989,2,10.1266511,10.1266411,6,141.7520509,1,1,2,2,2,4,5,0.322552,0.326102,0,No
714,vitriol,3,13.99791989,2,10.1266511,10.1266411,6,141.7520509,2,2,4,3,2,5,5,0.365894,0.379478,0,No
723,visor,3,13.99791989,2,10.1266511,10.1266411,6,141.7520509,3,1,4,3,1,4,5,0.343985,0.352404,0,No
733,visceral,3,13.99791989,2,10.1266511,10.1266411,6,141.7520509,2,2,4,2,2,4,5,0.319872,0.3234,0,No
798,vicksburg,3,13.99791989,2,10.1266511,10.1266411,6,141.7520509,3,3,6,3,3,6,5,0.348804,0.358375,0,No
820,vet,3,13.99791989,2,10.1266511,10.1266411,6,141.7520509,2,2,4,3,3,6,5,0.369689,0.384037,0,No
909,vee,3,13.99791989,2,10.1266511,10.1266411,6,141.7520509,1,1,2,1,3,4,5,0.309823,0.314574,0,No
917,vaudois,3,13.99791989,2,10.1266511,10.1266411,6,141.7520509,1,3,4,3,3,6,5,0.356991,0.368996,0,No
924,vasquez,3,13.99791989,2,10.1266511,10.1266411,6,141.7520509,2,1,3,3,1,4,5,0.319619,0.322909,0,No
973,vagabond,3,13.99791989,2,10.1266511,10.1266411,6,141.7520509,1,2,3,3,2,5,5,0.345646,0.354563,0,No
1149,twiddle,3,13.99791989,2,10.1266511,10.1266411,6,141.7520509,3,3,6,3,3,6,4,0.406387,0.423957,0,No
1178,turpentine,3,13.99791989,2,10.1266511,10.1266411,6,141.7520509,1,2,3,3,2,5,5,0.358353,0.370636,0,No
1199,turbidity,3,13.99791989,2,10.1266511,10.1266411,6,141.7520509,3,2,5,3,2,5,5,0.346923,0.356084,0,No
1221,tulane,3,13.99791989,2,10.1266511,10.1266411,6,141.7520509,2,0,2,3,0,3,0,0,0,0,No
1231,tubule,3,13.99791989,2,10.1266511,10.1266411,6,141.7520509,2,1,3,3,2,5,5,0.345599,0.354479,0,No
1246,trustworthy,3,13.99791989,2,10.1266511,10.1266411,6,141.7520509,2,3,5,3,3,6,5,0.332285,0.33704,0,No
1371,travail,3,13.99791989,2,10.1266511,10.1266411,6,141.7520509,1,2,3,2,2,4,4,0.422432,0.439107,0,No
1420,transducer,3,13.99791989,2,10.1266511,10.1266411,6,141.7520509,2,2,4,2,2,4,5,0.347384,0.357017,0,No
1493,toshiba,3,13.99791989,2,10.1266511,10.1266411,6,141.7520509,2,0,2,2,0,2,0,0,0,0,No
1629,timeshare,3,13.99791989,2,10.1266511,10.1266411,6,141.7520509,3,2,5,3,3,6,5,0.325683,0.329325,0,No
1798,theist,3,13.99791989,2,10.1266511,10.1266411,6,141.7520509,3,3,6,3,3,6,5,0.370129,0.384572,0,No
1885,tenet,3,13.99791989,2,10.1266511,10.1266411,6,141.7520509,2,3,5,2,3,5,4,0.417887,0.435079,0,No
2043,tamarind,3,13.99791989,2,10.1266511,10.1266411,6,141.7520509,2,2,4,2,2,4,5,0.303187,0.308738,0,No
2099,tablespoon,3,13.99791989,2,10.1266511,10.1266411,6,141.7520509,2,1,3,3,2,5,5,0.345599,0.354479,0,No
2150,symbiont,3,13.99791989,2,10.1266511,10.1266411,6,141.7520509,1,1,2,2,1,3,5,0.345599,0.354479,0,No
2203,swatch,3,13.99791989,2,10.1266511,10.1266411,6,141.7520509,2,1,3,3,1,4,5,0.325772,0.32925,0,No
2299,sunscreen,3,13.99791989,2,10.1266511,10.1266411,6,141.7520509,3,3,6,3,3,6,4,0.395777,0.412911,0,No
2398,subliminal,3,13.99791989,2,10.1266511,10.1266411,6,141.7520509,1,1,2,2,1,3,5,0.290362,0.296591,0,No
2466,streptococcus,3,13.99791989,2,10.1266511,10.1266411,6,141.7520509,3,1,4,3,1,4,5,0.332161,0.339406,0,No
2574,stethoscope,3,13.99791989,2,10.1266511,10.1266411,6,141.7520509,2,1,3,3,2,5,5,0.345599,0.354479,0,No
2735,spyglass,3,13.99791989,2,10.1266511,10.1266411,6,141.7520509,3,1,4,3,1,4,5,0.345068,0.353675,0,No
2778,spool,3,13.99791989,2,10.1266511,10.1266411,6,141.7520509,3,2,5,3,3,6,5,0.385196,0.401468,0,No
2839,spermatozoa,3,13.99791989,2,10.1266511,10.1266411,6,141.7520509,2,2,4,3,3,6,5,0.40483,0.422185,0,No
3140,sloop,3,13.99791989,2,10.1266511,10.1266411,6,141.7520509,2,3,5,2,3,5,5,0.390295,0.407164,0,No
3164,sleigh,3,13.99791989,2,10.1266511,10.1266411,6,141.7520509,3,2,5,3,2,5,5,0.361336,0.374125,0,No
3384,shrove,3,13.99791989,2,10.1266511,10.1266411,6,141.7520509,2,1,3,2,3,5,5,0.314249,0.318359,0,No
3436,shish,3,13.99791989,2,10.1266511,10.1266411,6,141.7520509,2,1,3,2,1,3,5,0.291315,0.297574,0,No
3493,sheaf,3,13.99791989,2,10.1266511,10.1266411,6,141.7520509,2,2,4,3,2,5,4,0.417798,0.43498,0,No
3509,sharecropper,3,13.99791989,2,10.1266511,10.1266411,6,141.7520509,1,2,3,3,3,6,5,0.384412,0.400613,0,No
3565,sevenfold,3,13.99791989,2,10.1266511,10.1266411,6,141.7520509,0,3,3,0,3,3,5,0.394656,0.411744,0,No
3617,sepia,3,13.99791989,2,10.1266511,10.1266411,6,141.7520509,3,2,5,3,2,5,5,0.359208,0.371588,0,No
3678,seep,3,13.99791989,2,10.1266511,10.1266411,6,141.7520509,2,1,3,3,2,5,5,0.32023,0.323457,0,No
3790,scoundrel,3,13.99791989,2,10.1266511,10.1266411,6,141.7520509,2,1,3,2,1,3,5,0.398076,0.415824,0,No
3802,scorn,3,13.99791989,2,10.1266511,10.1266411,6,141.7520509,2,2,4,2,3,5,5,0.382837,0.399116,0,No
3866,scheherazade,3,13.99791989,2,10.1266511,10.1266411,6,141.7520509,3,3,6,3,3,6,5,0.370059,0.384539,0,No
3905,scabbard,3,13.99791989,2,10.1266511,10.1266411,6,141.7520509,1,2,3,3,2,5,5,0.398112,0.41588,0,No
3964,sardine,3,13.99791989,2,10.1266511,10.1266411,6,141.7520509,3,3,6,3,3,6,5,0.348743,0.358375,0,No
3979,sapling,3,13.99791989,2,10.1266511,10.1266411,6,141.7520509,1,2,3,2,2,4,5,0.365412,0.379123,0,No
4074,sailboat,3,13.99791989,2,10.1266511,10.1266411,6,141.7520509,2,1,3,3,1,4,5,0.327999,0.3324,0,No
4161,rumford,3,13.99791989,2,10.1266511,10.1266411,6,141.7520509,3,2,5,3,2,5,5,0.395557,0.412641,0,No
4277,roebuck,3,13.99791989,2,10.1266511,10.1266411,6,141.7520509,0,2,2,0,3,3,5,0.324831,0.328243,0,No
4282,rodeo,3,13.99791989,2,10.1266511,10.1266411,6,141.7520509,1,3,4,1,3,4,5,0.37632,0.391623,0,No
4353,rime,3,13.99791989,2,10.1266511,10.1266411,6,141.7520509,2,2,4,3,3,6,5,0.382837,0.399116,0,No
4358,rightmost,3,13.99791989,2,10.1266511,10.1266411,6,141.7520509,2,3,5,3,3,6,5,0.355347,0.367106,0,No
4389,richfield,3,13.99791989,2,10.1266511,10.1266411,6,141.7520509,3,3,6,3,3,6,5,0.347303,0.35661,0,No
4420,rheumatism,3,13.99791989,2,10.1266511,10.1266411,6,141.7520509,3,3,6,3,3,6,5,0.357012,0.369137,0,No
4501,resistive,3,13.99791989,2,10.1266511,10.1266411,6,141.7520509,2,2,4,2,3,5,5,0.322951,0.326144,0,No
4649,reductio,3,13.99791989,2,10.1266511,10.1266411,6,141.7520509,1,1,2,1,3,4,5,0.318729,0.322423,0,No
4712,rd,3,13.99791989,2,10.1266511,10.1266411,6,141.7520509,3,3,6,3,3,6,5,0.378172,0.393928,0,No
4753,rant,3,13.99791989,2,10.1266511,10.1266411,6,141.7520509,2,2,4,3,2,5,5,0.33408,0.340125,0,No
4781,ralston,3,13.99791989,2,10.1266511,10.1266411,6,141.7520509,1,3,4,1,3,4,5,0.348373,0.358061,0,No
4870,quilt,3,13.99791989,2,10.1266511,10.1266411,6,141.7520509,3,3,6,3,3,6,5,0.349684,0.35983,0,No
4879,quicklime,3,13.99791989,2,10.1266511,10.1266411,6,141.7520509,3,2,5,3,2,5,5,0.347289,0.356398,0,No
4884,queueing,3,13.99791989,2,10.1266511,10.1266411,6,141.7520509,3,2,5,3,2,5,5,0.346699,0.355812,0,No
4920,quantico,3,13.99791989,2,10.1266511,10.1266411,6,141.7520509,2,1,3,2,3,5,5,0.323965,0.32736,0,No
4952,pyrolysis,3,13.99791989,2,10.1266511,10.1266411,6,141.7520509,3,1,4,3,2,5,5,0.345599,0.354479,0,No
4971,pussy,3,13.99791989,2,10.1266511,10.1266411,6,141.7520509,3,0,3,3,0,3,0,0,0,0,No
5080,psalter,3,13.99791989,2,10.1266511,10.1266411,6,141.7520509,1,3,4,1,3,4,4,0.389695,0.406418,0,No
5249,probate,3,13.99791989,2,10.1266511,10.1266411,6,141.7520509,3,2,5,3,2,5,5,0.378858,0.394688,0,No
5390,potlatch,3,13.99791989,2,10.1266511,10.1266411,6,141.7520509,3,3,6,3,3,6,5,0.348743,0.358389,0,No
5493,pompano,3,13.99791989,2,10.1266511,10.1266411,6,141.7520509,2,1,3,2,3,5,5,0.320409,0.323865,0,No
5516,polygyny,3,13.99791989,2,10.1266511,10.1266411,6,141.7520509,1,3,4,1,3,4,4,0.416651,0.433703,0,No
5581,pneumococcus,3,13.99791989,2,10.1266511,10.1266411,6,141.7520509,2,3,5,3,3,6,5,0.356682,0.368345,0,No
5739,pinhead,3,13.99791989,2,10.1266511,10.1266411,6,141.7520509,0,1,1,0,3,3,5,0.313285,0.317501,0,No
5747,pinafore,3,13.99791989,2,10.1266511,10.1266411,6,141.7520509,1,3,4,1,3,4,4,0.386774,0.403203,0,No
5780,picosecond,3,13.99791989,2,10.1266511,10.1266411,6,141.7520509,2,2,4,3,3,6,5,0.347806,0.357164,0,No
5796,pianoforte,3,13.99791989,2,10.1266511,10.1266411,6,141.7520509,2,2,4,3,2,5,5,0.348537,0.358145,0,No
5921,pershing,3,13.99791989,2,10.1266511,10.1266411,6,141.7520509,2,1,3,3,1,4,5,0.32579,0.329222,0,No
6066,pediatric,3,13.99791989,2,10.1266511,10.1266411,6,141.7520509,3,2,5,3,2,5,5,0.319245,0.322632,0,No
6218,parrish,3,13.99791989,2,10.1266511,10.1266411,6,141.7520509,0,3,3,0,3,3,5,0.329216,0.333644,0,No
6227,parkland,3,13.99791989,2,10.1266511,10.1266411,6,141.7520509,1,2,3,1,2,3,5,0.346625,0.355826,0,No
6397,oxbow,3,13.99791989,2,10.1266511,10.1266411,6,141.7520509,1,1,2,2,2,4,5,0.322816,0.326138,0,No
6415,ovate,3,13.99791989,2,10.1266511,10.1266411,6,141.7520509,1,2,3,1,2,3,5,0.358729,0.371271,0,No
6486,orin,3,13.99791989,2,10.1266511,10.1266411,6,141.7520509,3,3,6,3,3,6,4,0.389746,0.406465,0,No
6552,operand,3,13.99791989,2,10.1266511,10.1266411,6,141.7520509,3,1,4,3,1,4,5,0.325324,0.329175,0,No
6650,officiate,3,13.99791989,2,10.1266511,10.1266411,6,141.7520509,1,2,3,2,2,4,5,0.398263,0.416025,0,No
6684,octagon,3,13.99791989,2,10.1266511,10.1266411,6,141.7520509,3,3,6,3,3,6,5,0.351561,0.361814,0,No
6719,observant,3,13.99791989,2,10.1266511,10.1266411,6,141.7520509,3,1,4,3,1,4,5,0.321029,0.327198,0,No
6745,oakwood,3,13.99791989,2,10.1266511,10.1266411,6,141.7520509,2,1,3,3,1,4,5,0.308976,0.313878,0,No
6817,notify,3,13.99791989,2,10.1266511,10.1266411,6,141.7520509,2,2,4,2,2,4,5,0.399024,0.416795,0,No
6827,nostril,3,13.99791989,2,10.1266511,10.1266411,6,141.7520509,3,3,6,3,3,6,5,0.395759,0.413084,0,No
6936,nighthawk,3,13.99791989,2,10.1266511,10.1266411,6,141.7520509,2,3,5,3,3,6,5,0.332266,0.33721,0,No
6944,nigger,3,13.99791989,2,10.1266511,10.1266411,6,141.7520509,3,2,5,3,2,5,5,0.348537,0.358056,0,No
7010,neurology,3,13.99791989,2,10.1266511,10.1266411,6,141.7520509,2,2,4,2,3,5,5,0.369689,0.384037,0,No
7018,nestor,3,13.99791989,2,10.1266511,10.1266411,6,141.7520509,3,1,4,3,1,4,5,0.345599,0.354479,0,No
7184,myoglobin,3,13.99791989,2,10.1266511,10.1266411,6,141.7520509,3,3,6,3,3,6,4,0.387729,0.40478,0,No
7372,moreland,3,13.99791989,2,10.1266511,10.1266411,6,141.7520509,3,2,5,3,2,5,5,0.325277,0.328616,0,No
7535,misogyny,3,13.99791989,2,10.1266511,10.1266411,6,141.7520509,1,2,3,1,2,3,5,0.345612,0.354516,0,No
7563,minot,3,13.99791989,2,10.1266511,10.1266411,6,141.7520509,0,2,2,0,3,3,5,0.328893,0.333095,0,No
7589,mincemeat,3,13.99791989,2,10.1266511,10.1266411,6,141.7520509,2,2,4,2,2,4,5,0.384296,0.400486,0,No
7702,methionine,3,13.99791989,2,10.1266511,10.1266411,6,141.7520509,3,3,6,3,3,6,5,0.342511,0.350284,0,No
7781,menlo,3,13.99791989,2,10.1266511,10.1266411,6,141.7520509,2,3,5,2,3,5,5,0.348777,0.358492,0,No
7821,melcher,3,13.99791989,2,10.1266511,10.1266411,6,141.7520509,3,2,5,3,2,5,5,0.356224,0.367705,0,No
7837,megahertz,3,13.99791989,2,10.1266511,10.1266411,6,141.7520509,3,2,5,3,2,5,5,0.345592,0.354469,0,No
7905,mcgovern,3,13.99791989,2,10.1266511,10.1266411,6,141.7520509,2,3,5,3,3,6,4,0.417828,0.435022,0,No
7921,mcclure,3,13.99791989,2,10.1266511,10.1266411,6,141.7520509,2,3,5,2,3,5,5,0.398156,0.415936,0,No
7958,maverick,3,13.99791989,2,10.1266511,10.1266411,6,141.7520509,2,2,4,2,2,4,5,0.395565,0.41265,0,No
8188,malton,3,13.99791989,2,10.1266511,10.1266411,6,141.7520509,2,1,3,2,2,4,5,0.398076,0.415824,0,No
8321,machete,3,13.99791989,2,10.1266511,10.1266411,6,141.7520509,2,2,4,3,3,6,5,0.36662,0.380527,0,No
8377,lure,3,13.99791989,2,10.1266511,10.1266411,6,141.7520509,2,2,4,2,2,4,5,0.398594,0.416312,0,No
8382,lunchtime,3,13.99791989,2,10.1266511,10.1266411,6,141.7520509,3,3,6,3,3,6,5,0.328704,0.332701,0,No
8389,lumpy,3,13.99791989,2,10.1266511,10.1266411,6,141.7520509,3,2,5,3,3,6,5,0.322435,0.325573,0,No
8512,loggerhead,3,13.99791989,2,10.1266511,10.1266411,6,141.7520509,2,1,3,2,1,3,5,0.324593,0.328066,0,No
8610,linton,3,13.99791989,2,10.1266511,10.1266411,6,141.7520509,2,2,4,2,2,4,5,0.346293,0.355347,0,No
8645,limousine,3,13.99791989,2,10.1266511,10.1266411,6,141.7520509,2,3,5,3,3,6,5,0.342525,0.350316,0,No
8665,lignite,3,13.99791989,2,10.1266511,10.1266411,6,141.7520509,3,2,5,3,2,5,5,0.356417,0.368364,0,No
8890,laue,3,13.99791989,2,10.1266511,10.1266411,6,141.7520509,2,2,4,3,3,6,5,0.384279,0.400468,0,No
8942,lanthanum,3,13.99791989,2,10.1266511,10.1266411,6,141.7520509,2,2,4,2,2,4,4,0.389755,0.406475,0,No
9007,ladle,3,13.99791989,2,10.1266511,10.1266411,6,141.7520509,2,3,5,2,3,5,4,0.412555,0.429985,0,No
9040,kumquat,3,13.99791989,2,10.1266511,10.1266411,6,141.7520509,2,2,4,2,2,4,5,0.34574,0.354685,0,No
9059,krause,3,13.99791989,2,10.1266511,10.1266411,6,141.7520509,2,2,4,3,2,5,5,0.330626,0.334938,0,No
9099,knit,3,13.99791989,2,10.1266511,10.1266411,6,141.7520509,1,3,4,2,3,5,5,0.347963,0.357394,0,No
9127,kirov,3,13.99791989,2,10.1266511,10.1266411,6,141.7520509,1,2,3,3,3,6,5,0.32237,0.325597,0,No
9135,kiowa,3,13.99791989,2,10.1266511,10.1266411,6,141.7520509,3,1,4,3,3,6,5,0.325677,0.329423,0,No
9140,kink,3,13.99791989,2,10.1266511,10.1266411,6,141.7520509,1,3,4,1,3,4,5,0.355475,0.36727,0,No
9247,kaskaskia,3,13.99791989,2,10.1266511,10.1266411,6,141.7520509,3,2,5,3,3,6,5,0.360969,0.373739,0,No
9258,kapok,3,13.99791989,2,10.1266511,10.1266411,6,141.7520509,3,3,6,3,3,6,5,0.366627,0.380555,0,No
9260,kaolinite,3,13.99791989,2,10.1266511,10.1266411,6,141.7520509,3,3,6,3,3,6,4,0.422613,0.43929,0,No
9343,jubilate,3,13.99791989,2,10.1266511,10.1266411,6,141.7520509,2,1,3,2,1,3,5,0.303514,0.308941,0,No
9495,jag,3,13.99791989,2,10.1266511,10.1266411,6,141.7520509,1,1,2,1,1,2,5,0.398067,0.415814,0,No
9582,irredentism,3,13.99791989,2,10.1266511,10.1266411,6,141.7520509,3,3,6,3,3,6,5,0.350505,0.360627,0,No
9739,instinctual,3,13.99791989,2,10.1266511,10.1266411,6,141.7520509,1,2,3,1,2,3,5,0.304096,0.30967,0,No
9744,instantaneous,3,13.99791989,2,10.1266511,10.1266411,6,141.7520509,2,2,4,3,3,6,5,0.318284,0.321891,0,No
9811,inheritor,3,13.99791989,2,10.1266511,10.1266411,6,141.7520509,2,3,5,2,3,5,5,0.380808,0.396889,0,No
9883,inertial,3,13.99791989,2,10.1266511,10.1266411,6,141.7520509,2,1,3,2,2,4,5,0.31764,0.321233,0,No
9899,inductance,3,13.99791989,2,10.1266511,10.1266411,6,141.7520509,2,2,4,2,3,5,5,0.326413,0.331288,0,No
10058,immersion,3,13.99791989,2,10.1266511,10.1266411,6,141.7520509,3,3,6,3,3,6,5,0.381152,0.397233,0,No
10144,iambic,3,13.99791989,2,10.1266511,10.1266411,6,141.7520509,2,0,2,3,0,3,0,0,0,0,No
10150,hypotonic,3,13.99791989,2,10.1266511,10.1266411,6,141.7520509,1,2,3,1,2,3,5,0.321268,0.324442,0,No
10292,housefly,3,13.99791989,2,10.1266511,10.1266411,6,141.7520509,2,2,4,2,3,5,5,0.347452,0.356777,0,No
10341,hopeful,3,13.99791989,2,10.1266511,10.1266411,6,141.7520509,2,3,5,3,3,6,5,0.348264,0.357674,0,No
10388,homeopathic,3,13.99791989,2,10.1266511,10.1266411,6,141.7520509,3,1,4,3,1,4,5,0.317419,0.321258,0,No
10415,hollerith,3,13.99791989,2,10.1266511,10.1266411,6,141.7520509,2,2,4,3,2,5,5,0.32199,0.325104,0,No
10428,hoe,3,13.99791989,2,10.1266511,10.1266411,6,141.7520509,3,1,4,3,3,6,5,0.345599,0.354479,0,No
10448,hitch,3,13.99791989,2,10.1266511,10.1266411,6,141.7520509,1,3,4,1,3,4,4,0.401615,0.419183,0,No
10539,hew,3,13.99791989,2,10.1266511,10.1266411,6,141.7520509,3,1,4,3,2,5,5,0.336021,0.342018,0,No
10542,heterozygous,3,13.99791989,2,10.1266511,10.1266411,6,141.7520509,3,2,5,3,2,5,5,0.367371,0.381297,0,No
10758,hater,3,13.99791989,2,10.1266511,10.1266411,6,141.7520509,2,2,4,2,2,4,5,0.338779,0.345291,0,No
10802,hark,3,13.99791989,2,10.1266511,10.1266411,6,141.7520509,1,2,3,1,2,3,5,0.398371,0.416115,0,No
10931,hacksaw,3,13.99791989,2,10.1266511,10.1266411,6,141.7520509,2,2,4,3,3,6,5,0.345895,0.354887,0,No
10937,habitation,3,13.99791989,2,10.1266511,10.1266411,6,141.7520509,2,3,5,3,3,6,5,0.337767,0.344172,0,No
10951,gymnosperm,3,13.99791989,2,10.1266511,10.1266411,6,141.7520509,1,1,2,1,2,3,5,0.319027,0.322531,0,No
11054,grottoes,3,13.99791989,2,10.1266511,10.1266411,6,141.7520509,2,2,4,2,3,5,5,0.346564,0.355388,0,No
11251,goldwater,3,13.99791989,2,10.1266511,10.1266411,6,141.7520509,2,3,5,3,3,6,5,0.389969,0.406854,0,No
11258,goldeneye,3,13.99791989,2,10.1266511,10.1266411,6,141.7520509,3,3,6,3,3,6,4,0.405218,0.422788,0,No
11298,glycine,3,13.99791989,2,10.1266511,10.1266411,6,141.7520509,2,3,5,2,3,5,5,0.328814,0.333177,0,No
11328,glidden,3,13.99791989,2,10.1266511,10.1266411,6,141.7520509,2,2,4,2,2,4,5,0.347909,0.357464,0,No
11423,germinate,3,13.99791989,2,10.1266511,10.1266411,6,141.7520509,3,1,4,3,1,4,5,0.326479,0.32972,0,No
11442,geophysics,3,13.99791989,2,10.1266511,10.1266411,6,141.7520509,3,2,5,3,3,6,5,0.329186,0.333627,0,No
11443,geophysical,3,13.99791989,2,10.1266511,10.1266411,6,141.7520509,1,1,2,1,2,3,5,0.318936,0.322397,0,No
11507,gauze,3,13.99791989,2,10.1266511,10.1266411,6,141.7520509,2,2,4,2,2,4,5,0.329473,0.333509,0,No
11677,fullback,3,13.99791989,2,10.1266511,10.1266411,6,141.7520509,1,3,4,2,3,5,5,0.366802,0.380762,0,No
11745,fret,3,13.99791989,2,10.1266511,10.1266411,6,141.7520509,2,2,4,3,2,5,4,0.405163,0.422713,0,No
11821,foxhound,3,13.99791989,2,10.1266511,10.1266411,6,141.7520509,3,3,6,3,3,6,5,0.331894,0.336424,0,No
12072,flagellate,3,13.99791989,2,10.1266511,10.1266411,6,141.7520509,3,1,4,3,1,4,5,0.343985,0.352404,0,No
12108,firestone,3,13.99791989,2,10.1266511,10.1266411,6,141.7520509,3,2,5,3,3,6,5,0.398183,0.415941,0,No
12125,fink,3,13.99791989,2,10.1266511,10.1266411,6,141.7520509,2,2,4,3,2,5,5,0.325396,0.328867,0,No
12215,ferret,3,13.99791989,2,10.1266511,10.1266411,6,141.7520509,2,1,3,3,1,4,5,0.327999,0.3324,0,No
12279,fcc,3,13.99791989,2,10.1266511,10.1266411,6,141.7520509,1,3,4,3,3,6,5,0.347609,0.356946,0,No
12374,fafnir,3,13.99791989,2,10.1266511,10.1266411,6,141.7520509,2,3,5,3,3,6,5,0.396245,0.413373,0,No
12415,extrinsic,3,13.99791989,2,10.1266511,10.1266411,6,141.7520509,1,1,2,1,1,2,5,0.322136,0.325273,0,No
12508,exemplar,3,13.99791989,2,10.1266511,10.1266411,6,141.7520509,3,3,6,3,3,6,5,0.385221,0.401728,0,No
12580,evansville,3,13.99791989,2,10.1266511,10.1266411,6,141.7520509,2,3,5,2,3,5,5,0.3463,0.355375,0,No
12755,epilogue,3,13.99791989,2,10.1266511,10.1266411,6,141.7520509,1,1,2,1,1,2,5,0.378607,0.394397,0,No
12769,ephemerides,3,13.99791989,2,10.1266511,10.1266411,6,141.7520509,2,2,4,2,2,4,5,0.384362,0.400561,0,No
12798,enquiry,3,13.99791989,2,10.1266511,10.1266411,6,141.7520509,2,1,3,2,1,3,5,0.35519,0.366885,0,No
12883,embryology,3,13.99791989,2,10.1266511,10.1266411,6,141.7520509,2,2,4,2,2,4,4,0.405163,0.422713,0,No
12940,elinor,3,13.99791989,2,10.1266511,10.1266411,6,141.7520509,1,2,3,1,2,3,5,0.384262,0.400444,0,No
13102,earthenware,3,13.99791989,2,10.1266511,10.1266411,6,141.7520509,3,2,5,3,2,5,5,0.398094,0.415861,0,No
13237,dromedary,3,13.99791989,2,10.1266511,10.1266411,6,141.7520509,2,2,4,2,2,4,5,0.384262,0.400449,0,No
13238,drizzle,3,13.99791989,2,10.1266511,10.1266411,6,141.7520509,1,2,3,1,3,4,5,0.345747,0.354666,0,No
13300,downdraft,3,13.99791989,2,10.1266511,10.1266411,6,141.7520509,2,2,4,3,2,5,4,0.389755,0.406475,0,No
13338,dorcas,3,13.99791989,2,10.1266511,10.1266411,6,141.7520509,1,3,4,1,3,4,5,0.311837,0.316464,0,No
13507,dirge,3,13.99791989,2,10.1266511,10.1266411,6,141.7520509,2,1,3,3,3,6,5,0.378607,0.394397,0,No
13666,detonate,3,13.99791989,2,10.1266511,10.1266411,6,141.7520509,2,2,4,2,3,5,5,0.375571,0.392046,0,No
13766,demonic,3,13.99791989,2,10.1266511,10.1266411,6,141.7520509,3,2,5,3,3,6,5,0.315809,0.319836,0,No
13767,demoniac,3,13.99791989,2,10.1266511,10.1266411,6,141.7520509,2,1,3,3,1,4,5,0.345068,0.353675,0,No
13907,debugger,3,13.99791989,2,10.1266511,10.1266411,6,141.7520509,2,3,5,3,3,6,5,0.346469,0.355577,0,No
13994,dank,3,13.99791989,2,10.1266511,10.1266411,6,141.7520509,1,1,2,1,1,2,5,0.333596,0.339081,0,No
14074,cyclotron,3,13.99791989,2,10.1266511,10.1266411,6,141.7520509,2,3,5,3,3,6,4,0.389413,0.406587,0,No
14103,cushman,3,13.99791989,2,10.1266511,10.1266411,6,141.7520509,3,3,6,3,3,6,5,0.346591,0.355713,0,No
14120,curlew,3,13.99791989,2,10.1266511,10.1266411,6,141.7520509,2,3,5,2,3,5,5,0.348086,0.357699,0,No
14342,coven,3,13.99791989,2,10.1266511,10.1266411,6,141.7520509,1,3,4,2,3,5,5,0.37466,0.389797,0,No
14459,cornbread,3,13.99791989,2,10.1266511,10.1266411,6,141.7520509,2,2,4,2,2,4,5,0.388765,0.406153,0,No
14461,cormorant,3,13.99791989,2,10.1266511,10.1266411,6,141.7520509,2,1,3,2,1,3,5,0.398076,0.415824,0,No
14482,copperfield,3,13.99791989,2,10.1266511,10.1266411,6,141.7520509,1,2,3,3,3,6,5,0.36091,0.3736,0,No
14527,convair,3,13.99791989,2,10.1266511,10.1266411,6,141.7520509,2,3,5,2,3,5,4,0.402791,0.420399,0,No
14653,congresswoman,3,13.99791989,2,10.1266511,10.1266411,6,141.7520509,2,3,5,3,3,6,5,0.318964,0.323413,0,No
14704,condense,3,13.99791989,2,10.1266511,10.1266411,6,141.7520509,3,2,5,3,2,5,5,0.400655,0.418373,0,No
14707,concussion,3,13.99791989,2,10.1266511,10.1266411,6,141.7520509,3,3,6,3,3,6,5,0.352119,0.362598,0,No
14774,complementarity,3,13.99791989,2,10.1266511,10.1266411,6,141.7520509,2,3,5,2,3,5,5,0.348935,0.358559,0,No
14916,cohort,3,13.99791989,2,10.1266511,10.1266411,6,141.7520509,1,1,2,1,1,2,5,0.336021,0.342018,0,No
14919,cohesive,3,13.99791989,2,10.1266511,10.1266411,6,141.7520509,2,2,4,3,2,5,5,0.327195,0.330887,0,No
14940,codomain,3,13.99791989,2,10.1266511,10.1266411,6,141.7520509,1,3,4,3,3,6,5,0.38472,0.400984,0,No
15266,childish,3,13.99791989,2,10.1266511,10.1266411,6,141.7520509,1,1,2,1,1,2,5,0.384237,0.400402,0,No
15503,cavalier,3,13.99791989,2,10.1266511,10.1266411,6,141.7520509,2,1,3,2,1,3,5,0.332391,0.337648,0,No
15515,caucus,3,13.99791989,2,10.1266511,10.1266411,6,141.7520509,1,3,4,2,3,5,5,0.397675,0.415041,0,No
15658,carcinogenic,3,13.99791989,2,10.1266511,10.1266411,6,141.7520509,2,3,5,3,3,6,5,0.33141,0.336174,0,No
15757,campanile,3,13.99791989,2,10.1266511,10.1266411,6,141.7520509,3,3,6,3,3,6,5,0.385154,0.401676,0,No
16028,bryozoa,3,13.99791989,2,10.1266511,10.1266411,6,141.7520509,3,3,6,3,3,6,5,0.344238,0.352598,0,No
16210,brainard,3,13.99791989,2,10.1266511,10.1266411,6,141.7520509,1,2,3,1,2,3,5,0.385196,0.401468,0,No
16353,bonanza,3,13.99791989,2,10.1266511,10.1266411,6,141.7520509,2,2,4,2,2,4,5,0.324967,0.329105,0,No
16502,blackstone,3,13.99791989,2,10.1266511,10.1266411,6,141.7520509,3,3,6,3,3,6,5,0.346726,0.355892,0,No
16552,biplane,3,13.99791989,2,10.1266511,10.1266411,6,141.7520509,2,2,4,3,2,5,4,0.405154,0.422704,0,No
16685,bequest,3,13.99791989,2,10.1266511,10.1266411,6,141.7520509,2,3,5,3,3,6,5,0.376296,0.39185,0,No
16726,beloit,3,13.99791989,2,10.1266511,10.1266411,6,141.7520509,2,3,5,3,3,6,5,0.348107,0.35758,0,No
16789,beechwood,3,13.99791989,2,10.1266511,10.1266411,6,141.7520509,1,2,3,1,3,4,5,0.32341,0.326681,0,No
16800,bedlam,3,13.99791989,2,10.1266511,10.1266411,6,141.7520509,2,1,3,3,1,4,5,0.32681,0.33159,0,No
16901,baryon,3,13.99791989,2,10.1266511,10.1266411,6,141.7520509,3,0,3,3,0,3,0,0,0,0,No
16982,bandy,3,13.99791989,2,10.1266511,10.1266411,6,141.7520509,2,3,5,2,3,5,5,0.326485,0.329999,0,No
17151,autumnal,3,13.99791989,2,10.1266511,10.1266411,6,141.7520509,1,1,2,3,3,6,5,0.301595,0.307251,0,No
17205,auerbach,3,13.99791989,2,10.1266511,10.1266411,6,141.7520509,0,1,1,0,1,1,5,0.345598,0.354477,0,No
17243,atrophy,3,13.99791989,2,10.1266511,10.1266411,6,141.7520509,1,2,3,1,2,3,5,0.323339,0.32689,0,No
17314,assay,3,13.99791989,2,10.1266511,10.1266411,6,141.7520509,1,3,4,1,3,4,5,0.348708,0.358309,0,No
17338,asheville,3,13.99791989,2,10.1266511,10.1266411,6,141.7520509,3,3,6,3,3,6,5,0.398684,0.416443,0,No
17413,arlen,3,13.99791989,2,10.1266511,10.1266411,6,141.7520509,3,3,6,3,3,6,5,0.342584,0.350485,0,No
17527,appellant,3,13.99791989,2,10.1266511,10.1266411,6,141.7520509,0,2,2,0,2,2,5,0.384634,0.400863,0,No
17550,apogee,3,13.99791989,2,10.1266511,10.1266411,6,141.7520509,2,3,5,3,3,6,5,0.398308,0.416096,0,No
17650,annular,3,13.99791989,2,10.1266511,10.1266411,6,141.7520509,1,2,3,2,3,5,5,0.321739,0.325432,0,No
17709,androgen,3,13.99791989,2,10.1266511,10.1266411,6,141.7520509,2,3,5,3,3,6,5,0.346835,0.356056,0,No
17776,amoebae,3,13.99791989,2,10.1266511,10.1266411,6,141.7520509,2,3,5,2,3,5,5,0.35258,0.363303,0,No
17798,amharic,3,13.99791989,2,10.1266511,10.1266411,6,141.7520509,3,1,4,3,1,4,5,0.345599,0.354479,0,No
17911,alistair,3,13.99791989,2,10.1266511,10.1266411,6,141.7520509,2,1,3,2,1,3,5,0.304691,0.310021,0,No
17929,algonquin,3,13.99791989,2,10.1266511,10.1266411,6,141.7520509,3,1,4,3,1,4,5,0.326263,0.329724,0,No
18090,affine,3,13.99791989,2,10.1266511,10.1266411,6,141.7520509,2,1,3,2,1,3,5,0.316654,0.320423,0,No
18168,adiabatic,3,13.99791989,2,10.1266511,10.1266411,6,141.7520509,3,2,5,3,2,5,5,0.321786,0.325033,0,No
18220,acquittal,3,13.99791989,2,10.1266511,10.1266411,6,141.7520509,2,3,5,3,3,6,4,0.390656,0.407893,0,No
18325,abominable,3,13.99791989,2,10.1266511,10.1266411,6,141.7520509,2,2,4,3,2,5,5,0.327256,0.330849,0,No
18366,aardvark,3,13.99791989,2,10.1266511,10.1266411,6,141.7520509,2,1,3,3,1,4,5,0.319849,0.323786,0,No
145,wyeth,7,13.15062203,1,10.81979828,10.81979828,7,142.2870777,4,7,11,4,7,11,5,0.341424,0.348688,0,No
1163,tutu,7,13.15062203,1,10.81979828,10.81979828,7,142.2870777,7,3,10,7,4,11,5,0.338928,0.345476,0,No
2435,strychnine,7,13.15062203,1,10.81979828,10.81979828,7,142.2870777,4,2,6,4,6,10,5,0.347296,0.356648,0,No
3932,sauna,7,13.15062203,1,10.81979828,10.81979828,7,142.2870777,1,5,6,7,7,14,4,0.415112,0.432422,0,No
4941,quack,7,13.15062203,1,10.81979828,10.81979828,7,142.2870777,3,4,7,6,7,13,5,0.354403,0.365593,0,No
15521,cattail,7,13.15062203,1,10.81979828,10.81979828,7,142.2870777,7,3,10,7,3,10,5,0.356847,0.36893,0,No
110,yawn,6,13.30477271,1,10.81979828,10.81979828,6,143.9549569,5,3,8,5,4,9,4,0.389772,0.406512,0,No
931,varnish,6,13.30477271,1,10.81979828,10.81979828,6,143.9549569,4,5,9,4,6,10,5,0.390098,0.407042,0,No
942,vane,6,13.30477271,1,10.81979828,10.81979828,6,143.9549569,3,4,7,5,5,10,4,0.424036,0.440618,0,No
8155,manhole,6,13.30477271,1,10.81979828,10.81979828,6,143.9549569,3,2,5,6,5,11,5,0.331745,0.336795,0,No
10193,hydrate,6,13.30477271,1,10.81979828,10.81979828,6,143.9549569,1,2,3,6,5,11,5,0.349278,0.359164,0,No
10402,hologram,6,13.30477271,1,10.81979828,10.81979828,6,143.9549569,2,4,6,6,5,11,4,0.392149,0.40909,0,No
11270,godparent,6,13.30477271,1,10.81979828,10.81979828,6,143.9549569,2,3,5,6,6,12,5,0.351491,0.361852,0,No
14014,damocles,6,13.30477271,1,10.81979828,10.81979828,6,143.9549569,5,5,10,5,6,11,4,0.391915,0.409094,0,No
14049,dactyl,6,13.30477271,1,10.81979828,10.81979828,6,143.9549569,6,4,10,6,4,10,4,0.408821,0.426272,0,No
14326,cowry,6,13.30477271,1,10.81979828,10.81979828,6,143.9549569,4,3,7,5,4,9,5,0.398138,0.415927,0,No
14394,cottontail,6,13.30477271,1,10.81979828,10.81979828,6,143.9549569,4,1,5,4,1,5,5,0.308509,0.313462,0,No
15566,casserole,6,13.30477271,1,10.81979828,10.81979828,6,143.9549569,5,5,10,6,6,12,5,0.352035,0.362544,0,No
6807,nov,2,14.403385,3,10.1266511,10.1266411,6,145.8580546,2,2,4,2,2,4,5,0.398183,0.415941,0,No
3,zucchini,2,14.403385,2,10.1266511,10.1266411,4,145.8580546,2,1,3,2,2,4,5,0.322863,0.327324,0,No
15,zodiacal,2,14.403385,2,10.1266511,10.1266411,4,145.8580546,2,1,3,2,1,3,5,0.324409,0.327806,0,No
33,zenith,2,14.403385,2,10.1266511,10.1266411,4,145.8580546,0,2,2,0,2,2,5,0.325725,0.330297,0,No
35,zeiss,2,14.403385,2,10.1266511,10.1266411,4,145.8580546,1,0,1,2,0,2,0,0,0,0,No
41,zan,2,14.403385,2,10.1266511,10.1266411,4,145.8580546,0,1,1,0,1,1,5,0.321757,0.326069,0,No
66,youngster,2,14.403385,2,10.1266511,10.1266411,4,145.8580546,1,2,3,1,2,3,5,0.323404,0.32732,0,No
84,ymca,2,14.403385,2,10.1266511,10.1266411,4,145.8580546,2,1,3,2,1,3,5,0.360829,0.373487,0,No
92,yeshiva,2,14.403385,2,10.1266511,10.1266411,4,145.8580546,2,1,3,2,1,3,5,0.398076,0.415824,0,No
111,yaw,2,14.403385,2,10.1266511,10.1266411,4,145.8580546,1,1,2,1,1,2,5,0.398076,0.415824,0,No
118,yap,2,14.403385,2,10.1266511,10.1266411,4,145.8580546,0,1,1,0,1,1,5,0.384234,0.400398,0,No
151,wrought,2,14.403385,2,10.1266511,10.1266411,4,145.8580546,1,1,2,1,2,3,5,0.318152,0.32196,0,No
153,wrongful,2,14.403385,2,10.1266511,10.1266411,4,145.8580546,2,1,3,2,1,3,5,0.311848,0.316363,0,No
190,worsen,2,14.403385,2,10.1266511,10.1266411,4,145.8580546,2,1,3,2,2,4,5,0.398076,0.415824,0,No
205,workforce,2,14.403385,2,10.1266511,10.1266411,4,145.8580546,0,1,1,0,2,2,5,0.321868,0.325067,0,No
206,workbook,2,14.403385,2,10.1266511,10.1266411,4,145.8580546,2,2,4,2,2,4,5,0.348537,0.358145,0,No
215,wooster,2,14.403385,2,10.1266511,10.1266411,4,145.8580546,1,0,1,2,0,2,0,0,0,0,No
231,woodard,2,14.403385,2,10.1266511,10.1266411,4,145.8580546,2,1,3,2,1,3,5,0.313855,0.318215,0,No
253,woe,2,14.403385,2,10.1266511,10.1266411,4,145.8580546,2,2,4,2,2,4,4,0.422432,0.439107,0,No
254,wobble,2,14.403385,2,10.1266511,10.1266411,4,145.8580546,1,2,3,1,2,3,5,0.398085,0.415852,0,No
330,wilkie,2,14.403385,2,10.1266511,10.1266411,4,145.8580546,1,2,3,1,2,3,5,0.321233,0.324958,0,No
368,whomever,2,14.403385,2,10.1266511,10.1266411,4,145.8580546,2,2,4,2,2,4,5,0.326263,0.331761,0,No
375,whoa,2,14.403385,2,10.1266511,10.1266411,4,145.8580546,1,1,2,1,1,2,5,0.315489,0.319354,0,No
384,whitewash,2,14.403385,2,10.1266511,10.1266411,4,145.8580546,2,2,4,2,2,4,5,0.41003,0.427626,0,No
394,whirlwind,2,14.403385,2,10.1266511,10.1266411,4,145.8580546,1,0,1,1,0,1,0,0,0,0,No
466,weldon,2,14.403385,2,10.1266511,10.1266411,4,145.8580546,2,2,4,2,2,4,5,0.32803,0.332163,0,No
474,weinberg,2,14.403385,2,10.1266511,10.1266411,4,145.8580546,2,1,3,2,2,4,5,0.398076,0.415824,0,No
490,wed,2,14.403385,2,10.1266511,10.1266411,4,145.8580546,2,2,4,2,2,4,5,0.41003,0.427626,0,No
498,weary,2,14.403385,2,10.1266511,10.1266411,4,145.8580546,2,0,2,2,0,2,0,0,0,0,No
508,wayward,2,14.403385,2,10.1266511,10.1266411,4,145.8580546,2,1,3,2,2,4,5,0.323923,0.327177,0,No
518,wavefront,2,14.403385,2,10.1266511,10.1266411,4,145.8580546,2,2,4,2,2,4,5,0.360851,0.373534,0,No
527,watertown,2,14.403385,2,10.1266511,10.1266411,4,145.8580546,1,1,2,2,2,4,5,0.318592,0.322359,0,No
529,waterside,2,14.403385,2,10.1266511,10.1266411,4,145.8580546,1,1,2,2,2,4,5,0.378607,0.394397,0,No
542,watercourse,2,14.403385,2,10.1266511,10.1266411,4,145.8580546,2,2,4,2,2,4,5,0.361542,0.37426,0,No
555,wast,2,14.403385,2,10.1266511,10.1266411,4,145.8580546,1,2,3,1,2,3,5,0.346037,0.354979,0,No
559,washboard,2,14.403385,2,10.1266511,10.1266411,4,145.8580546,2,1,3,2,1,3,5,0.384237,0.400402,0,No
590,wane,2,14.403385,2,10.1266511,10.1266411,4,145.8580546,2,1,3,2,1,3,5,0.384237,0.400402,0,No
626,waite,2,14.403385,2,10.1266511,10.1266411,4,145.8580546,2,2,4,2,2,4,5,0.322072,0.326379,0,No
628,waistcoat,2,14.403385,2,10.1266511,10.1266411,4,145.8580546,2,2,4,2,2,4,5,0.384254,0.400439,0,No
633,wah,2,14.403385,2,10.1266511,10.1266411,4,145.8580546,0,1,1,0,1,1,5,0.336021,0.342018,0,No
645,wacky,2,14.403385,2,10.1266511,10.1266411,4,145.8580546,1,1,2,1,1,2,5,0.321082,0.324371,0,No
648,waals,2,14.403385,2,10.1266511,10.1266411,4,145.8580546,0,0,0,0,0,0,0,0,0,0,No
661,vought,2,14.403385,2,10.1266511,10.1266411,4,145.8580546,2,1,3,2,1,3,5,0.331268,0.335748,0,No
663,voss,2,14.403385,2,10.1266511,10.1266411,4,145.8580546,2,1,3,2,1,3,5,0.309445,0.314336,0,No
711,vivace,2,14.403385,2,10.1266511,10.1266411,4,145.8580546,1,1,2,1,1,2,6,0.242553,0.244075,0,No
734,visage,2,14.403385,2,10.1266511,10.1266411,4,145.8580546,1,1,2,1,2,3,5,0.398076,0.415824,0,No
744,virgule,2,14.403385,2,10.1266511,10.1266411,4,145.8580546,1,1,2,1,1,2,5,0.291823,0.298021,0,No
760,vinson,2,14.403385,2,10.1266511,10.1266411,4,145.8580546,1,2,3,1,2,3,5,0.350153,0.359943,0,No
804,vicarious,2,14.403385,2,10.1266511,10.1266411,4,145.8580546,2,1,3,2,1,3,5,0.320213,0.323513,0,No
851,verna,2,14.403385,2,10.1266511,10.1266411,4,145.8580546,2,0,2,2,0,2,0,0,0,0,No
852,vermouth,2,14.403385,2,10.1266511,10.1266411,4,145.8580546,2,1,3,2,1,3,5,0.384229,0.400392,0,No
873,venturi,2,14.403385,2,10.1266511,10.1266411,4,145.8580546,1,1,2,2,2,4,5,0.321053,0.324137,0,No
875,ventriloquist,2,14.403385,2,10.1266511,10.1266411,4,145.8580546,2,1,3,2,2,4,5,0.384237,0.400402,0,No
879,venous,2,14.403385,2,10.1266511,10.1266411,4,145.8580546,1,1,2,2,2,4,6,0.284877,0.291293,0,No
889,venereal,2,14.403385,2,10.1266511,10.1266411,4,145.8580546,1,0,1,1,0,1,0,0,0,0,No
899,vellum,2,14.403385,2,10.1266511,10.1266411,4,145.8580546,2,1,3,2,2,4,5,0.35519,0.366885,0,No
911,vectorial,2,14.403385,2,10.1266511,10.1266411,4,145.8580546,1,0,1,1,0,1,0,0,0,0,No
922,vassar,2,14.403385,2,10.1266511,10.1266411,4,145.8580546,2,1,3,2,2,4,5,0.324527,0.32819,0,No
925,vasoconstriction,2,14.403385,2,10.1266511,10.1266411,4,145.8580546,0,1,1,0,2,2,5,0.331268,0.335748,0,No
964,valerie,2,14.403385,2,10.1266511,10.1266411,4,145.8580546,1,2,3,1,2,3,5,0.319487,0.32308,0,No
974,vaduz,2,14.403385,2,10.1266511,10.1266411,4,145.8580546,2,1,3,2,1,3,5,0.375317,0.391855,0,No
1013,ursuline,2,14.403385,2,10.1266511,10.1266411,4,145.8580546,2,0,2,2,0,2,0,0,0,0,No
1017,uris,2,14.403385,2,10.1266511,10.1266411,4,145.8580546,2,1,3,2,1,3,5,0.375317,0.391855,0,No
1034,urania,2,14.403385,2,10.1266511,10.1266411,4,145.8580546,1,2,3,1,2,3,5,0.398112,0.415875,0,No
1048,uproar,2,14.403385,2,10.1266511,10.1266411,4,145.8580546,1,2,3,1,2,3,5,0.361447,0.374238,0,No
1055,uphold,2,14.403385,2,10.1266511,10.1266411,4,145.8580546,1,1,2,2,2,4,5,0.398076,0.415824,0,No
1057,upheld,2,14.403385,2,10.1266511,10.1266411,4,145.8580546,1,2,3,1,2,3,4,0.399177,0.416803,0,No
1095,umbra,2,14.403385,2,10.1266511,10.1266411,4,145.8580546,2,2,4,2,2,4,5,0.321774,0.324972,0,No
1113,ubiquitous,2,14.403385,2,10.1266511,10.1266411,4,145.8580546,1,2,3,2,2,4,5,0.321885,0.325047,0,No
1127,typewritten,2,14.403385,2,10.1266511,10.1266411,4,145.8580546,2,1,3,2,1,3,5,0.35519,0.366885,0,No
1132,tympanum,2,14.403385,2,10.1266511,10.1266411,4,145.8580546,2,2,4,2,2,4,5,0.357746,0.369935,0,No
1137,tyburn,2,14.403385,2,10.1266511,10.1266411,4,145.8580546,2,2,4,2,2,4,5,0.329571,0.333534,0,No
1142,twirl,2,14.403385,2,10.1266511,10.1266411,4,145.8580546,1,1,2,1,1,2,5,0.320248,0.324829,0,No
1146,twill,2,14.403385,2,10.1266511,10.1266411,4,145.8580546,2,2,4,2,2,4,5,0.318289,0.321834,0,No
1155,tweedy,2,14.403385,2,10.1266511,10.1266411,4,145.8580546,1,2,3,1,2,3,5,0.360859,0.373539,0,No
1182,turnout,2,14.403385,2,10.1266511,10.1266411,4,145.8580546,2,2,4,2,2,4,5,0.37864,0.394453,0,No
1184,turnaround,2,14.403385,2,10.1266511,10.1266411,4,145.8580546,2,2,4,2,2,4,5,0.350022,0.359779,0,No
1197,turbofan,2,14.403385,2,10.1266511,10.1266411,4,145.8580546,2,1,3,2,1,3,5,0.320126,0.323586,0,No
1209,tuneful,2,14.403385,2,10.1266511,10.1266411,4,145.8580546,1,1,2,2,1,3,5,0.32946,0.333471,0,No
1214,tumultuous,2,14.403385,2,10.1266511,10.1266411,4,145.8580546,1,2,3,1,2,3,5,0.327521,0.331086,0,No
1233,tuberous,2,14.403385,2,10.1266511,10.1266411,4,145.8580546,1,0,1,1,0,1,0,0,0,0,No
1253,trumbull,2,14.403385,2,10.1266511,10.1266411,4,145.8580546,2,2,4,2,2,4,5,0.326966,0.330712,0,No
1265,troupe,2,14.403385,2,10.1266511,10.1266411,4,145.8580546,1,2,3,2,2,4,5,0.345639,0.354544,0,No
1285,triune,2,14.403385,2,10.1266511,10.1266411,4,145.8580546,1,2,3,2,2,4,5,0.324119,0.327433,0,No
1292,triptych,2,14.403385,2,10.1266511,10.1266411,4,145.8580546,1,1,2,1,2,3,5,0.375309,0.391846,0,No
1334,triangulum,2,14.403385,2,10.1266511,10.1266411,4,145.8580546,2,1,3,2,1,3,5,0.319982,0.323217,0,No
1339,trestle,2,14.403385,2,10.1266511,10.1266411,4,145.8580546,2,2,4,2,2,4,5,0.325324,0.328635,0,No
1343,trendy,2,14.403385,2,10.1266511,10.1266411,4,145.8580546,2,1,3,2,1,3,5,0.310235,0.314982,0,No
1347,tremolo,2,14.403385,2,10.1266511,10.1266411,4,145.8580546,0,1,1,0,1,1,5,0.384234,0.400398,0,No
1350,trefoil,2,14.403385,2,10.1266511,10.1266411,4,145.8580546,0,2,2,0,2,2,5,0.336047,0.342074,0,No
1358,treasonous,2,14.403385,2,10.1266511,10.1266411,4,145.8580546,2,2,4,2,2,4,5,0.361653,0.374485,0,No
1362,treachery,2,14.403385,2,10.1266511,10.1266411,4,145.8580546,2,2,4,2,2,4,5,0.40483,0.422185,0,No
1369,travelogue,2,14.403385,2,10.1266511,10.1266411,4,145.8580546,2,1,3,2,1,3,5,0.398076,0.415824,0,No
1387,transplantation,2,14.403385,2,10.1266511,10.1266411,4,145.8580546,2,2,4,2,2,4,5,0.388391,0.405141,0,No
1404,transitive,2,14.403385,2,10.1266511,10.1266411,4,145.8580546,2,1,3,2,1,3,5,0.320415,0.324339,0,No
1413,transfinite,2,14.403385,2,10.1266511,10.1266411,4,145.8580546,2,0,2,2,0,2,0,0,0,0,No
1418,transept,2,14.403385,2,10.1266511,10.1266411,4,145.8580546,2,2,4,2,2,4,5,0.367379,0.381306,0,No
1423,transcribe,2,14.403385,2,10.1266511,10.1266411,4,145.8580546,1,1,2,1,1,2,5,0.398076,0.415824,0,No
1429,transalpine,2,14.403385,2,10.1266511,10.1266411,4,145.8580546,2,1,3,2,2,4,5,0.309445,0.314248,0,No
1442,trainee,2,14.403385,2,10.1266511,10.1266411,4,145.8580546,2,2,4,2,2,4,5,0.349464,0.359502,0,No
1448,tragedian,2,14.403385,2,10.1266511,10.1266411,4,145.8580546,2,2,4,2,2,4,5,0.3284,0.332331,0,No
1455,tradesman,2,14.403385,2,10.1266511,10.1266411,4,145.8580546,2,1,3,2,1,3,5,0.384237,0.400402,0,No
1469,toxicology,2,14.403385,2,10.1266511,10.1266411,4,145.8580546,2,2,4,2,2,4,5,0.348578,0.358234,0,No
1495,torus,2,14.403385,2,10.1266511,10.1266411,4,145.8580546,2,2,4,2,2,4,5,0.325563,0.328932,0,No
1502,torrid,2,14.403385,2,10.1266511,10.1266411,4,145.8580546,2,2,4,2,2,4,5,0.340664,0.347988,0,No
1508,torpor,2,14.403385,2,10.1266511,10.1266411,4,145.8580546,1,1,2,1,1,2,5,0.384237,0.400402,0,No
1520,topsoil,2,14.403385,2,10.1266511,10.1266411,4,145.8580546,1,2,3,2,2,4,5,0.329803,0.334265,0,No
1524,topmost,2,14.403385,2,10.1266511,10.1266411,4,145.8580546,1,1,2,2,1,3,5,0.322616,0.326158,0,No
1533,toothache,2,14.403385,2,10.1266511,10.1266411,4,145.8580546,2,2,4,2,2,4,5,0.348537,0.358145,0,No
1554,tomography,2,14.403385,2,10.1266511,10.1266411,4,145.8580546,0,1,1,0,1,1,6,0.28477,0.291196,0,No
1575,toil,2,14.403385,2,10.1266511,10.1266411,4,145.8580546,1,1,2,1,1,2,5,0.384237,0.400402,0,No
1576,togs,2,14.403385,2,10.1266511,10.1266411,4,145.8580546,1,1,2,1,1,2,5,0.336028,0.342206,0,No
1578,toggle,2,14.403385,2,10.1266511,10.1266411,4,145.8580546,1,1,2,1,1,2,5,0.312259,0.31671,0,No
1615,tint,2,14.403385,2,10.1266511,10.1266411,4,145.8580546,2,2,4,2,2,4,5,0.37864,0.394448,0,No
1642,tighten,2,14.403385,2,10.1266511,10.1266411,4,145.8580546,1,2,3,1,2,3,5,0.3284,0.332386,0,No
1659,tic,2,14.403385,2,10.1266511,10.1266411,4,145.8580546,2,0,2,2,0,2,0,0,0,0,No
1671,thwart,2,14.403385,2,10.1266511,10.1266411,4,145.8580546,1,2,3,2,2,4,5,0.398344,0.416101,0,No
1755,thicken,2,14.403385,2,10.1266511,10.1266411,4,145.8580546,1,0,1,2,0,2,0,0,0,0,No
1784,theoretician,2,14.403385,2,10.1266511,10.1266411,4,145.8580546,2,2,4,2,2,4,5,0.365345,0.378812,0,No
1791,thence,2,14.403385,2,10.1266511,10.1266411,4,145.8580546,2,2,4,2,2,4,5,0.335393,0.341006,0,No
1810,thankful,2,14.403385,2,10.1266511,10.1266411,4,145.8580546,2,2,4,2,2,4,5,0.359492,0.371936,0,No
1814,thalia,2,14.403385,2,10.1266511,10.1266411,4,145.8580546,2,1,3,2,1,3,5,0.398076,0.415824,0,No
1834,testimonial,2,14.403385,2,10.1266511,10.1266411,4,145.8580546,2,1,3,2,2,4,5,0.320577,0.323851,0,No
1862,termini,2,14.403385,2,10.1266511,10.1266411,4,145.8580546,2,2,4,2,2,4,5,0.326611,0.330295,0,No
1868,tepee,2,14.403385,2,10.1266511,10.1266411,4,145.8580546,1,2,3,1,2,3,5,0.355233,0.366961,0,No
1908,telltale,2,14.403385,2,10.1266511,10.1266411,4,145.8580546,2,2,4,2,2,4,5,0.323782,0.326909,0,No
1911,teletype,2,14.403385,2,10.1266511,10.1266411,4,145.8580546,1,2,3,2,2,4,5,0.361182,0.373947,0,No
1912,telescopic,2,14.403385,2,10.1266511,10.1266411,4,145.8580546,2,2,4,2,2,4,5,0.319792,0.323215,0,No
1914,teleprinter,2,14.403385,2,10.1266511,10.1266411,4,145.8580546,1,1,2,2,1,3,5,0.345599,0.354479,0,No
1918,telepathy,2,14.403385,2,10.1266511,10.1266411,4,145.8580546,2,1,3,2,1,3,5,0.345599,0.354479,0,No
1919,telepathic,2,14.403385,2,10.1266511,10.1266411,4,145.8580546,1,0,1,1,0,1,0,0,0,0,No
1944,technic,2,14.403385,2,10.1266511,10.1266411,4,145.8580546,1,1,2,2,1,3,5,0.345599,0.354479,0,No
1959,teahouse,2,14.403385,2,10.1266511,10.1266411,4,145.8580546,2,2,4,2,2,4,5,0.37906,0.394922,0,No
1960,teacup,2,14.403385,2,10.1266511,10.1266411,4,145.8580546,2,2,4,2,2,4,5,0.339375,0.34626,0,No
1969,taxicab,2,14.403385,2,10.1266511,10.1266411,4,145.8580546,1,2,3,2,2,4,4,0.40718,0.424812,0,No
1979,taunt,2,14.403385,2,10.1266511,10.1266411,4,145.8580546,2,2,4,2,2,4,5,0.332584,0.337604,0,No
1984,tat,2,14.403385,2,10.1266511,10.1266411,4,145.8580546,2,2,4,2,2,4,5,0.355546,0.367317,0,No
1993,tartary,2,14.403385,2,10.1266511,10.1266411,4,145.8580546,2,2,4,2,2,4,5,0.387416,0.403918,0,No
2017,tantrum,2,14.403385,2,10.1266511,10.1266411,4,145.8580546,2,2,4,2,2,4,5,0.384262,0.400449,0,No
2027,tangle,2,14.403385,2,10.1266511,10.1266411,4,145.8580546,2,2,4,2,2,4,5,0.388391,0.405141,0,No
2034,tandem,2,14.403385,2,10.1266511,10.1266411,4,145.8580546,1,2,3,1,2,3,5,0.394633,0.411702,0,No
2047,talus,2,14.403385,2,10.1266511,10.1266411,4,145.8580546,1,1,2,1,1,2,5,0.345599,0.354479,0,No
2048,talon,2,14.403385,2,10.1266511,10.1266411,4,145.8580546,2,1,3,2,1,3,5,0.384237,0.400402,0,No
2056,talkative,2,14.403385,2,10.1266511,10.1266411,4,145.8580546,1,1,2,1,1,2,5,0.384237,0.400402,0,No
2062,talc,2,14.403385,2,10.1266511,10.1266411,4,145.8580546,2,1,3,2,1,3,5,0.328412,0.333573,0,No
2083,tact,2,14.403385,2,10.1266511,10.1266411,4,145.8580546,2,2,4,2,2,4,5,0.359317,0.371692,0,No
2091,tabular,2,14.403385,2,10.1266511,10.1266411,4,145.8580546,2,2,4,2,2,4,5,0.324361,0.327658,0,No
2114,syrinx,2,14.403385,2,10.1266511,10.1266411,4,145.8580546,2,1,3,2,1,3,5,0.301094,0.306845,0,No
2115,syringe,2,14.403385,2,10.1266511,10.1266411,4,145.8580546,1,1,2,2,1,3,5,0.345599,0.354479,0,No
2153,sylvan,2,14.403385,2,10.1266511,10.1266411,4,145.8580546,2,2,4,2,2,4,5,0.345963,0.354904,0,No
2155,syllabus,2,14.403385,2,10.1266511,10.1266411,4,145.8580546,1,1,2,1,1,2,5,0.343985,0.352404,0,No
2165,swordplay,2,14.403385,2,10.1266511,10.1266411,4,145.8580546,1,1,2,1,1,2,5,0.360829,0.373487,0,No
2176,swirl,2,14.403385,2,10.1266511,10.1266411,4,145.8580546,2,2,4,2,2,4,4,0.400248,0.417826,0,No
2177,swipe,2,14.403385,2,10.1266511,10.1266411,4,145.8580546,2,2,4,2,2,4,5,0.386252,0.402655,0,No
2194,sweaty,2,14.403385,2,10.1266511,10.1266411,4,145.8580546,1,1,2,2,1,3,5,0.320705,0.324646,0,No
2228,sustenance,2,14.403385,2,10.1266511,10.1266411,4,145.8580546,2,2,4,2,2,4,4,0.388136,0.404686,0,No
2249,surrogate,2,14.403385,2,10.1266511,10.1266411,4,145.8580546,2,1,3,2,1,3,5,0.323847,0.327224,0,No
2268,supranational,2,14.403385,2,10.1266511,10.1266411,4,145.8580546,2,1,3,2,1,3,5,0.384237,0.400402,0,No
2306,sunglasses,2,14.403385,2,10.1266511,10.1266411,4,145.8580546,0,2,2,0,2,2,5,0.344198,0.352841,0,No
2314,sunder,2,14.403385,2,10.1266511,10.1266411,4,145.8580546,1,2,3,1,2,3,5,0.386749,0.403195,0,No
2316,sunburnt,2,14.403385,2,10.1266511,10.1266411,4,145.8580546,1,1,2,1,1,2,5,0.326966,0.330447,0,No
2334,sulfurous,2,14.403385,2,10.1266511,10.1266411,4,145.8580546,2,2,4,2,2,4,5,0.321372,0.324699,0,No
2340,suitor,2,14.403385,2,10.1266511,10.1266411,4,145.8580546,1,2,3,1,2,3,5,0.350963,0.360998,0,No
2360,suey,2,14.403385,2,10.1266511,10.1266411,4,145.8580546,1,0,1,2,0,2,0,0,0,0,No
2382,subtly,2,14.403385,2,10.1266511,10.1266411,4,145.8580546,1,1,2,1,1,2,5,0.321879,0.325211,0,No
2391,subsidy,2,14.403385,2,10.1266511,10.1266411,4,145.8580546,1,2,3,2,2,4,5,0.346314,0.355371,0,No
2403,styrofoam,2,14.403385,2,10.1266511,10.1266411,4,145.8580546,2,1,3,2,1,3,5,0.375317,0.391855,0,No
2418,stun,2,14.403385,2,10.1266511,10.1266411,4,145.8580546,1,2,3,1,2,3,5,0.384479,0.400684,0,No
2421,stumble,2,14.403385,2,10.1266511,10.1266411,4,145.8580546,2,1,3,2,2,4,5,0.317714,0.321479,0,No
2428,studebaker,2,14.403385,2,10.1266511,10.1266411,4,145.8580546,1,0,1,1,0,1,0,0,0,0,No
2431,stucco,2,14.403385,2,10.1266511,10.1266411,4,145.8580546,2,1,3,2,2,4,5,0.384229,0.400392,0,No
2453,stringy,2,14.403385,2,10.1266511,10.1266411,4,145.8580546,2,2,4,2,2,4,6,0.269698,0.275111,0,No
2454,stringent,2,14.403385,2,10.1266511,10.1266411,4,145.8580546,1,1,2,1,1,2,5,0.321704,0.324841,0,No
2467,strenuous,2,14.403385,2,10.1266511,10.1266411,4,145.8580546,2,2,4,2,2,4,5,0.326215,0.329654,0,No
2500,stowaway,2,14.403385,2,10.1266511,10.1266411,4,145.8580546,1,2,3,1,2,3,5,0.378019,0.393745,0,No
2539,stoat,2,14.403385,2,10.1266511,10.1266411,4,145.8580546,2,2,4,2,2,4,5,0.355361,0.367101,0,No
2549,stingray,2,14.403385,2,10.1266511,10.1266411,4,145.8580546,2,1,3,2,1,3,5,0.322499,0.325684,0,No
2573,steuben,2,14.403385,2,10.1266511,10.1266411,4,145.8580546,1,0,1,2,0,2,0,0,0,0,No
2593,stench,2,14.403385,2,10.1266511,10.1266411,4,145.8580546,0,2,2,0,2,2,5,0.378618,0.394427,0,No
2614,stealthy,2,14.403385,2,10.1266511,10.1266411,4,145.8580546,2,1,3,2,1,3,5,0.343985,0.352404,0,No
2624,staunch,2,14.403385,2,10.1266511,10.1266411,4,145.8580546,2,0,2,2,0,2,0,0,0,0,No
2632,statler,2,14.403385,2,10.1266511,10.1266411,4,145.8580546,2,1,3,2,1,3,5,0.384237,0.400402,0,No
2637,statewide,2,14.403385,2,10.1266511,10.1266411,4,145.8580546,1,1,2,2,1,3,5,0.35519,0.366885,0,No
2651,starkey,2,14.403385,2,10.1266511,10.1266411,4,145.8580546,1,1,2,1,1,2,5,0.326551,0.330051,0,No
2682,stamen,2,14.403385,2,10.1266511,10.1266411,4,145.8580546,1,1,2,2,1,3,5,0.398076,0.415824,0,No
2694,stair,2,14.403385,2,10.1266511,10.1266411,4,145.8580546,2,2,4,2,2,4,5,0.324521,0.327811,0,No
2716,squishy,2,14.403385,2,10.1266511,10.1266411,4,145.8580546,2,1,3,2,1,3,5,0.310077,0.315053,0,No
2720,squint,2,14.403385,2,10.1266511,10.1266411,4,145.8580546,2,1,3,2,1,3,5,0.324943,0.328333,0,No
2723,squeal,2,14.403385,2,10.1266511,10.1266411,4,145.8580546,2,2,4,2,2,4,5,0.385012,0.40127,0,No
2725,squeak,2,14.403385,2,10.1266511,10.1266411,4,145.8580546,2,2,4,2,2,4,5,0.398514,0.416246,0,No
2727,squatter,2,14.403385,2,10.1266511,10.1266411,4,145.8580546,2,0,2,2,0,2,0,0,0,0,No
2746,sprung,2,14.403385,2,10.1266511,10.1266411,4,145.8580546,2,2,4,2,2,4,5,0.359798,0.372288,0,No
2749,sprocket,2,14.403385,2,10.1266511,10.1266411,4,145.8580546,1,1,2,2,1,3,5,0.345606,0.354483,0,No
2755,springboard,2,14.403385,2,10.1266511,10.1266411,4,145.8580546,2,2,4,2,2,4,5,0.364489,0.378076,0,No
2765,spout,2,14.403385,2,10.1266511,10.1266411,4,145.8580546,1,2,3,2,2,4,4,0.38452,0.401386,0,No
2792,spoilage,2,14.403385,2,10.1266511,10.1266411,4,145.8580546,1,1,2,2,1,3,5,0.326479,0.331386,0,No
2846,speedy,2,14.403385,2,10.1266511,10.1266411,4,145.8580546,1,1,2,1,1,2,5,0.320948,0.324274,0,No
2851,sped,2,14.403385,2,10.1266511,10.1266411,4,145.8580546,2,2,4,2,2,4,5,0.376799,0.393259,0,No
2867,speck,2,14.403385,2,10.1266511,10.1266411,4,145.8580546,2,1,3,2,1,3,5,0.378607,0.394397,0,No
2890,sparkle,2,14.403385,2,10.1266511,10.1266411,4,145.8580546,2,2,4,2,2,4,5,0.380009,0.395993,0,No
2927,sousa,2,14.403385,2,10.1266511,10.1266411,4,145.8580546,1,0,1,1,0,1,0,0,0,0,No
2930,soupy,2,14.403385,2,10.1266511,10.1266411,4,145.8580546,2,1,3,2,1,3,5,0.309596,0.314385,0,No
2934,soulful,2,14.403385,2,10.1266511,10.1266411,4,145.8580546,2,1,3,2,1,3,5,0.321372,0.324529,0,No
2948,sorcery,2,14.403385,2,10.1266511,10.1266411,4,145.8580546,1,1,2,2,1,3,5,0.345599,0.354479,0,No
2952,sophomore,2,14.403385,2,10.1266511,10.1266411,4,145.8580546,1,2,3,1,2,3,5,0.333596,0.338535,0,No
2983,someplace,2,14.403385,2,10.1266511,10.1266411,4,145.8580546,2,2,4,2,2,4,5,0.378745,0.394556,0,No
3024,soggy,2,14.403385,2,10.1266511,10.1266411,4,145.8580546,1,2,3,1,2,3,5,0.384271,0.400458,0,No
3031,sofa,2,14.403385,2,10.1266511,10.1266411,4,145.8580546,1,2,3,2,2,4,5,0.394633,0.411702,0,No
3042,socioeconomic,2,14.403385,2,10.1266511,10.1266411,4,145.8580546,2,1,3,2,1,3,5,0.305899,0.31105,0,No
3069,snorkel,2,14.403385,2,10.1266511,10.1266411,4,145.8580546,2,2,4,2,2,4,5,0.41003,0.427626,0,No
3073,snipe,2,14.403385,2,10.1266511,10.1266411,4,145.8580546,2,2,4,2,2,4,5,0.339051,0.345861,0,No
3098,smoothbore,2,14.403385,2,10.1266511,10.1266411,4,145.8580546,1,1,2,1,1,2,5,0.30432,0.309686,0,No
3100,smoky,2,14.403385,2,10.1266511,10.1266411,4,145.8580546,2,1,3,2,1,3,5,0.322857,0.325969,0,No
3108,smelt,2,14.403385,2,10.1266511,10.1266411,4,145.8580546,2,2,4,2,2,4,4,0.399554,0.417155,0,No
3111,smear,2,14.403385,2,10.1266511,10.1266411,4,145.8580546,2,2,4,2,2,4,5,0.326635,0.330501,0,No
3119,slush,2,14.403385,2,10.1266511,10.1266411,4,145.8580546,2,0,2,2,0,2,0,0,0,0,No
3120,slurry,2,14.403385,2,10.1266511,10.1266411,4,145.8580546,1,1,2,1,1,2,5,0.378607,0.394397,0,No
3123,slump,2,14.403385,2,10.1266511,10.1266411,4,145.8580546,2,1,3,2,1,3,5,0.360829,0.373487,0,No
3126,sluice,2,14.403385,2,10.1266511,10.1266411,4,145.8580546,1,2,3,1,2,3,5,0.320855,0.32443,0,No
3129,sludge,2,14.403385,2,10.1266511,10.1266411,4,145.8580546,2,2,4,2,2,4,5,0.384279,0.400468,0,No
3150,slingshot,2,14.403385,2,10.1266511,10.1266411,4,145.8580546,2,2,4,2,2,4,5,0.335723,0.341853,0,No
3152,slimy,2,14.403385,2,10.1266511,10.1266411,4,145.8580546,1,2,3,1,2,3,5,0.384254,0.400439,0,No
3178,slav,2,14.403385,2,10.1266511,10.1266411,4,145.8580546,2,1,3,2,1,3,5,0.328145,0.333093,0,No
3222,skeptic,2,14.403385,2,10.1266511,10.1266411,4,145.8580546,1,2,3,1,2,3,5,0.323339,0.326911,0,No
3236,siva,2,14.403385,2,10.1266511,10.1266411,4,145.8580546,1,2,3,2,2,4,4,0.398532,0.416169,0,No
3250,sinusoidal,2,14.403385,2,10.1266511,10.1266411,4,145.8580546,2,2,4,2,2,4,5,0.322411,0.325726,0,No
3258,sinister,2,14.403385,2,10.1266511,10.1266411,4,145.8580546,1,0,1,1,0,1,0,0,0,0,No
3263,singe,2,14.403385,2,10.1266511,10.1266411,4,145.8580546,1,1,2,1,1,2,5,0.360829,0.373487,0,No
3267,sinew,2,14.403385,2,10.1266511,10.1266411,4,145.8580546,2,2,4,2,2,4,5,0.347806,0.357164,0,No
3291,simmer,2,14.403385,2,10.1266511,10.1266411,4,145.8580546,2,1,3,2,1,3,5,0.323604,0.327285,0,No
3299,silverware,2,14.403385,2,10.1266511,10.1266411,4,145.8580546,2,1,3,2,1,3,5,0.321914,0.325019,0,No
3337,sigh,2,14.403385,2,10.1266511,10.1266411,4,145.8580546,2,2,4,2,2,4,5,0.355226,0.366946,0,No
3385,shroud,2,14.403385,2,10.1266511,10.1266411,4,145.8580546,2,1,3,2,1,3,5,0.378607,0.394397,0,No
3394,shred,2,14.403385,2,10.1266511,10.1266411,4,145.8580546,2,1,3,2,1,3,5,0.310734,0.315474,0,No
3398,showroom,2,14.403385,2,10.1266511,10.1266411,4,145.8580546,1,2,3,1,2,3,5,0.334124,0.33994,0,No
3401,showman,2,14.403385,2,10.1266511,10.1266411,4,145.8580546,2,2,4,2,2,4,5,0.350984,0.360967,0,No
3444,shipley,2,14.403385,2,10.1266511,10.1266411,4,145.8580546,1,2,3,1,2,3,5,0.350063,0.35984,0,No
3496,shay,2,14.403385,2,10.1266511,10.1266411,4,145.8580546,1,2,3,1,2,3,5,0.361196,0.373966,0,No
3502,sharpen,2,14.403385,2,10.1266511,10.1266411,4,145.8580546,2,1,3,2,2,4,5,0.398076,0.415824,0,No
3533,shakedown,2,14.403385,2,10.1266511,10.1266411,4,145.8580546,2,2,4,2,2,4,5,0.318941,0.322562,0,No
3540,shadowy,2,14.403385,2,10.1266511,10.1266411,4,145.8580546,2,0,2,2,0,2,0,0,0,0,No
3550,sextans,2,14.403385,2,10.1266511,10.1266411,4,145.8580546,1,1,2,2,2,4,5,0.309467,0.314309,0,No
3553,sewerage,2,14.403385,2,10.1266511,10.1266411,4,145.8580546,2,1,3,2,1,3,5,0.384229,0.400392,0,No
3569,seton,2,14.403385,2,10.1266511,10.1266411,4,145.8580546,2,1,3,2,1,3,5,0.319596,0.32378,0,No
3571,setback,2,14.403385,2,10.1266511,10.1266411,4,145.8580546,2,1,3,2,1,3,5,0.343985,0.352404,0,No
3581,serviceman,2,14.403385,2,10.1266511,10.1266411,4,145.8580546,1,1,2,1,1,2,5,0.384237,0.400402,0,No
3600,serendipity,2,14.403385,2,10.1266511,10.1266411,4,145.8580546,2,2,4,2,2,4,5,0.41003,0.427626,0,No
3604,seraglio,2,14.403385,2,10.1266511,10.1266411,4,145.8580546,2,2,4,2,2,4,5,0.324539,0.327767,0,No
3620,sentry,2,14.403385,2,10.1266511,10.1266411,4,145.8580546,1,1,2,1,1,2,5,0.384237,0.400402,0,No
3637,senile,2,14.403385,2,10.1266511,10.1266411,4,145.8580546,2,1,3,2,2,4,5,0.293604,0.299768,0,No
3644,semper,2,14.403385,2,10.1266511,10.1266411,4,145.8580546,1,0,1,1,0,1,0,0,0,0,No
3648,seminar,2,14.403385,2,10.1266511,10.1266411,4,145.8580546,0,2,2,0,2,2,5,0.352993,0.363653,0,No
3656,seltzer,2,14.403385,2,10.1266511,10.1266411,4,145.8580546,2,2,4,2,2,4,5,0.3319,0.336635,0,No
3661,selfridge,2,14.403385,2,10.1266511,10.1266411,4,145.8580546,1,0,1,1,0,1,0,0,0,0,No
3665,selena,2,14.403385,2,10.1266511,10.1266411,4,145.8580546,2,1,3,2,1,3,5,0.324628,0.32797,0,No
3674,segregate,2,14.403385,2,10.1266511,10.1266411,4,145.8580546,2,2,4,2,2,4,5,0.36337,0.376471,0,No
3676,segmentation,2,14.403385,2,10.1266511,10.1266411,4,145.8580546,1,1,2,1,1,2,5,0.378607,0.394397,0,No
3684,seedling,2,14.403385,2,10.1266511,10.1266411,4,145.8580546,1,1,2,2,1,3,5,0.345599,0.354479,0,No
3687,seductive,2,14.403385,2,10.1266511,10.1266411,4,145.8580546,2,1,3,2,1,3,5,0.333854,0.3397,0,No
3702,secretive,2,14.403385,2,10.1266511,10.1266411,4,145.8580546,2,2,4,2,2,4,5,0.384371,0.400566,0,No
3710,secondhand,2,14.403385,2,10.1266511,10.1266411,4,145.8580546,2,2,4,2,2,4,5,0.324124,0.327443,0,No
3722,seaward,2,14.403385,2,10.1266511,10.1266411,4,145.8580546,1,2,3,1,2,3,5,0.381438,0.397561,0,No
3737,sealant,2,14.403385,2,10.1266511,10.1266411,4,145.8580546,1,2,3,1,2,3,5,0.325994,0.329557,0,No
3740,seagull,2,14.403385,2,10.1266511,10.1266411,4,145.8580546,2,2,4,2,2,4,5,0.340233,0.347547,0,No
3756,sculptural,2,14.403385,2,10.1266511,10.1266411,4,145.8580546,2,1,3,2,1,3,5,0.307595,0.312634,0,No
3771,scrimmage,2,14.403385,2,10.1266511,10.1266411,4,145.8580546,1,2,3,2,2,4,5,0.331144,0.336043,0,No
3809,scold,2,14.403385,2,10.1266511,10.1266411,4,145.8580546,2,2,4,2,2,4,5,0.377312,0.393754,0,No
3814,scissor,2,14.403385,2,10.1266511,10.1266411,4,145.8580546,2,1,3,2,1,3,5,0.314673,0.318682,0,No
3840,schoolhouse,2,14.403385,2,10.1266511,10.1266411,4,145.8580546,2,2,4,2,2,4,5,0.320126,0.323426,0,No
3858,schizoid,2,14.403385,2,10.1266511,10.1266411,4,145.8580546,2,0,2,2,0,2,0,0,0,0,No
3863,schematic,2,14.403385,2,10.1266511,10.1266411,4,145.8580546,2,1,3,2,1,3,5,0.338882,0.345659,0,No
3868,schafer,2,14.403385,2,10.1266511,10.1266411,4,145.8580546,2,1,3,2,1,3,5,0.302294,0.307931,0,No
3879,scarsdale,2,14.403385,2,10.1266511,10.1266411,4,145.8580546,2,2,4,2,2,4,5,0.329969,0.334752,0,No
3885,scarecrow,2,14.403385,2,10.1266511,10.1266411,4,145.8580546,2,2,4,2,2,4,5,0.39747,0.415068,0,No
3890,scapula,2,14.403385,2,10.1266511,10.1266411,4,145.8580546,2,2,4,2,2,4,5,0.355347,0.367092,0,No
3900,scallop,2,14.403385,2,10.1266511,10.1266411,4,145.8580546,1,2,3,2,2,4,5,0.336684,0.342727,0,No
3926,savant,2,14.403385,2,10.1266511,10.1266411,4,145.8580546,2,1,3,2,1,3,5,0.345068,0.353675,0,No
3941,saturnalia,2,14.403385,2,10.1266511,10.1266411,4,145.8580546,2,2,4,2,2,4,5,0.323681,0.326937,0,No
3944,saturate,2,14.403385,2,10.1266511,10.1266411,4,145.8580546,0,2,2,0,2,2,5,0.321286,0.32509,0,No
3973,saracen,2,14.403385,2,10.1266511,10.1266411,4,145.8580546,0,1,1,0,1,1,5,0.317988,0.321496,0,No
3975,saprophytic,2,14.403385,2,10.1266511,10.1266411,4,145.8580546,1,2,3,1,2,3,5,0.376527,0.392996,0,No
3991,sanhedrin,2,14.403385,2,10.1266511,10.1266411,4,145.8580546,1,2,3,2,2,4,5,0.38467,0.400899,0,No
4001,sandpaper,2,14.403385,2,10.1266511,10.1266411,4,145.8580546,2,1,3,2,1,3,5,0.384237,0.400402,0,No
4009,sanctity,2,14.403385,2,10.1266511,10.1266411,4,145.8580546,2,1,3,2,2,4,5,0.378607,0.394397,0,No
4031,salve,2,14.403385,2,10.1266511,10.1266411,4,145.8580546,1,2,3,1,2,3,5,0.398103,0.41587,0,No
4050,salivate,2,14.403385,2,10.1266511,10.1266411,4,145.8580546,1,2,3,2,2,4,5,0.332746,0.337565,0,No
4053,salish,2,14.403385,2,10.1266511,10.1266411,4,145.8580546,2,2,4,2,2,4,5,0.384337,0.400524,0,No
4056,salina,2,14.403385,2,10.1266511,10.1266411,4,145.8580546,0,1,1,0,1,1,5,0.303406,0.308838,0,No
4058,salesperson,2,14.403385,2,10.1266511,10.1266411,4,145.8580546,2,2,4,2,2,4,5,0.329773,0.333988,0,No
4112,sabine,2,14.403385,2,10.1266511,10.1266411,4,145.8580546,1,2,3,2,2,4,5,0.328121,0.331908,0,No
4132,rustic,2,14.403385,2,10.1266511,10.1266411,4,145.8580546,1,2,3,2,2,4,5,0.328078,0.331966,0,No
4154,rundown,2,14.403385,2,10.1266511,10.1266411,4,145.8580546,1,2,3,1,2,3,5,0.326065,0.329494,0,No
4159,ruminate,2,14.403385,2,10.1266511,10.1266411,4,145.8580546,2,2,4,2,2,4,4,0.386429,0.402804,0,No
4160,ruminant,2,14.403385,2,10.1266511,10.1266411,4,145.8580546,1,2,3,2,2,4,5,0.319746,0.323321,0,No
4167,rug,2,14.403385,2,10.1266511,10.1266411,4,145.8580546,2,1,3,2,1,3,6,0.289034,0.295349,0,No
4169,rufous,2,14.403385,2,10.1266511,10.1266411,4,145.8580546,1,1,2,2,1,3,5,0.35519,0.366885,0,No
4175,rudimentary,2,14.403385,2,10.1266511,10.1266411,4,145.8580546,2,2,4,2,2,4,5,0.323522,0.326813,0,No
4196,rowena,2,14.403385,2,10.1266511,10.1266411,4,145.8580546,1,0,1,1,0,1,0,0,0,0,No
4260,romp,2,14.403385,2,10.1266511,10.1266411,4,145.8580546,1,2,3,1,2,3,5,0.346145,0.355018,0,No
4313,roadster,2,14.403385,2,10.1266511,10.1266411,4,145.8580546,1,1,2,1,1,2,5,0.375309,0.391846,0,No
4325,riverbank,2,14.403385,2,10.1266511,10.1266411,4,145.8580546,2,1,3,2,1,3,5,0.32681,0.33159,0,No
4350,ringside,2,14.403385,2,10.1266511,10.1266411,4,145.8580546,1,2,3,2,2,4,5,0.327274,0.3311,0,No
4352,rinehart,2,14.403385,2,10.1266511,10.1266411,4,145.8580546,1,2,3,1,2,3,5,0.384271,0.400458,0,No
4362,riggs,2,14.403385,2,10.1266511,10.1266411,4,145.8580546,2,2,4,2,2,4,4,0.399986,0.417606,0,No
4364,rigel,2,14.403385,2,10.1266511,10.1266411,4,145.8580546,2,1,3,2,1,3,5,0.345599,0.354479,0,No
4373,ridicule,2,14.403385,2,10.1266511,10.1266411,4,145.8580546,2,2,4,2,2,4,5,0.378672,0.394467,0,No
4379,riddance,2,14.403385,2,10.1266511,10.1266411,4,145.8580546,1,1,2,2,1,3,5,0.329418,0.333526,0,No
4381,ricotta,2,14.403385,2,10.1266511,10.1266411,4,145.8580546,1,2,3,1,2,3,5,0.321367,0.32473,0,No
4415,rhizome,2,14.403385,2,10.1266511,10.1266411,4,145.8580546,2,2,4,2,2,4,5,0.380661,0.396683,0,No
4432,reykjavik,2,14.403385,2,10.1266511,10.1266411,4,145.8580546,2,1,3,2,1,3,5,0.321233,0.324339,0,No
4440,revert,2,14.403385,2,10.1266511,10.1266411,4,145.8580546,2,2,4,2,2,4,5,0.375675,0.391127,0,No
4456,retrofitted,2,14.403385,2,10.1266511,10.1266411,4,145.8580546,2,0,2,2,0,2,0,0,0,0,No
4457,retroactive,2,14.403385,2,10.1266511,10.1266411,4,145.8580546,1,2,3,1,2,3,5,0.365412,0.379123,0,No
4468,retardant,2,14.403385,2,10.1266511,10.1266411,4,145.8580546,2,2,4,2,2,4,5,0.375349,0.391907,0,No
4491,respondent,2,14.403385,2,10.1266511,10.1266411,4,145.8580546,1,2,3,2,2,4,5,0.323847,0.327245,0,No
4520,reptilian,2,14.403385,2,10.1266511,10.1266411,4,145.8580546,1,1,2,1,1,2,5,0.317805,0.321298,0,No
4524,repressive,2,14.403385,2,10.1266511,10.1266411,4,145.8580546,2,1,3,2,1,3,5,0.35519,0.366885,0,No
4536,repellent,2,14.403385,2,10.1266511,10.1266411,4,145.8580546,2,2,4,2,2,4,5,0.326077,0.331131,0,No
4539,repeater,2,14.403385,2,10.1266511,10.1266411,4,145.8580546,2,2,4,2,2,4,5,0.332466,0.337293,0,No
4547,renovate,2,14.403385,2,10.1266511,10.1266411,4,145.8580546,1,2,3,2,2,4,5,0.398621,0.416377,0,No
4565,remit,2,14.403385,2,10.1266511,10.1266411,4,145.8580546,2,2,4,2,2,4,4,0.399294,0.416887,0,No
4603,regretted,2,14.403385,2,10.1266511,10.1266411,4,145.8580546,1,2,3,2,2,4,5,0.331608,0.336236,0,No
4621,refute,2,14.403385,2,10.1266511,10.1266411,4,145.8580546,2,2,4,2,2,4,5,0.398183,0.415936,0,No
4627,refractory,2,14.403385,2,10.1266511,10.1266411,4,145.8580546,2,1,3,2,1,3,5,0.323251,0.326383,0,No
4637,refereeing,2,14.403385,2,10.1266511,10.1266411,4,145.8580546,2,0,2,2,0,2,0,0,0,0,No
4640,reese,2,14.403385,2,10.1266511,10.1266411,4,145.8580546,2,2,4,2,2,4,5,0.384296,0.400486,0,No
4671,reconcile,2,14.403385,2,10.1266511,10.1266411,4,145.8580546,1,1,2,2,1,3,5,0.398076,0.415824,0,No
4689,receptacle,2,14.403385,2,10.1266511,10.1266411,4,145.8580546,1,2,3,1,2,3,5,0.345498,0.354107,0,No
4699,reap,2,14.403385,2,10.1266511,10.1266411,4,145.8580546,0,2,2,0,2,2,5,0.398134,0.415903,0,No
4700,ream,2,14.403385,2,10.1266511,10.1266411,4,145.8580546,2,2,4,2,2,4,5,0.332335,0.337435,0,No
4752,raoul,2,14.403385,2,10.1266511,10.1266411,4,145.8580546,1,2,3,1,2,3,5,0.32766,0.331487,0,No
4810,radix,2,14.403385,2,10.1266511,10.1266411,4,145.8580546,1,2,3,2,2,4,4,0.405163,0.422713,0,No
4821,radii,2,14.403385,2,10.1266511,10.1266411,4,145.8580546,1,2,3,2,2,4,5,0.398246,0.415993,0,No
4851,quorum,2,14.403385,2,10.1266511,10.1266411,4,145.8580546,1,2,3,1,2,3,5,0.405756,0.42333,0,No
4861,quirk,2,14.403385,2,10.1266511,10.1266411,4,145.8580546,1,1,2,2,2,4,5,0.378607,0.394397,0,No
4877,quicksilver,2,14.403385,2,10.1266511,10.1266411,4,145.8580546,2,2,4,2,2,4,5,0.355254,0.36697,0,No
4880,quicken,2,14.403385,2,10.1266511,10.1266411,4,145.8580546,1,0,1,2,0,2,0,0,0,0,No
4899,quasi,2,14.403385,2,10.1266511,10.1266411,4,145.8580546,0,1,1,0,2,2,5,0.384234,0.400398,0,No
4919,quantify,2,14.403385,2,10.1266511,10.1266411,4,145.8580546,1,2,3,2,2,4,5,0.413931,0.431649,0,No
4932,quadrillion,2,14.403385,2,10.1266511,10.1266411,4,145.8580546,1,1,2,1,1,2,5,0.328625,0.333509,0,No
4950,pyrotechnic,2,14.403385,2,10.1266511,10.1266411,4,145.8580546,2,1,3,2,1,3,5,0.319171,0.322649,0,No
4956,pyre,2,14.403385,2,10.1266511,10.1266411,4,145.8580546,1,1,2,2,1,3,5,0.375309,0.391846,0,No
4957,pyramidal,2,14.403385,2,10.1266511,10.1266411,4,145.8580546,2,1,3,2,1,3,5,0.321343,0.325025,0,No
4977,purvey,2,14.403385,2,10.1266511,10.1266411,4,145.8580546,1,2,3,2,2,4,5,0.384971,0.401214,0,No
5001,pupal,2,14.403385,2,10.1266511,10.1266411,4,145.8580546,2,1,3,2,2,4,5,0.321687,0.324836,0,No
5007,punky,2,14.403385,2,10.1266511,10.1266411,4,145.8580546,2,2,4,2,2,4,5,0.32321,0.326475,0,No
5014,pungent,2,14.403385,2,10.1266511,10.1266411,4,145.8580546,1,2,3,2,2,4,5,0.319728,0.323404,0,No
5030,pullover,2,14.403385,2,10.1266511,10.1266411,4,145.8580546,2,1,3,2,1,3,5,0.318833,0.322526,0,No
5066,psychopathic,2,14.403385,2,10.1266511,10.1266411,4,145.8580546,2,1,3,2,1,3,6,0.278561,0.284579,0,No
5077,psych,2,14.403385,2,10.1266511,10.1266411,4,145.8580546,2,2,4,2,2,4,5,0.294872,0.301048,0,No
5085,prudent,2,14.403385,2,10.1266511,10.1266411,4,145.8580546,2,1,3,2,1,3,5,0.359172,0.371523,0,No
5090,provocative,2,14.403385,2,10.1266511,10.1266411,4,145.8580546,1,1,2,1,1,2,5,0.319062,0.322956,0,No
5112,proto,2,14.403385,2,10.1266511,10.1266411,4,145.8580546,2,2,4,2,2,4,5,0.323823,0.327088,0,No
5135,prosody,2,14.403385,2,10.1266511,10.1266411,4,145.8580546,2,2,4,2,2,4,5,0.413931,0.431649,0,No
5145,prosaic,2,14.403385,2,10.1266511,10.1266411,4,145.8580546,2,2,4,2,2,4,5,0.322288,0.32543,0,No
5181,prompt,2,14.403385,2,10.1266511,10.1266411,4,145.8580546,2,2,4,2,2,4,5,0.349656,0.359617,0,No
5228,prodigious,2,14.403385,2,10.1266511,10.1266411,4,145.8580546,2,2,4,2,2,4,5,0.384962,0.401214,0,No
5229,prodigal,2,14.403385,2,10.1266511,10.1266411,4,145.8580546,2,1,3,2,1,3,5,0.323929,0.327182,0,No
5333,preemptive,2,14.403385,2,10.1266511,10.1266411,4,145.8580546,1,1,2,2,1,3,5,0.35519,0.366885,0,No
5343,precipitous,2,14.403385,2,10.1266511,10.1266411,4,145.8580546,2,0,2,2,0,2,0,0,0,0,No
5400,potable,2,14.403385,2,10.1266511,10.1266411,4,145.8580546,2,2,4,2,2,4,5,0.325772,0.329566,0,No
5408,postmodern,2,14.403385,2,10.1266511,10.1266411,4,145.8580546,1,2,3,1,2,3,5,0.324931,0.328302,0,No
5417,postdoctoral,2,14.403385,2,10.1266511,10.1266411,4,145.8580546,1,1,2,1,2,3,6,0.286159,0.292535,0,No
5481,pontificate,2,14.403385,2,10.1266511,10.1266411,4,145.8580546,2,2,4,2,2,4,5,0.378809,0.394627,0,No
5482,pontiff,2,14.403385,2,10.1266511,10.1266411,4,145.8580546,1,1,2,2,1,3,5,0.398067,0.415814,0,No
5497,pomelo,2,14.403385,2,10.1266511,10.1266411,4,145.8580546,2,1,3,2,1,3,5,0.330941,0.335429,0,No
5509,polymeric,2,14.403385,2,10.1266511,10.1266411,4,145.8580546,2,1,3,2,1,3,5,0.289231,0.29548,0,No
5522,polyandry,2,14.403385,2,10.1266511,10.1266411,4,145.8580546,1,2,3,1,2,3,4,0.377456,0.393804,0,No
5529,pollutant,2,14.403385,2,10.1266511,10.1266411,4,145.8580546,2,1,3,2,1,3,5,0.398076,0.415824,0,No
5539,politic,2,14.403385,2,10.1266511,10.1266411,4,145.8580546,1,1,2,1,1,2,5,0.311028,0.315638,0,No
5553,polaroid,2,14.403385,2,10.1266511,10.1266411,4,145.8580546,2,2,4,2,2,4,5,0.319326,0.323045,0,No
5603,plowshare,2,14.403385,2,10.1266511,10.1266411,4,145.8580546,1,2,3,1,2,3,5,0.398138,0.415908,0,No
5612,plethora,2,14.403385,2,10.1266511,10.1266411,4,145.8580546,2,1,3,2,2,4,5,0.378607,0.394397,0,No
5615,plenipotentiary,2,14.403385,2,10.1266511,10.1266411,4,145.8580546,2,2,4,2,2,4,5,0.344138,0.352559,0,No
5630,plaything,2,14.403385,2,10.1266511,10.1266411,4,145.8580546,2,2,4,2,2,4,5,0.328887,0.333289,0,No
5654,plastron,2,14.403385,2,10.1266511,10.1266411,4,145.8580546,2,2,4,2,2,4,5,0.328887,0.333256,0,No
5684,placeholder,2,14.403385,2,10.1266511,10.1266411,4,145.8580546,2,1,3,2,1,3,5,0.321588,0.324758,0,No
5701,pitney,2,14.403385,2,10.1266511,10.1266411,4,145.8580546,2,2,4,2,2,4,5,0.32924,0.333215,0,No
5703,pitiful,2,14.403385,2,10.1266511,10.1266411,4,145.8580546,2,1,3,2,2,4,5,0.343985,0.352404,0,No
5726,pion,2,14.403385,2,10.1266511,10.1266411,4,145.8580546,2,2,4,2,2,4,4,0.412325,0.42953,0,No
5735,pinkie,2,14.403385,2,10.1266511,10.1266411,4,145.8580546,2,1,3,2,1,3,5,0.310582,0.315406,0,No
5801,physique,2,14.403385,2,10.1266511,10.1266411,4,145.8580546,1,2,3,1,2,3,5,0.321436,0.324779,0,No
5822,phosphine,2,14.403385,2,10.1266511,10.1266411,4,145.8580546,2,2,4,2,2,4,5,0.347255,0.356458,0,No
5838,philosophic,2,14.403385,2,10.1266511,10.1266411,4,145.8580546,1,0,1,1,0,1,0,0,0,0,No
5842,philistine,2,14.403385,2,10.1266511,10.1266411,4,145.8580546,2,1,3,2,1,3,5,0.398076,0.415824,0,No
5847,philanthropic,2,14.403385,2,10.1266511,10.1266411,4,145.8580546,2,1,3,2,1,3,5,0.325104,0.328358,0,No
5857,phenol,2,14.403385,2,10.1266511,10.1266411,4,145.8580546,2,1,3,2,1,3,5,0.31649,0.320281,0,No
5900,pervert,2,14.403385,2,10.1266511,10.1266411,4,145.8580546,1,1,2,2,1,3,5,0.320705,0.324646,0,No
5902,perverse,2,14.403385,2,10.1266511,10.1266411,4,145.8580546,1,2,3,2,2,4,5,0.321285,0.325224,0,No
5903,pervasive,2,14.403385,2,10.1266511,10.1266411,4,145.8580546,2,1,3,2,1,3,5,0.312512,0.317059,0,No
5908,persuasive,2,14.403385,2,10.1266511,10.1266411,4,145.8580546,2,1,3,2,1,3,5,0.360829,0.373487,0,No
5933,permute,2,14.403385,2,10.1266511,10.1266411,4,145.8580546,2,1,3,2,2,4,5,0.35519,0.366885,0,No
5935,permitting,2,14.403385,2,10.1266511,10.1266411,4,145.8580546,2,1,3,2,1,3,5,0.375317,0.391855,0,No
5964,perfusion,2,14.403385,2,10.1266511,10.1266411,4,145.8580546,1,2,3,1,2,3,5,0.388331,0.404923,0,No
5979,perceptual,2,14.403385,2,10.1266511,10.1266411,4,145.8580546,1,1,2,1,1,2,5,0.320566,0.323664,0,No
5982,perceptible,2,14.403385,2,10.1266511,10.1266411,4,145.8580546,0,2,2,0,2,2,5,0.293126,0.299472,0,No
5983,percentile,2,14.403385,2,10.1266511,10.1266411,4,145.8580546,2,2,4,2,2,4,5,0.360983,0.373803,0,No
6045,pelt,2,14.403385,2,10.1266511,10.1266411,4,145.8580546,2,1,3,2,1,3,5,0.317839,0.321445,0,No
6064,pedigree,2,14.403385,2,10.1266511,10.1266411,4,145.8580546,1,2,3,1,2,3,5,0.388331,0.404923,0,No
6091,peachtree,2,14.403385,2,10.1266511,10.1266411,4,145.8580546,2,2,4,2,2,4,5,0.322095,0.325652,0,No
6117,paulus,2,14.403385,2,10.1266511,10.1266411,4,145.8580546,2,1,3,2,1,3,5,0.281266,0.287617,0,No
6132,patroness,2,14.403385,2,10.1266511,10.1266411,4,145.8580546,2,1,3,2,2,4,5,0.378607,0.394397,0,No
6140,patrilineal,2,14.403385,2,10.1266511,10.1266411,4,145.8580546,1,2,3,1,2,3,5,0.320427,0.323666,0,No
6163,pate,2,14.403385,2,10.1266511,10.1266411,4,145.8580546,0,0,0,0,0,0,0,0,0,0,No
6164,patchy,2,14.403385,2,10.1266511,10.1266411,4,145.8580546,2,1,3,2,1,3,6,0.281748,0.288232,0,No
6174,pastime,2,14.403385,2,10.1266511,10.1266411,4,145.8580546,1,2,3,1,2,3,5,0.36152,0.374332,0,No
6203,participle,2,14.403385,2,10.1266511,10.1266411,4,145.8580546,1,2,3,1,2,3,5,0.378688,0.3945,0,No
6211,parson,2,14.403385,2,10.1266511,10.1266411,4,145.8580546,2,2,4,2,2,4,5,0.37889,0.39473,0,No
6212,parsnip,2,14.403385,2,10.1266511,10.1266411,4,145.8580546,2,2,4,2,2,4,5,0.285887,0.292177,0,No
6245,parasympathetic,2,14.403385,2,10.1266511,10.1266411,4,145.8580546,2,1,3,2,2,4,5,0.303358,0.308801,0,No
6283,paperwork,2,14.403385,2,10.1266511,10.1266411,4,145.8580546,2,2,4,2,2,4,5,0.336544,0.342661,0,No
6287,papaw,2,14.403385,2,10.1266511,10.1266411,4,145.8580546,1,2,3,1,2,3,4,0.40717,0.424802,0,No
6303,panicked,2,14.403385,2,10.1266511,10.1266411,4,145.8580546,2,2,4,2,2,4,5,0.405756,0.42333,0,No
6332,pallet,2,14.403385,2,10.1266511,10.1266411,4,145.8580546,2,1,3,2,1,3,5,0.338011,0.344413,0,No
6346,palazzi,2,14.403385,2,10.1266511,10.1266411,4,145.8580546,1,2,3,1,2,3,5,0.386395,0.403331,0,No
6367,padlock,2,14.403385,2,10.1266511,10.1266411,4,145.8580546,2,2,4,2,2,4,5,0.361241,0.374027,0,No
6379,pacifism,2,14.403385,2,10.1266511,10.1266411,4,145.8580546,2,1,3,2,1,3,5,0.326479,0.32972,0,No
6393,oxidant,2,14.403385,2,10.1266511,10.1266411,4,145.8580546,1,2,3,2,2,4,5,0.360925,0.373668,0,No
6407,ovoviviparous,2,14.403385,2,10.1266511,10.1266411,4,145.8580546,2,1,3,2,1,3,5,0.323551,0.326892,0,No
6420,outrageous,2,14.403385,2,10.1266511,10.1266411,4,145.8580546,1,1,2,1,1,2,6,0.265459,0.270255,0,No
6451,oshkosh,2,14.403385,2,10.1266511,10.1266411,4,145.8580546,2,1,3,2,1,3,5,0.318329,0.322003,0,No
6464,orthogonal,2,14.403385,2,10.1266511,10.1266411,4,145.8580546,2,1,3,2,1,3,5,0.359172,0.371523,0,No
6495,organometallic,2,14.403385,2,10.1266511,10.1266411,4,145.8580546,2,1,3,2,1,3,5,0.32351,0.327546,0,No
6525,opulent,2,14.403385,2,10.1266511,10.1266411,4,145.8580546,2,2,4,2,2,4,5,0.325742,0.329308,0,No
6537,oppress,2,14.403385,2,10.1266511,10.1266411,4,145.8580546,2,2,4,2,2,4,5,0.340762,0.348105,0,No
6567,onslaught,2,14.403385,2,10.1266511,10.1266411,4,145.8580546,0,0,0,0,0,0,0,0,0,0,No
6569,onomatopoeic,2,14.403385,2,10.1266511,10.1266411,4,145.8580546,1,1,2,2,2,4,5,0.323953,0.328002,0,No
6577,oncoming,2,14.403385,2,10.1266511,10.1266411,4,145.8580546,2,1,3,2,1,3,5,0.321932,0.325169,0,No
6585,omnibus,2,14.403385,2,10.1266511,10.1266411,4,145.8580546,2,2,4,2,2,4,5,0.323451,0.326676,0,No
6612,olefin,2,14.403385,2,10.1266511,10.1266411,4,145.8580546,1,1,2,1,1,2,5,0.35519,0.366885,0,No
6614,olduvai,2,14.403385,2,10.1266511,10.1266411,4,145.8580546,2,1,3,2,2,4,5,0.30903,0.313816,0,No
6629,oilseed,2,14.403385,2,10.1266511,10.1266411,4,145.8580546,1,1,2,2,1,3,5,0.314505,0.318534,0,No
6630,oilman,2,14.403385,2,10.1266511,10.1266411,4,145.8580546,1,2,3,1,2,3,5,0.345727,0.354605,0,No
6642,offstage,2,14.403385,2,10.1266511,10.1266411,4,145.8580546,2,2,4,2,2,4,5,0.399977,0.417673,0,No
6659,offal,2,14.403385,2,10.1266511,10.1266411,4,145.8580546,2,1,3,2,1,3,5,0.341779,0.349674,0,No
6675,octet,2,14.403385,2,10.1266511,10.1266411,4,145.8580546,2,1,3,2,1,3,5,0.322189,0.325372,0,No
6678,octant,2,14.403385,2,10.1266511,10.1266411,4,145.8580546,2,0,2,2,0,2,0,0,0,0,No
6682,octahedral,2,14.403385,2,10.1266511,10.1266411,4,145.8580546,1,0,1,1,0,1,0,0,0,0,No
6683,octagonal,2,14.403385,2,10.1266511,10.1266411,4,145.8580546,1,1,2,2,1,3,5,0.320757,0.323925,0,No
6686,ocelot,2,14.403385,2,10.1266511,10.1266411,4,145.8580546,2,1,3,2,1,3,5,0.331138,0.336083,0,No
6861,nordstrom,2,14.403385,2,10.1266511,10.1266411,4,145.8580546,2,2,4,2,2,4,5,0.395557,0.412641,0,No
6865,noose,2,14.403385,2,10.1266511,10.1266411,4,145.8580546,1,1,2,2,1,3,5,0.294481,0.300852,0,No
6882,nodule,2,14.403385,2,10.1266511,10.1266411,4,145.8580546,2,2,4,2,2,4,5,0.313152,0.317602,0,No
6883,nodular,2,14.403385,2,10.1266511,10.1266411,4,145.8580546,2,0,2,2,0,2,0,0,0,0,No
6906,nitride,2,14.403385,2,10.1266511,10.1266411,4,145.8580546,2,1,3,2,1,3,5,0.328625,0.333509,0,No
6938,nightfall,2,14.403385,2,10.1266511,10.1266411,4,145.8580546,2,1,3,2,1,3,5,0.32946,0.333471,0,No
6943,nigh,2,14.403385,2,10.1266511,10.1266411,4,145.8580546,2,1,3,2,1,3,5,0.384237,0.400402,0,No
6960,nicholls,2,14.403385,2,10.1266511,10.1266411,4,145.8580546,2,2,4,2,2,4,5,0.390544,0.407303,0,No
6986,newfound,2,14.403385,2,10.1266511,10.1266411,4,145.8580546,2,1,3,2,1,3,5,0.319458,0.322833,0,No
6991,newbold,2,14.403385,2,10.1266511,10.1266411,4,145.8580546,1,1,2,2,2,4,5,0.311574,0.316207,0,No
7007,neuronal,2,14.403385,2,10.1266511,10.1266411,4,145.8580546,2,2,4,2,2,4,5,0.323628,0.326914,0,No
7034,neonatal,2,14.403385,2,10.1266511,10.1266411,4,145.8580546,1,1,2,1,1,2,5,0.321559,0.324691,0,No
7052,negligent,2,14.403385,2,10.1266511,10.1266411,4,145.8580546,2,2,4,2,2,4,5,0.320438,0.324396,0,No
7054,nefarious,2,14.403385,2,10.1266511,10.1266411,4,145.8580546,2,0,2,2,0,2,0,0,0,0,No
7055,needy,2,14.403385,2,10.1266511,10.1266411,4,145.8580546,2,2,4,2,2,4,5,0.326275,0.330345,0,No
7064,necrosis,2,14.403385,2,10.1266511,10.1266411,4,145.8580546,1,1,2,1,2,3,5,0.384237,0.400402,0,No
7066,necromancer,2,14.403385,2,10.1266511,10.1266411,4,145.8580546,1,2,3,1,2,3,5,0.397479,0.415077,0,No
7078,neater,2,14.403385,2,10.1266511,10.1266411,4,145.8580546,2,2,4,2,2,4,5,0.388331,0.404923,0,No
7079,neat,2,14.403385,2,10.1266511,10.1266411,4,145.8580546,1,0,1,1,0,1,0,0,0,0,No
7096,nazarene,2,14.403385,2,10.1266511,10.1266411,4,145.8580546,2,1,3,2,1,3,5,0.324527,0.32819,0,No
7148,nanette,2,14.403385,2,10.1266511,10.1266411,4,145.8580546,1,1,2,1,1,2,5,0.322681,0.326231,0,No
7166,nabisco,2,14.403385,2,10.1266511,10.1266411,4,145.8580546,1,2,3,1,2,3,5,0.363355,0.37651,0,No
7191,mycobacteria,2,14.403385,2,10.1266511,10.1266411,4,145.8580546,2,1,3,2,1,3,5,0.360829,0.373487,0,No
7203,mutate,2,14.403385,2,10.1266511,10.1266411,4,145.8580546,2,1,3,2,1,3,5,0.360829,0.373487,0,No
7213,musky,2,14.403385,2,10.1266511,10.1266411,4,145.8580546,2,2,4,2,2,4,5,0.318044,0.32163,0,No
7215,muskox,2,14.403385,2,10.1266511,10.1266411,4,145.8580546,0,2,2,0,2,2,5,0.377012,0.393664,0,No
7216,muskmelon,2,14.403385,2,10.1266511,10.1266411,4,145.8580546,2,1,3,2,1,3,5,0.338882,0.345659,0,No
7235,muriel,2,14.403385,2,10.1266511,10.1266411,4,145.8580546,2,1,3,2,1,3,5,0.332161,0.339406,0,No
7246,mundane,2,14.403385,2,10.1266511,10.1266411,4,145.8580546,2,1,3,2,1,3,5,0.290476,0.297051,0,No
7250,mummify,2,14.403385,2,10.1266511,10.1266411,4,145.8580546,1,1,2,1,2,3,5,0.375317,0.391855,0,No
7266,mulch,2,14.403385,2,10.1266511,10.1266411,4,145.8580546,2,1,3,2,1,3,5,0.360829,0.373487,0,No
7271,mugging,2,14.403385,2,10.1266511,10.1266411,4,145.8580546,2,1,3,2,1,3,5,0.310132,0.314814,0,No
7305,mournful,2,14.403385,2,10.1266511,10.1266411,4,145.8580546,1,2,3,1,2,3,5,0.384304,0.400496,0,No
7318,motorcade,2,14.403385,2,10.1266511,10.1266411,4,145.8580546,2,1,3,2,1,3,5,0.32071,0.32465,0,No
7341,mortuary,2,14.403385,2,10.1266511,10.1266411,4,145.8580546,2,2,4,2,2,4,4,0.422422,0.439097,0,No
7350,morsel,2,14.403385,2,10.1266511,10.1266411,4,145.8580546,2,2,4,2,2,4,5,0.323504,0.326798,0,No
7362,moron,2,14.403385,2,10.1266511,10.1266411,4,145.8580546,1,2,3,2,2,4,4,0.402681,0.42031,0,No
7461,moll,2,14.403385,2,10.1266511,10.1266411,4,145.8580546,1,2,3,2,2,4,5,0.360888,0.373581,0,No
7537,misnomer,2,14.403385,2,10.1266511,10.1266411,4,145.8580546,1,2,3,2,2,4,5,0.327921,0.33198,0,No
7560,minsky,2,14.403385,2,10.1266511,10.1266411,4,145.8580546,2,1,3,2,1,3,6,0.243311,0.244833,0,No
7574,minion,2,14.403385,2,10.1266511,10.1266411,4,145.8580546,1,2,3,1,2,3,5,0.338146,0.344572,0,No
7597,mimi,2,14.403385,2,10.1266511,10.1266411,4,145.8580546,1,2,3,1,2,3,5,0.395565,0.41265,0,No
7601,milt,2,14.403385,2,10.1266511,10.1266411,4,145.8580546,1,1,2,1,1,2,6,0.284855,0.291087,0,No
7645,midterm,2,14.403385,2,10.1266511,10.1266411,4,145.8580546,2,1,3,2,1,3,5,0.384237,0.400402,0,No
7667,microbe,2,14.403385,2,10.1266511,10.1266411,4,145.8580546,2,2,4,2,2,4,5,0.366612,0.380518,0,No
7685,mezzanine,2,14.403385,2,10.1266511,10.1266411,4,145.8580546,1,2,3,1,2,3,5,0.338108,0.344553,0,No
7696,methylene,2,14.403385,2,10.1266511,10.1266411,4,145.8580546,2,1,3,2,1,3,5,0.323416,0.326858,0,No
7699,methuen,2,14.403385,2,10.1266511,10.1266411,4,145.8580546,1,2,3,1,2,3,5,0.319286,0.322775,0,No
7716,metalwork,2,14.403385,2,10.1266511,10.1266411,4,145.8580546,2,2,4,2,2,4,5,0.3791,0.395721,0,No
7735,meson,2,14.403385,2,10.1266511,10.1266411,4,145.8580546,2,2,4,2,2,4,4,0.387729,0.40478,0,No
7737,mescaline,2,14.403385,2,10.1266511,10.1266411,4,145.8580546,2,1,3,2,1,3,5,0.345606,0.354483,0,No
7739,mervin,2,14.403385,2,10.1266511,10.1266411,4,145.8580546,0,1,1,0,2,2,5,0.310312,0.315019,0,No
7745,merriam,2,14.403385,2,10.1266511,10.1266411,4,145.8580546,2,1,3,2,1,3,5,0.384237,0.400402,0,No
7767,mercator,2,14.403385,2,10.1266511,10.1266411,4,145.8580546,0,2,2,0,2,2,5,0.309786,0.314676,0,No
7776,menstruate,2,14.403385,2,10.1266511,10.1266411,4,145.8580546,1,2,3,2,2,4,4,0.399698,0.417315,0,No
7790,mend,2,14.403385,2,10.1266511,10.1266411,4,145.8580546,2,1,3,2,1,3,5,0.306999,0.312093,0,No
7836,megalopolis,2,14.403385,2,10.1266511,10.1266411,4,145.8580546,1,2,3,1,2,3,5,0.333408,0.338937,0,No
7839,megabit,2,14.403385,2,10.1266511,10.1266411,4,145.8580546,2,1,3,2,1,3,5,0.345599,0.354479,0,No
7849,mediocre,2,14.403385,2,10.1266511,10.1266411,4,145.8580546,2,1,3,2,1,3,5,0.35519,0.366885,0,No
7853,medic,2,14.403385,2,10.1266511,10.1266411,4,145.8580546,1,1,2,1,1,2,5,0.316423,0.320149,0,No
7876,meadowlark,2,14.403385,2,10.1266511,10.1266411,4,145.8580546,2,2,4,2,2,4,5,0.375404,0.391972,0,No
7893,mckenzie,2,14.403385,2,10.1266511,10.1266411,4,145.8580546,2,1,3,2,1,3,5,0.316186,0.320573,0,No
7896,mckay,2,14.403385,2,10.1266511,10.1266411,4,145.8580546,2,1,3,2,1,3,5,0.384237,0.400402,0,No
7922,mcclellan,2,14.403385,2,10.1266511,10.1266411,4,145.8580546,2,0,2,2,0,2,0,0,0,0,No
7924,mccauley,2,14.403385,2,10.1266511,10.1266411,4,145.8580546,2,1,3,2,1,3,5,0.345606,0.354483,0,No
7925,mccarty,2,14.403385,2,10.1266511,10.1266411,4,145.8580546,0,2,2,0,2,2,5,0.395561,0.412646,0,No
7937,mayoral,2,14.403385,2,10.1266511,10.1266411,4,145.8580546,2,0,2,2,0,2,0,0,0,0,No
7953,maxima,2,14.403385,2,10.1266511,10.1266411,4,145.8580546,2,2,4,2,2,4,5,0.354864,0.365819,0,No
7977,matriarch,2,14.403385,2,10.1266511,10.1266411,4,145.8580546,1,1,2,1,1,2,5,0.345068,0.353675,0,No
7979,matins,2,14.403385,2,10.1266511,10.1266411,4,145.8580546,2,2,4,2,2,4,5,0.347806,0.357164,0,No
7980,matinee,2,14.403385,2,10.1266511,10.1266411,4,145.8580546,1,0,1,1,0,1,0,0,0,0,No
8009,massage,2,14.403385,2,10.1266511,10.1266411,4,145.8580546,2,1,3,2,1,3,5,0.35519,0.366885,0,No
8026,marzipan,2,14.403385,2,10.1266511,10.1266411,4,145.8580546,2,1,3,2,1,3,5,0.384237,0.400402,0,No
8073,marksman,2,14.403385,2,10.1266511,10.1266411,4,145.8580546,2,1,3,2,1,3,5,0.3155,0.319412,0,No
8079,marjoram,2,14.403385,2,10.1266511,10.1266411,4,145.8580546,2,1,3,2,1,3,5,0.328412,0.333573,0,No
8139,manna,2,14.403385,2,10.1266511,10.1266411,4,145.8580546,2,1,3,2,1,3,5,0.384237,0.400402,0,No
8159,mangel,2,14.403385,2,10.1266511,10.1266411,4,145.8580546,1,1,2,1,1,2,5,0.326593,0.330078,0,No
8194,malpractice,2,14.403385,2,10.1266511,10.1266411,4,145.8580546,0,1,1,0,1,1,5,0.384234,0.400398,0,No
8218,malarial,2,14.403385,2,10.1266511,10.1266411,4,145.8580546,1,2,3,2,2,4,5,0.309958,0.314697,0,No
8242,mailbox,2,14.403385,2,10.1266511,10.1266411,4,145.8580546,2,2,4,2,2,4,5,0.378753,0.39457,0,No
8245,maidservant,2,14.403385,2,10.1266511,10.1266411,4,145.8580546,1,2,3,1,2,3,5,0.390879,0.407922,0,No
8248,mahoney,2,14.403385,2,10.1266511,10.1266411,4,145.8580546,2,2,4,2,2,4,5,0.338566,0.345107,0,No
8255,magnuson,2,14.403385,2,10.1266511,10.1266411,4,145.8580546,2,1,3,2,2,4,5,0.324753,0.328036,0,No
8282,mafioso,2,14.403385,2,10.1266511,10.1266411,4,145.8580546,2,2,4,2,2,4,5,0.327896,0.332093,0,No
8306,macromolecule,2,14.403385,2,10.1266511,10.1266411,4,145.8580546,2,2,4,2,2,4,5,0.352994,0.363655,0,No
8313,mackerel,2,14.403385,2,10.1266511,10.1266411,4,145.8580546,1,1,2,1,1,2,5,0.305152,0.310447,0,No
8317,macho,2,14.403385,2,10.1266511,10.1266411,4,145.8580546,1,2,3,1,2,3,5,0.32585,0.329389,0,No
8330,macaw,2,14.403385,2,10.1266511,10.1266411,4,145.8580546,1,0,1,1,0,1,0,0,0,0,No
8378,lurch,2,14.403385,2,10.1266511,10.1266411,4,145.8580546,2,2,4,2,2,4,5,0.384262,0.400444,0,No
8395,lumen,2,14.403385,2,10.1266511,10.1266411,4,145.8580546,1,2,3,1,2,3,5,0.317538,0.321185,0,No
8407,luge,2,14.403385,2,10.1266511,10.1266411,4,145.8580546,1,1,2,1,1,2,5,0.314094,0.318224,0,No
8422,lucian,2,14.403385,2,10.1266511,10.1266411,4,145.8580546,2,1,3,2,1,3,5,0.306554,0.311665,0,No
8440,lovelace,2,14.403385,2,10.1266511,10.1266411,4,145.8580546,2,1,3,2,1,3,5,0.340155,0.347429,0,No
8491,longhand,2,14.403385,2,10.1266511,10.1266411,4,145.8580546,2,1,3,2,1,3,5,0.375317,0.391855,0,No
8532,lockhart,2,14.403385,2,10.1266511,10.1266411,4,145.8580546,1,2,3,1,2,3,5,0.347262,0.356463,0,No
8535,loci,2,14.403385,2,10.1266511,10.1266411,4,145.8580546,2,2,4,2,2,4,5,0.339031,0.345875,0,No
8545,loathe,2,14.403385,2,10.1266511,10.1266411,4,145.8580546,1,2,3,2,2,4,4,0.399869,0.41746,0,No
8547,loanword,2,14.403385,2,10.1266511,10.1266411,4,145.8580546,2,2,4,2,2,4,5,0.34853,0.358051,0,No
8570,litton,2,14.403385,2,10.1266511,10.1266411,4,145.8580546,1,1,2,1,2,3,5,0.307899,0.31291,0,No
8580,lithic,2,14.403385,2,10.1266511,10.1266411,4,145.8580546,2,1,3,2,1,3,5,0.323251,0.326383,0,No
8603,lippincott,2,14.403385,2,10.1266511,10.1266411,4,145.8580546,2,1,3,2,1,3,5,0.320931,0.324628,0,No
8631,lindstrom,2,14.403385,2,10.1266511,10.1266411,4,145.8580546,2,2,4,2,2,4,5,0.326804,0.330901,0,No
8655,lim,2,14.403385,2,10.1266511,10.1266411,4,145.8580546,1,1,2,1,1,2,5,0.336021,0.342018,0,No
8661,lila,2,14.403385,2,10.1266511,10.1266411,4,145.8580546,1,2,3,1,2,3,5,0.384329,0.400524,0,No
8663,likeable,2,14.403385,2,10.1266511,10.1266411,4,145.8580546,2,1,3,2,1,3,5,0.298828,0.304661,0,No
8673,ligand,2,14.403385,2,10.1266511,10.1266411,4,145.8580546,2,2,4,2,2,4,4,0.402672,0.420267,0,No
8681,lifeguard,2,14.403385,2,10.1266511,10.1266411,4,145.8580546,2,1,3,2,1,3,5,0.345599,0.354479,0,No
8687,lieberman,2,14.403385,2,10.1266511,10.1266411,4,145.8580546,1,2,3,1,2,3,5,0.350153,0.359943,0,No
8705,libertine,2,14.403385,2,10.1266511,10.1266411,4,145.8580546,2,2,4,2,2,4,5,0.384362,0.400557,0,No
8712,liaison,2,14.403385,2,10.1266511,10.1266411,4,145.8580546,2,1,3,2,1,3,5,0.32728,0.331671,0,No
8713,liable,2,14.403385,2,10.1266511,10.1266411,4,145.8580546,2,2,4,2,2,4,5,0.367386,0.381436,0,No
8718,lexicographer,2,14.403385,2,10.1266511,10.1266411,4,145.8580546,2,1,3,2,1,3,5,0.322505,0.325937,0,No
8744,lessor,2,14.403385,2,10.1266511,10.1266411,4,145.8580546,1,2,3,2,2,4,4,0.417789,0.434971,0,No
8746,lessen,2,14.403385,2,10.1266511,10.1266411,4,145.8580546,2,1,3,2,2,4,5,0.398076,0.415824,0,No
8755,lepidopterist,2,14.403385,2,10.1266511,10.1266411,4,145.8580546,2,2,4,2,2,4,5,0.398129,0.415894,0,No
8756,leper,2,14.403385,2,10.1266511,10.1266411,4,145.8580546,1,2,3,2,2,4,5,0.350637,0.360521,0,No
8770,lenore,2,14.403385,2,10.1266511,10.1266411,4,145.8580546,1,1,2,1,1,2,5,0.347133,0.356191,0,No
8798,leguminous,2,14.403385,2,10.1266511,10.1266411,4,145.8580546,1,2,3,1,2,3,5,0.32311,0.326662,0,No
8807,legato,2,14.403385,2,10.1266511,10.1266411,4,145.8580546,2,2,4,2,2,4,5,0.376735,0.393177,0,No
8812,lefty,2,14.403385,2,10.1266511,10.1266411,4,145.8580546,1,1,2,1,1,2,5,0.340162,0.347434,0,No
8818,leer,2,14.403385,2,10.1266511,10.1266411,4,145.8580546,2,1,3,2,1,3,5,0.324622,0.328324,0,No
8819,leek,2,14.403385,2,10.1266511,10.1266411,4,145.8580546,1,2,3,1,2,3,4,0.389755,0.406475,0,No
8835,leash,2,14.403385,2,10.1266511,10.1266411,4,145.8580546,1,1,2,1,1,2,5,0.347133,0.356191,0,No
8843,leakage,2,14.403385,2,10.1266511,10.1266411,4,145.8580546,1,1,2,1,2,3,5,0.378607,0.394397,0,No
8849,leaden,2,14.403385,2,10.1266511,10.1266411,4,145.8580546,2,1,3,2,1,3,5,0.307467,0.31255,0,No
8851,leach,2,14.403385,2,10.1266511,10.1266411,4,145.8580546,1,2,3,1,2,3,5,0.365345,0.378812,0,No
8858,layman,2,14.403385,2,10.1266511,10.1266411,4,145.8580546,1,2,3,2,2,4,5,0.336346,0.34261,0,No
8868,lawgiver,2,14.403385,2,10.1266511,10.1266411,4,145.8580546,1,2,3,1,2,3,5,0.395565,0.41265,0,No
8871,lavoisier,2,14.403385,2,10.1266511,10.1266411,4,145.8580546,1,2,3,2,2,4,5,0.352573,0.36327,0,No
8899,latinate,2,14.403385,2,10.1266511,10.1266411,4,145.8580546,1,0,1,1,0,1,0,0,0,0,No
8910,laszlo,2,14.403385,2,10.1266511,10.1266411,4,145.8580546,1,0,1,1,0,1,0,0,0,0,No
8914,lash,2,14.403385,2,10.1266511,10.1266411,4,145.8580546,1,1,2,2,2,4,5,0.384237,0.400402,0,No
8917,laryngeal,2,14.403385,2,10.1266511,10.1266411,4,145.8580546,1,0,1,2,0,2,0,0,0,0,No
8932,lard,2,14.403385,2,10.1266511,10.1266411,4,145.8580546,1,2,3,1,2,3,5,0.34024,0.347561,0,No
8983,lamarck,2,14.403385,2,10.1266511,10.1266411,4,145.8580546,2,2,4,2,2,4,5,0.384412,0.400613,0,No
9015,lackey,2,14.403385,2,10.1266511,10.1266411,4,145.8580546,2,1,3,2,2,4,5,0.384237,0.400402,0,No
9036,kwashiorkor,2,14.403385,2,10.1266511,10.1266411,4,145.8580546,1,2,3,1,2,3,5,0.345633,0.35454,0,No
9039,kurd,2,14.403385,2,10.1266511,10.1266411,4,145.8580546,1,2,3,1,2,3,5,0.382953,0.399188,0,No
9055,kresge,2,14.403385,2,10.1266511,10.1266411,4,145.8580546,1,1,2,1,1,2,5,0.321128,0.32449,0,No
9066,kovacs,2,14.403385,2,10.1266511,10.1266411,4,145.8580546,1,1,2,2,1,3,5,0.384237,0.400402,0,No
9082,knuckle,2,14.403385,2,10.1266511,10.1266411,4,145.8580546,2,1,3,2,1,3,5,0.360829,0.373487,0,No
9088,knowledgeable,2,14.403385,2,10.1266511,10.1266411,4,145.8580546,2,2,4,2,2,4,5,0.325796,0.32938,0,No
9094,knoll,2,14.403385,2,10.1266511,10.1266411,4,145.8580546,2,1,3,2,1,3,5,0.321938,0.325417,0,No
9108,knack,2,14.403385,2,10.1266511,10.1266411,4,145.8580546,2,2,4,2,2,4,5,0.384279,0.400468,0,No
9113,klaxon,2,14.403385,2,10.1266511,10.1266411,4,145.8580546,2,2,4,2,2,4,5,0.33062,0.33513,0,No
9131,kirchoff,2,14.403385,2,10.1266511,10.1266411,4,145.8580546,1,2,3,2,2,4,5,0.395565,0.41265,0,No
9148,kinematic,2,14.403385,2,10.1266511,10.1266411,4,145.8580546,2,1,3,2,1,3,5,0.296874,0.30288,0,No
9149,kindred,2,14.403385,2,10.1266511,10.1266411,4,145.8580546,1,1,2,2,2,4,5,0.306983,0.312161,0,No
9193,kestrel,2,14.403385,2,10.1266511,10.1266411,4,145.8580546,1,1,2,1,1,2,5,0.336021,0.342018,0,No
9211,kenney,2,14.403385,2,10.1266511,10.1266411,4,145.8580546,1,1,2,1,1,2,5,0.318644,0.322412,0,No
9233,kazoo,2,14.403385,2,10.1266511,10.1266411,4,145.8580546,1,2,3,1,2,3,5,0.377705,0.394214,0,No
9237,kauffman,2,14.403385,2,10.1266511,10.1266411,4,145.8580546,2,2,4,2,2,4,5,0.384337,0.400529,0,No
9310,juncture,2,14.403385,2,10.1266511,10.1266411,4,145.8580546,1,1,2,2,2,4,5,0.378607,0.394397,0,No
9323,jukebox,2,14.403385,2,10.1266511,10.1266411,4,145.8580546,1,1,2,2,1,3,5,0.319475,0.322924,0,No
9324,juke,2,14.403385,2,10.1266511,10.1266411,4,145.8580546,1,1,2,1,1,2,5,0.317073,0.320833,0,No
9328,juggle,2,14.403385,2,10.1266511,10.1266411,4,145.8580546,2,1,3,2,1,3,5,0.323045,0.326414,0,No
9354,jove,2,14.403385,2,10.1266511,10.1266411,4,145.8580546,2,2,4,2,2,4,5,0.384437,0.400641,0,No
9377,jolt,2,14.403385,2,10.1266511,10.1266411,4,145.8580546,1,2,3,1,2,3,5,0.366923,0.380689,0,No
9387,johnsen,2,14.403385,2,10.1266511,10.1266411,4,145.8580546,1,1,2,1,1,2,5,0.326702,0.330524,0,No
9403,jock,2,14.403385,2,10.1266511,10.1266411,4,145.8580546,2,1,3,2,1,3,5,0.32582,0.329549,0,No
9411,jitter,2,14.403385,2,10.1266511,10.1266411,4,145.8580546,1,2,3,1,2,3,5,0.323723,0.327734,0,No
9416,jimenez,2,14.403385,2,10.1266511,10.1266411,4,145.8580546,1,2,3,1,2,3,5,0.36141,0.374238,0,No
9419,jigsaw,2,14.403385,2,10.1266511,10.1266411,4,145.8580546,1,0,1,1,0,1,0,0,0,0,No
9421,jiffy,2,14.403385,2,10.1266511,10.1266411,4,145.8580546,2,1,3,2,1,3,5,0.316445,0.320462,0,No
9500,jacobson,2,14.403385,2,10.1266511,10.1266411,4,145.8580546,2,2,4,2,2,4,5,0.384312,0.400505,0,No
9517,jab,2,14.403385,2,10.1266511,10.1266411,4,145.8580546,1,0,1,1,0,1,0,0,0,0,No
9540,israelite,2,14.403385,2,10.1266511,10.1266411,4,145.8580546,0,1,1,0,1,1,5,0.269935,0.275407,0,No
9567,irs,2,14.403385,2,10.1266511,10.1266411,4,145.8580546,2,2,4,2,2,4,5,0.327328,0.331334,0,No
9569,irritate,2,14.403385,2,10.1266511,10.1266411,4,145.8580546,2,1,3,2,1,3,5,0.398076,0.415824,0,No
9572,irrigate,2,14.403385,2,10.1266511,10.1266411,4,145.8580546,1,2,3,2,2,4,5,0.377745,0.394474,0,No
9575,irrespective,2,14.403385,2,10.1266511,10.1266411,4,145.8580546,0,1,1,0,2,2,5,0.378604,0.394393,0,No
9592,irma,2,14.403385,2,10.1266511,10.1266411,4,145.8580546,1,1,2,1,1,2,5,0.326816,0.331594,0,No
9625,invoice,2,14.403385,2,10.1266511,10.1266411,4,145.8580546,1,1,2,1,1,2,5,0.332154,0.339397,0,No
9630,invincible,2,14.403385,2,10.1266511,10.1266411,4,145.8580546,2,1,3,2,1,3,5,0.332391,0.337648,0,No
9642,inventive,2,14.403385,2,10.1266511,10.1266411,4,145.8580546,2,1,3,2,1,3,6,0.281753,0.288236,0,No
9652,intuition,2,14.403385,2,10.1266511,10.1266411,4,145.8580546,1,1,2,1,1,2,5,0.378607,0.394397,0,No
9691,intermediary,2,14.403385,2,10.1266511,10.1266411,4,145.8580546,1,1,2,2,1,3,5,0.321728,0.325636,0,No
9700,interdict,2,14.403385,2,10.1266511,10.1266411,4,145.8580546,2,1,3,2,1,3,5,0.384237,0.400402,0,No
9725,insure,2,14.403385,2,10.1266511,10.1266411,4,145.8580546,1,2,3,2,2,4,5,0.341267,0.348983,0,No
9731,insufficient,2,14.403385,2,10.1266511,10.1266411,4,145.8580546,2,2,4,2,2,4,5,0.345149,0.353803,0,No
9736,instruct,2,14.403385,2,10.1266511,10.1266411,4,145.8580546,2,1,3,2,2,4,5,0.398076,0.415824,0,No
9755,insolvent,2,14.403385,2,10.1266511,10.1266411,4,145.8580546,2,2,4,2,2,4,5,0.377167,0.393644,0,No
9758,insofar,2,14.403385,2,10.1266511,10.1266411,4,145.8580546,1,1,2,1,2,3,5,0.349987,0.359713,0,No
9759,insignificant,2,14.403385,2,10.1266511,10.1266411,4,145.8580546,2,2,4,2,2,4,5,0.325092,0.328409,0,No
9791,inmate,2,14.403385,2,10.1266511,10.1266411,4,145.8580546,2,1,3,2,1,3,5,0.360829,0.373487,0,No
9803,iniquity,2,14.403385,2,10.1266511,10.1266411,4,145.8580546,1,2,3,1,2,3,5,0.378785,0.394608,0,No
9804,inhumane,2,14.403385,2,10.1266511,10.1266411,4,145.8580546,2,1,3,2,1,3,5,0.347133,0.356191,0,No
9806,inhospitable,2,14.403385,2,10.1266511,10.1266411,4,145.8580546,2,2,4,2,2,4,5,0.359332,0.37172,0,No
9814,inherent,2,14.403385,2,10.1266511,10.1266411,4,145.8580546,2,2,4,2,2,4,5,0.384454,0.40066,0,No
9822,ingest,2,14.403385,2,10.1266511,10.1266411,4,145.8580546,1,2,3,1,2,3,5,0.398085,0.415852,0,No
9825,ingenious,2,14.403385,2,10.1266511,10.1266411,4,145.8580546,2,2,4,2,2,4,5,0.333214,0.338678,0,No
9829,infrequent,2,14.403385,2,10.1266511,10.1266411,4,145.8580546,2,2,4,2,2,4,5,0.41003,0.427626,0,No
9849,infirmary,2,14.403385,2,10.1266511,10.1266411,4,145.8580546,1,2,3,2,2,4,4,0.422432,0.439107,0,No
9853,infinitesimal,2,14.403385,2,10.1266511,10.1266411,4,145.8580546,1,2,3,1,2,3,5,0.32213,0.325367,0,No
9855,infiltrate,2,14.403385,2,10.1266511,10.1266411,4,145.8580546,1,2,3,2,2,4,5,0.318724,0.323329,0,No
9856,infield,2,14.403385,2,10.1266511,10.1266411,4,145.8580546,2,1,3,2,1,3,5,0.319895,0.323202,0,No
9873,infantile,2,14.403385,2,10.1266511,10.1266411,4,145.8580546,1,1,2,1,1,2,5,0.29132,0.297565,0,No
9936,indecisive,2,14.403385,2,10.1266511,10.1266411,4,145.8580546,1,1,2,1,1,2,5,0.321938,0.325173,0,No
9954,incompetent,2,14.403385,2,10.1266511,10.1266411,4,145.8580546,1,2,3,1,2,3,5,0.328722,0.33365,0,No
9963,incline,2,14.403385,2,10.1266511,10.1266411,4,145.8580546,2,1,3,2,1,3,5,0.378607,0.394397,0,No
9974,incentive,2,14.403385,2,10.1266511,10.1266411,4,145.8580546,2,1,3,2,1,3,5,0.320201,0.323386,0,No
9980,incapable,2,14.403385,2,10.1266511,10.1266411,4,145.8580546,2,1,3,2,2,4,5,0.378607,0.394397,0,No
9989,inappropriate,2,14.403385,2,10.1266511,10.1266411,4,145.8580546,2,2,4,2,2,4,5,0.357746,0.369935,0,No
9997,inaccuracy,2,14.403385,2,10.1266511,10.1266411,4,145.8580546,1,1,2,1,1,2,5,0.378607,0.394397,0,No
9998,inaccessible,2,14.403385,2,10.1266511,10.1266411,4,145.8580546,2,1,3,2,1,3,5,0.325958,0.329379,0,No
10002,impunity,2,14.403385,2,10.1266511,10.1266411,4,145.8580546,1,2,3,1,2,3,5,0.399024,0.416795,0,No
10003,impulsive,2,14.403385,2,10.1266511,10.1266411,4,145.8580546,2,0,2,2,0,2,0,0,0,0,No
10010,impromptu,2,14.403385,2,10.1266511,10.1266411,4,145.8580546,2,1,3,2,1,3,5,0.320577,0.323851,0,No
10039,impede,2,14.403385,2,10.1266511,10.1266411,4,145.8580546,2,2,4,2,2,4,5,0.320757,0.324243,0,No
10050,immovable,2,14.403385,2,10.1266511,10.1266411,4,145.8580546,1,1,2,1,2,3,5,0.320995,0.32409,0,No
10060,immemorial,2,14.403385,2,10.1266511,10.1266411,4,145.8580546,1,1,2,2,1,3,5,0.360829,0.373487,0,No
10074,illustrious,2,14.403385,2,10.1266511,10.1266411,4,145.8580546,1,1,2,2,1,3,6,0.282466,0.288897,0,No
10084,illegitimacy,2,14.403385,2,10.1266511,10.1266411,4,145.8580546,1,2,3,1,2,3,5,0.360932,0.373628,0,No
10099,igloo,2,14.403385,2,10.1266511,10.1266411,4,145.8580546,1,2,3,1,2,3,5,0.394633,0.411702,0,No
10102,idyllic,2,14.403385,2,10.1266511,10.1266411,4,145.8580546,2,2,4,2,2,4,5,0.32448,0.327662,0,No
10109,idiosyncratic,2,14.403385,2,10.1266511,10.1266411,4,145.8580546,2,2,4,2,2,4,5,0.32696,0.330602,0,No
10140,ibis,2,14.403385,2,10.1266511,10.1266411,4,145.8580546,1,2,3,1,2,3,5,0.324385,0.327728,0,No
10145,ia,2,14.403385,2,10.1266511,10.1266411,4,145.8580546,2,2,4,2,2,4,5,0.350409,0.360486,0,No
10157,hypocrisy,2,14.403385,2,10.1266511,10.1266411,4,145.8580546,1,2,3,1,2,3,5,0.320948,0.324369,0,No
10179,hydrophobic,2,14.403385,2,10.1266511,10.1266411,4,145.8580546,1,1,2,2,1,3,5,0.338882,0.345659,0,No
10200,huxtable,2,14.403385,2,10.1266511,10.1266411,4,145.8580546,0,2,2,0,2,2,5,0.386585,0.403022,0,No
10248,humane,2,14.403385,2,10.1266511,10.1266411,4,145.8580546,2,2,4,2,2,4,5,0.331887,0.336464,0,No
10275,hoyt,2,14.403385,2,10.1266511,10.1266411,4,145.8580546,2,1,3,2,1,3,6,0.29122,0.29746,0,No
10281,howdy,2,14.403385,2,10.1266511,10.1266411,4,145.8580546,1,2,3,1,2,3,5,0.332422,0.339695,0,No
10309,hospitable,2,14.403385,2,10.1266511,10.1266411,4,145.8580546,2,2,4,2,2,4,5,0.328692,0.332889,0,No
10315,horsewoman,2,14.403385,2,10.1266511,10.1266411,4,145.8580546,2,2,4,2,2,4,5,0.335723,0.34281,0,No
10320,horseman,2,14.403385,2,10.1266511,10.1266411,4,145.8580546,2,1,3,2,1,3,5,0.384237,0.400402,0,No
10321,horsehair,2,14.403385,2,10.1266511,10.1266411,4,145.8580546,2,2,4,2,2,4,5,0.36662,0.380527,0,No
10329,hornet,2,14.403385,2,10.1266511,10.1266411,4,145.8580546,1,2,3,1,2,3,5,0.331615,0.336152,0,No
10330,hornblende,2,14.403385,2,10.1266511,10.1266411,4,145.8580546,2,2,4,2,2,4,4,0.412325,0.42953,0,No
10347,hooligan,2,14.403385,2,10.1266511,10.1266411,4,145.8580546,2,1,3,2,1,3,5,0.319222,0.322923,0,No
10368,hone,2,14.403385,2,10.1266511,10.1266411,4,145.8580546,1,1,2,1,1,2,5,0.319062,0.322956,0,No
10377,homologue,2,14.403385,2,10.1266511,10.1266411,4,145.8580546,1,1,2,1,1,2,5,0.345599,0.354479,0,No
10403,holocene,2,14.403385,2,10.1266511,10.1266411,4,145.8580546,1,1,2,1,1,2,5,0.398067,0.415814,0,No
10422,holbrook,2,14.403385,2,10.1266511,10.1266411,4,145.8580546,2,1,3,2,1,3,5,0.31313,0.317667,0,No
10427,hoff,2,14.403385,2,10.1266511,10.1266411,4,145.8580546,1,2,3,2,2,4,5,0.345471,0.354164,0,No
10433,hoc,2,14.403385,2,10.1266511,10.1266411,4,145.8580546,2,0,2,2,0,2,0,0,0,0,No
10437,hobbs,2,14.403385,2,10.1266511,10.1266411,4,145.8580546,1,1,2,1,1,2,5,0.384237,0.400402,0,No
10449,hitachi,2,14.403385,2,10.1266511,10.1266411,4,145.8580546,1,1,2,1,1,2,5,0.384237,0.400402,0,No
10467,hippy,2,14.403385,2,10.1266511,10.1266411,4,145.8580546,1,2,3,1,2,3,5,0.34572,0.354648,0,No
10482,hindquarters,2,14.403385,2,10.1266511,10.1266411,4,145.8580546,1,2,3,1,2,3,4,0.422432,0.439107,0,No
10501,hilarious,2,14.403385,2,10.1266511,10.1266411,4,145.8580546,2,1,3,2,1,3,5,0.309985,0.314784,0,No
10503,highwayman,2,14.403385,2,10.1266511,10.1266411,4,145.8580546,2,1,3,2,1,3,5,0.32254,0.32815,0,No
10528,heyday,2,14.403385,2,10.1266511,10.1266411,4,145.8580546,1,2,3,1,2,3,5,0.395565,0.41265,0,No
10541,hetman,2,14.403385,2,10.1266511,10.1266411,4,145.8580546,1,1,2,1,1,2,5,0.297466,0.303372,0,No
10551,hesitate,2,14.403385,2,10.1266511,10.1266411,4,145.8580546,1,1,2,2,2,4,5,0.359172,0.371523,0,No
10569,hernia,2,14.403385,2,10.1266511,10.1266411,4,145.8580546,1,0,1,1,0,1,0,0,0,0,No
10571,hermosa,2,14.403385,2,10.1266511,10.1266411,4,145.8580546,2,1,3,2,2,4,5,0.360829,0.373487,0,No
10588,hereafter,2,14.403385,2,10.1266511,10.1266411,4,145.8580546,2,2,4,2,2,4,5,0.380866,0.396941,0,No
10613,henchmen,2,14.403385,2,10.1266511,10.1266411,4,145.8580546,1,1,2,1,1,2,5,0.319079,0.323889,0,No
10615,henceforth,2,14.403385,2,10.1266511,10.1266411,4,145.8580546,2,2,4,2,2,4,5,0.333822,0.339511,0,No
10621,hemlock,2,14.403385,2,10.1266511,10.1266411,4,145.8580546,1,2,3,1,2,3,4,0.412334,0.429539,0,No
10631,helmholtz,2,14.403385,2,10.1266511,10.1266411,4,145.8580546,2,2,4,2,2,4,5,0.323551,0.326937,0,No
10647,helga,2,14.403385,2,10.1266511,10.1266411,4,145.8580546,1,1,2,1,1,2,5,0.309105,0.313909,0,No
10675,hecate,2,14.403385,2,10.1266511,10.1266411,4,145.8580546,1,2,3,2,2,4,5,0.398094,0.415861,0,No
10689,heartfelt,2,14.403385,2,10.1266511,10.1266411,4,145.8580546,1,1,2,1,1,2,5,0.384237,0.400402,0,No
10695,hearsay,2,14.403385,2,10.1266511,10.1266411,4,145.8580546,2,1,3,2,1,3,5,0.359172,0.371523,0,No
10703,healey,2,14.403385,2,10.1266511,10.1266411,4,145.8580546,0,2,2,0,2,2,5,0.318502,0.322088,0,No
10705,headwater,2,14.403385,2,10.1266511,10.1266411,4,145.8580546,2,2,4,2,2,4,5,0.34267,0.350567,0,No
10746,hausa,2,14.403385,2,10.1266511,10.1266411,4,145.8580546,2,1,3,2,1,3,5,0.329381,0.333472,0,No
10750,haughty,2,14.403385,2,10.1266511,10.1266411,4,145.8580546,1,2,3,1,2,3,5,0.384321,0.400515,0,No
10752,hattie,2,14.403385,2,10.1266511,10.1266411,4,145.8580546,1,2,3,1,2,3,5,0.316175,0.320106,0,No
10756,hath,2,14.403385,2,10.1266511,10.1266411,4,145.8580546,2,2,4,2,2,4,5,0.327896,0.332557,0,No
10759,hateful,2,14.403385,2,10.1266511,10.1266411,4,145.8580546,2,2,4,2,2,4,5,0.323092,0.326353,0,No
10765,hasty,2,14.403385,2,10.1266511,10.1266411,4,145.8580546,2,1,3,2,1,3,5,0.311372,0.315978,0,No
10793,harmonious,2,14.403385,2,10.1266511,10.1266411,4,145.8580546,1,2,3,1,2,3,5,0.345444,0.354079,0,No
10837,hanley,2,14.403385,2,10.1266511,10.1266411,4,145.8580546,2,1,3,2,1,3,5,0.384237,0.400402,0,No
10839,hangover,2,14.403385,2,10.1266511,10.1266411,4,145.8580546,1,2,3,2,2,4,5,0.344279,0.352628,0,No
10842,hangman,2,14.403385,2,10.1266511,10.1266411,4,145.8580546,1,1,2,1,1,2,5,0.345068,0.353675,0,No
10845,hanford,2,14.403385,2,10.1266511,10.1266411,4,145.8580546,2,2,4,2,2,4,5,0.326365,0.329908,0,No
10847,handyman,2,14.403385,2,10.1266511,10.1266411,4,145.8580546,2,2,4,2,2,4,5,0.345357,0.354096,0,No
10854,handmade,2,14.403385,2,10.1266511,10.1266411,4,145.8580546,2,1,3,2,1,3,5,0.285795,0.292138,0,No
10861,handgun,2,14.403385,2,10.1266511,10.1266411,4,145.8580546,1,1,2,2,1,3,5,0.32946,0.333471,0,No
10884,halstead,2,14.403385,2,10.1266511,10.1266411,4,145.8580546,2,2,4,2,2,4,5,0.322957,0.326267,0,No
10886,halogen,2,14.403385,2,10.1266511,10.1266411,4,145.8580546,1,1,2,1,1,2,5,0.331268,0.335748,0,No
10890,hallucinogen,2,14.403385,2,10.1266511,10.1266411,4,145.8580546,2,2,4,2,2,4,5,0.329448,0.333882,0,No
10897,halite,2,14.403385,2,10.1266511,10.1266411,4,145.8580546,1,1,2,1,1,2,5,0.328625,0.333509,0,No
10936,habitual,2,14.403385,2,10.1266511,10.1266411,4,145.8580546,1,1,2,1,1,2,6,0.276909,0.28287,0,No
10941,habeas,2,14.403385,2,10.1266511,10.1266411,4,145.8580546,2,1,3,2,2,4,5,0.309807,0.314487,0,No
10947,gyro,2,14.403385,2,10.1266511,10.1266411,4,145.8580546,1,1,2,1,1,2,5,0.311099,0.31563,0,No
10967,gustafson,2,14.403385,2,10.1266511,10.1266411,4,145.8580546,1,2,3,1,2,3,5,0.363363,0.376515,0,No
10969,gush,2,14.403385,2,10.1266511,10.1266411,4,145.8580546,1,1,2,1,1,2,5,0.29166,0.297952,0,No
10982,gunfight,2,14.403385,2,10.1266511,10.1266411,4,145.8580546,1,2,3,2,2,4,5,0.366923,0.380689,0,No
10985,gumshoe,2,14.403385,2,10.1266511,10.1266411,4,145.8580546,1,2,3,1,2,3,5,0.384979,0.401237,0,No
10992,gullah,2,14.403385,2,10.1266511,10.1266411,4,145.8580546,0,1,1,0,2,2,5,0.345598,0.354477,0,No
10993,gull,2,14.403385,2,10.1266511,10.1266411,4,145.8580546,2,2,4,2,2,4,5,0.331077,0.335283,0,No
10996,gulch,2,14.403385,2,10.1266511,10.1266411,4,145.8580546,2,2,4,2,2,4,5,0.340606,0.347763,0,No
11010,guideline,2,14.403385,2,10.1266511,10.1266411,4,145.8580546,2,1,3,2,1,3,5,0.359172,0.371523,0,No
11024,guardia,2,14.403385,2,10.1266511,10.1266411,4,145.8580546,2,1,3,2,2,4,5,0.360829,0.373487,0,No
11031,gu,2,14.403385,2,10.1266511,10.1266411,4,145.8580546,1,1,2,1,1,2,5,0.306173,0.31137,0,No
11032,gryphon,2,14.403385,2,10.1266511,10.1266411,4,145.8580546,2,2,4,2,2,4,5,0.38452,0.400735,0,No
11046,grout,2,14.403385,2,10.1266511,10.1266411,4,145.8580546,1,2,3,1,2,3,5,0.308182,0.313345,0,No
11070,gristmill,2,14.403385,2,10.1266511,10.1266411,4,145.8580546,2,1,3,2,1,3,6,0.265122,0.269761,0,No
11073,grippe,2,14.403385,2,10.1266511,10.1266411,4,145.8580546,2,2,4,2,2,4,5,0.385038,0.401526,0,No
11081,grimace,2,14.403385,2,10.1266511,10.1266411,4,145.8580546,0,1,1,0,1,1,5,0.398072,0.415819,0,No
11082,grim,2,14.403385,2,10.1266511,10.1266411,4,145.8580546,1,1,2,1,2,3,5,0.384237,0.400402,0,No
11086,grievous,2,14.403385,2,10.1266511,10.1266411,4,145.8580546,1,2,3,2,2,4,5,0.384279,0.400468,0,No
11087,grieve,2,14.403385,2,10.1266511,10.1266411,4,145.8580546,1,2,3,1,2,3,5,0.378212,0.394554,0,No
11103,gremlin,2,14.403385,2,10.1266511,10.1266411,4,145.8580546,0,1,1,0,1,1,5,0.336021,0.342018,0,No
11116,greengrocer,2,14.403385,2,10.1266511,10.1266411,4,145.8580546,2,2,4,2,2,4,5,0.375746,0.392287,0,No
11118,greenery,2,14.403385,2,10.1266511,10.1266411,4,145.8580546,2,1,3,2,1,3,5,0.360829,0.373487,0,No
11138,graven,2,14.403385,2,10.1266511,10.1266411,4,145.8580546,2,1,3,2,1,3,5,0.320908,0.324071,0,No
11141,gratitude,2,14.403385,2,10.1266511,10.1266411,4,145.8580546,2,2,4,2,2,4,4,0.384529,0.401395,0,No
11162,granitic,2,14.403385,2,10.1266511,10.1266411,4,145.8580546,2,1,3,2,1,3,5,0.299757,0.305484,0,No
11164,grandstand,2,14.403385,2,10.1266511,10.1266411,4,145.8580546,1,1,2,1,1,2,5,0.360829,0.373487,0,No
11169,grandma,2,14.403385,2,10.1266511,10.1266411,4,145.8580546,2,2,4,2,2,4,5,0.326828,0.330255,0,No
11179,grammarian,2,14.403385,2,10.1266511,10.1266411,4,145.8580546,2,0,2,2,0,2,0,0,0,0,No
11206,gouge,2,14.403385,2,10.1266511,10.1266411,4,145.8580546,2,1,3,2,1,3,5,0.375317,0.391855,0,No
11224,goren,2,14.403385,2,10.1266511,10.1266411,4,145.8580546,2,1,3,2,1,3,5,0.360829,0.373487,0,No
11234,goodyear,2,14.403385,2,10.1266511,10.1266411,4,145.8580546,1,1,2,1,1,2,5,0.323298,0.326765,0,No
11292,gnaw,2,14.403385,2,10.1266511,10.1266411,4,145.8580546,1,2,3,2,2,4,4,0.412334,0.429539,0,No
11310,glottal,2,14.403385,2,10.1266511,10.1266411,4,145.8580546,1,1,2,2,2,4,5,0.320734,0.324139,0,No
11339,glassy,2,14.403385,2,10.1266511,10.1266411,4,145.8580546,1,2,3,2,2,4,5,0.327358,0.331062,0,No
11346,glance,2,14.403385,2,10.1266511,10.1266411,4,145.8580546,2,1,3,2,1,3,5,0.326047,0.329684,0,No
11358,gizzard,2,14.403385,2,10.1266511,10.1266411,4,145.8580546,1,1,2,1,1,2,5,0.384237,0.400402,0,No
11451,geochemistry,2,14.403385,2,10.1266511,10.1266411,4,145.8580546,2,1,3,2,1,3,5,0.318638,0.322407,0,No
11460,gent,2,14.403385,2,10.1266511,10.1266411,4,145.8580546,2,2,4,2,2,4,5,0.347228,0.356309,0,No
11468,genevieve,2,14.403385,2,10.1266511,10.1266411,4,145.8580546,1,1,2,1,1,2,6,0.242258,0.244055,0,No
11484,gemma,2,14.403385,2,10.1266511,10.1266411,4,145.8580546,2,1,3,2,1,3,5,0.326161,0.329757,0,No
11515,gauleiter,2,14.403385,2,10.1266511,10.1266411,4,145.8580546,2,2,4,2,2,4,5,0.384262,0.400449,0,No
11527,gastronomy,2,14.403385,2,10.1266511,10.1266411,4,145.8580546,0,2,2,0,2,2,4,0.389751,0.406471,0,No
11545,garnish,2,14.403385,2,10.1266511,10.1266411,4,145.8580546,2,2,4,2,2,4,5,0.388331,0.404923,0,No
11576,gam,2,14.403385,2,10.1266511,10.1266411,4,145.8580546,0,2,2,0,2,2,4,0.422425,0.439101,0,No
11585,gallows,2,14.403385,2,10.1266511,10.1266411,4,145.8580546,1,2,3,1,2,3,5,0.356983,0.369064,0,No
11613,gaines,2,14.403385,2,10.1266511,10.1266411,4,145.8580546,1,2,3,1,2,3,5,0.360844,0.373524,0,No
11617,gaggle,2,14.403385,2,10.1266511,10.1266411,4,145.8580546,1,1,2,2,1,3,5,0.324178,0.327665,0,No
11637,fussy,2,14.403385,2,10.1266511,10.1266411,4,145.8580546,2,1,3,2,2,4,5,0.384237,0.400402,0,No
11640,fuselage,2,14.403385,2,10.1266511,10.1266411,4,145.8580546,1,2,3,2,2,4,5,0.382837,0.399116,0,No
11673,fumarole,2,14.403385,2,10.1266511,10.1266411,4,145.8580546,2,2,4,2,2,4,5,0.322189,0.325685,0,No
11716,frivolous,2,14.403385,2,10.1266511,10.1266411,4,145.8580546,2,1,3,2,1,3,5,0.384237,0.400402,0,No
11724,frill,2,14.403385,2,10.1266511,10.1266411,4,145.8580546,2,2,4,2,2,4,5,0.33825,0.344751,0,No
11727,frighten,2,14.403385,2,10.1266511,10.1266411,4,145.8580546,1,2,3,2,2,4,5,0.398971,0.416664,0,No
11743,frey,2,14.403385,2,10.1266511,10.1266411,4,145.8580546,1,2,3,1,2,3,5,0.357278,0.369181,0,No
11747,fresnel,2,14.403385,2,10.1266511,10.1266411,4,145.8580546,1,1,2,1,1,2,5,0.318724,0.322146,0,No
11749,freshmen,2,14.403385,2,10.1266511,10.1266411,4,145.8580546,2,1,3,2,1,3,5,0.336021,0.342018,0,No
11801,francine,2,14.403385,2,10.1266511,10.1266411,4,145.8580546,2,2,4,2,2,4,5,0.384254,0.400439,0,No
11810,frail,2,14.403385,2,10.1266511,10.1266411,4,145.8580546,2,2,4,2,2,4,5,0.320861,0.324148,0,No
11818,foyer,2,14.403385,2,10.1266511,10.1266411,4,145.8580546,2,2,4,2,2,4,5,0.379165,0.395049,0,No
11840,fossiliferous,2,14.403385,2,10.1266511,10.1266411,4,145.8580546,2,2,4,2,2,4,5,0.338999,0.345824,0,No
11851,fortitude,2,14.403385,2,10.1266511,10.1266411,4,145.8580546,1,0,1,1,0,1,0,0,0,0,No
11853,fortieth,2,14.403385,2,10.1266511,10.1266411,4,145.8580546,1,2,3,2,2,4,5,0.327057,0.330593,0,No
11862,formulaic,2,14.403385,2,10.1266511,10.1266411,4,145.8580546,1,2,3,1,2,3,5,0.356195,0.368083,0,No
11866,formidable,2,14.403385,2,10.1266511,10.1266411,4,145.8580546,2,1,3,2,1,3,5,0.308407,0.313343,0,No
11867,formica,2,14.403385,2,10.1266511,10.1266411,4,145.8580546,0,1,1,0,2,2,5,0.384234,0.400398,0,No
11886,forfeiture,2,14.403385,2,10.1266511,10.1266411,4,145.8580546,1,2,3,2,2,4,4,0.40836,0.425906,0,No
11896,forceful,2,14.403385,2,10.1266511,10.1266411,4,145.8580546,2,2,4,2,2,4,5,0.325068,0.328333,0,No
11907,footwork,2,14.403385,2,10.1266511,10.1266411,4,145.8580546,1,2,3,1,2,3,5,0.390544,0.407303,0,No
11915,foothold,2,14.403385,2,10.1266511,10.1266411,4,145.8580546,2,1,3,2,2,4,5,0.360829,0.373487,0,No
11917,foote,2,14.403385,2,10.1266511,10.1266411,4,145.8580546,2,2,4,2,2,4,5,0.321378,0.324503,0,No
11930,fomalhaut,2,14.403385,2,10.1266511,10.1266411,4,145.8580546,0,1,1,0,1,1,5,0.325785,0.329217,0,No
11951,fodder,2,14.403385,2,10.1266511,10.1266411,4,145.8580546,1,2,3,1,2,3,5,0.344005,0.352451,0,No
11958,foal,2,14.403385,2,10.1266511,10.1266411,4,145.8580546,1,2,3,1,2,3,4,0.382186,0.398785,0,No
11966,flush,2,14.403385,2,10.1266511,10.1266411,4,145.8580546,2,2,4,2,2,4,4,0.40718,0.424812,0,No
11973,fluoresce,2,14.403385,2,10.1266511,10.1266411,4,145.8580546,1,2,3,1,2,3,5,0.35581,0.367651,0,No
11974,fluke,2,14.403385,2,10.1266511,10.1266411,4,145.8580546,2,2,4,2,2,4,5,0.33495,0.34095,0,No
11979,flue,2,14.403385,2,10.1266511,10.1266411,4,145.8580546,2,2,4,2,2,4,5,0.32374,0.327116,0,No
11992,florist,2,14.403385,2,10.1266511,10.1266411,4,145.8580546,2,2,4,2,2,4,5,0.379961,0.395871,0,No
12034,fledgling,2,14.403385,2,10.1266511,10.1266411,4,145.8580546,1,2,3,2,2,4,5,0.324527,0.328,0,No
12040,flautist,2,14.403385,2,10.1266511,10.1266411,4,145.8580546,1,2,3,2,2,4,5,0.326641,0.329941,0,No
12062,flamboyant,2,14.403385,2,10.1266511,10.1266411,4,145.8580546,2,0,2,2,0,2,0,0,0,0,No
12063,flaky,2,14.403385,2,10.1266511,10.1266411,4,145.8580546,1,1,2,1,1,2,6,0.269342,0.274623,0,No
12065,flak,2,14.403385,2,10.1266511,10.1266411,4,145.8580546,2,1,3,2,1,3,5,0.35519,0.366885,0,No
12077,fizzle,2,14.403385,2,10.1266511,10.1266411,4,145.8580546,2,1,3,2,1,3,5,0.360829,0.373487,0,No
12078,fizeau,2,14.403385,2,10.1266511,10.1266411,4,145.8580546,1,1,2,1,1,2,5,0.384237,0.400402,0,No
12081,fivefold,2,14.403385,2,10.1266511,10.1266411,4,145.8580546,2,1,3,2,1,3,5,0.312958,0.317192,0,No
12091,fissile,2,14.403385,2,10.1266511,10.1266411,4,145.8580546,2,1,3,2,1,3,5,0.384237,0.400402,0,No
12114,firehouse,2,14.403385,2,10.1266511,10.1266411,4,145.8580546,2,1,3,2,1,3,5,0.321012,0.324469,0,No
12123,finley,2,14.403385,2,10.1266511,10.1266411,4,145.8580546,2,2,4,2,2,4,5,0.359871,0.372368,0,No
12133,finery,2,14.403385,2,10.1266511,10.1266411,4,145.8580546,2,1,3,2,1,3,5,0.321326,0.324524,0,No
12155,filbert,2,14.403385,2,10.1266511,10.1266411,4,145.8580546,0,2,2,0,2,2,5,0.326654,0.330904,0,No
12183,fictive,2,14.403385,2,10.1266511,10.1266411,4,145.8580546,2,1,3,2,1,3,5,0.321053,0.324284,0,No
12202,fete,2,14.403385,2,10.1266511,10.1266411,4,145.8580546,2,2,4,2,2,4,5,0.34655,0.35574,0,No
12208,fervent,2,14.403385,2,10.1266511,10.1266411,4,145.8580546,2,1,3,2,1,3,6,0.281231,0.287457,0,No
12256,feeble,2,14.403385,2,10.1266511,10.1266411,4,145.8580546,2,1,3,2,1,3,5,0.321372,0.324529,0,No
12268,featherweight,2,14.403385,2,10.1266511,10.1266411,4,145.8580546,2,2,4,2,2,4,5,0.351582,0.361666,0,No
12274,fearful,2,14.403385,2,10.1266511,10.1266411,4,145.8580546,1,1,2,2,1,3,5,0.330602,0.335239,0,No
12276,fealty,2,14.403385,2,10.1266511,10.1266411,4,145.8580546,2,2,4,2,2,4,5,0.369405,0.383823,0,No
12278,fda,2,14.403385,2,10.1266511,10.1266411,4,145.8580546,1,0,1,1,0,1,0,0,0,0,No
12285,faustus,2,14.403385,2,10.1266511,10.1266411,4,145.8580546,2,1,3,2,1,3,5,0.345599,0.354479,0,No
12288,faunal,2,14.403385,2,10.1266511,10.1266411,4,145.8580546,1,1,2,1,1,2,5,0.313616,0.317776,0,No
12294,faucet,2,14.403385,2,10.1266511,10.1266411,4,145.8580546,2,2,4,2,2,4,5,0.357746,0.369935,0,No
12313,faro,2,14.403385,2,10.1266511,10.1266411,4,145.8580546,2,2,4,2,2,4,4,0.405163,0.422713,0,No
12319,farkas,2,14.403385,2,10.1266511,10.1266411,4,145.8580546,1,1,2,1,1,2,5,0.294613,0.300687,0,No
12341,familial,2,14.403385,2,10.1266511,10.1266411,4,145.8580546,2,0,2,2,0,2,0,0,0,0,No
12344,falsify,2,14.403385,2,10.1266511,10.1266411,4,145.8580546,1,2,3,2,2,4,5,0.413931,0.431649,0,No
12348,fallow,2,14.403385,2,10.1266511,10.1266411,4,145.8580546,2,2,4,2,2,4,5,0.321833,0.325002,0,No
12353,fallacious,2,14.403385,2,10.1266511,10.1266411,4,145.8580546,2,2,4,2,2,4,4,0.399545,0.417146,0,No
12356,falconry,2,14.403385,2,10.1266511,10.1266411,4,145.8580546,2,2,4,2,2,4,5,0.336053,0.342258,0,No
12365,fairchild,2,14.403385,2,10.1266511,10.1266411,4,145.8580546,2,1,3,2,1,3,5,0.375317,0.391855,0,No
12403,eyelet,2,14.403385,2,10.1266511,10.1266411,4,145.8580546,1,2,3,1,2,3,5,0.312199,0.3166,0,No
12404,eyelash,2,14.403385,2,10.1266511,10.1266411,4,145.8580546,2,1,3,2,1,3,5,0.345599,0.354479,0,No
12427,extinguish,2,14.403385,2,10.1266511,10.1266411,4,145.8580546,1,1,2,2,2,4,5,0.375317,0.391855,0,No
12463,expire,2,14.403385,2,10.1266511,10.1266411,4,145.8580546,2,2,4,2,2,4,5,0.361094,0.373724,0,No
12473,expelling,2,14.403385,2,10.1266511,10.1266411,4,145.8580546,2,2,4,2,2,4,4,0.399294,0.416887,0,No
12488,exorcist,2,14.403385,2,10.1266511,10.1266411,4,145.8580546,1,2,3,2,2,4,5,0.326497,0.330691,0,No
12499,exhaustive,2,14.403385,2,10.1266511,10.1266411,4,145.8580546,1,1,2,1,1,2,5,0.318118,0.321665,0,No
12502,exhale,2,14.403385,2,10.1266511,10.1266411,4,145.8580546,2,2,4,2,2,4,5,0.331478,0.336021,0,No
12506,exemption,2,14.403385,2,10.1266511,10.1266411,4,145.8580546,2,1,3,2,1,3,5,0.341779,0.349674,0,No
12509,executor,2,14.403385,2,10.1266511,10.1266411,4,145.8580546,2,2,4,2,2,4,5,0.390879,0.407922,0,No
12541,excavate,2,14.403385,2,10.1266511,10.1266411,4,145.8580546,2,1,3,2,1,3,5,0.375317,0.391855,0,No
12563,everyman,2,14.403385,2,10.1266511,10.1266411,4,145.8580546,2,2,4,2,2,4,5,0.326798,0.330954,0,No
12600,euphoric,2,14.403385,2,10.1266511,10.1266411,4,145.8580546,2,2,4,2,2,4,5,0.329742,0.335413,0,No
12611,euglena,2,14.403385,2,10.1266511,10.1266411,4,145.8580546,2,2,4,2,2,4,4,0.412334,0.429539,0,No
12612,eugenic,2,14.403385,2,10.1266511,10.1266411,4,145.8580546,2,0,2,2,0,2,0,0,0,0,No
12664,esprit,2,14.403385,2,10.1266511,10.1266411,4,145.8580546,1,2,3,1,2,3,5,0.325146,0.328432,0,No
12673,escherichia,2,14.403385,2,10.1266511,10.1266411,4,145.8580546,2,1,3,2,1,3,5,0.319458,0.322886,0,No
12696,ermine,2,14.403385,2,10.1266511,10.1266411,4,145.8580546,2,2,4,2,2,4,5,0.324462,0.327745,0,No
12703,ergodic,2,14.403385,2,10.1266511,10.1266411,4,145.8580546,1,1,2,1,2,3,5,0.321361,0.324577,0,No
12707,erda,2,14.403385,2,10.1266511,10.1266411,4,145.8580546,2,2,4,2,2,4,5,0.41003,0.427626,0,No
12710,erato,2,14.403385,2,10.1266511,10.1266411,4,145.8580546,2,1,3,2,1,3,5,0.398076,0.415824,0,No
12711,erasure,2,14.403385,2,10.1266511,10.1266411,4,145.8580546,2,1,3,2,1,3,5,0.324866,0.328451,0,No
12716,eradicate,2,14.403385,2,10.1266511,10.1266411,4,145.8580546,1,0,1,2,0,2,0,0,0,0,No
12721,equitable,2,14.403385,2,10.1266511,10.1266411,4,145.8580546,2,2,4,2,2,4,5,0.31974,0.32324,0,No
12737,epoxy,2,14.403385,2,10.1266511,10.1266411,4,145.8580546,2,1,3,2,1,3,5,0.32946,0.333471,0,No
12741,epitome,2,14.403385,2,10.1266511,10.1266411,4,145.8580546,2,1,3,2,1,3,5,0.326858,0.330739,0,No
12742,epithet,2,14.403385,2,10.1266511,10.1266411,4,145.8580546,2,0,2,2,0,2,0,0,0,0,No
12764,epicurean,2,14.403385,2,10.1266511,10.1266411,4,145.8580546,1,1,2,1,1,2,5,0.298231,0.304124,0,No
12785,entomology,2,14.403385,2,10.1266511,10.1266411,4,145.8580546,1,2,3,1,2,3,4,0.389755,0.406475,0,No
12813,englander,2,14.403385,2,10.1266511,10.1266411,4,145.8580546,1,1,2,2,1,3,5,0.315125,0.319187,0,No
12824,endure,2,14.403385,2,10.1266511,10.1266411,4,145.8580546,2,2,4,2,2,4,5,0.413931,0.431649,0,No
12865,emissary,2,14.403385,2,10.1266511,10.1266411,4,145.8580546,1,2,3,1,2,3,5,0.386252,0.402655,0,No
12867,eminent,2,14.403385,2,10.1266511,10.1266411,4,145.8580546,2,0,2,2,0,2,0,0,0,0,No
12917,ellwood,2,14.403385,2,10.1266511,10.1266411,4,145.8580546,2,0,2,2,0,2,0,0,0,0,No
12948,elephantine,2,14.403385,2,10.1266511,10.1266411,4,145.8580546,2,2,4,2,2,4,5,0.326527,0.330062,0,No
12968,electress,2,14.403385,2,10.1266511,10.1266411,4,145.8580546,1,1,2,1,2,3,5,0.378607,0.394397,0,No
12982,elan,2,14.403385,2,10.1266511,10.1266411,4,145.8580546,1,1,2,1,1,2,5,0.304707,0.310043,0,No
12993,einsteinian,2,14.403385,2,10.1266511,10.1266411,4,145.8580546,2,0,2,2,0,2,0,0,0,0,No
12998,eightfold,2,14.403385,2,10.1266511,10.1266411,4,145.8580546,1,1,2,2,2,4,5,0.319418,0.322778,0,No
13004,egyptology,2,14.403385,2,10.1266511,10.1266411,4,145.8580546,2,2,4,2,2,4,5,0.349285,0.359009,0,No
13016,eft,2,14.403385,2,10.1266511,10.1266411,4,145.8580546,2,2,4,2,2,4,5,0.331726,0.338282,0,No
13052,edgerton,2,14.403385,2,10.1266511,10.1266411,4,145.8580546,2,2,4,2,2,4,5,0.334855,0.340814,0,No
13060,ecstatic,2,14.403385,2,10.1266511,10.1266411,4,145.8580546,2,2,4,2,2,4,5,0.384554,0.400773,0,No
13133,dyad,2,14.403385,2,10.1266511,10.1266411,4,145.8580546,2,2,4,2,2,4,6,0.28529,0.291655,0,No
13136,dwell,2,14.403385,2,10.1266511,10.1266411,4,145.8580546,2,1,3,2,1,3,6,0.273559,0.279465,0,No
13150,durrell,2,14.403385,2,10.1266511,10.1266411,4,145.8580546,2,2,4,2,2,4,5,0.340338,0.347328,0,No
13156,durance,2,14.403385,2,10.1266511,10.1266411,4,145.8580546,1,1,2,1,1,2,5,0.327697,0.331801,0,No
13184,duma,2,14.403385,2,10.1266511,10.1266411,4,145.8580546,1,1,2,2,1,3,5,0.384237,0.400402,0,No
13214,dryad,2,14.403385,2,10.1266511,10.1266411,4,145.8580546,1,1,2,2,2,4,5,0.360829,0.373487,0,No
13219,drunkard,2,14.403385,2,10.1266511,10.1266411,4,145.8580546,2,1,3,2,1,3,5,0.320705,0.324646,0,No
13222,drumhead,2,14.403385,2,10.1266511,10.1266411,4,145.8580546,2,1,3,2,1,3,5,0.32681,0.33159,0,No
13232,dropout,2,14.403385,2,10.1266511,10.1266411,4,145.8580546,1,2,3,2,2,4,5,0.346212,0.355281,0,No
13233,droplet,2,14.403385,2,10.1266511,10.1266411,4,145.8580546,1,1,2,2,2,4,5,0.378607,0.394397,0,No
13242,driscoll,2,14.403385,2,10.1266511,10.1266411,4,145.8580546,2,2,4,2,2,4,5,0.384837,0.401092,0,No
13250,drexel,2,14.403385,2,10.1266511,10.1266411,4,145.8580546,2,1,3,2,1,3,5,0.326479,0.32972,0,No
13257,dreadful,2,14.403385,2,10.1266511,10.1266411,4,145.8580546,2,1,3,2,1,3,5,0.345599,0.354479,0,No
13262,drawback,2,14.403385,2,10.1266511,10.1266411,4,145.8580546,1,2,3,1,2,3,5,0.379725,0.395631,0,No
13265,draught,2,14.403385,2,10.1266511,10.1266411,4,145.8580546,1,0,1,1,0,1,0,0,0,0,No
13266,drastic,2,14.403385,2,10.1266511,10.1266411,4,145.8580546,1,0,1,1,0,1,0,0,0,0,No
13295,downside,2,14.403385,2,10.1266511,10.1266411,4,145.8580546,2,2,4,2,2,4,4,0.395108,0.412188,0,No
13316,doublet,2,14.403385,2,10.1266511,10.1266411,4,145.8580546,2,2,4,2,2,4,5,0.384121,0.400592,0,No
13320,dostoevsky,2,14.403385,2,10.1266511,10.1266411,4,145.8580546,0,2,2,0,2,2,5,0.359272,0.371661,0,No
13322,dosimeter,2,14.403385,2,10.1266511,10.1266411,4,145.8580546,1,2,3,2,2,4,4,0.405163,0.422713,0,No
13343,dopant,2,14.403385,2,10.1266511,10.1266411,4,145.8580546,1,2,3,2,2,4,4,0.396715,0.414225,0,No
13345,doorstep,2,14.403385,2,10.1266511,10.1266411,4,145.8580546,2,2,4,2,2,4,5,0.388391,0.405141,0,No
13391,dogwood,2,14.403385,2,10.1266511,10.1266411,4,145.8580546,1,1,2,1,1,2,5,0.319832,0.323252,0,No
13410,doctrinal,2,14.403385,2,10.1266511,10.1266411,4,145.8580546,2,1,3,2,1,3,5,0.35519,0.366885,0,No
13414,dockyard,2,14.403385,2,10.1266511,10.1266411,4,145.8580546,2,1,3,2,1,3,5,0.300849,0.306515,0,No
13415,docket,2,14.403385,2,10.1266511,10.1266411,4,145.8580546,2,2,4,2,2,4,5,0.326948,0.330321,0,No
13425,dixieland,2,14.403385,2,10.1266511,10.1266411,4,145.8580546,2,2,4,2,2,4,5,0.327884,0.331741,0,No
13427,divorcee,2,14.403385,2,10.1266511,10.1266411,4,145.8580546,2,2,4,2,2,4,5,0.398612,0.416354,0,No
13456,distillate,2,14.403385,2,10.1266511,10.1266411,4,145.8580546,1,2,3,1,2,3,5,0.355575,0.367374,0,No
13458,distal,2,14.403385,2,10.1266511,10.1266411,4,145.8580546,2,1,3,2,1,3,5,0.32085,0.324143,0,No
13464,dissension,2,14.403385,2,10.1266511,10.1266411,4,145.8580546,1,2,3,1,2,3,5,0.398094,0.415861,0,No
13467,disruption,2,14.403385,2,10.1266511,10.1266411,4,145.8580546,2,2,4,2,2,4,5,0.392348,0.409441,0,No
13475,dispense,2,14.403385,2,10.1266511,10.1266411,4,145.8580546,1,1,2,1,2,3,5,0.345068,0.353675,0,No
13477,dispel,2,14.403385,2,10.1266511,10.1266411,4,145.8580546,1,2,3,2,2,4,5,0.325784,0.330371,0,No
13482,dismal,2,14.403385,2,10.1266511,10.1266411,4,145.8580546,2,1,3,2,1,3,5,0.398076,0.415824,0,No
13484,disjunct,2,14.403385,2,10.1266511,10.1266411,4,145.8580546,2,1,3,2,1,3,5,0.318432,0.321975,0,No
13490,discriminatory,2,14.403385,2,10.1266511,10.1266411,4,145.8580546,2,2,4,2,2,4,5,0.355674,0.3675,0,No
13537,dine,2,14.403385,2,10.1266511,10.1266411,4,145.8580546,2,2,4,2,2,4,5,0.346787,0.355574,0,No
13542,dimorphic,2,14.403385,2,10.1266511,10.1266411,4,145.8580546,0,1,1,0,1,1,5,0.349979,0.359707,0,No
13544,diminution,2,14.403385,2,10.1266511,10.1266411,4,145.8580546,2,2,4,2,2,4,5,0.378672,0.39449,0,No
13545,dimethyl,2,14.403385,2,10.1266511,10.1266411,4,145.8580546,2,0,2,2,0,2,0,0,0,0,No
13554,dilate,2,14.403385,2,10.1266511,10.1266411,4,145.8580546,1,1,2,1,1,2,5,0.322634,0.326458,0,No
13557,dignitary,2,14.403385,2,10.1266511,10.1266411,4,145.8580546,2,1,3,2,1,3,5,0.319947,0.323756,0,No
13577,dietz,2,14.403385,2,10.1266511,10.1266411,4,145.8580546,2,2,4,2,2,4,5,0.328382,0.332257,0,No
13590,dictum,2,14.403385,2,10.1266511,10.1266411,4,145.8580546,1,1,2,2,2,4,5,0.378607,0.394397,0,No
13636,dextrose,2,14.403385,2,10.1266511,10.1266411,4,145.8580546,2,2,4,2,2,4,5,0.384262,0.400449,0,No
13655,deviate,2,14.403385,2,10.1266511,10.1266411,4,145.8580546,2,1,3,2,1,3,5,0.341779,0.349674,0,No
13658,devastate,2,14.403385,2,10.1266511,10.1266411,4,145.8580546,1,2,3,2,2,4,5,0.413931,0.431649,0,No
13677,detach,2,14.403385,2,10.1266511,10.1266411,4,145.8580546,2,1,3,2,1,3,5,0.341779,0.349674,0,No
13680,destitute,2,14.403385,2,10.1266511,10.1266411,4,145.8580546,1,2,3,1,2,3,5,0.330436,0.334975,0,No
13710,dermatology,2,14.403385,2,10.1266511,10.1266411,4,145.8580546,2,2,4,2,2,4,5,0.354191,0.365413,0,No
13725,depositor,2,14.403385,2,10.1266511,10.1266411,4,145.8580546,1,2,3,1,2,3,5,0.326131,0.331196,0,No
13758,dendritic,2,14.403385,2,10.1266511,10.1266411,4,145.8580546,1,0,1,1,0,1,0,0,0,0,No
13761,demure,2,14.403385,2,10.1266511,10.1266411,4,145.8580546,2,2,4,2,2,4,5,0.384246,0.40043,0,No
13771,demography,2,14.403385,2,10.1266511,10.1266411,4,145.8580546,2,0,2,2,0,2,0,0,0,0,No
13791,delmarva,2,14.403385,2,10.1266511,10.1266411,4,145.8580546,2,1,3,2,2,4,5,0.320265,0.323648,0,No
13803,delightful,2,14.403385,2,10.1266511,10.1266411,4,145.8580546,1,1,2,1,1,2,6,0.283558,0.289745,0,No
13811,delia,2,14.403385,2,10.1266511,10.1266411,4,145.8580546,1,2,3,1,2,3,5,0.319579,0.323448,0,No
13831,defraud,2,14.403385,2,10.1266511,10.1266411,4,145.8580546,1,1,2,2,1,3,5,0.3215,0.324725,0,No
13835,deforest,2,14.403385,2,10.1266511,10.1266411,4,145.8580546,2,1,3,2,2,4,6,0.269825,0.275101,0,No
13836,deflect,2,14.403385,2,10.1266511,10.1266411,4,145.8580546,2,1,3,2,1,3,5,0.324628,0.32797,0,No
13844,defiant,2,14.403385,2,10.1266511,10.1266411,4,145.8580546,2,1,3,2,1,3,5,0.327027,0.330758,0,No
13864,decoy,2,14.403385,2,10.1266511,10.1266411,4,145.8580546,1,0,1,1,0,1,0,0,0,0,No
13865,decorum,2,14.403385,2,10.1266511,10.1266411,4,145.8580546,1,2,3,1,2,3,5,0.355632,0.367058,0,No
13868,decompress,2,14.403385,2,10.1266511,10.1266411,4,145.8580546,1,1,2,1,1,2,5,0.398076,0.415824,0,No
13877,declamation,2,14.403385,2,10.1266511,10.1266411,4,145.8580546,1,2,3,1,2,3,5,0.352994,0.363655,0,No
13881,decipher,2,14.403385,2,10.1266511,10.1266411,4,145.8580546,2,2,4,2,2,4,4,0.399788,0.41738,0,No
13892,deceit,2,14.403385,2,10.1266511,10.1266411,4,145.8580546,1,2,3,1,2,3,5,0.395557,0.412641,0,No
13898,decapod,2,14.403385,2,10.1266511,10.1266411,4,145.8580546,2,0,2,2,0,2,0,0,0,0,No
13902,debutante,2,14.403385,2,10.1266511,10.1266411,4,145.8580546,1,2,3,2,2,4,5,0.359187,0.37156,0,No
13921,deathbed,2,14.403385,2,10.1266511,10.1266411,4,145.8580546,2,2,4,2,2,4,5,0.323363,0.326902,0,No
13927,deanna,2,14.403385,2,10.1266511,10.1266411,4,145.8580546,0,0,0,0,0,0,0,0,0,0,No
13934,deadlock,2,14.403385,2,10.1266511,10.1266411,4,145.8580546,1,2,3,1,2,3,5,0.346314,0.355371,0,No
13960,dauphine,2,14.403385,2,10.1266511,10.1266411,4,145.8580546,2,2,4,2,2,4,5,0.395565,0.41265,0,No
13982,darken,2,14.403385,2,10.1266511,10.1266411,4,145.8580546,1,0,1,1,0,1,0,0,0,0,No
14001,dang,2,14.403385,2,10.1266511,10.1266411,4,145.8580546,2,2,4,2,2,4,5,0.330208,0.334597,0,No
14010,damsel,2,14.403385,2,10.1266511,10.1266411,4,145.8580546,2,2,4,2,2,4,5,0.366923,0.380689,0,No
14091,cutout,2,14.403385,2,10.1266511,10.1266411,4,145.8580546,1,1,2,1,1,2,5,0.318672,0.322073,0,No
14096,cutaneous,2,14.403385,2,10.1266511,10.1266411,4,145.8580546,2,1,3,2,1,3,5,0.319349,0.322714,0,No
14128,curfew,2,14.403385,2,10.1266511,10.1266411,4,145.8580546,2,2,4,2,2,4,5,0.384262,0.400449,0,No
14175,cryptographer,2,14.403385,2,10.1266511,10.1266411,4,145.8580546,2,2,4,2,2,4,5,0.385188,0.401458,0,No
14176,crypto,2,14.403385,2,10.1266511,10.1266411,4,145.8580546,1,1,2,1,1,2,5,0.325575,0.32918,0,No
14177,cryptic,2,14.403385,2,10.1266511,10.1266411,4,145.8580546,1,0,1,1,0,1,0,0,0,0,No
14178,cryptanalytic,2,14.403385,2,10.1266511,10.1266411,4,145.8580546,2,1,3,2,1,3,5,0.322318,0.325473,0,No
14212,crowbar,2,14.403385,2,10.1266511,10.1266411,4,145.8580546,1,2,3,1,2,3,5,0.326449,0.329834,0,No
14232,crocodilian,2,14.403385,2,10.1266511,10.1266411,4,145.8580546,2,1,3,2,1,3,5,0.323551,0.326892,0,No
14244,crispin,2,14.403385,2,10.1266511,10.1266411,4,145.8580546,2,1,3,2,1,3,5,0.324902,0.329008,0,No
14254,crib,2,14.403385,2,10.1266511,10.1266411,4,145.8580546,1,1,2,1,1,2,5,0.294916,0.301015,0,No
14257,crevice,2,14.403385,2,10.1266511,10.1266411,4,145.8580546,2,2,4,2,2,4,5,0.357436,0.369744,0,No
14278,credible,2,14.403385,2,10.1266511,10.1266411,4,145.8580546,2,1,3,2,1,3,5,0.398076,0.415824,0,No
14294,crave,2,14.403385,2,10.1266511,10.1266411,4,145.8580546,1,1,2,1,1,2,5,0.321355,0.324498,0,No
14296,crate,2,14.403385,2,10.1266511,10.1266411,4,145.8580546,2,2,4,2,2,4,5,0.378947,0.394772,0,No
14305,cranford,2,14.403385,2,10.1266511,10.1266411,4,145.8580546,2,2,4,2,2,4,5,0.398639,0.416382,0,No
14329,cowpea,2,14.403385,2,10.1266511,10.1266411,4,145.8580546,1,0,1,2,0,2,0,0,0,0,No
14355,courteous,2,14.403385,2,10.1266511,10.1266411,4,145.8580546,2,1,3,2,1,3,5,0.331788,0.336492,0,No
14391,cotyledon,2,14.403385,2,10.1266511,10.1266411,4,145.8580546,1,1,2,2,1,3,5,0.398076,0.415824,0,No
14392,cottrell,2,14.403385,2,10.1266511,10.1266411,4,145.8580546,1,2,3,2,2,4,5,0.30157,0.307317,0,No
14397,cotta,2,14.403385,2,10.1266511,10.1266411,4,145.8580546,2,0,2,2,0,2,0,0,0,0,No
14418,cortland,2,14.403385,2,10.1266511,10.1266411,4,145.8580546,2,2,4,2,2,4,5,0.327981,0.332972,0,No
14448,corny,2,14.403385,2,10.1266511,10.1266411,4,145.8580546,2,1,3,2,1,3,5,0.306771,0.311991,0,No
14470,cordial,2,14.403385,2,10.1266511,10.1266411,4,145.8580546,1,0,1,1,0,1,0,0,0,0,No
14472,corcoran,2,14.403385,2,10.1266511,10.1266411,4,145.8580546,2,2,4,2,2,4,5,0.384379,0.400576,0,No
14481,copra,2,14.403385,2,10.1266511,10.1266411,4,145.8580546,2,2,4,2,2,4,5,0.387754,0.404294,0,No
14538,contributory,2,14.403385,2,10.1266511,10.1266411,4,145.8580546,2,2,4,2,2,4,5,0.359237,0.371621,0,No
14546,contradictory,2,14.403385,2,10.1266511,10.1266411,4,145.8580546,2,1,3,2,1,3,5,0.323947,0.327997,0,No
14570,contentious,2,14.403385,2,10.1266511,10.1266411,4,145.8580546,2,1,3,2,1,3,5,0.307462,0.312772,0,No
14577,contaminate,2,14.403385,2,10.1266511,10.1266411,4,145.8580546,2,2,4,2,2,4,5,0.33634,0.342381,0,No
14610,consonantal,2,14.403385,2,10.1266511,10.1266411,4,145.8580546,1,1,2,1,1,2,6,0.249147,0.251225,0,No
14661,congestive,2,14.403385,2,10.1266511,10.1266411,4,145.8580546,2,1,3,2,2,4,5,0.321448,0.324655,0,No
14722,concession,2,14.403385,2,10.1266511,10.1266411,4,145.8580546,2,2,4,2,2,4,5,0.378019,0.393745,0,No
14731,concentric,2,14.403385,2,10.1266511,10.1266411,4,145.8580546,1,1,2,1,1,2,5,0.32023,0.323457,0,No
14734,conceal,2,14.403385,2,10.1266511,10.1266411,4,145.8580546,2,1,3,2,1,3,5,0.326185,0.333913,0,No
14754,comprehension,2,14.403385,2,10.1266511,10.1266411,4,145.8580546,2,1,3,2,2,4,5,0.378607,0.394397,0,No
14791,compatriot,2,14.403385,2,10.1266511,10.1266411,4,145.8580546,1,2,3,1,2,3,5,0.384296,0.400486,0,No
14805,commute,2,14.403385,2,10.1266511,10.1266411,4,145.8580546,1,1,2,1,1,2,5,0.345068,0.353675,0,No
14810,commotion,2,14.403385,2,10.1266511,10.1266411,4,145.8580546,1,2,3,2,2,4,5,0.326551,0.330283,0,No
14828,commensal,2,14.403385,2,10.1266511,10.1266411,4,145.8580546,2,2,4,2,2,4,5,0.360976,0.373679,0,No
14834,commandant,2,14.403385,2,10.1266511,10.1266411,4,145.8580546,2,2,4,2,2,4,5,0.388391,0.405141,0,No
14851,comatose,2,14.403385,2,10.1266511,10.1266411,4,145.8580546,2,2,4,2,2,4,5,0.384287,0.400472,0,No
14899,collaborate,2,14.403385,2,10.1266511,10.1266411,4,145.8580546,2,1,3,2,2,4,5,0.359172,0.371523,0,No
14907,colby,2,14.403385,2,10.1266511,10.1266411,4,145.8580546,2,1,3,2,1,3,5,0.398076,0.415824,0,No
14912,coincide,2,14.403385,2,10.1266511,10.1266411,4,145.8580546,1,1,2,1,2,3,5,0.345068,0.353675,0,No
14918,cohn,2,14.403385,2,10.1266511,10.1266411,4,145.8580546,1,1,2,1,1,2,5,0.360829,0.373487,0,No
14921,coherent,2,14.403385,2,10.1266511,10.1266411,4,145.8580546,1,1,2,1,1,2,5,0.30179,0.307371,0,No
14935,coercive,2,14.403385,2,10.1266511,10.1266411,4,145.8580546,2,1,3,2,1,3,5,0.322599,0.325644,0,No
14936,coercion,2,14.403385,2,10.1266511,10.1266411,4,145.8580546,1,2,3,2,2,4,5,0.356074,0.368031,0,No
14964,cobblestone,2,14.403385,2,10.1266511,10.1266411,4,145.8580546,1,1,2,1,1,2,5,0.384237,0.400402,0,No
14979,coalesce,2,14.403385,2,10.1266511,10.1266411,4,145.8580546,2,2,4,2,2,4,5,0.398398,0.416162,0,No
15000,clout,2,14.403385,2,10.1266511,10.1266411,4,145.8580546,2,2,4,2,2,4,5,0.384787,0.401031,0,No
15004,clothier,2,14.403385,2,10.1266511,10.1266411,4,145.8580546,2,1,3,2,1,3,5,0.378607,0.394397,0,No
15006,clothe,2,14.403385,2,10.1266511,10.1266411,4,145.8580546,1,1,2,1,1,2,5,0.398076,0.415824,0,No
15046,clergymen,2,14.403385,2,10.1266511,10.1266411,4,145.8580546,2,1,3,2,1,3,5,0.378607,0.394397,0,No
15054,cleave,2,14.403385,2,10.1266511,10.1266411,4,145.8580546,2,2,4,2,2,4,5,0.321495,0.324741,0,No
15055,cleavage,2,14.403385,2,10.1266511,10.1266411,4,145.8580546,2,2,4,2,2,4,4,0.417798,0.43498,0,No
15112,cityscape,2,14.403385,2,10.1266511,10.1266411,4,145.8580546,1,2,3,1,2,3,4,0.422432,0.439107,0,No
15160,chutney,2,14.403385,2,10.1266511,10.1266411,4,145.8580546,2,2,4,2,2,4,5,0.352924,0.363403,0,No
15162,churn,2,14.403385,2,10.1266511,10.1266411,4,145.8580546,1,1,2,1,1,2,5,0.297851,0.303793,0,No
15163,churchyard,2,14.403385,2,10.1266511,10.1266411,4,145.8580546,2,2,4,2,2,4,5,0.379044,0.394899,0,No
15170,chungking,2,14.403385,2,10.1266511,10.1266411,4,145.8580546,1,1,2,1,1,2,5,0.345599,0.354479,0,No
15183,chromosomal,2,14.403385,2,10.1266511,10.1266411,4,145.8580546,1,2,3,1,2,3,5,0.31254,0.316928,0,No
15224,choke,2,14.403385,2,10.1266511,10.1266411,4,145.8580546,2,2,4,2,2,4,5,0.355212,0.366932,0,No
15235,chlorate,2,14.403385,2,10.1266511,10.1266411,4,145.8580546,1,2,3,2,2,4,5,0.296869,0.302959,0,No
15259,chimera,2,14.403385,2,10.1266511,10.1266411,4,145.8580546,1,2,3,1,2,3,5,0.326882,0.330503,0,No
15279,chic,2,14.403385,2,10.1266511,10.1266411,4,145.8580546,2,2,4,2,2,4,5,0.360954,0.373661,0,No
15284,chewy,2,14.403385,2,10.1266511,10.1266411,4,145.8580546,1,2,3,1,2,3,5,0.355254,0.366984,0,No
15318,cheekbone,2,14.403385,2,10.1266511,10.1266411,4,145.8580546,1,2,3,2,2,4,5,0.330466,0.335506,0,No
15388,chancery,2,14.403385,2,10.1266511,10.1266411,4,145.8580546,2,2,4,2,2,4,5,0.321967,0.325461,0,No
15403,chalmers,2,14.403385,2,10.1266511,10.1266411,4,145.8580546,2,1,3,2,1,3,5,0.326816,0.331594,0,No
15411,chairmen,2,14.403385,2,10.1266511,10.1266411,4,145.8580546,1,1,2,1,1,2,5,0.378607,0.394397,0,No
15415,chaff,2,14.403385,2,10.1266511,10.1266411,4,145.8580546,1,2,3,1,2,3,5,0.384954,0.401205,0,No
15420,cetus,2,14.403385,2,10.1266511,10.1266411,4,145.8580546,1,2,3,1,2,3,5,0.33141,0.335936,0,No
15424,cession,2,14.403385,2,10.1266511,10.1266411,4,145.8580546,2,2,4,2,2,4,4,0.417798,0.43498,0,No
15427,cesare,2,14.403385,2,10.1266511,10.1266411,4,145.8580546,1,1,2,1,1,2,5,0.332161,0.339406,0,No
15448,centum,2,14.403385,2,10.1266511,10.1266411,4,145.8580546,2,1,3,2,1,3,5,0.384237,0.400402,0,No
15463,cenozoic,2,14.403385,2,10.1266511,10.1266411,4,145.8580546,1,2,3,2,2,4,5,0.322745,0.326216,0,No
15470,celluloid,2,14.403385,2,10.1266511,10.1266411,4,145.8580546,1,1,2,1,1,2,5,0.318272,0.321782,0,No
15491,cdc,2,14.403385,2,10.1266511,10.1266411,4,145.8580546,1,1,2,1,1,2,5,0.319108,0.322608,0,No
15500,caveman,2,14.403385,2,10.1266511,10.1266411,4,145.8580546,2,2,4,2,2,4,4,0.422432,0.439107,0,No
15505,cautious,2,14.403385,2,10.1266511,10.1266411,4,145.8580546,2,2,4,2,2,4,5,0.380661,0.396683,0,No
15506,cautionary,2,14.403385,2,10.1266511,10.1266411,4,145.8580546,2,1,3,2,1,3,5,0.309488,0.314267,0,No
15507,caution,2,14.403385,2,10.1266511,10.1266411,4,145.8580546,2,2,4,2,2,4,4,0.40718,0.424812,0,No
15510,causal,2,14.403385,2,10.1266511,10.1266411,4,145.8580546,1,1,2,1,1,2,5,0.321431,0.324685,0,No
15511,caulk,2,14.403385,2,10.1266511,10.1266411,4,145.8580546,1,2,3,1,2,3,5,0.328479,0.333667,0,No
15586,carton,2,14.403385,2,10.1266511,10.1266411,4,145.8580546,2,2,4,2,2,4,5,0.321337,0.325251,0,No
15649,cardiology,2,14.403385,2,10.1266511,10.1266411,4,145.8580546,2,1,3,2,1,3,5,0.317731,0.321452,0,No
15651,cardigan,2,14.403385,2,10.1266511,10.1266411,4,145.8580546,2,1,3,2,1,3,5,0.375317,0.391855,0,No
15701,capacitive,2,14.403385,2,10.1266511,10.1266411,4,145.8580546,2,1,3,2,1,3,5,0.35519,0.366885,0,No
15711,canticle,2,14.403385,2,10.1266511,10.1266411,4,145.8580546,1,1,2,1,2,3,5,0.378607,0.394397,0,No
15715,cant,2,14.403385,2,10.1266511,10.1266411,4,145.8580546,2,2,4,2,2,4,5,0.32826,0.3321,0,No
15720,canoga,2,14.403385,2,10.1266511,10.1266411,4,145.8580546,2,1,3,2,2,4,5,0.324753,0.328036,0,No
15725,cannery,2,14.403385,2,10.1266511,10.1266411,4,145.8580546,1,1,2,1,1,2,5,0.301534,0.3072,0,No
15733,candlelight,2,14.403385,2,10.1266511,10.1266411,4,145.8580546,1,1,2,2,1,3,5,0.398076,0.415824,0,No
15754,campground,2,14.403385,2,10.1266511,10.1266411,4,145.8580546,2,2,4,2,2,4,5,0.384954,0.401205,0,No
15755,campfire,2,14.403385,2,10.1266511,10.1266411,4,145.8580546,1,1,2,2,1,3,5,0.326347,0.330278,0,No
15806,calibrate,2,14.403385,2,10.1266511,10.1266411,4,145.8580546,2,1,3,2,1,3,5,0.31187,0.316351,0,No
15826,calamity,2,14.403385,2,10.1266511,10.1266411,4,145.8580546,2,2,4,2,2,4,5,0.378745,0.394566,0,No
15828,calabash,2,14.403385,2,10.1266511,10.1266411,4,145.8580546,2,2,4,2,2,4,5,0.320577,0.324247,0,No
15833,cairn,2,14.403385,2,10.1266511,10.1266411,4,145.8580546,2,1,3,2,1,3,5,0.31993,0.323296,0,No
15839,cafeteria,2,14.403385,2,10.1266511,10.1266411,4,145.8580546,2,1,3,2,1,3,5,0.32681,0.33159,0,No
15848,cadaver,2,14.403385,2,10.1266511,10.1266411,4,145.8580546,2,1,3,2,2,4,5,0.398076,0.415824,0,No
15881,buxton,2,14.403385,2,10.1266511,10.1266411,4,145.8580546,1,1,2,1,1,2,5,0.360829,0.373487,0,No
15919,burro,2,14.403385,2,10.1266511,10.1266411,4,145.8580546,1,2,3,1,2,3,5,0.375897,0.392423,0,No
15921,burp,2,14.403385,2,10.1266511,10.1266411,4,145.8580546,2,1,3,2,1,3,5,0.331268,0.335748,0,No
15924,burnout,2,14.403385,2,10.1266511,10.1266411,4,145.8580546,1,1,2,2,2,4,5,0.324373,0.32772,0,No
15933,burlap,2,14.403385,2,10.1266511,10.1266411,4,145.8580546,2,1,3,2,1,3,5,0.345599,0.354479,0,No
15940,burgher,2,14.403385,2,10.1266511,10.1266411,4,145.8580546,1,1,2,1,1,2,5,0.384237,0.400402,0,No
15946,bureaucrat,2,14.403385,2,10.1266511,10.1266411,4,145.8580546,2,2,4,2,2,4,5,0.33538,0.340862,0,No
15950,burch,2,14.403385,2,10.1266511,10.1266411,4,145.8580546,2,1,3,2,1,3,5,0.317424,0.321389,0,No
15952,buoyant,2,14.403385,2,10.1266511,10.1266411,4,145.8580546,2,1,3,2,1,3,5,0.32946,0.333471,0,No
15992,buggy,2,14.403385,2,10.1266511,10.1266411,4,145.8580546,1,2,3,1,2,3,5,0.357041,0.369209,0,No
15996,buffet,2,14.403385,2,10.1266511,10.1266411,4,145.8580546,1,1,2,1,1,2,5,0.322875,0.326141,0,No
16003,budge,2,14.403385,2,10.1266511,10.1266411,4,145.8580546,2,0,2,2,0,2,0,0,0,0,No
16025,buccaneer,2,14.403385,2,10.1266511,10.1266411,4,145.8580546,2,2,4,2,2,4,5,0.350409,0.360486,0,No
16030,bryophyta,2,14.403385,2,10.1266511,10.1266411,4,145.8580546,1,1,2,1,1,2,5,0.345599,0.354479,0,No
16074,bronchi,2,14.403385,2,10.1266511,10.1266411,4,145.8580546,2,0,2,2,0,2,0,0,0,0,No
16081,broglie,2,14.403385,2,10.1266511,10.1266411,4,145.8580546,2,2,4,2,2,4,5,0.331981,0.33634,0,No
16096,britches,2,14.403385,2,10.1266511,10.1266411,4,145.8580546,2,2,4,2,2,4,4,0.412334,0.429539,0,No
16105,brink,2,14.403385,2,10.1266511,10.1266411,4,145.8580546,1,2,3,2,2,4,5,0.378631,0.394444,0,No
16109,brindisi,2,14.403385,2,10.1266511,10.1266411,4,145.8580546,2,2,4,2,2,4,5,0.346138,0.355164,0,No
16113,brighten,2,14.403385,2,10.1266511,10.1266411,4,145.8580546,1,1,2,1,1,2,5,0.34998,0.359708,0,No
16117,brigantine,2,14.403385,2,10.1266511,10.1266411,4,145.8580546,1,0,1,2,0,2,0,0,0,0,No
16138,briar,2,14.403385,2,10.1266511,10.1266411,4,145.8580546,1,2,3,1,2,3,5,0.321739,0.324902,0,No
16170,breakpoint,2,14.403385,2,10.1266511,10.1266411,4,145.8580546,1,2,3,1,2,3,5,0.375325,0.391883,0,No
16183,brazier,2,14.403385,2,10.1266511,10.1266411,4,145.8580546,1,2,3,1,2,3,5,0.327975,0.331736,0,No
16196,brandywine,2,14.403385,2,10.1266511,10.1266411,4,145.8580546,2,1,3,2,2,4,5,0.320467,0.324055,0,No
16225,bract,2,14.403385,2,10.1266511,10.1266411,4,145.8580546,2,2,4,2,2,4,5,0.331925,0.336983,0,No
16258,bouquet,2,14.403385,2,10.1266511,10.1266411,4,145.8580546,2,1,3,2,1,3,5,0.318295,0.321889,0,No
16260,bountiful,2,14.403385,2,10.1266511,10.1266411,4,145.8580546,2,2,4,2,2,4,5,0.384779,0.401003,0,No
16271,botulism,2,14.403385,2,10.1266511,10.1266411,4,145.8580546,1,1,2,1,1,2,5,0.306893,0.31196,0,No
16288,bose,2,14.403385,2,10.1266511,10.1266411,4,145.8580546,0,2,2,0,2,2,5,0.311542,0.316402,0,No
16306,borderland,2,14.403385,2,10.1266511,10.1266411,4,145.8580546,1,2,3,1,2,3,5,0.392348,0.409441,0,No
16309,bordello,2,14.403385,2,10.1266511,10.1266411,4,145.8580546,1,1,2,1,1,2,5,0.360829,0.373487,0,No
16316,bootleg,2,14.403385,2,10.1266511,10.1266411,4,145.8580546,2,2,4,2,2,4,5,0.34197,0.349895,0,No
16357,bombastic,2,14.403385,2,10.1266511,10.1266411,4,145.8580546,0,1,1,0,1,1,5,0.326504,0.329927,0,No
16371,boldface,2,14.403385,2,10.1266511,10.1266411,4,145.8580546,1,1,2,2,1,3,5,0.340155,0.347429,0,No
16379,bogus,2,14.403385,2,10.1266511,10.1266411,4,145.8580546,2,2,4,2,2,4,5,0.321733,0.325041,0,No
16402,boatman,2,14.403385,2,10.1266511,10.1266411,4,145.8580546,2,2,4,2,2,4,5,0.356367,0.368325,0,No
16420,blumenthal,2,14.403385,2,10.1266511,10.1266411,4,145.8580546,1,1,2,1,1,2,5,0.327618,0.332596,0,No
16429,bludgeon,2,14.403385,2,10.1266511,10.1266411,4,145.8580546,2,2,4,2,2,4,4,0.387729,0.40478,0,No
16431,blowup,2,14.403385,2,10.1266511,10.1266411,4,145.8580546,2,2,4,2,2,4,5,0.346835,0.356033,0,No
16436,blot,2,14.403385,2,10.1266511,10.1266411,4,145.8580546,2,2,4,2,2,4,5,0.378631,0.394444,0,No
16445,bloodline,2,14.403385,2,10.1266511,10.1266411,4,145.8580546,1,0,1,1,0,1,0,0,0,0,No
16465,blissful,2,14.403385,2,10.1266511,10.1266411,4,145.8580546,2,0,2,2,0,2,0,0,0,0,No
16472,blest,2,14.403385,2,10.1266511,10.1266411,4,145.8580546,2,1,3,2,2,4,5,0.317742,0.321293,0,No
16474,blenheim,2,14.403385,2,10.1266511,10.1266411,4,145.8580546,2,1,3,2,2,4,5,0.320855,0.32417,0,No
16519,bivouac,2,14.403385,2,10.1266511,10.1266411,4,145.8580546,2,2,4,2,2,4,5,0.345713,0.354618,0,No
16520,bivalve,2,14.403385,2,10.1266511,10.1266411,4,145.8580546,1,1,2,2,1,3,5,0.319786,0.323335,0,No
16524,bittersweet,2,14.403385,2,10.1266511,10.1266411,4,145.8580546,2,2,4,2,2,4,5,0.331832,0.33667,0,No
16539,birthright,2,14.403385,2,10.1266511,10.1266411,4,145.8580546,2,2,4,2,2,4,5,0.346098,0.354929,0,No
16547,birdcage,2,14.403385,2,10.1266511,10.1266411,4,145.8580546,2,1,3,2,1,3,5,0.384237,0.400402,0,No
16550,biracial,2,14.403385,2,10.1266511,10.1266411,4,145.8580546,2,1,3,2,1,3,5,0.384237,0.400402,0,No
16555,biotic,2,14.403385,2,10.1266511,10.1266411,4,145.8580546,1,2,3,2,2,4,5,0.35524,0.36697,0,No
16574,billiard,2,14.403385,2,10.1266511,10.1266411,4,145.8580546,1,1,2,1,1,2,5,0.322517,0.325736,0,No
16581,bilayer,2,14.403385,2,10.1266511,10.1266411,4,145.8580546,2,2,4,2,2,4,5,0.352734,0.363044,0,No
16591,bigamy,2,14.403385,2,10.1266511,10.1266411,4,145.8580546,2,2,4,2,2,4,5,0.39889,0.416645,0,No
16602,bibliophile,2,14.403385,2,10.1266511,10.1266411,4,145.8580546,1,1,2,2,1,3,5,0.324628,0.327943,0,No
16606,bibb,2,14.403385,2,10.1266511,10.1266411,4,145.8580546,2,1,3,2,2,4,5,0.325677,0.329423,0,No
16634,bestow,2,14.403385,2,10.1266511,10.1266411,4,145.8580546,2,1,3,2,1,3,5,0.325688,0.329447,0,No
16654,berserk,2,14.403385,2,10.1266511,10.1266411,4,145.8580546,1,2,3,1,2,3,5,0.315983,0.319872,0,No
16669,berman,2,14.403385,2,10.1266511,10.1266411,4,145.8580546,1,2,3,1,2,3,5,0.326485,0.33042,0,No
16676,beriberi,2,14.403385,2,10.1266511,10.1266411,4,145.8580546,2,2,4,2,2,4,5,0.384795,0.401031,0,No
16677,bergson,2,14.403385,2,10.1266511,10.1266411,4,145.8580546,1,2,3,2,2,4,5,0.316733,0.321188,0,No
16680,bergamot,2,14.403385,2,10.1266511,10.1266411,4,145.8580546,2,2,4,2,2,4,5,0.320167,0.323858,0,No
16709,benedikt,2,14.403385,2,10.1266511,10.1266411,4,145.8580546,1,2,3,1,2,3,5,0.384396,0.400599,0,No
16729,bellwether,2,14.403385,2,10.1266511,10.1266411,4,145.8580546,1,2,3,2,2,4,5,0.380661,0.396683,0,No
16765,begotten,2,14.403385,2,10.1266511,10.1266411,4,145.8580546,2,2,4,2,2,4,5,0.334382,0.340109,0,No
16799,bedridden,2,14.403385,2,10.1266511,10.1266411,4,145.8580546,2,2,4,2,2,4,5,0.385113,0.401392,0,No
16821,beater,2,14.403385,2,10.1266511,10.1266411,4,145.8580546,2,2,4,2,2,4,5,0.360954,0.373656,0,No
16856,battleground,2,14.403385,2,10.1266511,10.1266411,4,145.8580546,0,1,1,0,1,1,5,0.360828,0.373485,0,No
16906,barth,2,14.403385,2,10.1266511,10.1266411,4,145.8580546,2,2,4,2,2,4,5,0.345673,0.354596,0,No
16919,barrage,2,14.403385,2,10.1266511,10.1266411,4,145.8580546,1,0,1,1,0,1,0,0,0,0,No
16985,bandstand,2,14.403385,2,10.1266511,10.1266411,4,145.8580546,0,1,1,0,1,1,5,0.334224,0.341137,0,No
16995,bamako,2,14.403385,2,10.1266511,10.1266411,4,145.8580546,1,1,2,1,1,2,5,0.345599,0.354479,0,No
17002,balsa,2,14.403385,2,10.1266511,10.1266411,4,145.8580546,0,2,2,0,2,2,5,0.325713,0.329656,0,No
17032,bakelite,2,14.403385,2,10.1266511,10.1266411,4,145.8580546,1,1,2,2,1,3,5,0.384229,0.400392,0,No
17042,bagpipe,2,14.403385,2,10.1266511,10.1266411,4,145.8580546,2,2,4,2,2,4,5,0.340808,0.348105,0,No
17064,backspace,2,14.403385,2,10.1266511,10.1266411,4,145.8580546,2,1,3,2,1,3,5,0.309289,0.314116,0,No
17066,backslash,2,14.403385,2,10.1266511,10.1266411,4,145.8580546,2,2,4,2,2,4,4,0.405154,0.422704,0,No
17069,backhand,2,14.403385,2,10.1266511,10.1266411,4,145.8580546,2,2,4,2,2,4,5,0.343506,0.35165,0,No
17080,bacchus,2,14.403385,2,10.1266511,10.1266411,4,145.8580546,2,1,3,2,1,3,5,0.303192,0.308766,0,No
17089,babcock,2,14.403385,2,10.1266511,10.1266411,4,145.8580546,1,2,3,1,2,3,5,0.313733,0.318022,0,No
17103,axolotl,2,14.403385,2,10.1266511,10.1266411,4,145.8580546,2,2,4,2,2,4,5,0.33606,0.342272,0,No
17113,awoke,2,14.403385,2,10.1266511,10.1266411,4,145.8580546,2,1,3,2,1,3,5,0.341779,0.349674,0,No
17119,awesome,2,14.403385,2,10.1266511,10.1266411,4,145.8580546,2,1,3,2,1,3,5,0.326197,0.329645,0,No
17149,avail,2,14.403385,2,10.1266511,10.1266411,4,145.8580546,2,2,4,2,2,4,5,0.381438,0.397561,0,No
17185,auspicious,2,14.403385,2,10.1266511,10.1266411,4,145.8580546,2,1,3,2,1,3,5,0.398067,0.415814,0,No
17194,auntie,2,14.403385,2,10.1266511,10.1266411,4,145.8580546,2,2,4,2,2,4,5,0.398094,0.415861,0,No
17223,attrition,2,14.403385,2,10.1266511,10.1266411,4,145.8580546,1,2,3,2,2,4,4,0.387729,0.40478,0,No
17244,atrocity,2,14.403385,2,10.1266511,10.1266411,4,145.8580546,2,2,4,2,2,4,5,0.361933,0.374825,0,No
17266,athabascan,2,14.403385,2,10.1266511,10.1266411,4,145.8580546,1,2,3,1,2,3,5,0.332329,0.337135,0,No
17276,asunder,2,14.403385,2,10.1266511,10.1266411,4,145.8580546,0,2,2,0,2,2,5,0.344018,0.352464,0,No
17296,astarte,2,14.403385,2,10.1266511,10.1266411,4,145.8580546,1,1,2,1,1,2,5,0.384229,0.400392,0,No
17298,assure,2,14.403385,2,10.1266511,10.1266411,4,145.8580546,1,2,3,2,2,4,5,0.338934,0.345744,0,No
17334,ashmolean,2,14.403385,2,10.1266511,10.1266411,4,145.8580546,1,1,2,2,2,4,5,0.321146,0.324431,0,No
17360,artie,2,14.403385,2,10.1266511,10.1266411,4,145.8580546,1,2,3,1,2,3,5,0.398121,0.415885,0,No
17370,arterial,2,14.403385,2,10.1266511,10.1266411,4,145.8580546,2,1,3,2,1,3,5,0.326257,0.329715,0,No
17430,argumentative,2,14.403385,2,10.1266511,10.1266411,4,145.8580546,2,2,4,2,2,4,5,0.331639,0.336246,0,No
17434,argot,2,14.403385,2,10.1266511,10.1266411,4,145.8580546,2,2,4,2,2,4,5,0.32539,0.330787,0,No
17438,argo,2,14.403385,2,10.1266511,10.1266411,4,145.8580546,2,2,4,2,2,4,5,0.384387,0.40058,0,No
17448,ardent,2,14.403385,2,10.1266511,10.1266411,4,145.8580546,2,2,4,2,2,4,5,0.316965,0.321733,0,No
17462,archenemy,2,14.403385,2,10.1266511,10.1266411,4,145.8580546,2,2,4,2,2,4,5,0.34568,0.354591,0,No
17491,aquarius,2,14.403385,2,10.1266511,10.1266411,4,145.8580546,2,1,3,2,1,3,5,0.398067,0.415814,0,No
17509,appraisal,2,14.403385,2,10.1266511,10.1266411,4,145.8580546,1,0,1,1,0,1,0,0,0,0,No
17512,applicant,2,14.403385,2,10.1266511,10.1266411,4,145.8580546,2,2,4,2,2,4,5,0.347079,0.356103,0,No
17526,appellate,2,14.403385,2,10.1266511,10.1266411,4,145.8580546,0,0,0,0,0,0,0,0,0,0,No
17548,apologetic,2,14.403385,2,10.1266511,10.1266411,4,145.8580546,1,0,1,1,0,1,0,0,0,0,No
17590,antler,2,14.403385,2,10.1266511,10.1266411,4,145.8580546,1,1,2,1,1,2,5,0.345606,0.354483,0,No
17591,antisemitic,2,14.403385,2,10.1266511,10.1266411,4,145.8580546,2,2,4,2,2,4,5,0.326095,0.329367,0,No
17594,antiquarian,2,14.403385,2,10.1266511,10.1266411,4,145.8580546,2,2,4,2,2,4,5,0.327527,0.331236,0,No
17612,anthracite,2,14.403385,2,10.1266511,10.1266411,4,145.8580546,2,2,4,2,2,4,5,0.34037,0.347706,0,No
17628,antagonism,2,14.403385,2,10.1266511,10.1266411,4,145.8580546,2,2,4,2,2,4,5,0.361653,0.37452,0,No
17658,annihilate,2,14.403385,2,10.1266511,10.1266411,4,145.8580546,1,2,3,1,2,3,5,0.332503,0.337748,0,No
17676,animate,2,14.403385,2,10.1266511,10.1266411,4,145.8580546,1,2,3,2,2,4,5,0.319769,0.324394,0,No
17680,anhydrous,2,14.403385,2,10.1266511,10.1266411,4,145.8580546,2,1,3,2,1,3,5,0.300015,0.305751,0,No
17704,anecdote,2,14.403385,2,10.1266511,10.1266411,4,145.8580546,1,2,3,1,2,3,5,0.339921,0.347227,0,No
17735,anarchic,2,14.403385,2,10.1266511,10.1266411,4,145.8580546,0,1,1,0,1,1,5,0.320775,0.323994,0,No
17771,amoral,2,14.403385,2,10.1266511,10.1266411,4,145.8580546,2,1,3,2,1,3,5,0.336028,0.342206,0,No
17775,amoeboid,2,14.403385,2,10.1266511,10.1266411,4,145.8580546,2,1,3,2,1,3,6,0.243822,0.245307,0,No
17779,amniotic,2,14.403385,2,10.1266511,10.1266411,4,145.8580546,2,2,4,2,2,4,5,0.319062,0.322552,0,No
17785,ammonite,2,14.403385,2,10.1266511,10.1266411,4,145.8580546,1,1,2,1,1,2,5,0.323551,0.326892,0,No
17808,ambrosia,2,14.403385,2,10.1266511,10.1266411,4,145.8580546,2,2,4,2,2,4,5,0.331881,0.336607,0,No
17816,ambidextrous,2,14.403385,2,10.1266511,10.1266411,4,145.8580546,2,0,2,2,0,2,0,0,0,0,No
17820,amateurish,2,14.403385,2,10.1266511,10.1266411,4,145.8580546,1,2,3,1,2,3,5,0.332946,0.338766,0,No
17824,amalgam,2,14.403385,2,10.1266511,10.1266411,4,145.8580546,1,2,3,2,2,4,5,0.383093,0.39941,0,No
17878,alluvium,2,14.403385,2,10.1266511,10.1266411,4,145.8580546,2,2,4,2,2,4,5,0.346118,0.354853,0,No
17881,allusion,2,14.403385,2,10.1266511,10.1266411,4,145.8580546,1,1,2,2,2,4,5,0.359172,0.371523,0,No
17882,allure,2,14.403385,2,10.1266511,10.1266411,4,145.8580546,2,1,3,2,1,3,5,0.378607,0.394397,0,No
17888,allotted,2,14.403385,2,10.1266511,10.1266411,4,145.8580546,2,2,4,2,2,4,4,0.396724,0.414235,0,No
17922,alibi,2,14.403385,2,10.1266511,10.1266411,4,145.8580546,1,2,3,1,2,3,5,0.320369,0.323663,0,No
17959,alderman,2,14.403385,2,10.1266511,10.1266411,4,145.8580546,2,1,3,2,1,3,5,0.360829,0.373487,0,No
17967,alcoa,2,14.403385,2,10.1266511,10.1266411,4,145.8580546,1,1,2,1,1,2,5,0.341786,0.349679,0,No
17970,alcestis,2,14.403385,2,10.1266511,10.1266411,4,145.8580546,1,0,1,1,0,1,0,0,0,0,No
17993,alameda,2,14.403385,2,10.1266511,10.1266411,4,145.8580546,2,2,4,2,2,4,5,0.327111,0.331028,0,No
17994,alai,2,14.403385,2,10.1266511,10.1266411,4,145.8580546,0,1,1,0,1,1,5,0.384234,0.400398,0,No
18001,akers,2,14.403385,2,10.1266511,10.1266411,4,145.8580546,2,2,4,2,2,4,5,0.379076,0.395468,0,No
18014,airman,2,14.403385,2,10.1266511,10.1266411,4,145.8580546,1,1,2,1,1,2,5,0.324908,0.329012,0,No
18019,airflow,2,14.403385,2,10.1266511,10.1266411,4,145.8580546,0,2,2,0,2,2,5,0.378016,0.393742,0,No
18036,agronomy,2,14.403385,2,10.1266511,10.1266411,4,145.8580546,0,2,2,0,2,2,5,0.345618,0.354524,0,No
18071,afterbirth,2,14.403385,2,10.1266511,10.1266411,4,145.8580546,2,2,4,2,2,4,5,0.351088,0.361232,0,No
18072,afro,2,14.403385,2,10.1266511,10.1266411,4,145.8580546,1,1,2,1,1,2,5,0.343985,0.352404,0,No
18080,afire,2,14.403385,2,10.1266511,10.1266411,4,145.8580546,2,1,3,2,1,3,5,0.398076,0.415824,0,No
18081,afield,2,14.403385,2,10.1266511,10.1266411,4,145.8580546,2,1,3,2,1,3,5,0.398076,0.415824,0,No
18086,affluent,2,14.403385,2,10.1266511,10.1266411,4,145.8580546,1,1,2,2,2,4,5,0.378607,0.394397,0,No
18089,affirm,2,14.403385,2,10.1266511,10.1266411,4,145.8580546,2,2,4,2,2,4,5,0.342333,0.349997,0,No
18111,aegis,2,14.403385,2,10.1266511,10.1266411,4,145.8580546,1,2,3,1,2,3,5,0.384962,0.401214,0,No
18118,advisable,2,14.403385,2,10.1266511,10.1266411,4,145.8580546,2,2,4,2,2,4,5,0.359354,0.371757,0,No
18123,adversary,2,14.403385,2,10.1266511,10.1266411,4,145.8580546,1,2,3,1,2,3,5,0.335152,0.342309,0,No
18132,adulterous,2,14.403385,2,10.1266511,10.1266411,4,145.8580546,2,1,3,2,1,3,5,0.305451,0.310719,0,No
18141,adore,2,14.403385,2,10.1266511,10.1266411,4,145.8580546,0,1,1,0,1,1,5,0.327334,0.331133,0,No
18155,admire,2,14.403385,2,10.1266511,10.1266411,4,145.8580546,2,2,4,2,2,4,4,0.386437,0.402813,0,No
18171,adherent,2,14.403385,2,10.1266511,10.1266411,4,145.8580546,2,1,3,2,2,4,5,0.378607,0.394397,0,No
18199,acupuncture,2,14.403385,2,10.1266511,10.1266411,4,145.8580546,2,0,2,2,0,2,0,0,0,0,No
18201,actuarial,2,14.403385,2,10.1266511,10.1266411,4,145.8580546,1,1,2,1,1,2,5,0.323333,0.32659,0,No
18217,acrobatic,2,14.403385,2,10.1266511,10.1266411,4,145.8580546,1,1,2,1,1,2,5,0.322798,0.325959,0,No
18242,acetate,2,14.403385,2,10.1266511,10.1266411,4,145.8580546,2,1,3,2,1,3,5,0.311979,0.316596,0,No
18252,accreditation,2,14.403385,2,10.1266511,10.1266411,4,145.8580546,1,1,2,1,1,2,5,0.314851,0.319782,0,No
18265,acclamation,2,14.403385,2,10.1266511,10.1266411,4,145.8580546,2,2,4,2,2,4,5,0.40483,0.422185,0,No
18274,acceptor,2,14.403385,2,10.1266511,10.1266411,4,145.8580546,2,1,3,2,1,3,5,0.312672,0.317885,0,No
18292,abutting,2,14.403385,2,10.1266511,10.1266411,4,145.8580546,1,2,3,1,2,3,5,0.398103,0.41587,0,No
18307,absolution,2,14.403385,2,10.1266511,10.1266411,4,145.8580546,0,1,1,0,1,1,5,0.384234,0.400398,0,No
18323,aborigine,2,14.403385,2,10.1266511,10.1266411,4,145.8580546,1,1,2,1,1,2,5,0.398076,0.415824,0,No
18333,ablution,2,14.403385,2,10.1266511,10.1266411,4,145.8580546,1,0,1,1,0,1,0,0,0,0,No
18345,abelian,2,14.403385,2,10.1266511,10.1266411,4,145.8580546,2,1,3,2,1,3,5,0.325772,0.32925,0,No
18348,abduct,2,14.403385,2,10.1266511,10.1266411,4,145.8580546,1,2,3,2,2,4,5,0.37546,0.39201,0,No
18028,ail,1,14.403385,1,10.1266511,10.1266411,1,145.8580546,1,0,1,1,0,1,0,0,0,0,No
847,vernier,5,13.48709426,1,10.81979828,10.81979828,5,145.9276394,3,2,5,5,4,9,5,0.33019,0.334589,0,No
2090,tachyon,5,13.48709426,1,10.81979828,10.81979828,5,145.9276394,2,2,4,4,3,7,5,0.346239,0.355291,0,No
3053,soapstone,5,13.48709426,1,10.81979828,10.81979828,5,145.9276394,3,5,8,3,5,8,4,0.371663,0.386476,0,No
3833,schottky,5,13.48709426,1,10.81979828,10.81979828,5,145.9276394,3,4,7,4,4,8,5,0.350803,0.360746,0,No
4878,quicksand,5,13.48709426,1,10.81979828,10.81979828,5,145.9276394,4,5,9,4,5,9,4,0.396245,0.413667,0,No
5524,polonaise,5,13.48709426,1,10.81979828,10.81979828,5,145.9276394,3,5,8,4,5,9,5,0.374842,0.39006,0,No
6391,oxnard,5,13.48709426,1,10.81979828,10.81979828,5,145.9276394,3,4,7,3,4,7,4,0.40545,0.423018,0,No
6914,niobium,5,13.48709426,1,10.81979828,10.81979828,5,145.9276394,3,3,6,3,5,8,5,0.350409,0.360486,0,No
7268,mulatto,5,13.48709426,1,10.81979828,10.81979828,5,145.9276394,5,4,9,5,4,9,5,0.348626,0.358114,0,No
7770,meow,5,13.48709426,1,10.81979828,10.81979828,5,145.9276394,3,4,7,4,4,8,5,0.387847,0.404683,0,No
10274,hrothgar,5,13.48709426,1,10.81979828,10.81979828,5,145.9276394,3,3,6,4,3,7,4,0.413343,0.430539,0,No
11546,garnet,5,13.48709426,1,10.81979828,10.81979828,5,145.9276394,4,2,6,4,3,7,5,0.352566,0.363265,0,No
13007,egret,5,13.48709426,1,10.81979828,10.81979828,5,145.9276394,2,2,4,5,2,7,5,0.345673,0.354596,0,No
13120,dysprosium,5,13.48709426,1,10.81979828,10.81979828,5,145.9276394,2,2,4,2,4,6,5,0.350409,0.360486,0,No
13492,discriminant,5,13.48709426,1,10.81979828,10.81979828,5,145.9276394,1,2,3,5,5,10,5,0.385038,0.401526,0,No
14039,daguerreotype,5,13.48709426,1,10.81979828,10.81979828,5,145.9276394,3,3,6,5,4,9,5,0.350665,0.36081,0,No
14163,cubicle,5,13.48709426,1,10.81979828,10.81979828,5,145.9276394,4,4,8,5,5,10,5,0.375635,0.390928,0,No
17536,appanage,5,13.48709426,1,10.81979828,10.81979828,5,145.9276394,3,5,8,4,5,9,5,0.365194,0.378624,0,No
59,ytterbium,4,13.71023782,1,10.81979828,10.81979828,4,148.3420076,1,1,2,1,4,5,5,0.345606,0.354483,0,No
606,wallet,4,13.71023782,1,10.81979828,10.81979828,4,148.3420076,4,2,6,4,2,6,5,0.346118,0.355054,0,No
1239,ttl,4,13.71023782,1,10.81979828,10.81979828,4,148.3420076,4,3,7,4,4,8,5,0.345963,0.354995,0,No
1627,timex,4,13.71023782,1,10.81979828,10.81979828,4,148.3420076,2,2,4,2,3,5,5,0.33386,0.339173,0,No
2009,tapeworm,4,13.71023782,1,10.81979828,10.81979828,4,148.3420076,2,3,5,4,3,7,5,0.350956,0.361394,0,No
2263,surety,4,13.71023782,1,10.81979828,10.81979828,4,148.3420076,2,1,3,4,3,7,5,0.320201,0.323462,0,No
2269,supra,4,13.71023782,1,10.81979828,10.81979828,4,148.3420076,2,3,5,3,4,7,5,0.365616,0.37915,0,No
2717,squirt,4,13.71023782,1,10.81979828,10.81979828,4,148.3420076,1,4,5,4,4,8,4,0.401861,0.419549,0,No
2882,spat,4,13.71023782,1,10.81979828,10.81979828,4,148.3420076,4,3,7,4,4,8,5,0.336034,0.342153,0,No
3322,silage,4,13.71023782,1,10.81979828,10.81979828,4,148.3420076,3,1,4,3,1,4,5,0.336021,0.342018,0,No
4422,rheum,4,13.71023782,1,10.81979828,10.81979828,4,148.3420076,4,3,7,4,3,7,5,0.346991,0.356173,0,No
4622,refutation,4,13.71023782,1,10.81979828,10.81979828,4,148.3420076,3,4,7,4,4,8,5,0.364654,0.378089,0,No
5188,promethium,4,13.71023782,1,10.81979828,10.81979828,4,148.3420076,3,1,4,3,4,7,5,0.345599,0.354479,0,No
5504,polyploidy,4,13.71023782,1,10.81979828,10.81979828,4,148.3420076,3,2,5,3,2,5,5,0.331646,0.336391,0,No
6594,ombudsman,4,13.71023782,1,10.81979828,10.81979828,4,148.3420076,3,4,7,4,4,8,4,0.361152,0.373749,0,No
7504,mobil,4,13.71023782,1,10.81979828,10.81979828,4,148.3420076,3,3,6,4,3,7,5,0.356389,0.368325,0,No
8276,maggot,4,13.71023782,1,10.81979828,10.81979828,4,148.3420076,3,2,5,3,3,6,5,0.345646,0.354563,0,No
8646,limnology,4,13.71023782,1,10.81979828,10.81979828,4,148.3420076,3,2,5,3,2,5,5,0.369405,0.383823,0,No
8832,leatherback,4,13.71023782,1,10.81979828,10.81979828,4,148.3420076,1,3,4,4,3,7,5,0.344012,0.352166,0,No
8948,langur,4,13.71023782,1,10.81979828,10.81979828,4,148.3420076,2,2,4,2,2,4,5,0.355219,0.366942,0,No
9940,incubi,4,13.71023782,1,10.81979828,10.81979828,4,148.3420076,4,4,8,4,4,8,5,0.342155,0.349638,0,No
10126,iconoclasm,4,13.71023782,1,10.81979828,10.81979828,4,148.3420076,2,3,5,2,3,5,5,0.345922,0.354664,0,No
11281,gob,4,13.71023782,1,10.81979828,10.81979828,4,148.3420076,3,3,6,3,3,6,5,0.340455,0.347838,0,No
11325,glitch,4,13.71023782,1,10.81979828,10.81979828,4,148.3420076,2,3,5,3,3,6,5,0.349946,0.359952,0,No
11622,gadolinium,4,13.71023782,1,10.81979828,10.81979828,4,148.3420076,1,1,2,2,1,3,5,0.345599,0.354479,0,No
11629,gaberones,4,13.71023782,1,10.81979828,10.81979828,4,148.3420076,4,3,7,4,3,7,4,0.387729,0.40478,0,No
12527,excise,4,13.71023782,1,10.81979828,10.81979828,4,148.3420076,3,3,6,3,4,7,5,0.336716,0.343075,0,No
13605,diatomaceous,4,13.71023782,1,10.81979828,10.81979828,4,148.3420076,4,1,5,4,4,8,5,0.322969,0.326681,0,No
14484,coplanar,4,13.71023782,1,10.81979828,10.81979828,4,148.3420076,3,2,5,4,2,6,5,0.338037,0.344464,0,No
15277,chicano,4,13.71023782,1,10.81979828,10.81979828,4,148.3420076,3,3,6,3,3,6,4,0.389772,0.406512,0,No
15659,carcinogen,4,13.71023782,1,10.81979828,10.81979828,4,148.3420076,2,4,6,4,4,8,4,0.390132,0.407282,0,No
16587,bigot,4,13.71023782,1,10.81979828,10.81979828,4,148.3420076,3,3,6,4,4,8,5,0.371508,0.386168,0,No
16683,beresford,4,13.71023782,1,10.81979828,10.81979828,4,148.3420076,4,3,7,4,3,7,5,0.347527,0.356962,0,No
17189,auriga,4,13.71023782,1,10.81979828,10.81979828,4,148.3420076,2,4,6,4,4,8,5,0.343114,0.351185,0,No
17388,arpeggio,4,13.71023782,1,10.81979828,10.81979828,4,148.3420076,3,2,5,4,3,7,5,0.348921,0.358671,0,No
115,yarmulke,3,13.99791989,1,10.81979828,10.81979828,3,151.4546696,3,3,6,3,3,6,5,0.34945,0.359521,0,No
121,yank,3,13.99791989,1,10.81979828,10.81979828,3,151.4546696,1,2,3,1,3,4,5,0.349374,0.359427,0,No
157,writeup,3,13.99791989,1,10.81979828,10.81979828,3,151.4546696,1,3,4,3,3,6,5,0.362984,0.376277,0,No
517,waveguide,3,13.99791989,1,10.81979828,10.81979828,3,151.4546696,2,1,3,2,1,3,5,0.319395,0.322743,0,No
688,vole,3,13.99791989,1,10.81979828,10.81979828,3,151.4546696,2,2,4,2,2,4,5,0.346469,0.355544,0,No
1374,trastevere,3,13.99791989,1,10.81979828,10.81979828,3,151.4546696,1,2,3,3,2,5,5,0.41002,0.427616,0,No
2089,tacit,3,13.99791989,1,10.81979828,10.81979828,3,151.4546696,1,2,3,2,3,5,5,0.328412,0.333573,0,No
2295,suntan,3,13.99791989,1,10.81979828,10.81979828,3,151.4546696,2,1,3,2,3,5,6,0.262931,0.26748,0,No
2814,spinster,3,13.99791989,1,10.81979828,10.81979828,3,151.4546696,2,1,3,3,3,6,5,0.345599,0.354479,0,No
2981,somersault,3,13.99791989,1,10.81979828,10.81979828,3,151.4546696,2,3,5,2,3,5,5,0.35025,0.360488,0,No
3218,skid,3,13.99791989,1,10.81979828,10.81979828,3,151.4546696,2,1,3,2,3,5,5,0.320224,0.32338,0,No
3244,sis,3,13.99791989,1,10.81979828,10.81979828,3,151.4546696,2,2,4,2,2,4,5,0.320919,0.324224,0,No
3516,shank,3,13.99791989,1,10.81979828,10.81979828,3,151.4546696,2,2,4,3,3,6,4,0.405154,0.422704,0,No
3556,sew,3,13.99791989,1,10.81979828,10.81979828,3,151.4546696,2,2,4,3,2,5,5,0.347466,0.356595,0,No
3976,saprophyte,3,13.99791989,1,10.81979828,10.81979828,3,151.4546696,3,2,5,3,2,5,5,0.36662,0.380527,0,No
4493,resplendent,3,13.99791989,1,10.81979828,10.81979828,3,151.4546696,2,1,3,3,3,6,5,0.298562,0.304437,0,No
4900,quasar,3,13.99791989,1,10.81979828,10.81979828,3,151.4546696,1,2,3,2,3,5,5,0.347011,0.356195,0,No
5026,pulsar,3,13.99791989,1,10.81979828,10.81979828,3,151.4546696,3,3,6,3,3,6,4,0.407582,0.425023,0,No
5179,prong,3,13.99791989,1,10.81979828,10.81979828,3,151.4546696,0,1,1,0,1,1,5,0.30821,0.313122,0,No
5705,pitchfork,3,13.99791989,1,10.81979828,10.81979828,3,151.4546696,2,2,4,2,2,4,5,0.336838,0.342924,0,No
6336,palindromic,3,13.99791989,1,10.81979828,10.81979828,3,151.4546696,2,1,3,3,1,4,5,0.317118,0.320858,0,No
7198,mutter,3,13.99791989,1,10.81979828,10.81979828,3,151.4546696,2,3,5,2,3,5,4,0.387297,0.403775,0,No
7632,mila,3,13.99791989,1,10.81979828,10.81979828,3,151.4546696,2,0,2,2,0,2,0,0,0,0,No
7769,mephistopheles,3,13.99791989,1,10.81979828,10.81979828,3,151.4546696,2,2,4,2,2,4,5,0.352042,0.362347,0,No
7934,mazurka,3,13.99791989,1,10.81979828,10.81979828,3,151.4546696,1,1,2,3,3,6,5,0.345599,0.354479,0,No
8174,manama,3,13.99791989,1,10.81979828,10.81979828,3,151.4546696,2,3,5,2,3,5,5,0.348298,0.357957,0,No
8189,malthusian,3,13.99791989,1,10.81979828,10.81979828,3,151.4546696,3,3,6,3,3,6,5,0.32206,0.325426,0,No
8826,lectern,3,13.99791989,1,10.81979828,10.81979828,3,151.4546696,1,3,4,3,3,6,5,0.365917,0.379748,0,No
9202,kerchief,3,13.99791989,1,10.81979828,10.81979828,3,151.4546696,2,2,4,2,2,4,5,0.355632,0.367058,0,No
9234,kayo,3,13.99791989,1,10.81979828,10.81979828,3,151.4546696,1,2,3,1,2,3,5,0.328175,0.332431,0,No
9516,jablonsky,3,13.99791989,1,10.81979828,10.81979828,3,151.4546696,2,2,4,2,2,4,5,0.332684,0.337481,0,No
9544,isotherm,3,13.99791989,1,10.81979828,10.81979828,3,151.4546696,1,0,1,1,0,1,0,0,0,0,No
9587,ironstone,3,13.99791989,1,10.81979828,10.81979828,3,151.4546696,2,2,4,2,2,4,5,0.318873,0.322549,0,No
9626,invitee,3,13.99791989,1,10.81979828,10.81979828,3,151.4546696,1,3,4,3,3,6,5,0.37098,0.385558,0,No
9847,inflammable,3,13.99791989,1,10.81979828,10.81979828,3,151.4546696,2,1,3,3,1,4,5,0.384237,0.400402,0,No
9889,inelastic,3,13.99791989,1,10.81979828,10.81979828,3,151.4546696,2,1,3,3,2,5,5,0.311903,0.316335,0,No
10071,imagen,3,13.99791989,1,10.81979828,10.81979828,3,151.4546696,1,1,2,2,2,4,5,0.320461,0.323715,0,No
10107,idiotic,3,13.99791989,1,10.81979828,10.81979828,3,151.4546696,2,1,3,2,3,5,5,0.398076,0.415824,0,No
10352,hooch,3,13.99791989,1,10.81979828,10.81979828,3,151.4546696,2,2,4,2,2,4,5,0.34853,0.358051,0,No
10398,holster,3,13.99791989,1,10.81979828,10.81979828,3,151.4546696,3,3,6,3,3,6,4,0.425806,0.442229,0,No
10493,hillock,3,13.99791989,1,10.81979828,10.81979828,3,151.4546696,1,2,3,3,3,6,4,0.405163,0.422713,0,No
11135,graviton,3,13.99791989,1,10.81979828,10.81979828,3,151.4546696,3,1,4,3,1,4,5,0.345599,0.354479,0,No
11312,glossolalia,3,13.99791989,1,10.81979828,10.81979828,3,151.4546696,3,2,5,3,2,5,5,0.360317,0.37324,0,No
11539,garvey,3,13.99791989,1,10.81979828,10.81979828,3,151.4546696,2,3,5,2,3,5,4,0.378623,0.395105,0,No
11554,gardenia,3,13.99791989,1,10.81979828,10.81979828,3,151.4546696,1,2,3,1,2,3,5,0.349367,0.359422,0,No
11672,fumble,3,13.99791989,1,10.81979828,10.81979828,3,151.4546696,1,1,2,1,1,2,5,0.338011,0.344413,0,No
12175,fieldwork,3,13.99791989,1,10.81979828,10.81979828,3,151.4546696,2,3,5,2,3,5,5,0.356181,0.367833,0,No
12414,extroversion,3,13.99791989,1,10.81979828,10.81979828,3,151.4546696,1,3,4,3,3,6,5,0.355326,0.366617,0,No
12423,extractor,3,13.99791989,1,10.81979828,10.81979828,3,151.4546696,1,2,3,1,2,3,4,0.405154,0.422704,0,No
12641,etch,3,13.99791989,1,10.81979828,10.81979828,3,151.4546696,1,2,3,1,2,3,5,0.349079,0.358424,0,No
12727,equine,3,13.99791989,1,10.81979828,10.81979828,3,151.4546696,2,0,2,2,0,2,0,0,0,0,No
12861,emitter,3,13.99791989,1,10.81979828,10.81979828,3,151.4546696,1,2,3,3,2,5,4,0.422422,0.439097,0,No
13190,dugong,3,13.99791989,1,10.81979828,10.81979828,3,151.4546696,2,2,4,2,2,4,5,0.384237,0.400402,0,No
13787,delphinus,3,13.99791989,1,10.81979828,10.81979828,3,151.4546696,2,1,3,3,1,4,5,0.323894,0.32813,0,No
14863,colorimeter,3,13.99791989,1,10.81979828,10.81979828,3,151.4546696,2,3,5,3,3,6,5,0.354602,0.365809,0,No
15894,butene,3,13.99791989,1,10.81979828,10.81979828,3,151.4546696,2,1,3,2,1,3,5,0.340155,0.347429,0,No
15943,burette,3,13.99791989,1,10.81979828,10.81979828,3,151.4546696,3,3,6,3,3,6,5,0.354149,0.365072,0,No
16159,breccia,3,13.99791989,1,10.81979828,10.81979828,3,151.4546696,2,2,4,3,2,5,5,0.323074,0.327107,0,No
16515,blackball,3,13.99791989,1,10.81979828,10.81979828,3,151.4546696,1,2,3,2,2,4,5,0.326401,0.330086,0,No
17608,anthropomorphism,3,13.99791989,1,10.81979828,10.81979828,3,151.4546696,2,2,4,2,2,4,4,0.405163,0.422713,0,No
18239,acetylene,3,13.99791989,1,10.81979828,10.81979828,3,151.4546696,1,1,2,1,2,3,5,0.345599,0.354479,0,No
99,yellowknife,2,14.403385,1,10.81979828,10.81979828,2,155.8417203,2,2,4,2,2,4,5,0.336021,0.342018,0,No
420,whelan,2,14.403385,1,10.81979828,10.81979828,2,155.8417203,2,2,4,2,2,4,5,0.322681,0.325858,0,No
450,wert,2,14.403385,1,10.81979828,10.81979828,2,155.8417203,1,2,3,2,2,4,5,0.325635,0.32948,0,No
462,weller,2,14.403385,1,10.81979828,10.81979828,2,155.8417203,1,2,3,2,2,4,5,0.325003,0.328335,0,No
536,waterhouse,2,14.403385,1,10.81979828,10.81979828,2,155.8417203,2,2,4,2,2,4,5,0.328807,0.332487,0,No
587,wappinger,2,14.403385,1,10.81979828,10.81979828,2,155.8417203,1,2,3,1,2,3,5,0.349663,0.359364,0,No
616,waldron,2,14.403385,1,10.81979828,10.81979828,2,155.8417203,2,2,4,2,2,4,5,0.346381,0.355474,0,No
637,wag,2,14.403385,1,10.81979828,10.81979828,2,155.8417203,1,2,3,1,2,3,5,0.361321,0.374081,0,No
638,waffle,2,14.403385,1,10.81979828,10.81979828,2,155.8417203,1,2,3,2,2,4,5,0.346003,0.354981,0,No
715,vitreous,2,14.403385,1,10.81979828,10.81979828,2,155.8417203,0,1,1,0,1,1,5,0.290797,0.296999,0,No
716,vito,2,14.403385,1,10.81979828,10.81979828,2,155.8417203,1,1,2,1,1,2,5,0.305994,0.311318,0,No
866,verbatim,2,14.403385,1,10.81979828,10.81979828,2,155.8417203,1,0,1,1,0,1,0,0,0,0,No
1116,tyrosine,2,14.403385,1,10.81979828,10.81979828,2,155.8417203,1,2,3,2,2,4,5,0.334817,0.340297,0,No
1122,typo,2,14.403385,1,10.81979828,10.81979828,2,155.8417203,2,1,3,2,1,3,5,0.345599,0.354479,0,No
1196,turbojet,2,14.403385,1,10.81979828,10.81979828,2,155.8417203,1,0,1,1,0,1,0,0,0,0,No
1309,trilobite,2,14.403385,1,10.81979828,10.81979828,2,155.8417203,1,1,2,1,1,2,5,0.324415,0.328228,0,No
1315,trig,2,14.403385,1,10.81979828,10.81979828,2,155.8417203,2,1,3,2,2,4,5,0.323257,0.326421,0,No
1509,torpedoes,2,14.403385,1,10.81979828,10.81979828,2,155.8417203,2,2,4,2,2,4,5,0.385063,0.401345,0,No
1654,tid,2,14.403385,1,10.81979828,10.81979828,2,155.8417203,0,2,2,0,2,2,4,0.399047,0.416667,0,No
1665,thyroxine,2,14.403385,1,10.81979828,10.81979828,2,155.8417203,2,1,3,2,2,4,5,0.398076,0.415824,0,No
1921,telekinesis,2,14.403385,1,10.81979828,10.81979828,2,155.8417203,1,2,3,1,2,3,5,0.347337,0.356694,0,No
1935,teeing,2,14.403385,1,10.81979828,10.81979828,2,155.8417203,1,2,3,2,2,4,5,0.326221,0.329836,0,No
1998,tarpon,2,14.403385,1,10.81979828,10.81979828,2,155.8417203,1,0,1,1,0,1,0,0,0,0,No
2132,syndic,2,14.403385,1,10.81979828,10.81979828,2,155.8417203,2,2,4,2,2,4,5,0.385038,0.401526,0,No
2197,sweatband,2,14.403385,1,10.81979828,10.81979828,2,155.8417203,2,2,4,2,2,4,5,0.336901,0.342924,0,No
2224,suzerain,2,14.403385,1,10.81979828,10.81979828,2,155.8417203,1,2,3,2,2,4,4,0.40098,0.418643,0,No
2399,sublimate,2,14.403385,1,10.81979828,10.81979828,2,155.8417203,2,2,4,2,2,4,5,0.363512,0.376745,0,No
2605,steen,2,14.403385,1,10.81979828,10.81979828,2,155.8417203,1,2,3,2,2,4,5,0.332983,0.33784,0,No
2662,staphylococcus,2,14.403385,1,10.81979828,10.81979828,2,155.8417203,1,0,1,1,0,1,0,0,0,0,No
2663,staph,2,14.403385,1,10.81979828,10.81979828,2,155.8417203,1,0,1,2,0,2,0,0,0,0,No
2671,standby,2,14.403385,1,10.81979828,10.81979828,2,155.8417203,1,0,1,2,0,2,0,0,0,0,No
2847,speedwell,2,14.403385,1,10.81979828,10.81979828,2,155.8417203,2,1,3,2,1,3,5,0.338011,0.344413,0,No
2848,speedup,2,14.403385,1,10.81979828,10.81979828,2,155.8417203,0,2,2,0,2,2,5,0.344098,0.352543,0,No
2878,spay,2,14.403385,1,10.81979828,10.81979828,2,155.8417203,1,1,2,1,1,2,5,0.345599,0.354479,0,No
2880,spatula,2,14.403385,1,10.81979828,10.81979828,2,155.8417203,2,1,3,2,1,3,5,0.331138,0.336083,0,No
2903,spacesuit,2,14.403385,1,10.81979828,10.81979828,2,155.8417203,2,1,3,2,1,3,5,0.345599,0.354479,0,No
2919,southey,2,14.403385,1,10.81979828,10.81979828,2,155.8417203,1,2,3,1,2,3,5,0.384387,0.40059,0,No
3075,snider,2,14.403385,1,10.81979828,10.81979828,2,155.8417203,1,2,3,2,2,4,5,0.32545,0.32889,0,No
3097,smother,2,14.403385,1,10.81979828,10.81979828,2,155.8417203,2,1,3,2,2,4,5,0.321617,0.325126,0,No
3138,sloppy,2,14.403385,1,10.81979828,10.81979828,2,155.8417203,2,1,3,2,2,4,5,0.323787,0.327159,0,No
3217,skiff,2,14.403385,1,10.81979828,10.81979828,2,155.8417203,1,2,3,1,2,3,5,0.384371,0.400571,0,No
3259,sinh,2,14.403385,1,10.81979828,10.81979828,2,155.8417203,1,0,1,1,0,1,0,0,0,0,No
3288,simper,2,14.403385,1,10.81979828,10.81979828,2,155.8417203,2,2,4,2,2,4,4,0.384795,0.401034,0,No
3366,sibley,2,14.403385,1,10.81979828,10.81979828,2,155.8417203,1,2,3,1,2,3,5,0.347909,0.357464,0,No
3453,shimmy,2,14.403385,1,10.81979828,10.81979828,2,155.8417203,2,2,4,2,2,4,6,0.259097,0.262853,0,No
3460,sherrill,2,14.403385,1,10.81979828,10.81979828,2,155.8417203,1,2,3,1,2,3,5,0.347909,0.357464,0,No
3484,sheepskin,2,14.403385,1,10.81979828,10.81979828,2,155.8417203,2,0,2,2,0,2,0,0,0,0,No
3598,serf,2,14.403385,1,10.81979828,10.81979828,2,155.8417203,1,1,2,2,2,4,5,0.345599,0.354479,0,No
3989,sanitary,2,14.403385,1,10.81979828,10.81979828,2,155.8417203,1,1,2,1,1,2,6,0.268617,0.27384,0,No
4157,rumpus,2,14.403385,1,10.81979828,10.81979828,2,155.8417203,1,1,2,2,2,4,5,0.322423,0.325662,0,No
4187,rubaiyat,2,14.403385,1,10.81979828,10.81979828,2,155.8417203,2,2,4,2,2,4,5,0.381201,0.39726,0,No
4289,rockland,2,14.403385,1,10.81979828,10.81979828,2,155.8417203,2,2,4,2,2,4,5,0.346226,0.3553,0,No
4347,riordan,2,14.403385,1,10.81979828,10.81979828,2,155.8417203,1,2,3,2,2,4,5,0.327201,0.331335,0,No
4455,retrofitting,2,14.403385,1,10.81979828,10.81979828,2,155.8417203,1,1,2,2,1,3,5,0.345606,0.354483,0,No
4465,retentive,2,14.403385,1,10.81979828,10.81979828,2,155.8417203,0,1,1,0,1,1,5,0.326924,0.33095,0,No
4467,retardation,2,14.403385,1,10.81979828,10.81979828,2,155.8417203,1,0,1,2,0,2,0,0,0,0,No
4540,repartee,2,14.403385,1,10.81979828,10.81979828,2,155.8417203,2,2,4,2,2,4,5,0.345639,0.354549,0,No
4550,rennet,2,14.403385,1,10.81979828,10.81979828,2,155.8417203,2,2,4,2,2,4,5,0.349367,0.359422,0,No
4556,rend,2,14.403385,1,10.81979828,10.81979828,2,155.8417203,0,1,1,0,1,1,5,0.318982,0.322622,0,No
4707,readout,2,14.403385,1,10.81979828,10.81979828,2,155.8417203,1,2,3,2,2,4,5,0.349367,0.359422,0,No
4863,quip,2,14.403385,1,10.81979828,10.81979828,2,155.8417203,2,2,4,2,2,4,4,0.389755,0.406475,0,No
4874,quiescent,2,14.403385,1,10.81979828,10.81979828,2,155.8417203,2,0,2,2,0,2,0,0,0,0,No
4897,quaver,2,14.403385,1,10.81979828,10.81979828,2,155.8417203,1,2,3,2,2,4,5,0.360917,0.373609,0,No
4904,quartic,2,14.403385,1,10.81979828,10.81979828,2,155.8417203,2,0,2,2,0,2,0,0,0,0,No
4966,putt,2,14.403385,1,10.81979828,10.81979828,2,155.8417203,1,2,3,1,2,3,5,0.359798,0.372297,0,No
5036,puke,2,14.403385,1,10.81979828,10.81979828,2,155.8417203,0,1,1,0,1,1,5,0.345598,0.354477,0,No
5143,prosciutto,2,14.403385,1,10.81979828,10.81979828,2,155.8417203,2,0,2,2,0,2,0,0,0,0,No
5159,prophesy,2,14.403385,1,10.81979828,10.81979828,2,155.8417203,1,1,2,1,2,3,5,0.345599,0.354479,0,No
5192,prolong,2,14.403385,1,10.81979828,10.81979828,2,155.8417203,2,2,4,2,2,4,5,0.313966,0.318173,0,No
5230,prod,2,14.403385,1,10.81979828,10.81979828,2,155.8417203,1,2,3,1,2,3,4,0.389755,0.406475,0,No
5356,praseodymium,2,14.403385,1,10.81979828,10.81979828,2,155.8417203,0,2,2,0,2,2,5,0.350408,0.360484,0,No
5393,potentiometer,2,14.403385,1,10.81979828,10.81979828,2,155.8417203,2,2,4,2,2,4,5,0.330559,0.33513,0,No
5514,polyhedral,2,14.403385,1,10.81979828,10.81979828,2,155.8417203,1,1,2,1,1,2,5,0.314874,0.318839,0,No
5698,pittsfield,2,14.403385,1,10.81979828,10.81979828,2,155.8417203,1,2,3,1,2,3,5,0.346936,0.356101,0,No
5741,pinehurst,2,14.403385,1,10.81979828,10.81979828,2,155.8417203,2,2,4,2,2,4,5,0.346226,0.3553,0,No
5866,phantasy,2,14.403385,1,10.81979828,10.81979828,2,155.8417203,1,1,2,1,2,3,5,0.323776,0.326926,0,No
5873,pewee,2,14.403385,1,10.81979828,10.81979828,2,155.8417203,1,1,2,1,2,3,5,0.321897,0.32525,0,No
5893,petal,2,14.403385,1,10.81979828,10.81979828,2,155.8417203,2,2,4,2,2,4,5,0.369405,0.383823,0,No
6037,penates,2,14.403385,1,10.81979828,10.81979828,2,155.8417203,1,1,2,1,1,2,5,0.332391,0.337648,0,No
6230,parka,2,14.403385,1,10.81979828,10.81979828,2,155.8417203,1,2,3,2,2,4,5,0.359245,0.371888,0,No
6298,pantheist,2,14.403385,1,10.81979828,10.81979828,2,155.8417203,2,1,3,2,1,3,5,0.311634,0.316168,0,No
6526,optometry,2,14.403385,1,10.81979828,10.81979828,2,155.8417203,2,1,3,2,1,3,5,0.375317,0.391855,0,No
6564,ontogeny,2,14.403385,1,10.81979828,10.81979828,2,155.8417203,2,0,2,2,0,2,0,0,0,0,No
6578,oncology,2,14.403385,1,10.81979828,10.81979828,2,155.8417203,0,1,1,0,2,2,5,0.345598,0.354477,0,No
6672,ocular,2,14.403385,1,10.81979828,10.81979828,2,155.8417203,2,0,2,2,0,2,0,0,0,0,No
6709,obstinate,2,14.403385,1,10.81979828,10.81979828,2,155.8417203,2,2,4,2,2,4,5,0.385196,0.401468,0,No
6729,obligate,2,14.403385,1,10.81979828,10.81979828,2,155.8417203,2,0,2,2,0,2,0,0,0,0,No
6762,nutria,2,14.403385,1,10.81979828,10.81979828,2,155.8417203,2,1,3,2,1,3,5,0.334937,0.340901,0,No
6782,nuclide,2,14.403385,1,10.81979828,10.81979828,2,155.8417203,1,2,3,1,2,3,5,0.354092,0.365058,0,No
6926,nil,2,14.403385,1,10.81979828,10.81979828,2,155.8417203,1,1,2,2,2,4,5,0.312254,0.316792,0,No
6928,nihilist,2,14.403385,1,10.81979828,10.81979828,2,155.8417203,1,2,3,2,2,4,5,0.325832,0.329334,0,No
6978,newsman,2,14.403385,1,10.81979828,10.81979828,2,155.8417203,1,2,3,2,2,4,5,0.354191,0.365413,0,No
7065,necromancy,2,14.403385,1,10.81979828,10.81979828,2,155.8417203,1,1,2,1,2,3,5,0.345599,0.354479,0,No
7097,nay,2,14.403385,1,10.81979828,10.81979828,2,155.8417203,2,2,4,2,2,4,5,0.345599,0.354479,0,No
7201,mutineer,2,14.403385,1,10.81979828,10.81979828,2,155.8417203,2,1,3,2,2,4,5,0.336021,0.342018,0,No
7218,muskegon,2,14.403385,1,10.81979828,10.81979828,2,155.8417203,2,2,4,2,2,4,5,0.324065,0.328201,0,No
7242,munition,2,14.403385,1,10.81979828,10.81979828,2,155.8417203,1,2,3,1,2,3,5,0.343805,0.352822,0,No
7257,multiplicand,2,14.403385,1,10.81979828,10.81979828,2,155.8417203,1,1,2,1,1,2,5,0.384237,0.400402,0,No
7295,mow,2,14.403385,1,10.81979828,10.81979828,2,155.8417203,2,1,3,2,1,3,5,0.332161,0.339406,0,No
7427,monochromator,2,14.403385,1,10.81979828,10.81979828,2,155.8417203,1,1,2,2,1,3,5,0.398067,0.415814,0,No
7477,mohammedan,2,14.403385,1,10.81979828,10.81979828,2,155.8417203,1,1,2,2,2,4,5,0.325976,0.330994,0,No
7557,minuend,2,14.403385,1,10.81979828,10.81979828,2,155.8417203,2,2,4,2,2,4,5,0.345612,0.354516,0,No
7595,mimicked,2,14.403385,1,10.81979828,10.81979828,2,155.8417203,2,1,3,2,1,3,5,0.297038,0.303021,0,No
7681,miaow,2,14.403385,1,10.81979828,10.81979828,2,155.8417203,2,1,3,2,1,3,5,0.345599,0.354479,0,No
7743,merrimack,2,14.403385,1,10.81979828,10.81979828,2,155.8417203,1,2,3,2,2,4,5,0.331627,0.336484,0,No
7883,mcnally,2,14.403385,1,10.81979828,10.81979828,2,155.8417203,1,2,3,1,2,3,5,0.329222,0.334601,0,No
8000,mastic,2,14.403385,1,10.81979828,10.81979828,2,155.8417203,2,2,4,2,2,4,5,0.32311,0.326264,0,No
8008,masseur,2,14.403385,1,10.81979828,10.81979828,2,155.8417203,1,2,3,2,2,4,5,0.39821,0.415974,0,No
8025,mascara,2,14.403385,1,10.81979828,10.81979828,2,155.8417203,0,0,0,0,0,0,0,0,0,0,No
8130,mantissa,2,14.403385,1,10.81979828,10.81979828,2,155.8417203,1,1,2,1,1,2,5,0.329253,0.333542,0,No
8222,maladroit,2,14.403385,1,10.81979828,10.81979828,2,155.8417203,1,1,2,1,2,3,5,0.325856,0.329672,0,No
8287,madsen,2,14.403385,1,10.81979828,10.81979828,2,155.8417203,1,2,3,2,2,4,5,0.324071,0.327721,0,No
8295,madhouse,2,14.403385,1,10.81979828,10.81979828,2,155.8417203,1,1,2,1,1,2,6,0.245624,0.247137,0,No
8327,macdougall,2,14.403385,1,10.81979828,10.81979828,2,155.8417203,1,1,2,1,1,2,5,0.345599,0.354479,0,No
8694,licensee,2,14.403385,1,10.81979828,10.81979828,2,155.8417203,2,2,4,2,2,4,5,0.367965,0.381994,0,No
9001,lager,2,14.403385,1,10.81979828,10.81979828,2,155.8417203,2,2,4,2,2,4,5,0.328942,0.333336,0,No
9021,labradorite,2,14.403385,1,10.81979828,10.81979828,2,155.8417203,2,2,4,2,2,4,5,0.352566,0.363265,0,No
9200,kern,2,14.403385,1,10.81979828,10.81979828,2,155.8417203,1,1,2,2,2,4,5,0.325677,0.329423,0,No
9215,kennan,2,14.403385,1,10.81979828,10.81979828,2,155.8417203,1,1,2,2,1,3,5,0.319136,0.322512,0,No
9239,katydid,2,14.403385,1,10.81979828,10.81979828,2,155.8417203,2,1,3,2,1,3,5,0.319464,0.322891,0,No
9322,jukes,2,14.403385,1,10.81979828,10.81979828,2,155.8417203,1,2,3,1,2,3,5,0.365352,0.378816,0,No
9384,johnstown,2,14.403385,1,10.81979828,10.81979828,2,155.8417203,1,2,3,1,2,3,5,0.321728,0.325038,0,No
9397,jog,2,14.403385,1,10.81979828,10.81979828,2,155.8417203,2,2,4,2,2,4,5,0.360851,0.373534,0,No
9454,jejune,2,14.403385,1,10.81979828,10.81979828,2,155.8417203,2,1,3,2,1,3,5,0.314728,0.318831,0,No
9648,invariable,2,14.403385,1,10.81979828,10.81979828,2,155.8417203,1,2,3,2,2,4,5,0.320902,0.324148,0,No
9778,inquest,2,14.403385,1,10.81979828,10.81979828,2,155.8417203,2,1,3,2,1,3,5,0.324089,0.327327,0,No
9799,injun,2,14.403385,1,10.81979828,10.81979828,2,155.8417203,2,1,3,2,2,4,5,0.310321,0.315231,0,No
9844,inflate,2,14.403385,1,10.81979828,10.81979828,2,155.8417203,1,1,2,2,1,3,5,0.332391,0.337648,0,No
9957,incommensurable,2,14.403385,1,10.81979828,10.81979828,2,155.8417203,2,2,4,2,2,4,5,0.33172,0.336321,0,No
10037,impeller,2,14.403385,1,10.81979828,10.81979828,2,155.8417203,2,1,3,2,1,3,5,0.360829,0.373487,0,No
10065,immanent,2,14.403385,1,10.81979828,10.81979828,2,155.8417203,1,2,3,2,2,4,5,0.347235,0.356108,0,No
10149,hysterectomy,2,14.403385,1,10.81979828,10.81979828,2,155.8417203,1,2,3,2,2,4,5,0.346374,0.355508,0,No
10158,hypochlorous,2,14.403385,1,10.81979828,10.81979828,2,155.8417203,2,1,3,2,2,4,5,0.318244,0.321897,0,No
10160,hypnotic,2,14.403385,1,10.81979828,10.81979828,2,155.8417203,2,0,2,2,0,2,0,0,0,0,No
10194,hydrangea,2,14.403385,1,10.81979828,10.81979828,2,155.8417203,1,2,3,1,2,3,5,0.325509,0.329652,0,No
10276,hoy,2,14.403385,1,10.81979828,10.81979828,2,155.8417203,1,1,2,1,1,2,0,0,0,0,No
10336,horehound,2,14.403385,1,10.81979828,10.81979828,2,155.8417203,1,1,2,1,1,2,5,0.345599,0.354479,0,No
10401,holography,2,14.403385,1,10.81979828,10.81979828,2,155.8417203,2,2,4,2,2,4,5,0.349973,0.360103,0,No
10405,holmium,2,14.403385,1,10.81979828,10.81979828,2,155.8417203,1,1,2,1,2,3,5,0.345606,0.354483,0,No
10597,herbarium,2,14.403385,1,10.81979828,10.81979828,2,155.8417203,1,2,3,2,2,4,5,0.369689,0.384037,0,No
10706,headstrong,2,14.403385,1,10.81979828,10.81979828,2,155.8417203,1,2,3,1,2,3,5,0.336652,0.343571,0,No
10929,haddad,2,14.403385,1,10.81979828,10.81979828,2,155.8417203,0,2,2,0,2,2,5,0.361261,0.37402,0,No
11332,glenda,2,14.403385,1,10.81979828,10.81979828,2,155.8417203,2,2,4,2,2,4,5,0.398094,0.415861,0,No
11349,glamor,2,14.403385,1,10.81979828,10.81979828,2,155.8417203,2,1,3,2,1,3,5,0.378607,0.394397,0,No
11399,gibbous,2,14.403385,1,10.81979828,10.81979828,2,155.8417203,0,2,2,0,2,2,5,0.329981,0.334294,0,No
11472,genesco,2,14.403385,1,10.81979828,10.81979828,2,155.8417203,2,2,4,2,2,4,5,0.319786,0.323225,0,No
11620,gaff,2,14.403385,1,10.81979828,10.81979828,2,155.8417203,2,2,4,2,2,4,5,0.398085,0.415828,0,No
11682,fujitsu,2,14.403385,1,10.81979828,10.81979828,2,155.8417203,2,1,3,2,1,3,0,0,0,0,No
11768,freehold,2,14.403385,1,10.81979828,10.81979828,2,155.8417203,1,1,2,2,1,3,5,0.318672,0.322077,0,No
11954,foci,2,14.403385,1,10.81979828,10.81979828,2,155.8417203,2,2,4,2,2,4,5,0.389473,0.406167,0,No
12007,flogging,2,14.403385,1,10.81979828,10.81979828,2,155.8417203,1,2,3,1,2,3,5,0.350409,0.360486,0,No
12116,firebreak,2,14.403385,1,10.81979828,10.81979828,2,155.8417203,1,2,3,2,2,4,5,0.346699,0.355812,0,No
12129,fingertip,2,14.403385,1,10.81979828,10.81979828,2,155.8417203,1,2,3,2,2,4,5,0.384504,0.400716,0,No
12212,ferrite,2,14.403385,1,10.81979828,10.81979828,2,155.8417203,1,2,3,1,2,3,4,0.389661,0.406362,0,No
12318,farley,2,14.403385,1,10.81979828,10.81979828,2,155.8417203,1,2,3,1,2,3,5,0.347909,0.357464,0,No
12373,fag,2,14.403385,1,10.81979828,10.81979828,2,155.8417203,2,2,4,2,2,4,5,0.378494,0.395196,0,No
12605,eumenides,2,14.403385,1,10.81979828,10.81979828,2,155.8417203,1,2,3,1,2,3,5,0.335551,0.341175,0,No
12724,equipoise,2,14.403385,1,10.81979828,10.81979828,2,155.8417203,1,1,2,2,2,4,5,0.384246,0.400407,0,No
12753,epiphyte,2,14.403385,1,10.81979828,10.81979828,2,155.8417203,1,1,2,2,1,3,5,0.345599,0.354479,0,No
12771,eohippus,2,14.403385,1,10.81979828,10.81979828,2,155.8417203,0,2,2,0,2,2,5,0.386249,0.402651,0,No
12914,elmhurst,2,14.403385,1,10.81979828,10.81979828,2,155.8417203,2,2,4,2,2,4,5,0.346936,0.356101,0,No
12976,eldon,2,14.403385,1,10.81979828,10.81979828,2,155.8417203,1,2,3,1,2,3,5,0.347909,0.357464,0,No
13003,eh,2,14.403385,1,10.81979828,10.81979828,2,155.8417203,1,2,3,1,2,3,5,0.346665,0.355774,0,No
13015,egalitarian,2,14.403385,1,10.81979828,10.81979828,2,155.8417203,2,2,4,2,2,4,5,0.361793,0.374546,0,No
13023,efferent,2,14.403385,1,10.81979828,10.81979828,2,155.8417203,1,0,1,1,0,1,0,0,0,0,No
13066,econometric,2,14.403385,1,10.81979828,10.81979828,2,155.8417203,1,1,2,1,2,3,5,0.323104,0.326216,0,No
13081,eben,2,14.403385,1,10.81979828,10.81979828,2,155.8417203,0,1,1,0,1,1,5,0.316706,0.320553,0,No
13166,dunlap,2,14.403385,1,10.81979828,10.81979828,2,155.8417203,1,2,3,1,2,3,5,0.347909,0.357464,0,No
13249,dreyfuss,2,14.403385,1,10.81979828,10.81979828,2,155.8417203,2,2,4,2,2,4,5,0.33794,0.344199,0,No
13418,doberman,2,14.403385,1,10.81979828,10.81979828,2,155.8417203,1,0,1,2,0,2,0,0,0,0,No
13481,dismissal,2,14.403385,1,10.81979828,10.81979828,2,155.8417203,1,1,2,1,1,2,5,0.375317,0.391855,0,No
13535,dinghy,2,14.403385,1,10.81979828,10.81979828,2,155.8417203,2,1,3,2,1,3,5,0.338011,0.344413,0,No
13536,ding,2,14.403385,1,10.81979828,10.81979828,2,155.8417203,2,2,4,2,2,4,5,0.384246,0.400407,0,No
13558,digitalis,2,14.403385,1,10.81979828,10.81979828,2,155.8417203,2,1,3,2,2,4,5,0.345599,0.354479,0,No
13659,deuteron,2,14.403385,1,10.81979828,10.81979828,2,155.8417203,1,2,3,1,2,3,4,0.412191,0.429633,0,No
13686,despicable,2,14.403385,1,10.81979828,10.81979828,2,155.8417203,2,1,3,2,2,4,5,0.321623,0.325136,0,No
13875,declarative,2,14.403385,1,10.81979828,10.81979828,2,155.8417203,1,2,3,1,2,3,5,0.321914,0.325151,0,No
13914,debonair,2,14.403385,1,10.81979828,10.81979828,2,155.8417203,0,1,1,0,1,1,5,0.398072,0.415819,0,No
14266,creosote,2,14.403385,1,10.81979828,10.81979828,2,155.8417203,2,2,4,2,2,4,5,0.3224,0.325849,0,No
14272,creekside,2,14.403385,1,10.81979828,10.81979828,2,155.8417203,2,2,4,2,2,4,5,0.346672,0.355878,0,No
14368,countryman,2,14.403385,1,10.81979828,10.81979828,2,155.8417203,0,1,1,0,1,1,5,0.341779,0.349673,0,No
14412,coset,2,14.403385,1,10.81979828,10.81979828,2,155.8417203,2,0,2,2,0,2,0,0,0,0,No
14483,copolymer,2,14.403385,1,10.81979828,10.81979828,2,155.8417203,1,2,3,2,2,4,5,0.329204,0.333702,0,No
14646,conjure,2,14.403385,1,10.81979828,10.81979828,2,155.8417203,2,1,3,2,1,3,5,0.322429,0.325646,0,No
14699,conductance,2,14.403385,1,10.81979828,10.81979828,2,155.8417203,0,1,1,0,1,1,5,0.345598,0.354477,0,No
14793,compassionate,2,14.403385,1,10.81979828,10.81979828,2,155.8417203,1,1,2,2,1,3,5,0.31797,0.322601,0,No
14901,colgate,2,14.403385,1,10.81979828,10.81979828,2,155.8417203,2,1,3,2,1,3,5,0.320305,0.323598,0,No
14928,coffman,2,14.403385,1,10.81979828,10.81979828,2,155.8417203,1,1,2,2,2,4,5,0.30354,0.308955,0,No
14958,cochineal,2,14.403385,1,10.81979828,10.81979828,2,155.8417203,2,1,3,2,2,4,5,0.384237,0.400402,0,No
15003,clotho,2,14.403385,1,10.81979828,10.81979828,2,155.8417203,2,1,3,2,1,3,5,0.281766,0.287891,0,No
15069,clausius,2,14.403385,1,10.81979828,10.81979828,2,155.8417203,2,2,4,2,2,4,5,0.369689,0.384037,0,No
15246,chippendale,2,14.403385,1,10.81979828,10.81979828,2,155.8417203,2,2,4,2,2,4,5,0.326329,0.330193,0,No
15298,cherubim,2,14.403385,1,10.81979828,10.81979828,2,155.8417203,0,2,2,0,2,2,5,0.319689,0.32324,0,No
15407,chalice,2,14.403385,1,10.81979828,10.81979828,2,155.8417203,2,1,3,2,1,3,5,0.343985,0.352404,0,No
15640,cargill,2,14.403385,1,10.81979828,10.81979828,2,155.8417203,1,1,2,1,1,2,5,0.314439,0.31876,0,No
15665,carbondale,2,14.403385,1,10.81979828,10.81979828,2,155.8417203,1,2,3,1,2,3,5,0.346936,0.356101,0,No
15900,bustard,2,14.403385,1,10.81979828,10.81979828,2,155.8417203,1,1,2,1,1,2,5,0.325688,0.329029,0,No
16017,buckhorn,2,14.403385,1,10.81979828,10.81979828,2,155.8417203,1,2,3,1,2,3,5,0.346672,0.355878,0,No
16040,brushfire,2,14.403385,1,10.81979828,10.81979828,2,155.8417203,1,0,1,1,0,1,0,0,0,0,No
16135,brice,2,14.403385,1,10.81979828,10.81979828,2,155.8417203,1,1,2,2,2,4,5,0.326503,0.329927,0,No
16157,breech,2,14.403385,1,10.81979828,10.81979828,2,155.8417203,2,2,4,2,2,4,5,0.325462,0.329142,0,No
16378,bogy,2,14.403385,1,10.81979828,10.81979828,2,155.8417203,1,2,3,1,2,3,5,0.349367,0.359422,0,No
16480,blazon,2,14.403385,1,10.81979828,10.81979828,2,155.8417203,1,2,3,1,2,3,5,0.332366,0.337401,0,No
16639,bessel,2,14.403385,1,10.81979828,10.81979828,2,155.8417203,2,2,4,2,2,4,5,0.326059,0.329457,0,No
16752,belch,2,14.403385,1,10.81979828,10.81979828,2,155.8417203,2,1,3,2,1,3,5,0.329828,0.334465,0,No
16876,bastion,2,14.403385,1,10.81979828,10.81979828,2,155.8417203,2,2,4,2,2,4,5,0.339103,0.345896,0,No
16994,bamberger,2,14.403385,1,10.81979828,10.81979828,2,155.8417203,1,0,1,2,0,2,0,0,0,0,No
17060,backwash,2,14.403385,1,10.81979828,10.81979828,2,155.8417203,1,1,2,2,1,3,5,0.398067,0.415814,0,No
17087,babel,2,14.403385,1,10.81979828,10.81979828,2,155.8417203,2,1,3,2,1,3,6,0.279587,0.285682,0,No
17131,avocet,2,14.403385,1,10.81979828,10.81979828,2,155.8417203,1,2,3,1,2,3,5,0.35131,0.361086,0,No
17168,autoclave,2,14.403385,1,10.81979828,10.81979828,2,155.8417203,2,2,4,2,2,4,5,0.350409,0.360486,0,No
17217,auctioneer,2,14.403385,1,10.81979828,10.81979828,2,155.8417203,1,1,2,2,1,3,5,0.320705,0.324646,0,No
17277,asuncion,2,14.403385,1,10.81979828,10.81979828,2,155.8417203,2,2,4,2,2,4,5,0.336021,0.342018,0,No
17443,arequipa,2,14.403385,1,10.81979828,10.81979828,2,155.8417203,1,1,2,1,1,2,0,0,0,0,No
17524,appendage,2,14.403385,1,10.81979828,10.81979828,2,155.8417203,2,2,4,2,2,4,5,0.363088,0.376214,0,No
17615,anther,2,14.403385,1,10.81979828,10.81979828,2,155.8417203,1,1,2,2,1,3,5,0.398067,0.415814,0,No
17651,annul,2,14.403385,1,10.81979828,10.81979828,2,155.8417203,1,1,2,2,2,4,5,0.398076,0.415824,0,No
17696,angeline,2,14.403385,1,10.81979828,10.81979828,2,155.8417203,2,2,4,2,2,4,5,0.322008,0.325605,0,No
17748,anacreon,2,14.403385,1,10.81979828,10.81979828,2,155.8417203,1,1,2,1,2,3,5,0.360829,0.373487,0,No
17842,altimeter,2,14.403385,1,10.81979828,10.81979828,2,155.8417203,1,1,2,1,1,2,5,0.340162,0.347434,0,No
17873,almagest,2,14.403385,1,10.81979828,10.81979828,2,155.8417203,1,2,3,2,2,4,5,0.3791,0.395721,0,No
18012,airpark,2,14.403385,1,10.81979828,10.81979828,2,155.8417203,1,1,2,2,1,3,5,0.345606,0.354483,0,No
18093,afferent,2,14.403385,1,10.81979828,10.81979828,2,155.8417203,0,0,0,0,0,0,0,0,0,0,No
18206,activate,2,14.403385,1,10.81979828,10.81979828,2,155.8417203,1,1,2,2,1,3,5,0.345599,0.354479,0,No
18226,acme,2,14.403385,1,10.81979828,10.81979828,2,155.8417203,1,0,1,1,0,1,0,0,0,0,No
18233,achromatic,2,14.403385,1,10.81979828,10.81979828,2,155.8417203,0,1,1,0,1,1,5,0.318725,0.322147,0,No
18299,abstinent,2,14.403385,1,10.81979828,10.81979828,2,155.8417203,2,2,4,2,2,4,5,0.343313,0.351489,0,No
12265,feb,1,15.09653218,4,10.81979828,10.81979828,4,163.341433,1,1,2,1,1,2,5,0.32178,0.324907,0,No
17204,aug,1,15.09653218,4,10.81979828,10.81979828,4,163.341433,1,1,2,1,1,2,5,0.384237,0.400402,0,No
62,yourselves,1,15.09653218,1,10.81979828,10.81979828,1,163.341433,1,0,1,1,0,1,0,0,0,0,Yes
24,zilch,1,15.09653218,1,10.81979828,10.81979828,1,163.341433,1,1,2,1,1,2,5,0.32071,0.32465,0,No
39,zazen,1,15.09653218,1,10.81979828,10.81979828,1,163.341433,1,1,2,1,1,2,5,0.326347,0.330278,0,No
47,ywca,1,15.09653218,1,10.81979828,10.81979828,1,163.341433,1,1,2,1,1,2,5,0.324148,0.327721,0,No
53,yuh,1,15.09653218,1,10.81979828,10.81979828,1,163.341433,0,1,1,0,1,1,5,0.326552,0.330051,0,No
60,ypsilanti,1,15.09653218,1,10.81979828,10.81979828,1,163.341433,1,1,2,1,1,2,5,0.384237,0.400402,0,No
74,yore,1,15.09653218,1,10.81979828,10.81979828,1,163.341433,1,0,1,1,0,1,0,0,0,0,No
90,yesteryear,1,15.09653218,1,10.81979828,10.81979828,1,163.341433,1,1,2,1,1,2,5,0.384237,0.400402,0,No
93,yeomen,1,15.09653218,1,10.81979828,10.81979828,1,163.341433,1,1,2,1,1,2,5,0.378607,0.394397,0,No
94,yeomanry,1,15.09653218,1,10.81979828,10.81979828,1,163.341433,1,1,2,1,1,2,5,0.384237,0.400402,0,No
95,yeoman,1,15.09653218,1,10.81979828,10.81979828,1,163.341433,1,1,2,1,1,2,5,0.321035,0.327202,0,No
119,yaounde,1,15.09653218,1,10.81979828,10.81979828,1,163.341433,1,1,2,1,1,2,5,0.315097,0.320424,0,No
147,wy,1,15.09653218,1,10.81979828,10.81979828,1,163.341433,1,0,1,1,0,1,0,0,0,0,No
148,wv,1,15.09653218,1,10.81979828,10.81979828,1,163.341433,1,1,2,1,1,2,5,0.324314,0.327946,0,No
149,wuhan,1,15.09653218,1,10.81979828,10.81979828,1,163.341433,1,1,2,1,1,2,5,0.325169,0.328458,0,No
154,wrongdoing,1,15.09653218,1,10.81979828,10.81979828,1,163.341433,1,0,1,1,0,1,0,0,0,0,No
160,wristwatch,1,15.09653218,1,10.81979828,10.81979828,1,163.341433,1,1,2,1,1,2,5,0.345599,0.354479,0,No
166,wretch,1,15.09653218,1,10.81979828,10.81979828,1,163.341433,1,1,2,1,1,2,6,0.246207,0.247682,0,No
170,wreckage,1,15.09653218,1,10.81979828,10.81979828,1,163.341433,1,1,2,1,1,2,5,0.378607,0.394397,0,No
174,wrathful,1,15.09653218,1,10.81979828,10.81979828,1,163.341433,1,1,2,1,1,2,5,0.360829,0.373487,0,No
198,workspace,1,15.09653218,1,10.81979828,10.81979828,1,163.341433,0,0,0,0,0,0,0,0,0,0,No
200,worksheet,1,15.09653218,1,10.81979828,10.81979828,1,163.341433,1,1,2,1,1,2,5,0.331274,0.335753,0,No
207,workbench,1,15.09653218,1,10.81979828,10.81979828,1,163.341433,1,1,2,1,1,2,5,0.328619,0.333504,0,No
214,wop,1,15.09653218,1,10.81979828,10.81979828,1,163.341433,0,1,1,0,1,1,5,0.31333,0.317655,0,No
248,wold,1,15.09653218,1,10.81979828,10.81979828,1,163.341433,1,0,1,1,0,1,0,0,0,0,No
252,woeful,1,15.09653218,1,10.81979828,10.81979828,1,163.341433,1,1,2,1,1,2,5,0.325283,0.329025,0,No
260,withstood,1,15.09653218,1,10.81979828,10.81979828,1,163.341433,1,1,2,1,1,2,5,0.329112,0.333417,0,No
264,withhold,1,15.09653218,1,10.81979828,10.81979828,1,163.341433,1,1,2,1,1,2,5,0.398076,0.415824,0,No
265,wither,1,15.09653218,1,10.81979828,10.81979828,1,163.341433,1,1,2,1,1,2,5,0.384237,0.400402,0,No
274,wistful,1,15.09653218,1,10.81979828,10.81979828,1,163.341433,1,1,2,1,1,2,5,0.310316,0.314972,0,No
276,wishbone,1,15.09653218,1,10.81979828,10.81979828,1,163.341433,0,0,0,0,0,0,0,0,0,0,No
291,winnetka,1,15.09653218,1,10.81979828,10.81979828,1,163.341433,1,1,2,1,1,2,5,0.320201,0.323386,0,No
303,windswept,1,15.09653218,1,10.81979828,10.81979828,1,163.341433,1,1,2,1,1,2,5,0.316553,0.320315,0,No
304,windstorm,1,15.09653218,1,10.81979828,10.81979828,1,163.341433,1,1,2,1,1,2,5,0.332161,0.339406,0,No
306,windshield,1,15.09653218,1,10.81979828,10.81979828,1,163.341433,1,1,2,1,1,2,5,0.375317,0.391855,0,No
324,willful,1,15.09653218,1,10.81979828,10.81979828,1,163.341433,0,1,1,0,1,1,5,0.320902,0.324877,0,No
326,willa,1,15.09653218,1,10.81979828,10.81979828,1,163.341433,1,1,2,1,1,2,5,0.280786,0.287068,0,No
336,wile,1,15.09653218,1,10.81979828,10.81979828,1,163.341433,1,1,2,1,1,2,5,0.285404,0.291667,0,No
344,wilcox,1,15.09653218,1,10.81979828,10.81979828,1,163.341433,1,1,2,1,1,2,5,0.345599,0.354479,0,No
346,wightman,1,15.09653218,1,10.81979828,10.81979828,1,163.341433,1,1,2,1,1,2,5,0.328546,0.33268,0,No
347,wiggly,1,15.09653218,1,10.81979828,10.81979828,1,163.341433,1,1,2,1,1,2,5,0.323569,0.326815,0,No
349,wiggins,1,15.09653218,1,10.81979828,10.81979828,1,163.341433,0,1,1,0,1,1,5,0.378604,0.394393,0,No
353,wield,1,15.09653218,1,10.81979828,10.81979828,1,163.341433,1,1,2,1,1,2,5,0.314851,0.318997,0,No
383,whither,1,15.09653218,1,10.81979828,10.81979828,1,163.341433,0,0,0,0,0,0,0,0,0,0,No
400,whim,1,15.09653218,1,10.81979828,10.81979828,1,163.341433,1,1,2,1,1,2,5,0.378607,0.394397,0,No
405,whey,1,15.09653218,1,10.81979828,10.81979828,1,163.341433,1,1,2,1,1,2,5,0.375317,0.391855,0,No
409,wheresoever,1,15.09653218,1,10.81979828,10.81979828,1,163.341433,1,1,2,1,1,2,5,0.32582,0.329549,0,No
411,wherefore,1,15.09653218,1,10.81979828,10.81979828,1,163.341433,0,1,1,0,1,1,5,0.343984,0.352403,0,No
418,whelp,1,15.09653218,1,10.81979828,10.81979828,1,163.341433,0,1,1,0,1,1,5,0.360828,0.373485,0,No
422,wheelbase,1,15.09653218,1,10.81979828,10.81979828,1,163.341433,1,1,2,1,1,2,5,0.321431,0.324683,0,No
427,whatley,1,15.09653218,1,10.81979828,10.81979828,1,163.341433,1,1,2,1,1,2,5,0.317566,0.321152,0,No
441,westfield,1,15.09653218,1,10.81979828,10.81979828,1,163.341433,1,1,2,1,1,2,5,0.32597,0.329306,0,No
449,werther,1,15.09653218,1,10.81979828,10.81979828,1,163.341433,1,0,1,1,0,1,0,0,0,0,No
463,wellbeing,1,15.09653218,1,10.81979828,10.81979828,1,163.341433,1,1,2,1,1,2,5,0.378607,0.394397,0,No
470,weiss,1,15.09653218,1,10.81979828,10.81979828,1,163.341433,1,1,2,1,1,2,5,0.326155,0.329752,0,No
475,weighty,1,15.09653218,1,10.81979828,10.81979828,1,163.341433,1,0,1,1,0,1,0,0,0,0,No
478,weierstrass,1,15.09653218,1,10.81979828,10.81979828,1,163.341433,1,0,1,1,0,1,0,0,0,0,No
484,weedy,1,15.09653218,1,10.81979828,10.81979828,1,163.341433,1,0,1,1,0,1,0,0,0,0,No
504,weal,1,15.09653218,1,10.81979828,10.81979828,1,163.341433,1,1,2,1,1,2,5,0.326353,0.330283,0,No
509,wayside,1,15.09653218,1,10.81979828,10.81979828,1,163.341433,1,1,2,1,1,2,5,0.307148,0.312183,0,No
515,wavenumber,1,15.09653218,1,10.81979828,10.81979828,1,163.341433,1,0,1,1,0,1,0,0,0,0,No
528,watertight,1,15.09653218,1,10.81979828,10.81979828,1,163.341433,1,1,2,1,1,2,5,0.326359,0.329865,0,No
535,waterline,1,15.09653218,1,10.81979828,10.81979828,1,163.341433,1,1,2,1,1,2,5,0.384237,0.400402,0,No
537,waterhole,1,15.09653218,1,10.81979828,10.81979828,1,163.341433,1,1,2,1,1,2,5,0.322417,0.325658,0,No
547,watchful,1,15.09653218,1,10.81979828,10.81979828,1,163.341433,1,1,2,1,1,2,5,0.321198,0.324427,0,No
552,wastewater,1,15.09653218,1,10.81979828,10.81979828,1,163.341433,1,0,1,1,0,1,0,0,0,0,No
556,wasserman,1,15.09653218,1,10.81979828,10.81979828,1,163.341433,0,1,1,0,1,1,5,0.321728,0.325933,0,No
564,warty,1,15.09653218,1,10.81979828,10.81979828,1,163.341433,1,1,2,1,1,2,5,0.322446,0.325554,0,No
572,warplane,1,15.09653218,1,10.81979828,10.81979828,1,163.341433,1,1,2,1,1,2,5,0.318484,0.32199,0,No
577,waring,1,15.09653218,1,10.81979828,10.81979828,1,163.341433,1,1,2,1,1,2,5,0.384237,0.400402,0,No
585,warburton,1,15.09653218,1,10.81979828,10.81979828,1,163.341433,1,1,2,1,1,2,5,0.315697,0.320525,0,No
613,walkout,1,15.09653218,1,10.81979828,10.81979828,1,163.341433,1,1,2,1,1,2,5,0.320473,0.324064,0,No
614,walkie,1,15.09653218,1,10.81979828,10.81979828,1,163.341433,0,1,1,0,1,1,6,0.245336,0.246778,0,No
621,wakeup,1,15.09653218,1,10.81979828,10.81979828,1,163.341433,0,1,1,0,1,1,5,0.321065,0.32439,0,No
624,waive,1,15.09653218,1,10.81979828,10.81979828,1,163.341433,1,1,2,1,1,2,5,0.334225,0.341138,0,No
639,wafer,1,15.09653218,1,10.81979828,10.81979828,1,163.341433,1,0,1,1,0,1,0,0,0,0,No
643,wad,1,15.09653218,1,10.81979828,10.81979828,1,163.341433,1,0,1,1,0,1,0,0,0,0,No
651,vying,1,15.09653218,1,10.81979828,10.81979828,1,163.341433,1,1,2,1,1,2,5,0.343985,0.352404,0,No
667,voracious,1,15.09653218,1,10.81979828,10.81979828,1,163.341433,1,1,2,1,1,2,6,0.278508,0.284499,0,No
674,voluminous,1,15.09653218,1,10.81979828,10.81979828,1,163.341433,1,1,2,1,1,2,5,0.384237,0.400402,0,No
687,volition,1,15.09653218,1,10.81979828,10.81979828,1,163.341433,1,1,2,1,1,2,5,0.384237,0.400402,0,No
705,vivo,1,15.09653218,1,10.81979828,10.81979828,1,163.341433,1,0,1,1,0,1,0,0,0,0,No
710,vivacious,1,15.09653218,1,10.81979828,10.81979828,1,163.341433,1,1,2,1,1,2,5,0.314662,0.318741,0,No
739,virtuosity,1,15.09653218,1,10.81979828,10.81979828,1,163.341433,1,1,2,1,1,2,6,0.247036,0.248717,0,No
740,virtuosi,1,15.09653218,1,10.81979828,10.81979828,1,163.341433,1,1,2,1,1,2,5,0.311094,0.315795,0,No
743,virile,1,15.09653218,1,10.81979828,10.81979828,1,163.341433,1,1,2,1,1,2,5,0.320902,0.324877,0,No
747,virginal,1,15.09653218,1,10.81979828,10.81979828,1,163.341433,0,1,1,0,1,1,5,0.324629,0.327943,0,No
758,vintner,1,15.09653218,1,10.81979828,10.81979828,1,163.341433,1,1,2,1,1,2,5,0.326233,0.33041,0,No
766,vinaigrette,1,15.09653218,1,10.81979828,10.81979828,1,163.341433,1,1,2,1,1,2,5,0.345599,0.354479,0,No
778,vigilant,1,15.09653218,1,10.81979828,10.81979828,1,163.341433,0,1,1,0,1,1,5,0.398072,0.415819,0,No
806,viburnum,1,15.09653218,1,10.81979828,10.81979828,1,163.341433,1,1,2,1,1,2,5,0.384237,0.400402,0,No
810,vial,1,15.09653218,1,10.81979828,10.81979828,1,163.341433,0,0,0,0,0,0,0,0,0,0,No
819,vetch,1,15.09653218,1,10.81979828,10.81979828,1,163.341433,1,0,1,1,0,1,0,0,0,0,No
823,vestibule,1,15.09653218,1,10.81979828,10.81979828,1,163.341433,1,1,2,1,1,2,5,0.32681,0.33159,0,No
827,vesper,1,15.09653218,1,10.81979828,10.81979828,1,163.341433,1,0,1,1,0,1,0,0,0,0,No
857,verity,1,15.09653218,1,10.81979828,10.81979828,1,163.341433,0,1,1,0,1,1,5,0.310187,0.314883,0,No
858,verisimilitude,1,15.09653218,1,10.81979828,10.81979828,1,163.341433,1,1,2,1,1,2,5,0.384237,0.400402,0,No
864,verdant,1,15.09653218,1,10.81979828,10.81979828,1,163.341433,1,1,2,1,1,2,5,0.309531,0.314326,0,No
865,verbena,1,15.09653218,1,10.81979828,10.81979828,1,163.341433,1,1,2,1,1,2,5,0.35519,0.366885,0,No
869,veranda,1,15.09653218,1,10.81979828,10.81979828,1,163.341433,0,1,1,0,1,1,5,0.317113,0.321038,0,No
870,veracity,1,15.09653218,1,10.81979828,10.81979828,1,163.341433,1,1,2,1,1,2,5,0.355198,0.36689,0,No
884,vengeful,1,15.09653218,1,10.81979828,10.81979828,1,163.341433,1,1,2,1,1,2,5,0.316909,0.320839,0,No
890,venerate,1,15.09653218,1,10.81979828,10.81979828,1,163.341433,1,1,2,1,1,2,5,0.312375,0.317214,0,No
892,veneer,1,15.09653218,1,10.81979828,10.81979828,1,163.341433,1,1,2,1,1,2,5,0.384237,0.400402,0,No
895,vend,1,15.09653218,1,10.81979828,10.81979828,1,163.341433,1,0,1,1,0,1,0,0,0,0,No
901,velar,1,15.09653218,1,10.81979828,10.81979828,1,163.341433,0,1,1,0,1,1,6,0.277592,0.283489,0,No
904,vehicular,1,15.09653218,1,10.81979828,10.81979828,1,163.341433,1,0,1,1,0,1,0,0,0,0,No
926,vasectomy,1,15.09653218,1,10.81979828,10.81979828,1,163.341433,0,1,1,0,1,1,5,0.338882,0.345659,0,No
937,vanquish,1,15.09653218,1,10.81979828,10.81979828,1,163.341433,1,1,2,1,1,2,5,0.323045,0.326414,0,No
939,vanish,1,15.09653218,1,10.81979828,10.81979828,1,163.341433,1,1,2,1,1,2,5,0.384237,0.400402,0,No
944,vandenberg,1,15.09653218,1,10.81979828,10.81979828,1,163.341433,1,1,2,1,1,2,5,0.298426,0.30446,0,No
960,valiant,1,15.09653218,1,10.81979828,10.81979828,1,163.341433,1,1,2,1,1,2,5,0.318976,0.32331,0,No
978,vaccinate,1,15.09653218,1,10.81979828,10.81979828,1,163.341433,1,1,2,1,1,2,5,0.34998,0.359708,0,No
989,utilitarian,1,15.09653218,1,10.81979828,10.81979828,1,163.341433,1,1,2,1,1,2,5,0.343985,0.352404,0,No
997,usurpation,1,15.09653218,1,10.81979828,10.81979828,1,163.341433,1,1,2,1,1,2,5,0.378607,0.394397,0,No
1031,uranyl,1,15.09653218,1,10.81979828,10.81979828,1,163.341433,0,1,1,0,1,1,5,0.287981,0.294249,0,No
1037,upturn,1,15.09653218,1,10.81979828,10.81979828,1,163.341433,1,0,1,1,0,1,0,0,0,0,No
1040,uptake,1,15.09653218,1,10.81979828,10.81979828,1,163.341433,1,1,2,1,1,2,5,0.347133,0.356191,0,No
1043,upslope,1,15.09653218,1,10.81979828,10.81979828,1,163.341433,1,1,2,1,1,2,5,0.307302,0.312326,0,No
1065,unruly,1,15.09653218,1,10.81979828,10.81979828,1,163.341433,1,1,2,1,1,2,5,0.319073,0.323884,0,No
1075,unisex,1,15.09653218,1,10.81979828,10.81979828,1,163.341433,1,1,2,1,1,2,5,0.338882,0.345659,0,No
1077,unipolar,1,15.09653218,1,10.81979828,10.81979828,1,163.341433,0,1,1,0,1,1,5,0.319321,0.322841,0,No
1082,unidirectional,1,15.09653218,1,10.81979828,10.81979828,1,163.341433,1,1,2,1,1,2,5,0.314689,0.318914,0,No
1086,underling,1,15.09653218,1,10.81979828,10.81979828,1,163.341433,1,1,2,1,1,2,5,0.309116,0.313937,0,No
1089,unary,1,15.09653218,1,10.81979828,10.81979828,1,163.341433,0,0,0,0,0,0,0,0,0,0,No
1091,unanimity,1,15.09653218,1,10.81979828,10.81979828,1,163.341433,0,1,1,0,1,1,5,0.360828,0.373485,0,No
1121,typographer,1,15.09653218,1,10.81979828,10.81979828,1,163.341433,1,1,2,1,1,2,5,0.375317,0.391855,0,No
1125,typhon,1,15.09653218,1,10.81979828,10.81979828,1,163.341433,1,1,2,1,1,2,5,0.384237,0.400402,0,No
1129,typeset,1,15.09653218,1,10.81979828,10.81979828,1,163.341433,0,1,1,0,1,1,5,0.349979,0.359707,0,No
1157,tweak,1,15.09653218,1,10.81979828,10.81979828,1,163.341433,1,1,2,1,1,2,5,0.398076,0.415824,0,No
1160,tva,1,15.09653218,1,10.81979828,10.81979828,1,163.341433,1,1,2,1,1,2,5,0.315495,0.319657,0,No
1168,tussle,1,15.09653218,1,10.81979828,10.81979828,1,163.341433,1,1,2,1,1,2,5,0.360829,0.373487,0,No
1215,tumult,1,15.09653218,1,10.81979828,10.81979828,1,163.341433,1,1,2,1,1,2,5,0.360829,0.373487,0,No
1216,tum,1,15.09653218,1,10.81979828,10.81979828,1,163.341433,1,0,1,1,0,1,0,0,0,0,No
1223,tugboat,1,15.09653218,1,10.81979828,10.81979828,1,163.341433,1,0,1,1,0,1,0,0,0,0,No
1257,trudy,1,15.09653218,1,10.81979828,10.81979828,1,163.341433,1,1,2,1,1,2,5,0.375317,0.391855,0,No
1258,truculent,1,15.09653218,1,10.81979828,10.81979828,1,163.341433,0,0,0,0,0,0,0,0,0,0,No
1261,truant,1,15.09653218,1,10.81979828,10.81979828,1,163.341433,0,1,1,0,1,1,5,0.321431,0.324637,0,No
1280,troff,1,15.09653218,1,10.81979828,10.81979828,1,163.341433,1,1,2,1,1,2,5,0.318684,0.322087,0,No
1281,trobriand,1,15.09653218,1,10.81979828,10.81979828,1,163.341433,1,0,1,1,0,1,0,0,0,0,No
1295,triploid,1,15.09653218,1,10.81979828,10.81979828,1,163.341433,1,1,2,1,1,2,5,0.323481,0.326742,0,No
1304,trinitarian,1,15.09653218,1,10.81979828,10.81979828,1,163.341433,1,1,2,1,1,2,5,0.312903,0.317192,0,No
1306,trimester,1,15.09653218,1,10.81979828,10.81979828,1,163.341433,1,1,2,1,1,2,5,0.398076,0.415824,0,No
1312,trilingual,1,15.09653218,1,10.81979828,10.81979828,1,163.341433,1,1,2,1,1,2,5,0.355198,0.36689,0,No
1314,trigonal,1,15.09653218,1,10.81979828,10.81979828,1,163.341433,1,1,2,1,1,2,5,0.29522,0.301313,0,No
1316,trifluoride,1,15.09653218,1,10.81979828,10.81979828,1,163.341433,1,1,2,1,1,2,5,0.340162,0.347434,0,No
1321,trickle,1,15.09653218,1,10.81979828,10.81979828,1,163.341433,1,1,2,1,1,2,5,0.343985,0.352404,0,No
1333,trianon,1,15.09653218,1,10.81979828,10.81979828,1,163.341433,1,1,2,1,1,2,5,0.345599,0.354479,0,No
1346,tremor,1,15.09653218,1,10.81979828,10.81979828,1,163.341433,1,1,2,1,1,2,5,0.398067,0.415814,0,No
1360,treadmill,1,15.09653218,1,10.81979828,10.81979828,1,163.341433,1,1,2,1,1,2,5,0.312259,0.316715,0,No
1368,traversal,1,15.09653218,1,10.81979828,10.81979828,1,163.341433,1,1,2,1,1,2,5,0.398067,0.415814,0,No
1380,transvestite,1,15.09653218,1,10.81979828,10.81979828,1,163.341433,1,1,2,1,1,2,5,0.320705,0.324646,0,No
1392,transoceanic,1,15.09653218,1,10.81979828,10.81979828,1,163.341433,1,0,1,1,0,1,0,0,0,0,No
1402,transliterate,1,15.09653218,1,10.81979828,10.81979828,1,163.341433,1,0,1,1,0,1,0,0,0,0,No
1409,transgression,1,15.09653218,1,10.81979828,10.81979828,1,163.341433,1,1,2,1,1,2,5,0.320693,0.323931,0,No
1416,transferee,1,15.09653218,1,10.81979828,10.81979828,1,163.341433,1,1,2,1,1,2,5,0.300426,0.306208,0,No
1426,transcendent,1,15.09653218,1,10.81979828,10.81979828,1,163.341433,1,0,1,1,0,1,0,0,0,0,No
1427,transceiver,1,15.09653218,1,10.81979828,10.81979828,1,163.341433,1,1,2,1,1,2,5,0.328619,0.333504,0,No
1430,transact,1,15.09653218,1,10.81979828,10.81979828,1,163.341433,1,1,2,1,1,2,5,0.360837,0.373492,0,No
1433,tranquil,1,15.09653218,1,10.81979828,10.81979828,1,163.341433,1,0,1,1,0,1,0,0,0,0,No
1439,traitorous,1,15.09653218,1,10.81979828,10.81979828,1,163.341433,1,0,1,1,0,1,0,0,0,0,No
1444,trailblazing,1,15.09653218,1,10.81979828,10.81979828,1,163.341433,1,1,2,1,1,2,5,0.322622,0.326163,0,No
1450,trafficker,1,15.09653218,1,10.81979828,10.81979828,1,163.341433,1,1,2,1,1,2,5,0.320334,0.323627,0,No
1451,trafficked,1,15.09653218,1,10.81979828,10.81979828,1,163.341433,0,1,1,0,1,1,5,0.341779,0.349673,0,No
1454,tradesmen,1,15.09653218,1,10.81979828,10.81979828,1,163.341433,1,0,1,1,0,1,0,0,0,0,No
1464,tracery,1,15.09653218,1,10.81979828,10.81979828,1,163.341433,1,0,1,1,0,1,0,0,0,0,No
1471,townsmen,1,15.09653218,1,10.81979828,10.81979828,1,163.341433,0,1,1,0,1,1,5,0.324902,0.329008,0,No
1473,townhouse,1,15.09653218,1,10.81979828,10.81979828,1,163.341433,1,1,2,1,1,2,5,0.375309,0.391846,0,No
1475,towhead,1,15.09653218,1,10.81979828,10.81979828,1,163.341433,1,1,2,1,1,2,5,0.319953,0.324254,0,No
1483,touchy,1,15.09653218,1,10.81979828,10.81979828,1,163.341433,1,1,2,1,1,2,5,0.325814,0.329544,0,No
1491,tot,1,15.09653218,1,10.81979828,10.81979828,1,163.341433,1,1,2,1,1,2,5,0.313982,0.318294,0,No
1497,tortuous,1,15.09653218,1,10.81979828,10.81979828,1,163.341433,1,1,2,1,1,2,5,0.319412,0.322773,0,No
1512,toroidal,1,15.09653218,1,10.81979828,10.81979828,1,163.341433,1,0,1,1,0,1,0,0,0,0,No
1521,topple,1,15.09653218,1,10.81979828,10.81979828,1,163.341433,1,1,2,1,1,2,5,0.34998,0.359708,0,No
1530,toothpick,1,15.09653218,1,10.81979828,10.81979828,1,163.341433,1,1,2,1,1,2,5,0.322499,0.325684,0,No
1535,toot,1,15.09653218,1,10.81979828,10.81979828,1,163.341433,1,1,2,1,1,2,5,0.298758,0.304654,0,No
1552,tompkins,1,15.09653218,1,10.81979828,10.81979828,1,163.341433,1,1,2,1,1,2,5,0.325886,0.32922,0,No
1556,tommie,1,15.09653218,1,10.81979828,10.81979828,1,163.341433,0,1,1,0,1,1,6,0.266811,0.271763,0,No
1564,toluene,1,15.09653218,1,10.81979828,10.81979828,1,163.341433,1,0,1,1,0,1,0,0,0,0,No
1569,tolerable,1,15.09653218,1,10.81979828,10.81979828,1,163.341433,1,1,2,1,1,2,5,0.32946,0.333471,0,No
1583,toenail,1,15.09653218,1,10.81979828,10.81979828,1,163.341433,1,1,2,1,1,2,5,0.338011,0.344413,0,No
1585,toddy,1,15.09653218,1,10.81979828,10.81979828,1,163.341433,0,1,1,0,1,1,5,0.326696,0.33052,0,No
1608,tiresome,1,15.09653218,1,10.81979828,10.81979828,1,163.341433,1,1,2,1,1,2,5,0.35519,0.366885,0,No
1611,tiptoe,1,15.09653218,1,10.81979828,10.81979828,1,163.341433,1,1,2,1,1,2,5,0.323728,0.327918,0,No
1621,tincture,1,15.09653218,1,10.81979828,10.81979828,1,163.341433,1,1,2,1,1,2,5,0.341779,0.349674,0,No
1632,timberland,1,15.09653218,1,10.81979828,10.81979828,1,163.341433,0,1,1,0,1,1,5,0.3138,0.318047,0,No
1641,tigress,1,15.09653218,1,10.81979828,10.81979828,1,163.341433,1,1,2,1,1,2,6,0.261448,0.265603,0,No
1645,tift,1,15.09653218,1,10.81979828,10.81979828,1,163.341433,0,1,1,0,1,1,6,0.249726,0.251691,0,No
1649,tidy,1,15.09653218,1,10.81979828,10.81979828,1,163.341433,1,0,1,1,0,1,0,0,0,0,No
1650,tidewater,1,15.09653218,1,10.81979828,10.81979828,1,163.341433,1,1,2,1,1,2,5,0.323977,0.327374,0,No
1651,tideland,1,15.09653218,1,10.81979828,10.81979828,1,163.341433,1,1,2,1,1,2,5,0.398076,0.415824,0,No
1655,ticklish,1,15.09653218,1,10.81979828,10.81979828,1,163.341433,1,1,2,1,1,2,5,0.319119,0.322475,0,No
1676,thunderclap,1,15.09653218,1,10.81979828,10.81979828,1,163.341433,1,1,2,1,1,2,5,0.290652,0.29691,0,No
1680,thulium,1,15.09653218,1,10.81979828,10.81979828,1,163.341433,0,0,0,0,0,0,0,0,0,0,No
1693,throes,1,15.09653218,1,10.81979828,10.81979828,1,163.341433,1,1,2,1,1,2,5,0.378607,0.394397,0,No
1694,throb,1,15.09653218,1,10.81979828,10.81979828,1,163.341433,1,1,2,1,1,2,5,0.384237,0.400402,0,No
1697,thrips,1,15.09653218,1,10.81979828,10.81979828,1,163.341433,0,0,0,0,0,0,0,0,0,0,No
1699,thrifty,1,15.09653218,1,10.81979828,10.81979828,1,163.341433,1,1,2,1,1,2,5,0.308745,0.313714,0,No
1704,threonine,1,15.09653218,1,10.81979828,10.81979828,1,163.341433,0,0,0,0,0,0,0,0,0,0,No
1705,threesome,1,15.09653218,1,10.81979828,10.81979828,1,163.341433,1,1,2,1,1,2,5,0.32403,0.327593,0,No
1706,threefold,1,15.09653218,1,10.81979828,10.81979828,1,163.341433,1,1,2,1,1,2,5,0.311897,0.316401,0,No
1722,thoroughfare,1,15.09653218,1,10.81979828,10.81979828,1,163.341433,1,1,2,1,1,2,5,0.378615,0.394401,0,No
1749,thimble,1,15.09653218,1,10.81979828,10.81979828,1,163.341433,0,0,0,0,0,0,0,0,0,0,No
1751,thieving,1,15.09653218,1,10.81979828,10.81979828,1,163.341433,1,0,1,1,0,1,0,0,0,0,No
1754,thicket,1,15.09653218,1,10.81979828,10.81979828,1,163.341433,1,0,1,1,0,1,0,0,0,0,No
1766,thermophilic,1,15.09653218,1,10.81979828,10.81979828,1,163.341433,0,1,1,0,1,1,6,0.28509,0.291513,0,No
1767,thermo,1,15.09653218,1,10.81979828,10.81979828,1,163.341433,1,0,1,1,0,1,0,0,0,0,No
1768,thermionic,1,15.09653218,1,10.81979828,10.81979828,1,163.341433,1,1,2,1,1,2,5,0.30488,0.310229,0,No
1771,thereon,1,15.09653218,1,10.81979828,10.81979828,1,163.341433,1,1,2,1,1,2,5,0.398076,0.415824,0,No
1775,therefor,1,15.09653218,1,10.81979828,10.81979828,1,163.341433,0,0,0,0,0,0,0,0,0,0,No
1789,theocratic,1,15.09653218,1,10.81979828,10.81979828,1,163.341433,1,0,1,1,0,1,0,0,0,0,No
1824,texaco,1,15.09653218,1,10.81979828,10.81979828,1,163.341433,1,1,2,1,1,2,5,0.321821,0.325138,0,No
1829,tetrachloride,1,15.09653218,1,10.81979828,10.81979828,1,163.341433,1,0,1,1,0,1,0,0,0,0,No
1830,tether,1,15.09653218,1,10.81979828,10.81979828,1,163.341433,0,0,0,0,0,0,0,0,0,0,No
1847,terrific,1,15.09653218,1,10.81979828,10.81979828,1,163.341433,1,0,1,1,0,1,0,0,0,0,No
1853,terramycin,1,15.09653218,1,10.81979828,10.81979828,1,163.341433,0,1,1,0,1,1,5,0.398072,0.415819,0,No
1857,terpsichore,1,15.09653218,1,10.81979828,10.81979828,1,163.341433,0,1,1,0,1,1,5,0.398072,0.415819,0,No
1858,ternary,1,15.09653218,1,10.81979828,10.81979828,1,163.341433,0,1,1,0,1,1,5,0.323481,0.326743,0,No
1867,terbium,1,15.09653218,1,10.81979828,10.81979828,1,163.341433,1,1,2,1,1,2,5,0.345599,0.354479,0,No
1870,tenuous,1,15.09653218,1,10.81979828,10.81979828,1,163.341433,1,0,1,1,0,1,0,0,0,0,No
1882,tenney,1,15.09653218,1,10.81979828,10.81979828,1,163.341433,1,1,2,1,1,2,5,0.384237,0.400402,0,No
1884,tenfold,1,15.09653218,1,10.81979828,10.81979828,1,163.341433,1,0,1,1,0,1,0,0,0,0,No
1891,tenable,1,15.09653218,1,10.81979828,10.81979828,1,163.341433,0,1,1,0,1,1,5,0.343984,0.352403,0,No
1904,temperance,1,15.09653218,1,10.81979828,10.81979828,1,163.341433,1,1,2,1,1,2,5,0.384237,0.400402,0,No
1926,tektronix,1,15.09653218,1,10.81979828,10.81979828,1,163.341433,1,0,1,1,0,1,0,0,0,0,No
1928,teheran,1,15.09653218,1,10.81979828,10.81979828,1,163.341433,1,1,2,1,1,2,5,0.345599,0.354479,0,No
1931,teethe,1,15.09653218,1,10.81979828,10.81979828,1,163.341433,1,1,2,1,1,2,5,0.322534,0.328145,0,No
1937,tedious,1,15.09653218,1,10.81979828,10.81979828,1,163.341433,1,1,2,1,1,2,5,0.384237,0.400402,0,No
1947,teat,1,15.09653218,1,10.81979828,10.81979828,1,163.341433,1,1,2,1,1,2,6,0.256848,0.260273,0,No
1948,teaspoonful,1,15.09653218,1,10.81979828,10.81979828,1,163.341433,1,1,2,1,1,2,5,0.378607,0.394397,0,No
1950,tearful,1,15.09653218,1,10.81979828,10.81979828,1,163.341433,1,0,1,1,0,1,0,0,0,0,No
1977,taut,1,15.09653218,1,10.81979828,10.81979828,1,163.341433,1,1,2,1,1,2,5,0.384237,0.400402,0,No
1987,tasteful,1,15.09653218,1,10.81979828,10.81979828,1,163.341433,1,0,1,1,0,1,0,0,0,0,No
1989,tassel,1,15.09653218,1,10.81979828,10.81979828,1,163.341433,1,1,2,1,1,2,5,0.375309,0.391846,0,No
1996,tarsier,1,15.09653218,1,10.81979828,10.81979828,1,163.341433,1,1,2,1,1,2,5,0.320369,0.323793,0,No
1997,tarrytown,1,15.09653218,1,10.81979828,10.81979828,1,163.341433,1,1,2,1,1,2,5,0.327624,0.332601,0,No
2000,tarnish,1,15.09653218,1,10.81979828,10.81979828,1,163.341433,1,1,2,1,1,2,5,0.398076,0.415824,0,No
2006,taproot,1,15.09653218,1,10.81979828,10.81979828,1,163.341433,1,1,2,1,1,2,5,0.325575,0.32918,0,No
2022,tankard,1,15.09653218,1,10.81979828,10.81979828,1,163.341433,0,1,1,0,1,1,5,0.320433,0.323587,0,No
2024,tanh,1,15.09653218,1,10.81979828,10.81979828,1,163.341433,1,1,2,1,1,2,5,0.398076,0.415824,0,No
2025,tangy,1,15.09653218,1,10.81979828,10.81979828,1,163.341433,1,1,2,1,1,2,5,0.301996,0.307539,0,No
2028,tangible,1,15.09653218,1,10.81979828,10.81979828,1,163.341433,1,0,1,1,0,1,0,0,0,0,No
2030,tangential,1,15.09653218,1,10.81979828,10.81979828,1,163.341433,1,0,1,1,0,1,0,0,0,0,No
2037,tampon,1,15.09653218,1,10.81979828,10.81979828,1,163.341433,1,1,2,1,1,2,5,0.345599,0.354479,0,No
2044,tamarack,1,15.09653218,1,10.81979828,10.81979828,1,163.341433,0,1,1,0,1,1,5,0.299748,0.305467,0,No
2045,tamale,1,15.09653218,1,10.81979828,10.81979828,1,163.341433,1,0,1,1,0,1,0,0,0,0,No
2054,talky,1,15.09653218,1,10.81979828,10.81979828,1,163.341433,1,1,2,1,1,2,5,0.398076,0.415824,0,No
2061,talcum,1,15.09653218,1,10.81979828,10.81979828,1,163.341433,0,1,1,0,1,1,5,0.315906,0.319816,0,No
2069,taint,1,15.09653218,1,10.81979828,10.81979828,1,163.341433,1,1,2,1,1,2,5,0.375317,0.391855,0,No
2070,tailwind,1,15.09653218,1,10.81979828,10.81979828,1,163.341433,1,0,1,1,0,1,0,0,0,0,No
2076,tagging,1,15.09653218,1,10.81979828,10.81979828,1,163.341433,1,1,2,1,1,2,5,0.323263,0.326531,0,No
2081,tactile,1,15.09653218,1,10.81979828,10.81979828,1,163.341433,1,1,2,1,1,2,5,0.311034,0.315601,0,No
2085,tacky,1,15.09653218,1,10.81979828,10.81979828,1,163.341433,0,0,0,0,0,0,0,0,0,0,No
2087,tack,1,15.09653218,1,10.81979828,10.81979828,1,163.341433,1,1,2,1,1,2,5,0.375317,0.391855,0,No
2096,tabletop,1,15.09653218,1,10.81979828,10.81979828,1,163.341433,1,1,2,1,1,2,5,0.325193,0.328627,0,No
2098,tablespoonful,1,15.09653218,1,10.81979828,10.81979828,1,163.341433,1,1,2,1,1,2,5,0.32681,0.33159,0,No
2100,tableland,1,15.09653218,1,10.81979828,10.81979828,1,163.341433,0,1,1,0,1,1,5,0.314936,0.319198,0,No
2101,tablecloth,1,15.09653218,1,10.81979828,10.81979828,1,163.341433,1,1,2,1,1,2,5,0.338882,0.345659,0,No
2102,tableaux,1,15.09653218,1,10.81979828,10.81979828,1,163.341433,1,0,1,1,0,1,0,0,0,0,No
2103,tableau,1,15.09653218,1,10.81979828,10.81979828,1,163.341433,1,1,2,1,1,2,5,0.378607,0.394397,0,No
2109,syzygy,1,15.09653218,1,10.81979828,10.81979828,1,163.341433,1,1,2,1,1,2,5,0.336028,0.342206,0,No
2124,synopsis,1,15.09653218,1,10.81979828,10.81979828,1,163.341433,1,1,2,1,1,2,5,0.375309,0.391846,0,No
2125,synopses,1,15.09653218,1,10.81979828,10.81979828,1,163.341433,1,1,2,1,1,2,5,0.378607,0.394397,0,No
2129,synergy,1,15.09653218,1,10.81979828,10.81979828,1,163.341433,1,1,2,1,1,2,5,0.345606,0.354483,0,No
2133,synchrotron,1,15.09653218,1,10.81979828,10.81979828,1,163.341433,1,1,2,1,1,2,5,0.338882,0.345659,0,No
2134,synchrony,1,15.09653218,1,10.81979828,10.81979828,1,163.341433,1,1,2,1,1,2,5,0.340155,0.347429,0,No
2159,syenite,1,15.09653218,1,10.81979828,10.81979828,1,163.341433,1,1,2,1,1,2,5,0.384237,0.400402,0,No
2171,switchgear,1,15.09653218,1,10.81979828,10.81979828,1,163.341433,0,0,0,0,0,0,0,0,0,0,No
2172,switchboard,1,15.09653218,1,10.81979828,10.81979828,1,163.341433,1,1,2,1,1,2,5,0.309089,0.313898,0,No
2173,switchback,1,15.09653218,1,10.81979828,10.81979828,1,163.341433,1,1,2,1,1,2,5,0.318615,0.322283,0,No
2180,swindle,1,15.09653218,1,10.81979828,10.81979828,1,163.341433,0,1,1,0,1,1,5,0.321693,0.324979,0,No
2193,swede,1,15.09653218,1,10.81979828,10.81979828,1,163.341433,1,1,2,1,1,2,6,0.264301,0.268958,0,No
2202,swath,1,15.09653218,1,10.81979828,10.81979828,1,163.341433,1,1,2,1,1,2,5,0.378607,0.394397,0,No
2213,swampland,1,15.09653218,1,10.81979828,10.81979828,1,163.341433,0,1,1,0,1,1,5,0.384234,0.400398,0,No
2221,svetlana,1,15.09653218,1,10.81979828,10.81979828,1,163.341433,0,0,0,0,0,0,0,0,0,0,No
2255,surpass,1,15.09653218,1,10.81979828,10.81979828,1,163.341433,1,1,2,1,1,2,5,0.315635,0.319864,0,No
2270,suppressor,1,15.09653218,1,10.81979828,10.81979828,1,163.341433,0,1,1,0,1,1,5,0.319758,0.323267,0,No
2273,supposition,1,15.09653218,1,10.81979828,10.81979828,1,163.341433,1,1,2,1,1,2,5,0.32946,0.333471,0,No
2277,supplicate,1,15.09653218,1,10.81979828,10.81979828,1,163.341433,1,1,2,1,1,2,5,0.359165,0.371513,0,No
2278,supplicant,1,15.09653218,1,10.81979828,10.81979828,1,163.341433,1,0,1,1,0,1,0,0,0,0,No
2280,supple,1,15.09653218,1,10.81979828,10.81979828,1,163.341433,1,1,2,1,1,2,5,0.398076,0.415824,0,No
2281,supine,1,15.09653218,1,10.81979828,10.81979828,1,163.341433,1,1,2,1,1,2,5,0.325479,0.3292,0,No
2285,supersede,1,15.09653218,1,10.81979828,10.81979828,1,163.341433,1,0,1,1,0,1,0,0,0,0,No
2290,superbly,1,15.09653218,1,10.81979828,10.81979828,1,163.341433,1,0,1,1,0,1,0,0,0,0,No
2293,sup,1,15.09653218,1,10.81979828,10.81979828,1,163.341433,1,1,2,1,1,2,6,0.284339,0.290625,0,No
2301,sunnyvale,1,15.09653218,1,10.81979828,10.81979828,1,163.341433,1,1,2,1,1,2,5,0.324581,0.327869,0,No
2310,sundry,1,15.09653218,1,10.81979828,10.81979828,1,163.341433,1,0,1,1,0,1,0,0,0,0,No
2313,sundew,1,15.09653218,1,10.81979828,10.81979828,1,163.341433,1,1,2,1,1,2,5,0.332391,0.337648,0,No
2320,sumptuous,1,15.09653218,1,10.81979828,10.81979828,1,163.341433,0,1,1,0,1,1,5,0.32284,0.326057,0,No
2329,sultry,1,15.09653218,1,10.81979828,10.81979828,1,163.341433,1,1,2,1,1,2,5,0.384237,0.400402,0,No
2339,sukiyaki,1,15.09653218,1,10.81979828,10.81979828,1,163.341433,1,1,2,1,1,2,5,0.322546,0.326813,0,No
2357,suffice,1,15.09653218,1,10.81979828,10.81979828,1,163.341433,1,1,2,1,1,2,5,0.360829,0.373487,0,No
2361,suet,1,15.09653218,1,10.81979828,10.81979828,1,163.341433,1,1,2,1,1,2,5,0.320415,0.323638,0,No
2371,succumb,1,15.09653218,1,10.81979828,10.81979828,1,163.341433,1,1,2,1,1,2,5,0.34998,0.359708,0,No
2385,subterfuge,1,15.09653218,1,10.81979828,10.81979828,1,163.341433,1,0,1,1,0,1,0,0,0,0,No
2389,substantive,1,15.09653218,1,10.81979828,10.81979828,1,163.341433,1,1,2,1,1,2,5,0.320144,0.323377,0,No
2393,subservient,1,15.09653218,1,10.81979828,10.81979828,1,163.341433,1,1,2,1,1,2,5,0.359172,0.371523,0,No
2394,subpoena,1,15.09653218,1,10.81979828,10.81979828,1,163.341433,1,1,2,1,1,2,5,0.321029,0.327198,0,No
2405,stymie,1,15.09653218,1,10.81979828,10.81979828,1,163.341433,1,0,1,1,0,1,0,0,0,0,No
2411,stutter,1,15.09653218,1,10.81979828,10.81979828,1,163.341433,1,1,2,1,1,2,5,0.336028,0.342206,0,No
2419,stumpy,1,15.09653218,1,10.81979828,10.81979828,1,163.341433,1,1,2,1,1,2,5,0.336028,0.342206,0,No
2425,studious,1,15.09653218,1,10.81979828,10.81979828,1,163.341433,1,1,2,1,1,2,5,0.323604,0.326832,0,No
2442,strophe,1,15.09653218,1,10.81979828,10.81979828,1,163.341433,1,1,2,1,1,2,5,0.341779,0.349674,0,No
2447,stroll,1,15.09653218,1,10.81979828,10.81979828,1,163.341433,1,1,2,1,1,2,5,0.323723,0.327913,0,No
2460,strickland,1,15.09653218,1,10.81979828,10.81979828,1,163.341433,1,1,2,1,1,2,5,0.326557,0.330056,0,No
2461,strewn,1,15.09653218,1,10.81979828,10.81979828,1,163.341433,0,1,1,0,1,1,5,0.329106,0.333412,0,No
2465,streptomycin,1,15.09653218,1,10.81979828,10.81979828,1,163.341433,1,1,2,1,1,2,5,0.35519,0.366885,0,No
2472,streamline,1,15.09653218,1,10.81979828,10.81979828,1,163.341433,1,0,1,1,0,1,0,0,0,0,No
2482,stratospheric,1,15.09653218,1,10.81979828,10.81979828,1,163.341433,1,1,2,1,1,2,5,0.314266,0.318449,0,No
2497,straightaway,1,15.09653218,1,10.81979828,10.81979828,1,163.341433,1,1,2,1,1,2,5,0.384237,0.400402,0,No
2499,strabismus,1,15.09653218,1,10.81979828,10.81979828,1,163.341433,0,1,1,0,1,1,5,0.326348,0.330278,0,No
2501,stow,1,15.09653218,1,10.81979828,10.81979828,1,163.341433,1,1,2,1,1,2,5,0.328747,0.332973,0,No
2515,stoppage,1,15.09653218,1,10.81979828,10.81979828,1,163.341433,1,1,2,1,1,2,5,0.378607,0.394397,0,No
2518,stooge,1,15.09653218,1,10.81979828,10.81979828,1,163.341433,1,1,2,1,1,2,5,0.295368,0.301438,0,No
2521,stonewort,1,15.09653218,1,10.81979828,10.81979828,1,163.341433,1,1,2,1,1,2,6,0.28682,0.293163,0,No
2544,stipend,1,15.09653218,1,10.81979828,10.81979828,1,163.341433,1,1,2,1,1,2,5,0.378607,0.394397,0,No
2548,stingy,1,15.09653218,1,10.81979828,10.81979828,1,163.341433,1,1,2,1,1,2,5,0.30896,0.31418,0,No
2555,stilt,1,15.09653218,1,10.81979828,10.81979828,1,163.341433,0,0,0,0,0,0,0,0,0,0,No
2559,stile,1,15.09653218,1,10.81979828,10.81979828,1,163.341433,1,1,2,1,1,2,5,0.321868,0.325066,0,No
2564,stickleback,1,15.09653218,1,10.81979828,10.81979828,1,163.341433,0,1,1,0,1,1,5,0.375314,0.391852,0,No
2567,stewardess,1,15.09653218,1,10.81979828,10.81979828,1,163.341433,1,1,2,1,1,2,5,0.324908,0.329012,0,No
2590,stenography,1,15.09653218,1,10.81979828,10.81979828,1,163.341433,1,1,2,1,1,2,5,0.345599,0.354479,0,No
2591,stenographer,1,15.09653218,1,10.81979828,10.81979828,1,163.341433,1,1,2,1,1,2,5,0.326479,0.32972,0,No
2603,steeple,1,15.09653218,1,10.81979828,10.81979828,1,163.341433,1,1,2,1,1,2,5,0.345599,0.354479,0,No
2609,steed,1,15.09653218,1,10.81979828,10.81979828,1,163.341433,1,0,1,1,0,1,0,0,0,0,No
2611,steamy,1,15.09653218,1,10.81979828,10.81979828,1,163.341433,1,1,2,1,1,2,6,0.248096,0.249961,0,No
2631,stator,1,15.09653218,1,10.81979828,10.81979828,1,163.341433,1,1,2,1,1,2,5,0.306252,0.311453,0,No
2638,statesmen,1,15.09653218,1,10.81979828,10.81979828,1,163.341433,1,1,2,1,1,2,5,0.323805,0.328212,0,No
2645,startup,1,15.09653218,1,10.81979828,10.81979828,1,163.341433,1,1,2,1,1,2,5,0.324314,0.329355,0,No
2656,starchy,1,15.09653218,1,10.81979828,10.81979828,1,163.341433,1,0,1,1,0,1,0,0,0,0,No
2658,starboard,1,15.09653218,1,10.81979828,10.81979828,1,163.341433,1,1,2,1,1,2,5,0.323941,0.327153,0,No
2660,stapleton,1,15.09653218,1,10.81979828,10.81979828,1,163.341433,1,1,2,1,1,2,5,0.30965,0.314617,0,No
2679,staminate,1,15.09653218,1,10.81979828,10.81979828,1,163.341433,1,1,2,1,1,2,5,0.35519,0.366885,0,No
2696,staid,1,15.09653218,1,10.81979828,10.81979828,1,163.341433,1,1,2,1,1,2,5,0.384237,0.400402,0,No
2697,stahl,1,15.09653218,1,10.81979828,10.81979828,1,163.341433,0,0,0,0,0,0,0,0,0,0,No
2708,staccato,1,15.09653218,1,10.81979828,10.81979828,1,163.341433,0,1,1,0,1,1,1,1,1,0,No
2712,ssw,1,15.09653218,1,10.81979828,10.81979828,1,163.341433,1,1,2,1,1,2,5,0.325575,0.32918,0,No
2714,sse,1,15.09653218,1,10.81979828,10.81979828,1,163.341433,1,1,2,1,1,2,5,0.345606,0.354483,0,No
2728,squatted,1,15.09653218,1,10.81979828,10.81979828,1,163.341433,1,1,2,1,1,2,5,0.321384,0.324528,0,No
2738,spurt,1,15.09653218,1,10.81979828,10.81979828,1,163.341433,1,1,2,1,1,2,5,0.291124,0.297441,0,No
2742,spunky,1,15.09653218,1,10.81979828,10.81979828,1,163.341433,1,1,2,1,1,2,5,0.334225,0.341138,0,No
2743,spunk,1,15.09653218,1,10.81979828,10.81979828,1,163.341433,1,0,1,1,0,1,0,0,0,0,No
2745,spud,1,15.09653218,1,10.81979828,10.81979828,1,163.341433,1,1,2,1,1,2,5,0.326509,0.329932,0,No
2752,sprinkle,1,15.09653218,1,10.81979828,10.81979828,1,163.341433,0,1,1,0,1,1,5,0.325474,0.329196,0,No
2757,sprig,1,15.09653218,1,10.81979828,10.81979828,1,163.341433,1,0,1,1,0,1,0,0,0,0,No
2767,spotty,1,15.09653218,1,10.81979828,10.81979828,1,163.341433,1,1,2,1,1,2,5,0.311339,0.315856,0,No
2780,spook,1,15.09653218,1,10.81979828,10.81979828,1,163.341433,1,1,2,1,1,2,5,0.320219,0.323518,0,No
2787,spokesmen,1,15.09653218,1,10.81979828,10.81979828,1,163.341433,1,1,2,1,1,2,5,0.329724,0.334564,0,No
2795,spline,1,15.09653218,1,10.81979828,10.81979828,1,163.341433,1,1,2,1,1,2,5,0.314227,0.318295,0,No
2796,splice,1,15.09653218,1,10.81979828,10.81979828,1,163.341433,0,1,1,0,1,1,5,0.303947,0.309312,0,No
2799,splashy,1,15.09653218,1,10.81979828,10.81979828,1,163.341433,1,1,2,1,1,2,5,0.331268,0.335748,0,No
2802,spittle,1,15.09653218,1,10.81979828,10.81979828,1,163.341433,1,1,2,1,1,2,5,0.314667,0.318852,0,No
2804,spiteful,1,15.09653218,1,10.81979828,10.81979828,1,163.341433,1,0,1,1,0,1,0,0,0,0,No
2807,spirogyra,1,15.09653218,1,10.81979828,10.81979828,1,163.341433,1,1,2,1,1,2,5,0.329106,0.333412,0,No
2826,spigot,1,15.09653218,1,10.81979828,10.81979828,1,163.341433,1,1,2,1,1,2,5,0.345599,0.354479,0,No
2831,spica,1,15.09653218,1,10.81979828,10.81979828,1,163.341433,0,0,0,0,0,0,0,0,0,0,No
2835,sphalerite,1,15.09653218,1,10.81979828,10.81979828,1,163.341433,0,1,1,0,1,1,5,0.297658,0.303554,0,No
2836,sphagnum,1,15.09653218,1,10.81979828,10.81979828,1,163.341433,0,0,0,0,0,0,0,0,0,0,No
2837,spew,1,15.09653218,1,10.81979828,10.81979828,1,163.341433,0,1,1,0,1,1,5,0.329822,0.33446,0,No
2838,spermatozoon,1,15.09653218,1,10.81979828,10.81979828,1,163.341433,1,1,2,1,1,2,5,0.35519,0.366885,0,No
2853,specular,1,15.09653218,1,10.81979828,10.81979828,1,163.341433,0,0,0,0,0,0,0,0,0,0,No
2865,spectacle,1,15.09653218,1,10.81979828,10.81979828,1,163.341433,1,1,2,1,1,2,5,0.331274,0.335753,0,No
2866,speckle,1,15.09653218,1,10.81979828,10.81979828,1,163.341433,1,0,1,1,0,1,0,0,0,0,No
2873,spec,1,15.09653218,1,10.81979828,10.81979828,1,163.341433,0,1,1,0,1,1,5,0.343984,0.352403,0,No
2875,spearhead,1,15.09653218,1,10.81979828,10.81979828,1,163.341433,1,1,2,1,1,2,5,0.343985,0.352404,0,No
2883,spasmodic,1,15.09653218,1,10.81979828,10.81979828,1,163.341433,1,1,2,1,1,2,5,0.315708,0.320371,0,No
2884,spasm,1,15.09653218,1,10.81979828,10.81979828,1,163.341433,0,1,1,0,1,1,5,0.398072,0.415819,0,No
2918,southland,1,15.09653218,1,10.81979828,10.81979828,1,163.341433,1,1,2,1,1,2,5,0.319746,0.323299,0,No
2924,southbound,1,15.09653218,1,10.81979828,10.81979828,1,163.341433,1,1,2,1,1,2,5,0.338018,0.344417,0,No
2932,soundproof,1,15.09653218,1,10.81979828,10.81979828,1,163.341433,1,1,2,1,1,2,5,0.321227,0.324554,0,No
2938,sortie,1,15.09653218,1,10.81979828,10.81979828,1,163.341433,1,1,2,1,1,2,5,0.32681,0.33159,0,No
2941,sorrowful,1,15.09653218,1,10.81979828,10.81979828,1,163.341433,1,1,2,1,1,2,5,0.307382,0.312875,0,No
2943,sorrel,1,15.09653218,1,10.81979828,10.81979828,1,163.341433,1,1,2,1,1,2,5,0.398076,0.415824,0,No
2946,sorenson,1,15.09653218,1,10.81979828,10.81979828,1,163.341433,0,1,1,0,1,1,5,0.324872,0.329267,0,No
2949,sorb,1,15.09653218,1,10.81979828,10.81979828,1,163.341433,1,1,2,1,1,2,5,0.384237,0.400402,0,No
2954,sophistry,1,15.09653218,1,10.81979828,10.81979828,1,163.341433,1,1,2,1,1,2,5,0.340155,0.347429,0,No
2958,soothsayer,1,15.09653218,1,10.81979828,10.81979828,1,163.341433,1,1,2,1,1,2,5,0.331268,0.335748,0,No
2962,sonorous,1,15.09653218,1,10.81979828,10.81979828,1,163.341433,1,1,2,1,1,2,5,0.321186,0.324416,0,No
2968,songbook,1,15.09653218,1,10.81979828,10.81979828,1,163.341433,0,1,1,0,1,1,5,0.320705,0.324646,0,No
3005,solipsism,1,15.09653218,1,10.81979828,10.81979828,1,163.341433,0,0,0,0,0,0,0,0,0,0,No
3006,soliloquy,1,15.09653218,1,10.81979828,10.81979828,1,163.341433,1,1,2,1,1,2,5,0.349987,0.359713,0,No
3021,sojourn,1,15.09653218,1,10.81979828,10.81979828,1,163.341433,1,1,2,1,1,2,5,0.32946,0.333471,0,No
3022,soiree,1,15.09653218,1,10.81979828,10.81979828,1,163.341433,1,1,2,1,1,2,5,0.375325,0.39186,0,No
3037,sockeye,1,15.09653218,1,10.81979828,10.81979828,1,163.341433,1,1,2,1,1,2,5,0.30881,0.313735,0,No
3041,sociolinguistic,1,15.09653218,1,10.81979828,10.81979828,1,163.341433,1,1,2,1,1,2,5,0.319464,0.32281,0,No
3059,snub,1,15.09653218,1,10.81979828,10.81979828,1,163.341433,1,1,2,1,1,2,5,0.398076,0.415824,0,No
3062,snowshoe,1,15.09653218,1,10.81979828,10.81979828,1,163.341433,1,1,2,1,1,2,5,0.308659,0.313578,0,No
3068,snort,1,15.09653218,1,10.81979828,10.81979828,1,163.341433,1,1,2,1,1,2,5,0.324486,0.329501,0,No
3072,snob,1,15.09653218,1,10.81979828,10.81979828,1,163.341433,1,1,2,1,1,2,5,0.32946,0.333471,0,No
3076,snick,1,15.09653218,1,10.81979828,10.81979828,1,163.341433,1,0,1,1,0,1,0,0,0,0,No
3079,sneaky,1,15.09653218,1,10.81979828,10.81979828,1,163.341433,1,1,2,1,1,2,5,0.324824,0.328028,0,No
3082,snark,1,15.09653218,1,10.81979828,10.81979828,1,163.341433,1,1,2,1,1,2,5,0.322189,0.325372,0,No
3085,snappy,1,15.09653218,1,10.81979828,10.81979828,1,163.341433,0,0,0,0,0,0,0,0,0,0,No
3095,smug,1,15.09653218,1,10.81979828,10.81979828,1,163.341433,1,1,2,1,1,2,5,0.319907,0.323327,0,No
3115,smalley,1,15.09653218,1,10.81979828,10.81979828,1,163.341433,1,1,2,1,1,2,5,0.33386,0.339705,0,No
3122,slung,1,15.09653218,1,10.81979828,10.81979828,1,163.341433,1,1,2,1,1,2,5,0.324314,0.329355,0,No
3124,slumber,1,15.09653218,1,10.81979828,10.81979828,1,163.341433,1,1,2,1,1,2,5,0.325223,0.328478,0,No
3137,slosh,1,15.09653218,1,10.81979828,10.81979828,1,163.341433,1,1,2,1,1,2,5,0.331268,0.335748,0,No
3146,slither,1,15.09653218,1,10.81979828,10.81979828,1,163.341433,1,0,1,1,0,1,0,0,0,0,No
3160,slew,1,15.09653218,1,10.81979828,10.81979828,1,163.341433,1,1,2,1,1,2,5,0.35519,0.366885,0,No
3161,sleuth,1,15.09653218,1,10.81979828,10.81979828,1,163.341433,1,0,1,1,0,1,0,0,0,0,No
3170,sledgehammer,1,15.09653218,1,10.81979828,10.81979828,1,163.341433,1,1,2,1,1,2,5,0.345599,0.354479,0,No
3190,slake,1,15.09653218,1,10.81979828,10.81979828,1,163.341433,0,1,1,0,1,1,5,0.384234,0.400398,0,No
3193,slacken,1,15.09653218,1,10.81979828,10.81979828,1,163.341433,1,1,2,1,1,2,5,0.334225,0.341138,0,No
3197,skylight,1,15.09653218,1,10.81979828,10.81979828,1,163.341433,1,1,2,1,1,2,5,0.319435,0.323125,0,No
3198,skylark,1,15.09653218,1,10.81979828,10.81979828,1,163.341433,1,0,1,1,0,1,0,0,0,0,No
3199,skyhook,1,15.09653218,1,10.81979828,10.81979828,1,163.341433,1,0,1,1,0,1,0,0,0,0,No
3208,skippy,1,15.09653218,1,10.81979828,10.81979828,1,163.341433,1,1,2,1,1,2,5,0.300167,0.305927,0,No
3220,sketchy,1,15.09653218,1,10.81979828,10.81979828,1,163.341433,1,1,2,1,1,2,5,0.32946,0.333471,0,No
3225,skein,1,15.09653218,1,10.81979828,10.81979828,1,163.341433,1,1,2,1,1,2,5,0.359172,0.371523,0,No
3226,skeet,1,15.09653218,1,10.81979828,10.81979828,1,163.341433,1,1,2,1,1,2,5,0.384229,0.400392,0,No
3240,sisyphus,1,15.09653218,1,10.81979828,10.81979828,1,163.341433,0,0,0,0,0,0,0,0,0,0,No
3243,sisal,1,15.09653218,1,10.81979828,10.81979828,1,163.341433,1,1,2,1,1,2,5,0.32034,0.323565,0,No
3252,sinuous,1,15.09653218,1,10.81979828,10.81979828,1,163.341433,1,1,2,1,1,2,5,0.320913,0.324293,0,No
3253,sinology,1,15.09653218,1,10.81979828,10.81979828,1,163.341433,1,1,2,1,1,2,5,0.345606,0.354483,0,No
3254,sino,1,15.09653218,1,10.81979828,10.81979828,1,163.341433,1,0,1,1,0,1,0,0,0,0,No
3255,sinkhole,1,15.09653218,1,10.81979828,10.81979828,1,163.341433,1,1,2,1,1,2,5,0.338882,0.345659,0,No
3257,sinistral,1,15.09653218,1,10.81979828,10.81979828,1,163.341433,1,1,2,1,1,2,5,0.35519,0.366885,0,No
3276,simultaneity,1,15.09653218,1,10.81979828,10.81979828,1,163.341433,1,1,2,1,1,2,5,0.315714,0.320375,0,No
3277,simulcast,1,15.09653218,1,10.81979828,10.81979828,1,163.341433,1,1,2,1,1,2,5,0.338011,0.344413,0,No
3293,similitude,1,15.09653218,1,10.81979828,10.81979828,1,163.341433,1,1,2,1,1,2,5,0.321436,0.32469,0,No
3300,silversmith,1,15.09653218,1,10.81979828,10.81979828,1,163.341433,1,1,2,1,1,2,5,0.384237,0.400402,0,No
3303,silty,1,15.09653218,1,10.81979828,10.81979828,1,163.341433,1,1,2,1,1,2,5,0.322329,0.325479,0,No
3304,siltstone,1,15.09653218,1,10.81979828,10.81979828,1,163.341433,1,1,2,1,1,2,5,0.331268,0.335748,0,No
3311,silken,1,15.09653218,1,10.81979828,10.81979828,1,163.341433,1,1,2,1,1,2,5,0.31111,0.315651,0,No
3316,siliceous,1,15.09653218,1,10.81979828,10.81979828,1,163.341433,1,1,2,1,1,2,5,0.304299,0.309652,0,No
3329,signet,1,15.09653218,1,10.81979828,10.81979828,1,163.341433,1,0,1,1,0,1,0,0,0,0,No
3338,sift,1,15.09653218,1,10.81979828,10.81979828,1,163.341433,1,1,2,1,1,2,5,0.398076,0.415824,0,No
3350,sidewall,1,15.09653218,1,10.81979828,10.81979828,1,163.341433,1,1,2,1,1,2,5,0.322839,0.325996,0,No
3354,sideman,1,15.09653218,1,10.81979828,10.81979828,1,163.341433,1,1,2,1,1,2,5,0.360829,0.373487,0,No
3355,sideline,1,15.09653218,1,10.81979828,10.81979828,1,163.341433,1,1,2,1,1,2,5,0.398076,0.415824,0,No
3375,shutdown,1,15.09653218,1,10.81979828,10.81979828,1,163.341433,1,1,2,1,1,2,5,0.360829,0.373487,0,No
3379,shuck,1,15.09653218,1,10.81979828,10.81979828,1,163.341433,1,0,1,1,0,1,0,0,0,0,No
3382,shrubbery,1,15.09653218,1,10.81979828,10.81979828,1,163.341433,1,1,2,1,1,2,5,0.345599,0.354479,0,No
3389,shrill,1,15.09653218,1,10.81979828,10.81979828,1,163.341433,1,1,2,1,1,2,5,0.321372,0.324529,0,No
3391,shriek,1,15.09653218,1,10.81979828,10.81979828,1,163.341433,1,1,2,1,1,2,5,0.345599,0.354479,0,No
3399,showpiece,1,15.09653218,1,10.81979828,10.81979828,1,163.341433,1,0,1,1,0,1,0,0,0,0,No
3413,shortish,1,15.09653218,1,10.81979828,10.81979828,1,163.341433,0,0,0,0,0,0,0,0,0,0,No
3417,shortcoming,1,15.09653218,1,10.81979828,10.81979828,1,163.341433,1,1,2,1,1,2,5,0.345606,0.354483,0,No
3422,shorebird,1,15.09653218,1,10.81979828,10.81979828,1,163.341433,1,0,1,1,0,1,0,0,0,0,No
3428,shoji,1,15.09653218,1,10.81979828,10.81979828,1,163.341433,1,0,1,1,0,1,0,0,0,0,No
3430,shockley,1,15.09653218,1,10.81979828,10.81979828,1,163.341433,1,1,2,1,1,2,5,0.384237,0.400402,0,No
3432,shmuel,1,15.09653218,1,10.81979828,10.81979828,1,163.341433,1,0,1,1,0,1,0,0,0,0,No
3435,shiv,1,15.09653218,1,10.81979828,10.81979828,1,163.341433,0,1,1,0,1,1,5,0.345598,0.354477,0,No
3439,shirk,1,15.09653218,1,10.81979828,10.81979828,1,163.341433,0,1,1,0,1,1,5,0.355189,0.366884,0,No
3456,shibboleth,1,15.09653218,1,10.81979828,10.81979828,1,163.341433,1,1,2,1,1,2,5,0.359172,0.371523,0,No
3458,sherwin,1,15.09653218,1,10.81979828,10.81979828,1,163.341433,1,1,2,1,1,2,5,0.318792,0.322352,0,No
3465,sheraton,1,15.09653218,1,10.81979828,10.81979828,1,163.341433,1,1,2,1,1,2,5,0.310012,0.314925,0,No
3467,shepherdess,1,15.09653218,1,10.81979828,10.81979828,1,163.341433,1,1,2,1,1,2,5,0.326479,0.331386,0,No
3500,shatter,1,15.09653218,1,10.81979828,10.81979828,1,163.341433,1,1,2,1,1,2,5,0.328321,0.332281,0,No
3507,shari,1,15.09653218,1,10.81979828,10.81979828,1,163.341433,1,1,2,1,1,2,5,0.302366,0.308206,0,No
3511,shard,1,15.09653218,1,10.81979828,10.81979828,1,163.341433,1,1,2,1,1,2,5,0.345599,0.354479,0,No
3512,shapiro,1,15.09653218,1,10.81979828,10.81979828,1,163.341433,1,0,1,1,0,1,0,0,0,0,No
3528,shaky,1,15.09653218,1,10.81979828,10.81979828,1,163.341433,1,1,2,1,1,2,5,0.319412,0.322773,0,No
3529,shakespearian,1,15.09653218,1,10.81979828,10.81979828,1,163.341433,1,1,2,1,1,2,5,0.32288,0.326176,0,No
3544,shackle,1,15.09653218,1,10.81979828,10.81979828,1,163.341433,1,1,2,1,1,2,5,0.331268,0.335748,0,No
3575,servomechanism,1,15.09653218,1,10.81979828,10.81979828,1,163.341433,1,0,1,1,0,1,0,0,0,0,No
3580,servicemen,1,15.09653218,1,10.81979828,10.81979828,1,163.341433,1,1,2,1,1,2,5,0.341779,0.349674,0,No
3590,serine,1,15.09653218,1,10.81979828,10.81979828,1,163.341433,0,0,0,0,0,0,0,0,0,0,No
3593,sericulture,1,15.09653218,1,10.81979828,10.81979828,1,163.341433,0,1,1,0,1,1,5,0.322535,0.328145,0,No
3606,sequoia,1,15.09653218,1,10.81979828,10.81979828,1,163.341433,1,0,1,1,0,1,0,0,0,0,No
3607,sequitur,1,15.09653218,1,10.81979828,10.81979828,1,163.341433,1,1,2,1,1,2,5,0.326359,0.329865,0,No
3608,sequestration,1,15.09653218,1,10.81979828,10.81979828,1,163.341433,1,1,2,1,1,2,5,0.280298,0.286369,0,No
3609,sequester,1,15.09653218,1,10.81979828,10.81979828,1,163.341433,1,1,2,1,1,2,5,0.398076,0.415824,0,No
3621,sentinel,1,15.09653218,1,10.81979828,10.81979828,1,163.341433,1,1,2,1,1,2,5,0.320305,0.323598,0,No
3624,sentential,1,15.09653218,1,10.81979828,10.81979828,1,163.341433,1,1,2,1,1,2,5,0.317101,0.320764,0,No
3633,senorita,1,15.09653218,1,10.81979828,10.81979828,1,163.341433,1,1,2,1,1,2,5,0.331943,0.336969,0,No
3635,senor,1,15.09653218,1,10.81979828,10.81979828,1,163.341433,1,1,2,1,1,2,5,0.345075,0.35368,0,No
3641,senatorial,1,15.09653218,1,10.81979828,10.81979828,1,163.341433,1,1,2,1,1,2,5,0.300691,0.306369,0,No
3652,semblance,1,15.09653218,1,10.81979828,10.81979828,1,163.341433,0,1,1,0,1,1,5,0.324309,0.329351,0,No
3658,sellout,1,15.09653218,1,10.81979828,10.81979828,1,163.341433,1,0,1,1,0,1,0,0,0,0,No
3673,segundo,1,15.09653218,1,10.81979828,10.81979828,1,163.341433,1,1,2,1,1,2,5,0.324587,0.327874,0,No
3683,seedy,1,15.09653218,1,10.81979828,10.81979828,1,163.341433,1,1,2,1,1,2,5,0.282898,0.289111,0,No
3688,seduction,1,15.09653218,1,10.81979828,10.81979828,1,163.341433,1,1,2,1,1,2,5,0.378615,0.394401,0,No
3690,sedimentation,1,15.09653218,1,10.81979828,10.81979828,1,163.341433,1,1,2,1,1,2,5,0.311903,0.316592,0,No
3700,sectarian,1,15.09653218,1,10.81979828,10.81979828,1,163.341433,1,0,1,1,0,1,0,0,0,0,No
3707,secretarial,1,15.09653218,1,10.81979828,10.81979828,1,163.341433,0,1,1,0,1,1,5,0.325104,0.328358,0,No
3719,seaworthy,1,15.09653218,1,10.81979828,10.81979828,1,163.341433,0,1,1,0,1,1,5,0.322946,0.326723,0,No
3741,seagram,1,15.09653218,1,10.81979828,10.81979828,1,163.341433,1,1,2,1,1,2,5,0.398076,0.415824,0,No
3743,seacoast,1,15.09653218,1,10.81979828,10.81979828,1,163.341433,1,1,2,1,1,2,5,0.360829,0.373487,0,No
3758,scud,1,15.09653218,1,10.81979828,10.81979828,1,163.341433,1,0,1,1,0,1,0,0,0,0,No
3760,scrutiny,1,15.09653218,1,10.81979828,10.81979828,1,163.341433,1,1,2,1,1,2,5,0.322622,0.325876,0,No
3761,scrupulous,1,15.09653218,1,10.81979828,10.81979828,1,163.341433,1,1,2,1,1,2,5,0.320502,0.323696,0,No
3773,scribble,1,15.09653218,1,10.81979828,10.81979828,1,163.341433,1,1,2,1,1,2,5,0.317578,0.321143,0,No
3774,screwdriver,1,15.09653218,1,10.81979828,10.81979828,1,163.341433,1,1,2,1,1,2,5,0.398076,0.415824,0,No
3778,screech,1,15.09653218,1,10.81979828,10.81979828,1,163.341433,1,1,2,1,1,2,5,0.384246,0.400407,0,No
3784,scrapbook,1,15.09653218,1,10.81979828,10.81979828,1,163.341433,1,0,1,1,0,1,0,0,0,0,No
3803,scoreboard,1,15.09653218,1,10.81979828,10.81979828,1,163.341433,1,1,2,1,1,2,5,0.326816,0.331594,0,No
3805,scops,1,15.09653218,1,10.81979828,10.81979828,1,163.341433,1,1,2,1,1,2,5,0.360829,0.373487,0,No
3807,scoot,1,15.09653218,1,10.81979828,10.81979828,1,163.341433,1,1,2,1,1,2,5,0.360829,0.373487,0,No
3810,scoff,1,15.09653218,1,10.81979828,10.81979828,1,163.341433,1,1,2,1,1,2,5,0.29252,0.29873,0,No
3811,scm,1,15.09653218,1,10.81979828,10.81979828,1,163.341433,1,1,2,1,1,2,5,0.327618,0.332596,0,No
3816,scimitar,1,15.09653218,1,10.81979828,10.81979828,1,163.341433,0,0,0,0,0,0,0,0,0,0,No
3823,schwab,1,15.09653218,1,10.81979828,10.81979828,1,163.341433,1,1,2,1,1,2,6,0.284125,0.290523,0,No
3831,schroedinger,1,15.09653218,1,10.81979828,10.81979828,1,163.341433,0,0,0,0,0,0,0,0,0,0,No
3835,schoolyard,1,15.09653218,1,10.81979828,10.81979828,1,163.341433,1,1,2,1,1,2,5,0.316366,0.320176,0,No
3836,schoolwork,1,15.09653218,1,10.81979828,10.81979828,1,163.341433,0,1,1,0,1,1,5,0.310773,0.315634,0,No
3846,schofield,1,15.09653218,1,10.81979828,10.81979828,1,163.341433,1,0,1,1,0,1,0,0,0,0,No
3854,schlieren,1,15.09653218,1,10.81979828,10.81979828,1,163.341433,0,0,0,0,0,0,0,0,0,0,No
3869,sceptic,1,15.09653218,1,10.81979828,10.81979828,1,163.341433,1,1,2,1,1,2,5,0.321006,0.324192,0,No
3891,scant,1,15.09653218,1,10.81979828,10.81979828,1,163.341433,1,1,2,1,1,2,5,0.318147,0.32168,0,No
3906,scab,1,15.09653218,1,10.81979828,10.81979828,1,163.341433,1,1,2,1,1,2,5,0.378607,0.394397,0,No
3912,saxifrage,1,15.09653218,1,10.81979828,10.81979828,1,163.341433,0,1,1,0,1,1,5,0.325689,0.32903,0,No
3916,sawfly,1,15.09653218,1,10.81979828,10.81979828,1,163.341433,1,1,2,1,1,2,5,0.315798,0.319692,0,No
3917,sawfish,1,15.09653218,1,10.81979828,10.81979828,1,163.341433,1,0,1,1,0,1,0,0,0,0,No
3918,sawdust,1,15.09653218,1,10.81979828,10.81979828,1,163.341433,1,1,2,1,1,2,5,0.336028,0.342023,0,No
3920,savvy,1,15.09653218,1,10.81979828,10.81979828,1,163.341433,1,1,2,1,1,2,5,0.345606,0.354483,0,No
3921,savoyard,1,15.09653218,1,10.81979828,10.81979828,1,163.341433,1,1,2,1,1,2,5,0.322933,0.32636,0,No
3957,sashimi,1,15.09653218,1,10.81979828,10.81979828,1,163.341433,1,1,2,1,1,2,5,0.320311,0.32358,0,No
3959,sarsaparilla,1,15.09653218,1,10.81979828,10.81979828,1,163.341433,0,0,0,0,0,0,0,0,0,0,No
3962,sardonic,1,15.09653218,1,10.81979828,10.81979828,1,163.341433,1,0,1,1,0,1,0,0,0,0,No
3965,sarcophagus,1,15.09653218,1,10.81979828,10.81979828,1,163.341433,1,1,2,1,1,2,5,0.320415,0.324339,0,No
3966,sarcoma,1,15.09653218,1,10.81979828,10.81979828,1,163.341433,0,1,1,0,1,1,5,0.360828,0.373485,0,No
3971,saran,1,15.09653218,1,10.81979828,10.81979828,1,163.341433,0,0,0,0,0,0,0,0,0,0,No
3992,sanguinary,1,15.09653218,1,10.81979828,10.81979828,1,163.341433,1,0,1,1,0,1,0,0,0,0,No
3998,sandusky,1,15.09653218,1,10.81979828,10.81979828,1,163.341433,1,1,2,1,1,2,5,0.323599,0.327454,0,No
4003,sandia,1,15.09653218,1,10.81979828,10.81979828,1,163.341433,1,1,2,1,1,2,5,0.318598,0.322123,0,No
4011,sanctify,1,15.09653218,1,10.81979828,10.81979828,1,163.341433,1,0,1,1,0,1,0,0,0,0,No
4015,sanatorium,1,15.09653218,1,10.81979828,10.81979828,1,163.341433,1,1,2,1,1,2,5,0.360829,0.373487,0,No
4019,samuelson,1,15.09653218,1,10.81979828,10.81979828,1,163.341433,1,1,2,1,1,2,5,0.281503,0.287638,0,No
4028,samarium,1,15.09653218,1,10.81979828,10.81979828,1,163.341433,0,1,1,0,1,1,5,0.345598,0.354477,0,No
4030,salvo,1,15.09653218,1,10.81979828,10.81979828,1,163.341433,1,1,2,1,1,2,5,0.398076,0.415824,0,No
4034,salvage,1,15.09653218,1,10.81979828,10.81979828,1,163.341433,1,0,1,1,0,1,0,0,0,0,No
4037,salutary,1,15.09653218,1,10.81979828,10.81979828,1,163.341433,1,1,2,1,1,2,6,0.265992,0.270862,0,No
4049,salk,1,15.09653218,1,10.81979828,10.81979828,1,163.341433,1,1,2,1,1,2,5,0.320496,0.323727,0,No
4057,salient,1,15.09653218,1,10.81979828,10.81979828,1,163.341433,1,1,2,1,1,2,5,0.332397,0.337652,0,No
4073,sailfish,1,15.09653218,1,10.81979828,10.81979828,1,163.341433,1,1,2,1,1,2,5,0.311552,0.316074,0,No
4081,sagittal,1,15.09653218,1,10.81979828,10.81979828,1,163.341433,1,0,1,1,0,1,0,0,0,0,No
4083,sagging,1,15.09653218,1,10.81979828,10.81979828,1,163.341433,1,1,2,1,1,2,5,0.322218,0.326515,0,No
4084,sagebrush,1,15.09653218,1,10.81979828,10.81979828,1,163.341433,1,0,1,1,0,1,0,0,0,0,No
4090,safekeeping,1,15.09653218,1,10.81979828,10.81979828,1,163.341433,1,1,2,1,1,2,5,0.321035,0.327202,0,No
4099,sacristan,1,15.09653218,1,10.81979828,10.81979828,1,163.341433,1,1,2,1,1,2,5,0.384237,0.400402,0,No
4101,sacrificial,1,15.09653218,1,10.81979828,10.81979828,1,163.341433,1,0,1,1,0,1,0,0,0,0,No
4106,sacral,1,15.09653218,1,10.81979828,10.81979828,1,163.341433,1,1,2,1,1,2,5,0.319131,0.322592,0,No
4110,sabotage,1,15.09653218,1,10.81979828,10.81979828,1,163.341433,0,1,1,0,1,1,5,0.32648,0.329721,0,No
4113,sabina,1,15.09653218,1,10.81979828,10.81979828,1,163.341433,1,1,2,1,1,2,5,0.310034,0.314732,0,No
4114,sabbatical,1,15.09653218,1,10.81979828,10.81979828,1,163.341433,1,1,2,1,1,2,5,0.341779,0.349674,0,No
4123,rutile,1,15.09653218,1,10.81979828,10.81979828,1,163.341433,1,1,2,1,1,2,5,0.302155,0.30771,0,No
4138,rusk,1,15.09653218,1,10.81979828,10.81979828,1,163.341433,1,1,2,1,1,2,5,0.35519,0.366885,0,No
4145,runyon,1,15.09653218,1,10.81979828,10.81979828,1,163.341433,1,1,2,1,1,2,5,0.331274,0.335753,0,No
4147,runt,1,15.09653218,1,10.81979828,10.81979828,1,163.341433,1,0,1,1,0,1,0,0,0,0,No
4163,rumania,1,15.09653218,1,10.81979828,10.81979828,1,163.341433,0,0,0,0,0,0,0,0,0,0,No
4177,ruddy,1,15.09653218,1,10.81979828,10.81979828,1,163.341433,0,0,0,0,0,0,0,0,0,0,No
4183,rube,1,15.09653218,1,10.81979828,10.81979828,1,163.341433,1,1,2,1,1,2,5,0.308842,0.313707,0,No
4204,roustabout,1,15.09653218,1,10.81979828,10.81979828,1,163.341433,1,1,2,1,1,2,5,0.375317,0.391855,0,No
4207,roundworm,1,15.09653218,1,10.81979828,10.81979828,1,163.341433,1,1,2,1,1,2,5,0.35519,0.366885,0,No
4209,roundtable,1,15.09653218,1,10.81979828,10.81979828,1,163.341433,0,1,1,0,1,1,5,0.338011,0.344412,0,No
4225,rostrum,1,15.09653218,1,10.81979828,10.81979828,1,163.341433,1,1,2,1,1,2,5,0.345599,0.354479,0,No
4231,rosenblum,1,15.09653218,1,10.81979828,10.81979828,1,163.341433,1,1,2,1,1,2,5,0.320705,0.324646,0,No
4235,roseland,1,15.09653218,1,10.81979828,10.81979828,1,163.341433,1,1,2,1,1,2,5,0.324753,0.328036,0,No
4240,ropy,1,15.09653218,1,10.81979828,10.81979828,1,163.341433,1,1,2,1,1,2,5,0.325277,0.32902,0,No
4242,rootstock,1,15.09653218,1,10.81979828,10.81979828,1,163.341433,0,1,1,0,1,1,5,0.32648,0.329721,0,No
4246,roomy,1,15.09653218,1,10.81979828,10.81979828,1,163.341433,1,0,1,1,0,1,0,0,0,0,No
4248,roomful,1,15.09653218,1,10.81979828,10.81979828,1,163.341433,1,1,2,1,1,2,5,0.378607,0.394397,0,No
4254,rood,1,15.09653218,1,10.81979828,10.81979828,1,163.341433,1,1,2,1,1,2,5,0.320502,0.323716,0,No
4270,rollback,1,15.09653218,1,10.81979828,10.81979828,1,163.341433,1,1,2,1,1,2,5,0.322534,0.328145,0,No
4276,roentgen,1,15.09653218,1,10.81979828,10.81979828,1,163.341433,0,0,0,0,0,0,0,0,0,0,No
4306,robbin,1,15.09653218,1,10.81979828,10.81979828,1,163.341433,1,1,2,1,1,2,5,0.398076,0.415824,0,No
4316,roadblock,1,15.09653218,1,10.81979828,10.81979828,1,163.341433,1,0,1,1,0,1,0,0,0,0,No
4327,riven,1,15.09653218,1,10.81979828,10.81979828,1,163.341433,1,1,2,1,1,2,5,0.384237,0.400402,0,No
4339,ripple,1,15.09653218,1,10.81979828,10.81979828,1,163.341433,0,1,1,0,1,1,5,0.31674,0.320482,0,No
4340,ripoff,1,15.09653218,1,10.81979828,10.81979828,1,163.341433,1,1,2,1,1,2,5,0.317663,0.321266,0,No
4344,riparian,1,15.09653218,1,10.81979828,10.81979828,1,163.341433,1,1,2,1,1,2,5,0.320589,0.32475,0,No
4368,rifleman,1,15.09653218,1,10.81979828,10.81979828,1,163.341433,1,1,2,1,1,2,5,0.318552,0.321948,0,No
4370,rife,1,15.09653218,1,10.81979828,10.81979828,1,163.341433,1,1,2,1,1,2,5,0.345068,0.353675,0,No
4378,ridden,1,15.09653218,1,10.81979828,10.81979828,1,163.341433,1,0,1,1,0,1,0,0,0,0,No
4382,ricochet,1,15.09653218,1,10.81979828,10.81979828,1,163.341433,1,0,1,1,0,1,0,0,0,0,No
4407,rhombi,1,15.09653218,1,10.81979828,10.81979828,1,163.341433,1,1,2,1,1,2,5,0.340155,0.347429,0,No
4418,rhinestone,1,15.09653218,1,10.81979828,10.81979828,1,163.341433,1,1,2,1,1,2,5,0.306141,0.311339,0,No
4426,rheology,1,15.09653218,1,10.81979828,10.81979828,1,163.341433,1,0,1,1,0,1,0,0,0,0,No
4437,revoke,1,15.09653218,1,10.81979828,10.81979828,1,163.341433,1,1,2,1,1,2,5,0.312881,0.317259,0,No
4448,revelatory,1,15.09653218,1,10.81979828,10.81979828,1,163.341433,1,0,1,1,0,1,0,0,0,0,No
4450,revel,1,15.09653218,1,10.81979828,10.81979828,1,163.341433,0,0,0,0,0,0,0,0,0,0,No
4452,reuters,1,15.09653218,1,10.81979828,10.81979828,1,163.341433,0,1,1,0,1,1,5,0.325773,0.32925,0,No
4461,retinue,1,15.09653218,1,10.81979828,10.81979828,1,163.341433,1,1,2,1,1,2,5,0.35519,0.366885,0,No
4462,retinal,1,15.09653218,1,10.81979828,10.81979828,1,163.341433,1,1,2,1,1,2,5,0.315781,0.319696,0,No
4469,retard,1,15.09653218,1,10.81979828,10.81979828,1,163.341433,1,1,2,1,1,2,5,0.321419,0.324671,0,No
4470,retaliatory,1,15.09653218,1,10.81979828,10.81979828,1,163.341433,1,0,1,1,0,1,0,0,0,0,No
4472,ret,1,15.09653218,1,10.81979828,10.81979828,1,163.341433,1,0,1,1,0,1,0,0,0,0,No
4473,resuscitate,1,15.09653218,1,10.81979828,10.81979828,1,163.341433,1,0,1,1,0,1,0,0,0,0,No
4475,resurgent,1,15.09653218,1,10.81979828,10.81979828,1,163.341433,1,0,1,1,0,1,0,0,0,0,No
4476,resumption,1,15.09653218,1,10.81979828,10.81979828,1,163.341433,1,1,2,1,1,2,5,0.378607,0.394397,0,No
4482,restorative,1,15.09653218,1,10.81979828,10.81979828,1,163.341433,1,1,2,1,1,2,5,0.320172,0.323484,0,No
4488,responsive,1,15.09653218,1,10.81979828,10.81979828,1,163.341433,1,1,2,1,1,2,5,0.345068,0.353675,0,No
4495,respirator,1,15.09653218,1,10.81979828,10.81979828,1,163.341433,1,1,2,1,1,2,5,0.398076,0.415824,0,No
4497,respectful,1,15.09653218,1,10.81979828,10.81979828,1,163.341433,0,0,0,0,0,0,0,0,0,0,No
4499,resonate,1,15.09653218,1,10.81979828,10.81979828,1,163.341433,1,1,2,1,1,2,5,0.338011,0.344413,0,No
4506,residuary,1,15.09653218,1,10.81979828,10.81979828,1,163.341433,0,0,0,0,0,0,0,0,0,0,No
4515,repute,1,15.09653218,1,10.81979828,10.81979828,1,163.341433,0,1,1,0,1,1,5,0.305384,0.310696,0,No
4523,reprisal,1,15.09653218,1,10.81979828,10.81979828,1,163.341433,1,1,2,1,1,2,5,0.3103,0.314992,0,No
4530,replenish,1,15.09653218,1,10.81979828,10.81979828,1,163.341433,1,1,2,1,1,2,5,0.398076,0.415824,0,No
4532,repetitious,1,15.09653218,1,10.81979828,10.81979828,1,163.341433,0,1,1,0,1,1,5,0.32763,0.331412,0,No
4533,repertory,1,15.09653218,1,10.81979828,10.81979828,1,163.341433,0,0,0,0,0,0,0,0,0,0,No
4535,repelling,1,15.09653218,1,10.81979828,10.81979828,1,163.341433,1,0,1,1,0,1,0,0,0,0,No
4541,reparation,1,15.09653218,1,10.81979828,10.81979828,1,163.341433,0,0,0,0,0,0,0,0,0,0,No
4542,repairman,1,15.09653218,1,10.81979828,10.81979828,1,163.341433,1,1,2,1,1,2,5,0.30896,0.31418,0,No
4563,remorse,1,15.09653218,1,10.81979828,10.81979828,1,163.341433,1,1,2,1,1,2,5,0.307105,0.312188,0,No
4566,reminiscent,1,15.09653218,1,10.81979828,10.81979828,1,163.341433,1,1,2,1,1,2,5,0.378607,0.394397,0,No
4567,reminisce,1,15.09653218,1,10.81979828,10.81979828,1,163.341433,1,1,2,1,1,2,5,0.338882,0.345659,0,No
4572,remand,1,15.09653218,1,10.81979828,10.81979828,1,163.341433,1,1,2,1,1,2,5,0.384237,0.400402,0,No
4576,reliquary,1,15.09653218,1,10.81979828,10.81979828,1,163.341433,1,1,2,1,1,2,5,0.359172,0.371523,0,No
4577,relinquish,1,15.09653218,1,10.81979828,10.81979828,1,163.341433,1,1,2,1,1,2,5,0.310658,0.31523,0,No
4582,relict,1,15.09653218,1,10.81979828,10.81979828,1,163.341433,1,0,1,1,0,1,0,0,0,0,No
4587,rejoice,1,15.09653218,1,10.81979828,10.81979828,1,163.341433,1,1,2,1,1,2,5,0.360829,0.373487,0,No
4599,regulus,1,15.09653218,1,10.81979828,10.81979828,1,163.341433,1,1,2,1,1,2,5,0.322247,0.326426,0,No
4606,regress,1,15.09653218,1,10.81979828,10.81979828,1,163.341433,1,1,2,1,1,2,5,0.332397,0.337652,0,No
4628,refract,1,15.09653218,1,10.81979828,10.81979828,1,163.341433,1,1,2,1,1,2,5,0.328503,0.333262,0,No
4629,reflexive,1,15.09653218,1,10.81979828,10.81979828,1,163.341433,1,1,2,1,1,2,5,0.325605,0.330106,0,No
4630,reflector,1,15.09653218,1,10.81979828,10.81979828,1,163.341433,0,1,1,0,1,1,5,0.384234,0.400398,0,No
4631,reflectance,1,15.09653218,1,10.81979828,10.81979828,1,163.341433,1,1,2,1,1,2,5,0.317674,0.321296,0,No
4645,reedbuck,1,15.09653218,1,10.81979828,10.81979828,1,163.341433,0,0,0,0,0,0,0,0,0,0,No
4654,redhead,1,15.09653218,1,10.81979828,10.81979828,1,163.341433,0,1,1,0,1,1,5,0.345598,0.354477,0,No
4657,redden,1,15.09653218,1,10.81979828,10.81979828,1,163.341433,1,1,2,1,1,2,5,0.294071,0.300167,0,No
4658,redbud,1,15.09653218,1,10.81979828,10.81979828,1,163.341433,1,1,2,1,1,2,5,0.345606,0.354483,0,No
4661,recumbent,1,15.09653218,1,10.81979828,10.81979828,1,163.341433,1,1,2,1,1,2,5,0.398076,0.415824,0,No
4664,rectify,1,15.09653218,1,10.81979828,10.81979828,1,163.341433,1,0,1,1,0,1,0,0,0,0,No
4665,rectifier,1,15.09653218,1,10.81979828,10.81979828,1,163.341433,0,1,1,0,1,1,5,0.32681,0.33159,0,No
4672,reclusive,1,15.09653218,1,10.81979828,10.81979828,1,163.341433,1,1,2,1,1,2,5,0.384237,0.400402,0,No
4673,recluse,1,15.09653218,1,10.81979828,10.81979828,1,163.341433,1,0,1,1,0,1,0,0,0,0,No
4674,recline,1,15.09653218,1,10.81979828,10.81979828,1,163.341433,1,0,1,1,0,1,0,0,0,0,No
4678,reciprocity,1,15.09653218,1,10.81979828,10.81979828,1,163.341433,0,0,0,0,0,0,0,0,0,0,No
4692,rebuttal,1,15.09653218,1,10.81979828,10.81979828,1,163.341433,1,1,2,1,1,2,5,0.375317,0.391855,0,No
4701,realty,1,15.09653218,1,10.81979828,10.81979828,1,163.341433,0,0,0,0,0,0,0,0,0,0,No
4702,realtor,1,15.09653218,1,10.81979828,10.81979828,1,163.341433,1,1,2,1,1,2,5,0.324278,0.327668,0,No
4714,razorback,1,15.09653218,1,10.81979828,10.81979828,1,163.341433,0,1,1,0,1,1,5,0.323894,0.32813,0,No
4719,rawlinson,1,15.09653218,1,10.81979828,10.81979828,1,163.341433,1,1,2,1,1,2,5,0.328546,0.33268,0,No
4720,rawhide,1,15.09653218,1,10.81979828,10.81979828,1,163.341433,1,1,2,1,1,2,5,0.35519,0.366885,0,No
4726,raunchy,1,15.09653218,1,10.81979828,10.81979828,1,163.341433,1,0,1,1,0,1,0,0,0,0,No
4727,raul,1,15.09653218,1,10.81979828,10.81979828,1,163.341433,1,0,1,1,0,1,0,0,0,0,No
4730,rationale,1,15.09653218,1,10.81979828,10.81979828,1,163.341433,1,1,2,1,1,2,5,0.343985,0.352404,0,No
4735,rata,1,15.09653218,1,10.81979828,10.81979828,1,163.341433,0,1,1,0,1,1,6,0.256847,0.260272,0,No
4739,rasp,1,15.09653218,1,10.81979828,10.81979828,1,163.341433,1,1,2,1,1,2,5,0.32045,0.323781,0,No
4742,rascal,1,15.09653218,1,10.81979828,10.81979828,1,163.341433,0,1,1,0,1,1,5,0.324018,0.327394,0,No
4743,rasa,1,15.09653218,1,10.81979828,10.81979828,1,163.341433,1,1,2,1,1,2,5,0.326816,0.331594,0,No
4756,rankin,1,15.09653218,1,10.81979828,10.81979828,1,163.341433,1,1,2,1,1,2,5,0.3206,0.323908,0,No
4771,ramshackle,1,15.09653218,1,10.81979828,10.81979828,1,163.341433,1,1,2,1,1,2,5,0.319309,0.32271,0,No
4774,rampant,1,15.09653218,1,10.81979828,10.81979828,1,163.341433,1,1,2,1,1,2,5,0.398076,0.415824,0,No
4777,ramo,1,15.09653218,1,10.81979828,10.81979828,1,163.341433,1,1,2,1,1,2,5,0.360837,0.373492,0,No
4778,rambunctious,1,15.09653218,1,10.81979828,10.81979828,1,163.341433,1,0,1,1,0,1,0,0,0,0,No
4801,ragweed,1,15.09653218,1,10.81979828,10.81979828,1,163.341433,0,0,0,0,0,0,0,0,0,0,No
4802,ragout,1,15.09653218,1,10.81979828,10.81979828,1,163.341433,1,0,1,1,0,1,0,0,0,0,No
4806,rafferty,1,15.09653218,1,10.81979828,10.81979828,1,163.341433,0,1,1,0,1,1,5,0.300189,0.306005,0,No
4815,radiosonde,1,15.09653218,1,10.81979828,10.81979828,1,163.341433,1,1,2,1,1,2,5,0.359172,0.371523,0,No
4816,radiometer,1,15.09653218,1,10.81979828,10.81979828,1,163.341433,1,0,1,1,0,1,0,0,0,0,No
4829,racy,1,15.09653218,1,10.81979828,10.81979828,1,163.341433,0,0,0,0,0,0,0,0,0,0,No
4843,rabbinical,1,15.09653218,1,10.81979828,10.81979828,1,163.341433,1,1,2,1,1,2,5,0.318999,0.32248,0,No
4850,quota,1,15.09653218,1,10.81979828,10.81979828,1,163.341433,0,1,1,0,1,1,5,0.325575,0.32918,0,No
4857,quitter,1,15.09653218,1,10.81979828,10.81979828,1,163.341433,1,1,2,1,1,2,5,0.341779,0.349674,0,No
4872,quietus,1,15.09653218,1,10.81979828,10.81979828,1,163.341433,0,1,1,0,1,1,5,0.32219,0.325373,0,No
4876,quickstep,1,15.09653218,1,10.81979828,10.81979828,1,163.341433,1,1,2,1,1,2,6,0.257795,0.26139,0,No
4882,quichua,1,15.09653218,1,10.81979828,10.81979828,1,163.341433,1,1,2,1,1,2,5,0.35519,0.366885,0,No
4883,quezon,1,15.09653218,1,10.81979828,10.81979828,1,163.341433,1,1,2,1,1,2,5,0.329381,0.333472,0,No
4890,quench,1,15.09653218,1,10.81979828,10.81979828,1,163.341433,1,1,2,1,1,2,5,0.334225,0.341138,0,No
4891,quell,1,15.09653218,1,10.81979828,10.81979828,1,163.341433,1,1,2,1,1,2,5,0.398076,0.415824,0,No
4903,quarto,1,15.09653218,1,10.81979828,10.81979828,1,163.341433,0,0,0,0,0,0,0,0,0,0,No
4906,quartermaster,1,15.09653218,1,10.81979828,10.81979828,1,163.341433,1,0,1,1,0,1,0,0,0,0,No
4909,quarrymen,1,15.09653218,1,10.81979828,10.81979828,1,163.341433,1,1,2,1,1,2,5,0.326419,0.330114,0,No
4910,quarryman,1,15.09653218,1,10.81979828,10.81979828,1,163.341433,1,0,1,1,0,1,0,0,0,0,No
4912,quarrelsome,1,15.09653218,1,10.81979828,10.81979828,1,163.341433,1,0,1,1,0,1,0,0,0,0,No
4925,quaint,1,15.09653218,1,10.81979828,10.81979828,1,163.341433,1,1,2,1,1,2,5,0.322277,0.325478,0,No
4927,quahog,1,15.09653218,1,10.81979828,10.81979828,1,163.341433,0,1,1,0,1,1,6,0.245839,0.247328,0,No
4934,quadric,1,15.09653218,1,10.81979828,10.81979828,1,163.341433,0,0,0,0,0,0,0,0,0,0,No
4935,quadrature,1,15.09653218,1,10.81979828,10.81979828,1,163.341433,1,1,2,1,1,2,5,0.378607,0.394397,0,No
4938,quadrangular,1,15.09653218,1,10.81979828,10.81979828,1,163.341433,1,1,2,1,1,2,5,0.310968,0.315514,0,No
4939,quadrangle,1,15.09653218,1,10.81979828,10.81979828,1,163.341433,1,1,2,1,1,2,5,0.331268,0.335748,0,No
4942,qua,1,15.09653218,1,10.81979828,10.81979828,1,163.341433,0,0,0,0,0,0,0,0,0,0,No
4948,pyrrhic,1,15.09653218,1,10.81979828,10.81979828,1,163.341433,1,1,2,1,1,2,5,0.31421,0.318489,0,No
4951,pyrophosphate,1,15.09653218,1,10.81979828,10.81979828,1,163.341433,1,1,2,1,1,2,5,0.312314,0.316704,0,No
4967,putrid,1,15.09653218,1,10.81979828,10.81979828,1,163.341433,1,0,1,1,0,1,0,0,0,0,No
4972,pushy,1,15.09653218,1,10.81979828,10.81979828,1,163.341433,1,1,2,1,1,2,5,0.320705,0.324646,0,No
4974,pusan,1,15.09653218,1,10.81979828,10.81979828,1,163.341433,1,1,2,1,1,2,5,0.345599,0.354479,0,No
4975,pus,1,15.09653218,1,10.81979828,10.81979828,1,163.341433,1,1,2,1,1,2,5,0.324492,0.328918,0,No
4976,purview,1,15.09653218,1,10.81979828,10.81979828,1,163.341433,1,1,2,1,1,2,5,0.336028,0.342023,0,No
4982,purposeful,1,15.09653218,1,10.81979828,10.81979828,1,163.341433,1,1,2,1,1,2,5,0.30408,0.309618,0,No
4990,purgation,1,15.09653218,1,10.81979828,10.81979828,1,163.341433,1,0,1,1,0,1,0,0,0,0,No
4991,puree,1,15.09653218,1,10.81979828,10.81979828,1,163.341433,1,1,2,1,1,2,5,0.35519,0.366885,0,No
5000,pupate,1,15.09653218,1,10.81979828,10.81979828,1,163.341433,1,1,2,1,1,2,5,0.295058,0.301095,0,No
5005,puny,1,15.09653218,1,10.81979828,10.81979828,1,163.341433,1,1,2,1,1,2,5,0.32946,0.333471,0,No
5015,punditry,1,15.09653218,1,10.81979828,10.81979828,1,163.341433,1,1,2,1,1,2,5,0.322019,0.32509,0,No
5025,pulsate,1,15.09653218,1,10.81979828,10.81979828,1,163.341433,1,1,2,1,1,2,5,0.333854,0.3397,0,No
5037,pugh,1,15.09653218,1,10.81979828,10.81979828,1,163.341433,0,0,0,0,0,0,0,0,0,0,No
5044,puddingstone,1,15.09653218,1,10.81979828,10.81979828,1,163.341433,1,1,2,1,1,2,5,0.360829,0.373487,0,No
5055,pterodactyl,1,15.09653218,1,10.81979828,10.81979828,1,163.341433,1,1,2,1,1,2,5,0.341779,0.349674,0,No
5056,ptarmigan,1,15.09653218,1,10.81979828,10.81979828,1,163.341433,1,1,2,1,1,2,5,0.323599,0.327454,0,No
5057,pta,1,15.09653218,1,10.81979828,10.81979828,1,163.341433,0,1,1,0,1,1,5,0.384234,0.400398,0,No
5058,psyllium,1,15.09653218,1,10.81979828,10.81979828,1,163.341433,1,1,2,1,1,2,5,0.31897,0.32247,0,No
5062,psychotherapeutic,1,15.09653218,1,10.81979828,10.81979828,1,163.341433,1,0,1,1,0,1,0,0,0,0,No
5063,psychosomatic,1,15.09653218,1,10.81979828,10.81979828,1,163.341433,1,0,1,1,0,1,0,0,0,0,No
5065,psychoses,1,15.09653218,1,10.81979828,10.81979828,1,163.341433,1,1,2,1,1,2,5,0.398076,0.415824,0,No
5083,prune,1,15.09653218,1,10.81979828,10.81979828,1,163.341433,1,0,1,1,0,1,0,0,0,0,No
5089,provoke,1,15.09653218,1,10.81979828,10.81979828,1,163.341433,1,0,1,1,0,1,0,0,0,0,No
5103,protrusive,1,15.09653218,1,10.81979828,10.81979828,1,163.341433,1,1,2,1,1,2,5,0.328607,0.332758,0,No
5104,protrusion,1,15.09653218,1,10.81979828,10.81979828,1,163.341433,1,1,2,1,1,2,5,0.338011,0.344413,0,No
5116,proteolysis,1,15.09653218,1,10.81979828,10.81979828,1,163.341433,1,1,2,1,1,2,6,0.262624,0.26703,0,No
5124,prostrate,1,15.09653218,1,10.81979828,10.81979828,1,163.341433,1,1,2,1,1,2,5,0.35519,0.366885,0,No
5127,prosthetic,1,15.09653218,1,10.81979828,10.81979828,1,163.341433,1,1,2,1,1,2,5,0.333596,0.339081,0,No
5141,proscription,1,15.09653218,1,10.81979828,10.81979828,1,163.341433,1,0,1,1,0,1,0,0,0,0,No
5142,proscribe,1,15.09653218,1,10.81979828,10.81979828,1,163.341433,0,1,1,0,1,1,5,0.30741,0.312573,0,No
5144,proscenium,1,15.09653218,1,10.81979828,10.81979828,1,163.341433,1,0,1,1,0,1,0,0,0,0,No
5154,proportionate,1,15.09653218,1,10.81979828,10.81979828,1,163.341433,0,1,1,0,1,1,5,0.345598,0.354477,0,No
5156,proponent,1,15.09653218,1,10.81979828,10.81979828,1,163.341433,0,1,1,0,1,1,5,0.378604,0.394393,0,No
5173,proofread,1,15.09653218,1,10.81979828,10.81979828,1,163.341433,1,1,2,1,1,2,5,0.398076,0.415824,0,No
5186,promiscuity,1,15.09653218,1,10.81979828,10.81979828,1,163.341433,0,1,1,0,1,1,5,0.312024,0.316469,0,No
5210,programmatic,1,15.09653218,1,10.81979828,10.81979828,1,163.341433,1,0,1,1,0,1,0,0,0,0,No
5212,prognosis,1,15.09653218,1,10.81979828,10.81979828,1,163.341433,1,0,1,1,0,1,0,0,0,0,No
5213,progeny,1,15.09653218,1,10.81979828,10.81979828,1,163.341433,1,1,2,1,1,2,5,0.378607,0.394397,0,No
5214,progenitor,1,15.09653218,1,10.81979828,10.81979828,1,163.341433,1,1,2,1,1,2,5,0.378607,0.394397,0,No
5218,proficient,1,15.09653218,1,10.81979828,10.81979828,1,163.341433,1,1,2,1,1,2,5,0.360829,0.373487,0,No
5219,professorial,1,15.09653218,1,10.81979828,10.81979828,1,163.341433,1,1,2,1,1,2,5,0.318535,0.322197,0,No
5224,prof,1,15.09653218,1,10.81979828,10.81979828,1,163.341433,1,1,2,1,1,2,5,0.312787,0.317305,0,No
5234,procrastinate,1,15.09653218,1,10.81979828,10.81979828,1,163.341433,1,1,2,1,1,2,5,0.336028,0.342206,0,No
5248,probationary,1,15.09653218,1,10.81979828,10.81979828,1,163.341433,1,0,1,1,0,1,0,0,0,0,No
5254,privet,1,15.09653218,1,10.81979828,10.81979828,1,163.341433,1,0,1,1,0,1,0,0,0,0,No
5264,printout,1,15.09653218,1,10.81979828,10.81979828,1,163.341433,1,1,2,1,1,2,5,0.398076,0.415824,0,No
5285,prickle,1,15.09653218,1,10.81979828,10.81979828,1,163.341433,1,1,2,1,1,2,5,0.375317,0.391855,0,No
5295,presumption,1,15.09653218,1,10.81979828,10.81979828,1,163.341433,1,1,2,1,1,2,5,0.378607,0.394397,0,No
5310,prerogative,1,15.09653218,1,10.81979828,10.81979828,1,163.341433,1,1,2,1,1,2,5,0.378607,0.394397,0,No
5327,preferential,1,15.09653218,1,10.81979828,10.81979828,1,163.341433,0,0,0,0,0,0,0,0,0,0,No
5332,preen,1,15.09653218,1,10.81979828,10.81979828,1,163.341433,1,0,1,1,0,1,0,0,0,0,No
5337,predicament,1,15.09653218,1,10.81979828,10.81979828,1,163.341433,1,1,2,1,1,2,5,0.324077,0.327367,0,No
5340,precocious,1,15.09653218,1,10.81979828,10.81979828,1,163.341433,1,1,2,1,1,2,5,0.320705,0.324646,0,No
5348,precarious,1,15.09653218,1,10.81979828,10.81979828,1,163.341433,1,0,1,1,0,1,0,0,0,0,No
5352,prayerful,1,15.09653218,1,10.81979828,10.81979828,1,163.341433,1,1,2,1,1,2,5,0.325146,0.328644,0,No
5354,pravda,1,15.09653218,1,10.81979828,10.81979828,1,163.341433,1,0,1,1,0,1,0,0,0,0,No
5358,pram,1,15.09653218,1,10.81979828,10.81979828,1,163.341433,1,1,2,1,1,2,5,0.345599,0.354479,0,No
5370,practicable,1,15.09653218,1,10.81979828,10.81979828,1,163.341433,0,1,1,0,1,1,6,0.24252,0.244146,0,No
5373,powerhouse,1,15.09653218,1,10.81979828,10.81979828,1,163.341433,1,1,2,1,1,2,5,0.378607,0.394397,0,No
5381,pout,1,15.09653218,1,10.81979828,10.81979828,1,163.341433,0,1,1,0,1,1,5,0.345598,0.354477,0,No
5392,pothole,1,15.09653218,1,10.81979828,10.81979828,1,163.341433,1,0,1,1,0,1,0,0,0,0,No
5406,postoperative,1,15.09653218,1,10.81979828,10.81979828,1,163.341433,0,0,0,0,0,0,0,0,0,0,No
5407,postmortem,1,15.09653218,1,10.81979828,10.81979828,1,163.341433,1,1,2,1,1,2,5,0.312188,0.316586,0,No
5414,posterity,1,15.09653218,1,10.81979828,10.81979828,1,163.341433,1,1,2,1,1,2,5,0.321035,0.327202,0,No
5415,posteriori,1,15.09653218,1,10.81979828,10.81979828,1,163.341433,1,0,1,1,0,1,0,0,0,0,No
5418,postcondition,1,15.09653218,1,10.81979828,10.81979828,1,163.341433,1,1,2,1,1,2,5,0.398076,0.415824,0,No
5461,porcine,1,15.09653218,1,10.81979828,10.81979828,1,163.341433,1,1,2,1,1,2,5,0.311508,0.315949,0,No
5471,popish,1,15.09653218,1,10.81979828,10.81979828,1,163.341433,1,1,2,1,1,2,5,0.318244,0.32169,0,No
5486,ponder,1,15.09653218,1,10.81979828,10.81979828,1,163.341433,1,0,1,1,0,1,0,0,0,0,No
5488,poncho,1,15.09653218,1,10.81979828,10.81979828,1,163.341433,1,1,2,1,1,2,5,0.336028,0.342023,0,No
5490,pompous,1,15.09653218,1,10.81979828,10.81979828,1,163.341433,0,1,1,0,1,1,5,0.355189,0.366884,0,No
5499,pomade,1,15.09653218,1,10.81979828,10.81979828,1,163.341433,0,0,0,0,0,0,0,0,0,0,No
5502,polysemy,1,15.09653218,1,10.81979828,10.81979828,1,163.341433,0,0,0,0,0,0,0,0,0,0,No
5512,polyhymnia,1,15.09653218,1,10.81979828,10.81979828,1,163.341433,1,1,2,1,1,2,5,0.398076,0.415824,0,No
5517,polygynous,1,15.09653218,1,10.81979828,10.81979828,1,163.341433,1,1,2,1,1,2,5,0.310126,0.314893,0,No
5518,polygonal,1,15.09653218,1,10.81979828,10.81979828,1,163.341433,0,1,1,0,1,1,5,0.315143,0.319114,0,No
5537,politicking,1,15.09653218,1,10.81979828,10.81979828,1,163.341433,0,1,1,0,1,1,5,0.338882,0.345659,0,No
5547,policewoman,1,15.09653218,1,10.81979828,10.81979828,1,163.341433,1,1,2,1,1,2,5,0.324902,0.329008,0,No
5551,polecat,1,15.09653218,1,10.81979828,10.81979828,1,163.341433,1,1,2,1,1,2,5,0.321035,0.327202,0,No
5564,poignant,1,15.09653218,1,10.81979828,10.81979828,1,163.341433,1,1,2,1,1,2,5,0.318827,0.322201,0,No
5565,poi,1,15.09653218,1,10.81979828,10.81979828,1,163.341433,1,0,1,1,0,1,0,0,0,0,No
5567,pogo,1,15.09653218,1,10.81979828,10.81979828,1,163.341433,1,1,2,1,1,2,5,0.398076,0.415824,0,No
5576,pocketful,1,15.09653218,1,10.81979828,10.81979828,1,163.341433,0,1,1,0,1,1,5,0.378604,0.394393,0,No
5577,pocketbook,1,15.09653218,1,10.81979828,10.81979828,1,163.341433,1,1,2,1,1,2,5,0.326305,0.329516,0,No
5586,ply,1,15.09653218,1,10.81979828,10.81979828,1,163.341433,1,1,2,1,1,2,5,0.398076,0.415824,0,No
5588,pluton,1,15.09653218,1,10.81979828,10.81979828,1,163.341433,0,1,1,0,1,1,5,0.3216,0.326054,0,No
5597,plume,1,15.09653218,1,10.81979828,10.81979828,1,163.341433,1,1,2,1,1,2,5,0.398076,0.415824,0,No
5598,plumb,1,15.09653218,1,10.81979828,10.81979828,1,163.341433,1,1,2,1,1,2,5,0.323569,0.326815,0,No
5604,plowman,1,15.09653218,1,10.81979828,10.81979828,1,163.341433,0,0,0,0,0,0,0,0,0,0,No
5610,plexiglas,1,15.09653218,1,10.81979828,10.81979828,1,163.341433,1,1,2,1,1,2,5,0.384237,0.400402,0,No
5611,pleural,1,15.09653218,1,10.81979828,10.81979828,1,163.341433,1,1,2,1,1,2,5,0.285033,0.29138,0,No
5616,plenary,1,15.09653218,1,10.81979828,10.81979828,1,163.341433,0,0,0,0,0,0,0,0,0,0,No
5626,plead,1,15.09653218,1,10.81979828,10.81979828,1,163.341433,1,1,2,1,1,2,5,0.333854,0.3397,0,No
5644,platonist,1,15.09653218,1,10.81979828,10.81979828,1,163.341433,1,0,1,1,0,1,0,0,0,0,No
5650,platen,1,15.09653218,1,10.81979828,10.81979828,1,163.341433,1,1,2,1,1,2,5,0.338882,0.345659,0,No
5657,plasmid,1,15.09653218,1,10.81979828,10.81979828,1,163.341433,1,1,2,1,1,2,5,0.321914,0.325019,0,No
5659,plasm,1,15.09653218,1,10.81979828,10.81979828,1,163.341433,1,0,1,1,0,1,0,0,0,0,No
5662,plantain,1,15.09653218,1,10.81979828,10.81979828,1,163.341433,1,1,2,1,1,2,5,0.384237,0.400402,0,No
5665,plank,1,15.09653218,1,10.81979828,10.81979828,1,163.341433,1,1,2,1,1,2,5,0.360829,0.373487,0,No
5674,plaintive,1,15.09653218,1,10.81979828,10.81979828,1,163.341433,1,0,1,1,0,1,0,0,0,0,No
5687,placate,1,15.09653218,1,10.81979828,10.81979828,1,163.341433,1,0,1,1,0,1,0,0,0,0,No
5706,pitchblende,1,15.09653218,1,10.81979828,10.81979828,1,163.341433,0,1,1,0,1,1,5,0.345598,0.354477,0,No
5713,pisces,1,15.09653218,1,10.81979828,10.81979828,1,163.341433,0,1,1,0,1,1,5,0.398072,0.415819,0,No
5714,piscataway,1,15.09653218,1,10.81979828,10.81979828,1,163.341433,1,1,2,1,1,2,5,0.288418,0.294731,0,No
5718,pique,1,15.09653218,1,10.81979828,10.81979828,1,163.341433,1,1,2,1,1,2,5,0.312843,0.317223,0,No
5730,pinpoint,1,15.09653218,1,10.81979828,10.81979828,1,163.341433,1,1,2,1,1,2,5,0.375317,0.391855,0,No
5737,pinion,1,15.09653218,1,10.81979828,10.81979828,1,163.341433,1,1,2,1,1,2,5,0.317964,0.321471,0,No
5744,pinch,1,15.09653218,1,10.81979828,10.81979828,1,163.341433,1,0,1,1,0,1,0,0,0,0,No
5745,pincer,1,15.09653218,1,10.81979828,10.81979828,1,163.341433,1,1,2,1,1,2,5,0.326479,0.32972,0,No
5752,pillory,1,15.09653218,1,10.81979828,10.81979828,1,163.341433,1,1,2,1,1,2,5,0.32737,0.331262,0,No
5761,pigpen,1,15.09653218,1,10.81979828,10.81979828,1,163.341433,1,0,1,1,0,1,0,0,0,0,No
5764,pigeonhole,1,15.09653218,1,10.81979828,10.81979828,1,163.341433,1,1,2,1,1,2,5,0.316943,0.320653,0,No
5773,piecemeal,1,15.09653218,1,10.81979828,10.81979828,1,163.341433,0,1,1,0,1,1,5,0.35917,0.371521,0,No
5789,pickerel,1,15.09653218,1,10.81979828,10.81979828,1,163.341433,1,1,2,1,1,2,5,0.384237,0.400402,0,No
5802,physiotherapy,1,15.09653218,1,10.81979828,10.81979828,1,163.341433,0,0,0,0,0,0,0,0,0,0,No
5803,physiotherapist,1,15.09653218,1,10.81979828,10.81979828,1,163.341433,1,1,2,1,1,2,6,0.240829,0.242582,0,No
5806,physic,1,15.09653218,1,10.81979828,10.81979828,1,163.341433,0,1,1,0,1,1,5,0.384234,0.400398,0,No
5814,photometry,1,15.09653218,1,10.81979828,10.81979828,1,163.341433,1,0,1,1,0,1,0,0,0,0,No
5815,photolysis,1,15.09653218,1,10.81979828,10.81979828,1,163.341433,0,1,1,0,1,1,5,0.398072,0.415819,0,No
5820,phosphoric,1,15.09653218,1,10.81979828,10.81979828,1,163.341433,1,1,2,1,1,2,5,0.318244,0.321897,0,No
5823,phosphide,1,15.09653218,1,10.81979828,10.81979828,1,163.341433,0,1,1,0,1,1,5,0.384234,0.400398,0,No
5826,phony,1,15.09653218,1,10.81979828,10.81979828,1,163.341433,1,1,2,1,1,2,5,0.333596,0.339081,0,No
5856,phenolic,1,15.09653218,1,10.81979828,10.81979828,1,163.341433,1,0,1,1,0,1,0,0,0,0,No
5867,phalanx,1,15.09653218,1,10.81979828,10.81979828,1,163.341433,0,1,1,0,1,1,5,0.318684,0.322255,0,No
5869,phalanger,1,15.09653218,1,10.81979828,10.81979828,1,163.341433,0,1,1,0,1,1,5,0.319459,0.322887,0,No
5876,petunia,1,15.09653218,1,10.81979828,10.81979828,1,163.341433,0,1,1,0,1,1,5,0.345598,0.354477,0,No
5883,petrel,1,15.09653218,1,10.81979828,10.81979828,1,163.341433,1,0,1,1,0,1,0,0,0,0,No
5887,petiole,1,15.09653218,1,10.81979828,10.81979828,1,163.341433,1,1,2,1,1,2,5,0.355198,0.36689,0,No
5901,perversion,1,15.09653218,1,10.81979828,10.81979828,1,163.341433,1,1,2,1,1,2,5,0.347133,0.356191,0,No
5906,pertinent,1,15.09653218,1,10.81979828,10.81979828,1,163.341433,1,1,2,1,1,2,5,0.322201,0.325621,0,No
5919,persimmon,1,15.09653218,1,10.81979828,10.81979828,1,163.341433,1,1,2,1,1,2,5,0.31885,0.322247,0,No
5925,persecute,1,15.09653218,1,10.81979828,10.81979828,1,163.341433,1,1,2,1,1,2,5,0.328412,0.333573,0,No
5927,perpetuity,1,15.09653218,1,10.81979828,10.81979828,1,163.341433,1,1,2,1,1,2,5,0.375317,0.391855,0,No
5928,perpetuate,1,15.09653218,1,10.81979828,10.81979828,1,163.341433,1,1,2,1,1,2,5,0.398076,0.415824,0,No
5932,pernicious,1,15.09653218,1,10.81979828,10.81979828,1,163.341433,1,0,1,1,0,1,0,0,0,0,No
5942,permeable,1,15.09653218,1,10.81979828,10.81979828,1,163.341433,1,0,1,1,0,1,0,0,0,0,No
5945,perle,1,15.09653218,1,10.81979828,10.81979828,1,163.341433,1,1,2,1,1,2,5,0.313168,0.317493,0,No
5947,perk,1,15.09653218,1,10.81979828,10.81979828,1,163.341433,1,1,2,1,1,2,5,0.378607,0.394397,0,No
5951,periscope,1,15.09653218,1,10.81979828,10.81979828,1,163.341433,1,1,2,1,1,2,5,0.294349,0.300498,0,No
5965,perfumery,1,15.09653218,1,10.81979828,10.81979828,1,163.341433,1,1,2,1,1,2,5,0.319792,0.32323,0,No
5973,perdition,1,15.09653218,1,10.81979828,10.81979828,1,163.341433,1,1,2,1,1,2,5,0.32681,0.33159,0,No
5975,percussive,1,15.09653218,1,10.81979828,10.81979828,1,163.341433,0,1,1,0,1,1,5,0.311575,0.316132,0,No
5980,perceptive,1,15.09653218,1,10.81979828,10.81979828,1,163.341433,1,0,1,1,0,1,0,0,0,0,No
5991,peppy,1,15.09653218,1,10.81979828,10.81979828,1,163.341433,1,1,2,1,1,2,5,0.301713,0.307346,0,No
5992,peppery,1,15.09653218,1,10.81979828,10.81979828,1,163.341433,1,0,1,1,0,1,0,0,0,0,No
6000,penury,1,15.09653218,1,10.81979828,10.81979828,1,163.341433,1,0,1,1,0,1,0,0,0,0,No
6001,penultimate,1,15.09653218,1,10.81979828,10.81979828,1,163.341433,1,1,2,1,1,2,5,0.320467,0.323701,0,No
6002,penthouse,1,15.09653218,1,10.81979828,10.81979828,1,163.341433,1,1,2,1,1,2,5,0.360829,0.373487,0,No
6006,pentateuch,1,15.09653218,1,10.81979828,10.81979828,1,163.341433,1,1,2,1,1,2,5,0.375317,0.391855,0,No
6007,pentane,1,15.09653218,1,10.81979828,10.81979828,1,163.341433,0,0,0,0,0,0,0,0,0,0,No
6009,pentagonal,1,15.09653218,1,10.81979828,10.81979828,1,163.341433,1,0,1,1,0,1,0,0,0,0,No
6018,penna,1,15.09653218,1,10.81979828,10.81979828,1,163.341433,1,0,1,1,0,1,0,0,0,0,No
6020,penman,1,15.09653218,1,10.81979828,10.81979828,1,163.341433,0,1,1,0,1,1,6,0.251734,0.253992,0,No
6032,pendant,1,15.09653218,1,10.81979828,10.81979828,1,163.341433,1,1,2,1,1,2,5,0.345599,0.354479,0,No
6033,pend,1,15.09653218,1,10.81979828,10.81979828,1,163.341433,1,0,1,1,0,1,0,0,0,0,No
6035,penchant,1,15.09653218,1,10.81979828,10.81979828,1,163.341433,1,1,2,1,1,2,5,0.378607,0.394397,0,No
6058,peep,1,15.09653218,1,10.81979828,10.81979828,1,163.341433,0,1,1,0,1,1,5,0.336028,0.342206,0,No
6063,pediment,1,15.09653218,1,10.81979828,10.81979828,1,163.341433,1,1,2,1,1,2,5,0.398067,0.415814,0,No
6071,pedagogic,1,15.09653218,1,10.81979828,10.81979828,1,163.341433,1,0,1,1,0,1,0,0,0,0,No
6073,pectoralis,1,15.09653218,1,10.81979828,10.81979828,1,163.341433,0,1,1,0,1,1,5,0.345598,0.354477,0,No
6086,peal,1,15.09653218,1,10.81979828,10.81979828,1,163.341433,1,1,2,1,1,2,5,0.384246,0.400407,0,No
6088,peahen,1,15.09653218,1,10.81979828,10.81979828,1,163.341433,1,1,2,1,1,2,5,0.398076,0.415824,0,No
6093,peacetime,1,15.09653218,1,10.81979828,10.81979828,1,163.341433,1,1,2,1,1,2,5,0.322534,0.328145,0,No
6101,payroll,1,15.09653218,1,10.81979828,10.81979828,1,163.341433,0,1,1,0,1,1,5,0.301987,0.307557,0,No
6103,paymaster,1,15.09653218,1,10.81979828,10.81979828,1,163.341433,1,1,2,1,1,2,5,0.324361,0.327892,0,No
6108,pawpaw,1,15.09653218,1,10.81979828,10.81979828,1,163.341433,1,1,2,1,1,2,5,0.32946,0.333471,0,No
6111,pavlovian,1,15.09653218,1,10.81979828,10.81979828,1,163.341433,1,0,1,1,0,1,0,0,0,0,No
6123,paulette,1,15.09653218,1,10.81979828,10.81979828,1,163.341433,1,1,2,1,1,2,5,0.375317,0.391855,0,No
6135,patrolmen,1,15.09653218,1,10.81979828,10.81979828,1,163.341433,1,1,2,1,1,2,5,0.321605,0.326059,0,No
6136,patrolling,1,15.09653218,1,10.81979828,10.81979828,1,163.341433,1,1,2,1,1,2,5,0.338011,0.344413,0,No
6145,patriarchy,1,15.09653218,1,10.81979828,10.81979828,1,163.341433,1,1,2,1,1,2,5,0.378607,0.394397,0,No
6147,patois,1,15.09653218,1,10.81979828,10.81979828,1,163.341433,1,1,2,1,1,2,5,0.320288,0.323624,0,No
6156,pathetic,1,15.09653218,1,10.81979828,10.81979828,1,163.341433,1,1,2,1,1,2,5,0.320502,0.324085,0,No
6159,paternoster,1,15.09653218,1,10.81979828,10.81979828,1,163.341433,1,1,2,1,1,2,5,0.345599,0.354479,0,No
6165,patchwork,1,15.09653218,1,10.81979828,10.81979828,1,163.341433,1,1,2,1,1,2,5,0.332391,0.337648,0,No
6169,pasty,1,15.09653218,1,10.81979828,10.81979828,1,163.341433,0,1,1,0,1,1,5,0.31435,0.318635,0,No
6186,passaic,1,15.09653218,1,10.81979828,10.81979828,1,163.341433,1,1,2,1,1,2,5,0.327618,0.332596,0,No
6200,particulate,1,15.09653218,1,10.81979828,10.81979828,1,163.341433,1,0,1,1,0,1,0,0,0,0,No
6209,partake,1,15.09653218,1,10.81979828,10.81979828,1,163.341433,1,1,2,1,1,2,5,0.360829,0.373487,0,No
6215,parse,1,15.09653218,1,10.81979828,10.81979828,1,163.341433,1,1,2,1,1,2,5,0.347133,0.356191,0,No
6235,parimutuel,1,15.09653218,1,10.81979828,10.81979828,1,163.341433,0,0,0,0,0,0,0,0,0,0,No
6242,pare,1,15.09653218,1,10.81979828,10.81979828,1,163.341433,1,1,2,1,1,2,5,0.326017,0.329836,0,No
6246,parasol,1,15.09653218,1,10.81979828,10.81979828,1,163.341433,1,1,2,1,1,2,5,0.384237,0.400402,0,No
6250,paraphernalia,1,15.09653218,1,10.81979828,10.81979828,1,163.341433,1,1,2,1,1,2,5,0.375317,0.391855,0,No
6251,parapet,1,15.09653218,1,10.81979828,10.81979828,1,163.341433,1,1,2,1,1,2,5,0.336028,0.342206,0,No
6259,parallelogram,1,15.09653218,1,10.81979828,10.81979828,1,163.341433,1,1,2,1,1,2,5,0.345068,0.353675,0,No
6280,pappy,1,15.09653218,1,10.81979828,10.81979828,1,163.341433,1,1,2,1,1,2,5,0.300376,0.306141,0,No
6281,pappas,1,15.09653218,1,10.81979828,10.81979828,1,163.341433,1,0,1,1,0,1,0,0,0,0,No
6282,papery,1,15.09653218,1,10.81979828,10.81979828,1,163.341433,1,1,2,1,1,2,5,0.319383,0.322737,0,No
6284,paperweight,1,15.09653218,1,10.81979828,10.81979828,1,163.341433,1,1,2,1,1,2,5,0.384237,0.400402,0,No
6293,panty,1,15.09653218,1,10.81979828,10.81979828,1,163.341433,1,0,1,1,0,1,0,0,0,0,No
6294,pantry,1,15.09653218,1,10.81979828,10.81979828,1,163.341433,0,1,1,0,1,1,5,0.310079,0.314801,0,No
6311,pander,1,15.09653218,1,10.81979828,10.81979828,1,163.341433,1,1,2,1,1,2,5,0.359172,0.371523,0,No
6317,pancho,1,15.09653218,1,10.81979828,10.81979828,1,163.341433,1,1,2,1,1,2,5,0.308531,0.313504,0,No
6334,palladian,1,15.09653218,1,10.81979828,10.81979828,1,163.341433,1,0,1,1,0,1,0,0,0,0,No
6343,paleoanthropology,1,15.09653218,1,10.81979828,10.81979828,1,163.341433,1,1,2,1,1,2,5,0.384237,0.400402,0,No
6355,paintbrush,1,15.09653218,1,10.81979828,10.81979828,1,163.341433,0,0,0,0,0,0,0,0,0,0,No
6360,pail,1,15.09653218,1,10.81979828,10.81979828,1,163.341433,1,1,2,1,1,2,5,0.291631,0.297946,0,No
6377,pacify,1,15.09653218,1,10.81979828,10.81979828,1,163.341433,1,1,2,1,1,2,5,0.398076,0.415824,0,No
6382,pabst,1,15.09653218,1,10.81979828,10.81979828,1,163.341433,1,1,2,1,1,2,5,0.278002,0.283991,0,No
6389,oxygenate,1,15.09653218,1,10.81979828,10.81979828,1,163.341433,1,1,2,1,1,2,5,0.398076,0.415824,0,No
6398,oxalate,1,15.09653218,1,10.81979828,10.81979828,1,163.341433,1,0,1,1,0,1,0,0,0,0,No
6401,owlet,1,15.09653218,1,10.81979828,10.81979828,1,163.341433,0,0,0,0,0,0,0,0,0,0,No
6405,ow,1,15.09653218,1,10.81979828,10.81979828,1,163.341433,0,1,1,0,1,1,5,0.360828,0.373485,0,No
6419,ouzel,1,15.09653218,1,10.81979828,10.81979828,1,163.341433,1,1,2,1,1,2,5,0.384237,0.400402,0,No
6421,outlandish,1,15.09653218,1,10.81979828,10.81979828,1,163.341433,1,1,2,1,1,2,5,0.309046,0.313826,0,No
6424,oust,1,15.09653218,1,10.81979828,10.81979828,1,163.341433,1,1,2,1,1,2,5,0.398076,0.415824,0,No
6429,ouch,1,15.09653218,1,10.81979828,10.81979828,1,163.341433,1,1,2,1,1,2,5,0.343985,0.352404,0,No
6443,osteopathic,1,15.09653218,1,10.81979828,10.81979828,1,163.341433,1,1,2,1,1,2,5,0.321903,0.325089,0,No
6450,osier,1,15.09653218,1,10.81979828,10.81979828,1,163.341433,0,1,1,0,1,1,5,0.384234,0.400398,0,No
6461,orthophosphate,1,15.09653218,1,10.81979828,10.81979828,1,163.341433,1,1,2,1,1,2,5,0.31232,0.316709,0,No
6467,orthoclase,1,15.09653218,1,10.81979828,10.81979828,1,163.341433,0,1,1,0,1,1,5,0.355189,0.366884,0,No
6468,orthant,1,15.09653218,1,10.81979828,10.81979828,1,163.341433,1,1,2,1,1,2,5,0.320485,0.323851,0,No
6471,orphic,1,15.09653218,1,10.81979828,10.81979828,1,163.341433,1,0,1,1,0,1,0,0,0,0,No
6475,orono,1,15.09653218,1,10.81979828,10.81979828,1,163.341433,1,1,2,1,1,2,5,0.313406,0.317803,0,No
6479,ornament,1,15.09653218,1,10.81979828,10.81979828,1,163.341433,1,1,2,1,1,2,5,0.326924,0.330949,0,No
6508,ordain,1,15.09653218,1,10.81979828,10.81979828,1,163.341433,1,0,1,1,0,1,0,0,0,0,No
6532,optima,1,15.09653218,1,10.81979828,10.81979828,1,163.341433,0,0,0,0,0,0,0,0,0,0,No
6534,oppressor,1,15.09653218,1,10.81979828,10.81979828,1,163.341433,0,0,0,0,0,0,0,0,0,0,No
6541,opposable,1,15.09653218,1,10.81979828,10.81979828,1,163.341433,0,0,0,0,0,0,0,0,0,0,No
6553,operable,1,15.09653218,1,10.81979828,10.81979828,1,163.341433,1,1,2,1,1,2,6,0.290819,0.297288,0,No
6570,onomatopoeia,1,15.09653218,1,10.81979828,10.81979828,1,163.341433,1,1,2,1,1,2,5,0.331268,0.335748,0,No
6588,omission,1,15.09653218,1,10.81979828,10.81979828,1,163.341433,1,1,2,1,1,2,5,0.378607,0.394397,0,No
6589,ominous,1,15.09653218,1,10.81979828,10.81979828,1,163.341433,1,1,2,1,1,2,5,0.322242,0.326421,0,No
6592,omelet,1,15.09653218,1,10.81979828,10.81979828,1,163.341433,1,1,2,1,1,2,5,0.345599,0.354479,0,No
6609,oligarchic,1,15.09653218,1,10.81979828,10.81979828,1,163.341433,1,1,2,1,1,2,5,0.325575,0.32918,0,No
6637,ogle,1,15.09653218,1,10.81979828,10.81979828,1,163.341433,1,1,2,1,1,2,5,0.325677,0.329423,0,No
6647,offload,1,15.09653218,1,10.81979828,10.81979828,1,163.341433,0,1,1,0,1,1,5,0.398072,0.415819,0,No
6648,officious,1,15.09653218,1,10.81979828,10.81979828,1,163.341433,0,1,1,0,1,1,6,0.280349,0.286498,0,No
6649,officio,1,15.09653218,1,10.81979828,10.81979828,1,163.341433,1,1,2,1,1,2,5,0.378615,0.394401,0,No
6652,officeholder,1,15.09653218,1,10.81979828,10.81979828,1,163.341433,1,0,1,1,0,1,0,0,0,0,No
6654,offertory,1,15.09653218,1,10.81979828,10.81979828,1,163.341433,1,1,2,1,1,2,5,0.384246,0.400407,0,No
6662,oersted,1,15.09653218,1,10.81979828,10.81979828,1,163.341433,1,0,1,1,0,1,0,0,0,0,No
6666,odometer,1,15.09653218,1,10.81979828,10.81979828,1,163.341433,1,1,2,1,1,2,5,0.328619,0.333504,0,No
6687,oceanside,1,15.09653218,1,10.81979828,10.81979828,1,163.341433,1,1,2,1,1,2,5,0.324581,0.327869,0,No
6689,oceanographer,1,15.09653218,1,10.81979828,10.81979828,1,163.341433,1,1,2,1,1,2,5,0.320705,0.324646,0,No
6698,occupant,1,15.09653218,1,10.81979828,10.81979828,1,163.341433,1,0,1,1,0,1,0,0,0,0,No
6702,occident,1,15.09653218,1,10.81979828,10.81979828,1,163.341433,1,1,2,1,1,2,5,0.32681,0.33159,0,No
6710,obstetrician,1,15.09653218,1,10.81979828,10.81979828,1,163.341433,1,1,2,1,1,2,5,0.35519,0.366885,0,No
6725,oblivious,1,15.09653218,1,10.81979828,10.81979828,1,163.341433,1,1,2,1,1,2,5,0.359172,0.371523,0,No
6750,nyu,1,15.09653218,1,10.81979828,10.81979828,1,163.341433,1,1,2,1,1,2,5,0.345599,0.354479,0,No
6756,nv,1,15.09653218,1,10.81979828,10.81979828,1,163.341433,1,1,2,1,1,2,5,0.302737,0.308239,0,No
6758,nutritive,1,15.09653218,1,10.81979828,10.81979828,1,163.341433,1,1,2,1,1,2,5,0.321233,0.324362,0,No
6769,numismatist,1,15.09653218,1,10.81979828,10.81979828,1,163.341433,1,1,2,1,1,2,5,0.345599,0.354479,0,No
6779,nugget,1,15.09653218,1,10.81979828,10.81979828,1,163.341433,0,1,1,0,1,1,5,0.398072,0.415819,0,No
6780,nudge,1,15.09653218,1,10.81979828,10.81979828,1,163.341433,0,0,0,0,0,0,0,0,0,0,No
6786,nucleoli,1,15.09653218,1,10.81979828,10.81979828,1,163.341433,1,1,2,1,1,2,5,0.325976,0.330994,0,No
6805,novae,1,15.09653218,1,10.81979828,10.81979828,1,163.341433,1,1,2,1,1,2,5,0.329717,0.33456,0,No
6809,nourish,1,15.09653218,1,10.81979828,10.81979828,1,163.341433,1,1,2,1,1,2,5,0.359165,0.371513,0,No
6825,notary,1,15.09653218,1,10.81979828,10.81979828,1,163.341433,1,1,2,1,1,2,5,0.375309,0.391846,0,No
6829,nostalgic,1,15.09653218,1,10.81979828,10.81979828,1,163.341433,1,1,2,1,1,2,5,0.299737,0.305611,0,No
6831,nosebleed,1,15.09653218,1,10.81979828,10.81979828,1,163.341433,0,1,1,0,1,1,5,0.322195,0.325591,0,No
6842,northrup,1,15.09653218,1,10.81979828,10.81979828,1,163.341433,1,1,2,1,1,2,5,0.318649,0.322141,0,No
6877,nomad,1,15.09653218,1,10.81979828,10.81979828,1,163.341433,1,1,2,1,1,2,5,0.345606,0.354483,0,No
6885,nodal,1,15.09653218,1,10.81979828,10.81979828,1,163.341433,1,1,2,1,1,2,5,0.316457,0.320236,0,No
6895,nob,1,15.09653218,1,10.81979828,10.81979828,1,163.341433,1,1,2,1,1,2,5,0.302768,0.30836,0,No
6913,nip,1,15.09653218,1,10.81979828,10.81979828,1,163.341433,1,1,2,1,1,2,5,0.314238,0.318302,0,No
6924,nimble,1,15.09653218,1,10.81979828,10.81979828,1,163.341433,0,0,0,0,0,0,0,0,0,0,No
6930,nih,1,15.09653218,1,10.81979828,10.81979828,1,163.341433,0,1,1,0,1,1,5,0.313995,0.318159,0,No
6933,nightmarish,1,15.09653218,1,10.81979828,10.81979828,1,163.341433,1,0,1,1,0,1,0,0,0,0,No
6937,nightgown,1,15.09653218,1,10.81979828,10.81979828,1,163.341433,1,1,2,1,1,2,5,0.35519,0.366885,0,No
6939,nightdress,1,15.09653218,1,10.81979828,10.81979828,1,163.341433,1,1,2,1,1,2,5,0.345599,0.354479,0,No
6941,nightcap,1,15.09653218,1,10.81979828,10.81979828,1,163.341433,1,1,2,1,1,2,5,0.321984,0.325052,0,No
6952,nicotinamide,1,15.09653218,1,10.81979828,10.81979828,1,163.341433,0,1,1,0,1,1,5,0.298991,0.304808,0,No
6954,nicodemus,1,15.09653218,1,10.81979828,10.81979828,1,163.341433,0,1,1,0,1,1,5,0.343984,0.352403,0,No
6983,newlywed,1,15.09653218,1,10.81979828,10.81979828,1,163.341433,1,1,2,1,1,2,5,0.325193,0.328627,0,No
6984,newline,1,15.09653218,1,10.81979828,10.81979828,1,163.341433,1,1,2,1,1,2,5,0.384237,0.400402,0,No
7004,neuroses,1,15.09653218,1,10.81979828,10.81979828,1,163.341433,1,1,2,1,1,2,5,0.384237,0.400402,0,No
7005,neuropsychiatric,1,15.09653218,1,10.81979828,10.81979828,1,163.341433,0,0,0,0,0,0,0,0,0,0,No
7006,neurophysiology,1,15.09653218,1,10.81979828,10.81979828,1,163.341433,0,0,0,0,0,0,0,0,0,0,No
7009,neuromuscular,1,15.09653218,1,10.81979828,10.81979828,1,163.341433,1,0,1,1,0,1,0,0,0,0,No
7016,nether,1,15.09653218,1,10.81979828,10.81979828,1,163.341433,1,0,1,1,0,1,0,0,0,0,No
7019,nestle,1,15.09653218,1,10.81979828,10.81979828,1,163.341433,0,1,1,0,1,1,5,0.321344,0.325025,0,No
7030,nepenthe,1,15.09653218,1,10.81979828,10.81979828,1,163.341433,1,0,1,1,0,1,0,0,0,0,No
7032,neoteny,1,15.09653218,1,10.81979828,10.81979828,1,163.341433,0,1,1,0,1,1,5,0.326924,0.33095,0,No
7036,neologism,1,15.09653218,1,10.81979828,10.81979828,1,163.341433,0,1,1,0,1,1,5,0.343984,0.352403,0,No
7041,nematode,1,15.09653218,1,10.81979828,10.81979828,1,163.341433,1,1,2,1,1,2,5,0.331268,0.335748,0,No
7048,negroes,1,15.09653218,1,10.81979828,10.81979828,1,163.341433,1,1,2,1,1,2,5,0.323286,0.326533,0,No
7063,necrotic,1,15.09653218,1,10.81979828,10.81979828,1,163.341433,1,1,2,1,1,2,5,0.319389,0.322741,0,No
7072,nebulous,1,15.09653218,1,10.81979828,10.81979828,1,163.341433,1,1,2,1,1,2,5,0.304393,0.309724,0,No
7073,nebular,1,15.09653218,1,10.81979828,10.81979828,1,163.341433,1,1,2,1,1,2,5,0.321367,0.324586,0,No
7086,ndjamena,1,15.09653218,1,10.81979828,10.81979828,1,163.341433,1,0,1,1,0,1,0,0,0,0,No
7088,ncr,1,15.09653218,1,10.81979828,10.81979828,1,163.341433,0,1,1,0,1,1,6,0.279365,0.285469,0,No
7112,natty,1,15.09653218,1,10.81979828,10.81979828,1,163.341433,0,0,0,0,0,0,0,0,0,0,No
7125,nasturtium,1,15.09653218,1,10.81979828,10.81979828,1,163.341433,0,1,1,0,1,1,5,0.325689,0.32903,0,No
7134,narrate,1,15.09653218,1,10.81979828,10.81979828,1,163.341433,1,1,2,1,1,2,5,0.398076,0.415824,0,No
7152,nameplate,1,15.09653218,1,10.81979828,10.81979828,1,163.341433,1,1,2,1,1,2,5,0.319337,0.322658,0,No
7167,nab,1,15.09653218,1,10.81979828,10.81979828,1,163.341433,1,1,2,1,1,2,5,0.331144,0.336088,0,No
7171,mythic,1,15.09653218,1,10.81979828,10.81979828,1,163.341433,1,1,2,1,1,2,5,0.317959,0.321545,0,No
7181,myriad,1,15.09653218,1,10.81979828,10.81979828,1,163.341433,1,0,1,1,0,1,0,0,0,0,No
7188,myeloid,1,15.09653218,1,10.81979828,10.81979828,1,163.341433,1,1,2,1,1,2,5,0.319383,0.322737,0,No
7190,mycology,1,15.09653218,1,10.81979828,10.81979828,1,163.341433,1,1,2,1,1,2,5,0.332161,0.339406,0,No
7205,musty,1,15.09653218,1,10.81979828,10.81979828,1,163.341433,1,1,2,1,1,2,5,0.323705,0.326994,0,No
7211,muslin,1,15.09653218,1,10.81979828,10.81979828,1,163.341433,1,1,2,1,1,2,5,0.398067,0.415814,0,No
7227,musculature,1,15.09653218,1,10.81979828,10.81979828,1,163.341433,1,1,2,1,1,2,5,0.327394,0.331304,0,No
7230,muscovite,1,15.09653218,1,10.81979828,10.81979828,1,163.341433,1,0,1,1,0,1,0,0,0,0,No
7236,muriatic,1,15.09653218,1,10.81979828,10.81979828,1,163.341433,1,1,2,1,1,2,5,0.318238,0.321893,0,No
7251,mumford,1,15.09653218,1,10.81979828,10.81979828,1,163.341433,1,0,1,1,0,1,0,0,0,0,No
7258,multiplex,1,15.09653218,1,10.81979828,10.81979828,1,163.341433,1,1,2,1,1,2,5,0.32678,0.33055,0,No
7260,multics,1,15.09653218,1,10.81979828,10.81979828,1,163.341433,1,1,2,1,1,2,5,0.321873,0.325071,0,No
7274,muff,1,15.09653218,1,10.81979828,10.81979828,1,163.341433,1,0,1,1,0,1,0,0,0,0,No
7276,muenster,1,15.09653218,1,10.81979828,10.81979828,1,163.341433,1,1,2,1,1,2,5,0.360829,0.373487,0,No
7277,mueller,1,15.09653218,1,10.81979828,10.81979828,1,163.341433,1,1,2,1,1,2,5,0.322558,0.326107,0,No
7278,mudguard,1,15.09653218,1,10.81979828,10.81979828,1,163.341433,1,1,2,1,1,2,5,0.345599,0.354479,0,No
7280,mudd,1,15.09653218,1,10.81979828,10.81979828,1,163.341433,1,1,2,1,1,2,5,0.324533,0.328195,0,No
7294,moyer,1,15.09653218,1,10.81979828,10.81979828,1,163.341433,1,1,2,1,1,2,5,0.360829,0.373487,0,No
7303,mousse,1,15.09653218,1,10.81979828,10.81979828,1,163.341433,1,1,2,1,1,2,5,0.384237,0.400402,0,No
7306,mourn,1,15.09653218,1,10.81979828,10.81979828,1,163.341433,1,1,2,1,1,2,5,0.315545,0.319588,0,No
7322,motivate,1,15.09653218,1,10.81979828,10.81979828,1,163.341433,1,1,2,1,1,2,5,0.398076,0.415824,0,No
7332,mossy,1,15.09653218,1,10.81979828,10.81979828,1,163.341433,1,1,2,1,1,2,5,0.322382,0.325566,0,No
7337,moslem,1,15.09653218,1,10.81979828,10.81979828,1,163.341433,1,1,2,1,1,2,5,0.384237,0.400402,0,No
7343,mortgagor,1,15.09653218,1,10.81979828,10.81979828,1,163.341433,1,0,1,1,0,1,0,0,0,0,No
7344,mortgagee,1,15.09653218,1,10.81979828,10.81979828,1,163.341433,1,1,2,1,1,2,5,0.283277,0.289559,0,No
7360,morphemic,1,15.09653218,1,10.81979828,10.81979828,1,163.341433,0,0,0,0,0,0,0,0,0,0,No
7367,moribund,1,15.09653218,1,10.81979828,10.81979828,1,163.341433,1,0,1,1,0,1,0,0,0,0,No
7387,moonlit,1,15.09653218,1,10.81979828,10.81979828,1,163.341433,1,1,2,1,1,2,5,0.320138,0.323601,0,No
7389,mooney,1,15.09653218,1,10.81979828,10.81979828,1,163.341433,1,1,2,1,1,2,5,0.319561,0.323355,0,No
7393,moo,1,15.09653218,1,10.81979828,10.81979828,1,163.341433,1,0,1,1,0,1,0,0,0,0,No
7407,montclair,1,15.09653218,1,10.81979828,10.81979828,1,163.341433,1,1,2,1,1,2,5,0.327618,0.332596,0,No
7412,monstrous,1,15.09653218,1,10.81979828,10.81979828,1,163.341433,1,1,2,1,1,2,5,0.384237,0.400402,0,No
7424,monologist,1,15.09653218,1,10.81979828,10.81979828,1,163.341433,1,1,2,1,1,2,5,0.384237,0.400402,0,No
7428,monoceros,1,15.09653218,1,10.81979828,10.81979828,1,163.341433,0,1,1,0,1,1,5,0.324409,0.327806,0,No
7433,monies,1,15.09653218,1,10.81979828,10.81979828,1,163.341433,1,1,2,1,1,2,5,0.325976,0.330994,0,No
7439,monetarism,1,15.09653218,1,10.81979828,10.81979828,1,163.341433,0,1,1,0,1,1,5,0.345598,0.354477,0,No
7441,monaural,1,15.09653218,1,10.81979828,10.81979828,1,163.341433,1,1,2,1,1,2,6,0.268544,0.273744,0,No
7456,molybdenite,1,15.09653218,1,10.81979828,10.81979828,1,163.341433,1,1,2,1,1,2,5,0.331268,0.335748,0,No
7459,moloch,1,15.09653218,1,10.81979828,10.81979828,1,163.341433,1,1,2,1,1,2,5,0.331268,0.335748,0,No
7463,moliere,1,15.09653218,1,10.81979828,10.81979828,1,163.341433,1,0,1,1,0,1,0,0,0,0,No
7467,moldy,1,15.09653218,1,10.81979828,10.81979828,1,163.341433,1,1,2,1,1,2,5,0.384237,0.400402,0,No
7468,moldboard,1,15.09653218,1,10.81979828,10.81979828,1,163.341433,1,1,2,1,1,2,5,0.299474,0.305264,0,No
7479,mogadiscio,1,15.09653218,1,10.81979828,10.81979828,1,163.341433,1,1,2,1,1,2,5,0.316569,0.321278,0,No
7483,moduli,1,15.09653218,1,10.81979828,10.81979828,1,163.341433,1,1,2,1,1,2,5,0.359179,0.371527,0,No
7499,mocha,1,15.09653218,1,10.81979828,10.81979828,1,163.341433,0,1,1,0,1,1,5,0.384234,0.400398,0,No
7500,moccasin,1,15.09653218,1,10.81979828,10.81979828,1,163.341433,1,0,1,1,0,1,0,0,0,0,No
7511,mizar,1,15.09653218,1,10.81979828,10.81979828,1,163.341433,0,1,1,0,1,1,5,0.288711,0.295038,0,No
7517,mitral,1,15.09653218,1,10.81979828,10.81979828,1,163.341433,0,1,1,0,1,1,5,0.304876,0.310226,0,No
7520,mite,1,15.09653218,1,10.81979828,10.81979828,1,163.341433,1,1,2,1,1,2,5,0.293677,0.299827,0,No
7529,mississippian,1,15.09653218,1,10.81979828,10.81979828,1,163.341433,1,1,2,1,1,2,5,0.35519,0.366885,0,No
7536,misogynist,1,15.09653218,1,10.81979828,10.81979828,1,163.341433,1,1,2,1,1,2,5,0.345599,0.354479,0,No
7539,miser,1,15.09653218,1,10.81979828,10.81979828,1,163.341433,1,0,1,1,0,1,0,0,0,0,No
7540,miscible,1,15.09653218,1,10.81979828,10.81979828,1,163.341433,1,1,2,1,1,2,5,0.398076,0.415824,0,No
7543,mirth,1,15.09653218,1,10.81979828,10.81979828,1,163.341433,1,1,2,1,1,2,5,0.384237,0.400402,0,No
7553,minuteman,1,15.09653218,1,10.81979828,10.81979828,1,163.341433,1,1,2,1,1,2,5,0.333854,0.3397,0,No
7567,minnow,1,15.09653218,1,10.81979828,10.81979828,1,163.341433,1,1,2,1,1,2,5,0.332167,0.339411,0,No
7584,minefield,1,15.09653218,1,10.81979828,10.81979828,1,163.341433,1,1,2,1,1,2,5,0.378607,0.394397,0,No
7586,mindful,1,15.09653218,1,10.81979828,10.81979828,1,163.341433,0,1,1,0,1,1,6,0.262173,0.266628,0,No
7598,mimetic,1,15.09653218,1,10.81979828,10.81979828,1,163.341433,1,1,2,1,1,2,5,0.320908,0.324071,0,No
7602,millstone,1,15.09653218,1,10.81979828,10.81979828,1,163.341433,1,1,2,1,1,2,5,0.359172,0.371523,0,No
7607,millikan,1,15.09653218,1,10.81979828,10.81979828,1,163.341433,1,0,1,1,0,1,0,0,0,0,No
7615,milkweed,1,15.09653218,1,10.81979828,10.81979828,1,163.341433,1,1,2,1,1,2,5,0.291933,0.298209,0,No
7623,milieu,1,15.09653218,1,10.81979828,10.81979828,1,163.341433,1,0,1,1,0,1,0,0,0,0,No
7646,midstream,1,15.09653218,1,10.81979828,10.81979828,1,163.341433,1,1,2,1,1,2,5,0.398076,0.415824,0,No
7658,middlemen,1,15.09653218,1,10.81979828,10.81979828,1,163.341433,1,1,2,1,1,2,5,0.360829,0.373487,0,No
7659,middlebury,1,15.09653218,1,10.81979828,10.81979828,1,163.341433,1,1,2,1,1,2,5,0.324527,0.32819,0,No
7680,miasma,1,15.09653218,1,10.81979828,10.81979828,1,163.341433,1,1,2,1,1,2,5,0.321367,0.324586,0,No
7684,mezzo,1,15.09653218,1,10.81979828,10.81979828,1,163.341433,1,1,2,1,1,2,5,0.321873,0.325071,0,No
7695,metonymy,1,15.09653218,1,10.81979828,10.81979828,1,163.341433,0,1,1,0,1,1,5,0.32648,0.331386,0,No
7710,metazoa,1,15.09653218,1,10.81979828,10.81979828,1,163.341433,0,0,0,0,0,0,0,0,0,0,No
7711,metaphoric,1,15.09653218,1,10.81979828,10.81979828,1,163.341433,1,1,2,1,1,2,5,0.326587,0.33041,0,No
7714,metamorphism,1,15.09653218,1,10.81979828,10.81979828,1,163.341433,0,0,0,0,0,0,0,0,0,0,No
7718,metallurgic,1,15.09653218,1,10.81979828,10.81979828,1,163.341433,1,0,1,1,0,1,0,0,0,0,No
7722,metabolite,1,15.09653218,1,10.81979828,10.81979828,1,163.341433,1,0,1,1,0,1,0,0,0,0,No
7749,meritorious,1,15.09653218,1,10.81979828,10.81979828,1,163.341433,1,1,2,1,1,2,6,0.292467,0.29867,0,No
7758,mercuric,1,15.09653218,1,10.81979828,10.81979828,1,163.341433,0,0,0,0,0,0,0,0,0,0,No
7759,mercurial,1,15.09653218,1,10.81979828,10.81979828,1,163.341433,0,1,1,0,1,1,5,0.318193,0.321682,0,No
7760,merck,1,15.09653218,1,10.81979828,10.81979828,1,163.341433,1,1,2,1,1,2,5,0.308966,0.31384,0,No
7782,meniscus,1,15.09653218,1,10.81979828,10.81979828,1,163.341433,1,1,2,1,1,2,5,0.345599,0.354479,0,No
7784,menial,1,15.09653218,1,10.81979828,10.81979828,1,163.341433,0,1,1,0,1,1,5,0.325104,0.328358,0,No
7791,menarche,1,15.09653218,1,10.81979828,10.81979828,1,163.341433,1,1,2,1,1,2,5,0.398076,0.415824,0,No
7808,melpomene,1,15.09653218,1,10.81979828,10.81979828,1,163.341433,1,1,2,1,1,2,5,0.398076,0.415824,0,No
7820,meld,1,15.09653218,1,10.81979828,10.81979828,1,163.341433,0,1,1,0,1,1,5,0.306301,0.311498,0,No
7824,melanism,1,15.09653218,1,10.81979828,10.81979828,1,163.341433,1,0,1,1,0,1,0,0,0,0,No
7825,melanin,1,15.09653218,1,10.81979828,10.81979828,1,163.341433,0,1,1,0,1,1,5,0.338882,0.345659,0,No
7842,meek,1,15.09653218,1,10.81979828,10.81979828,1,163.341433,1,1,2,1,1,2,5,0.34998,0.359708,0,No
7854,mediate,1,15.09653218,1,10.81979828,10.81979828,1,163.341433,1,1,2,1,1,2,5,0.328412,0.333573,0,No
7865,meaty,1,15.09653218,1,10.81979828,10.81979828,1,163.341433,1,1,2,1,1,2,5,0.328607,0.332758,0,No
7872,meander,1,15.09653218,1,10.81979828,10.81979828,1,163.341433,0,1,1,0,1,1,5,0.318222,0.321681,0,No
7884,mcmullen,1,15.09653218,1,10.81979828,10.81979828,1,163.341433,1,1,2,1,1,2,5,0.331274,0.335753,0,No
7890,mckinney,1,15.09653218,1,10.81979828,10.81979828,1,163.341433,1,1,2,1,1,2,5,0.326551,0.330051,0,No
7892,mckeon,1,15.09653218,1,10.81979828,10.81979828,1,163.341433,1,1,2,1,1,2,5,0.34998,0.359708,0,No
7899,mchugh,1,15.09653218,1,10.81979828,10.81979828,1,163.341433,1,0,1,1,0,1,0,0,0,0,No
7928,mccallum,1,15.09653218,1,10.81979828,10.81979828,1,163.341433,1,1,2,1,1,2,5,0.32734,0.331093,0,No
7931,mcallister,1,15.09653218,1,10.81979828,10.81979828,1,163.341433,0,1,1,0,1,1,5,0.320225,0.324243,0,No
7949,maxine,1,15.09653218,1,10.81979828,10.81979828,1,163.341433,1,0,1,1,0,1,0,0,0,0,No
7957,maw,1,15.09653218,1,10.81979828,10.81979828,1,163.341433,0,1,1,0,1,1,6,0.271591,0.277106,0,No
7963,mauricio,1,15.09653218,1,10.81979828,10.81979828,1,163.341433,1,0,1,1,0,1,0,0,0,0,No
7972,matron,1,15.09653218,1,10.81979828,10.81979828,1,163.341433,1,1,2,1,1,2,5,0.378607,0.394397,0,No
7974,matrilineal,1,15.09653218,1,10.81979828,10.81979828,1,163.341433,0,1,1,0,1,1,5,0.317834,0.321414,0,No
7976,matriarchal,1,15.09653218,1,10.81979828,10.81979828,1,163.341433,1,1,2,1,1,2,5,0.384237,0.400402,0,No
7987,mathematic,1,15.09653218,1,10.81979828,10.81979828,1,163.341433,1,0,1,1,0,1,0,0,0,0,No
7995,matchbook,1,15.09653218,1,10.81979828,10.81979828,1,163.341433,1,1,2,1,1,2,5,0.345599,0.354479,0,No
8016,masonite,1,15.09653218,1,10.81979828,10.81979828,1,163.341433,1,1,2,1,1,2,5,0.35519,0.366885,0,No
8044,mart,1,15.09653218,1,10.81979828,10.81979828,1,163.341433,1,1,2,1,1,2,5,0.384237,0.400402,0,No
8051,marsha,1,15.09653218,1,10.81979828,10.81979828,1,163.341433,1,0,1,1,0,1,0,0,0,0,No
8056,marriott,1,15.09653218,1,10.81979828,10.81979828,1,163.341433,1,0,1,1,0,1,0,0,0,0,No
8061,marquee,1,15.09653218,1,10.81979828,10.81979828,1,163.341433,1,1,2,1,1,2,5,0.32681,0.33159,0,No
8065,marmoset,1,15.09653218,1,10.81979828,10.81979828,1,163.341433,1,1,2,1,1,2,5,0.345606,0.354483,0,No
8069,marlene,1,15.09653218,1,10.81979828,10.81979828,1,163.341433,1,1,2,1,1,2,5,0.291784,0.298007,0,No
8072,marksmen,1,15.09653218,1,10.81979828,10.81979828,1,163.341433,1,1,2,1,1,2,5,0.310321,0.315231,0,No
8087,marinate,1,15.09653218,1,10.81979828,10.81979828,1,163.341433,1,1,2,1,1,2,5,0.398076,0.415824,0,No
8125,manumission,1,15.09653218,1,10.81979828,10.81979828,1,163.341433,1,1,2,1,1,2,5,0.378607,0.394397,0,No
8137,mannitol,1,15.09653218,1,10.81979828,10.81979828,1,163.341433,1,1,2,1,1,2,5,0.326816,0.331594,0,No
8138,mannequin,1,15.09653218,1,10.81979828,10.81979828,1,163.341433,1,0,1,1,0,1,0,0,0,0,No
8151,manicure,1,15.09653218,1,10.81979828,10.81979828,1,163.341433,1,1,2,1,1,2,5,0.398076,0.415824,0,No
8164,mandrill,1,15.09653218,1,10.81979828,10.81979828,1,163.341433,1,0,1,1,0,1,0,0,0,0,No
8170,mandamus,1,15.09653218,1,10.81979828,10.81979828,1,163.341433,1,1,2,1,1,2,5,0.35519,0.366885,0,No
8177,manageable,1,15.09653218,1,10.81979828,10.81979828,1,163.341433,1,1,2,1,1,2,5,0.32199,0.325057,0,No
8195,maloney,1,15.09653218,1,10.81979828,10.81979828,1,163.341433,1,1,2,1,1,2,5,0.314055,0.318282,0,No
8198,malnourished,1,15.09653218,1,10.81979828,10.81979828,1,163.341433,1,1,2,1,1,2,5,0.320421,0.324344,0,No
8209,malformed,1,15.09653218,1,10.81979828,10.81979828,1,163.341433,1,1,2,1,1,2,5,0.384237,0.400402,0,No
8210,malformation,1,15.09653218,1,10.81979828,10.81979828,1,163.341433,1,1,2,1,1,2,5,0.338882,0.345659,0,No
8212,maldive,1,15.09653218,1,10.81979828,10.81979828,1,163.341433,1,1,2,1,1,2,5,0.384237,0.400402,0,No
8220,malaise,1,15.09653218,1,10.81979828,10.81979828,1,163.341433,0,0,0,0,0,0,0,0,0,0,No
8223,maladaptive,1,15.09653218,1,10.81979828,10.81979828,1,163.341433,1,1,2,1,1,2,5,0.326353,0.330283,0,No
8240,mailmen,1,15.09653218,1,10.81979828,10.81979828,1,163.341433,0,1,1,0,1,1,5,0.340155,0.347428,0,No
8254,magog,1,15.09653218,1,10.81979828,10.81979828,1,163.341433,1,1,2,1,1,2,5,0.321757,0.326069,0,No
8269,magnanimous,1,15.09653218,1,10.81979828,10.81979828,1,163.341433,1,1,2,1,1,2,5,0.294481,0.300852,0,No
8339,lysine,1,15.09653218,1,10.81979828,10.81979828,1,163.341433,0,1,1,0,1,1,5,0.331268,0.335748,0,No
8351,lymphocyte,1,15.09653218,1,10.81979828,10.81979828,1,163.341433,1,1,2,1,1,2,5,0.375317,0.391855,0,No
8358,lycopodium,1,15.09653218,1,10.81979828,10.81979828,1,163.341433,1,0,1,1,0,1,0,0,0,0,No
8359,lycee,1,15.09653218,1,10.81979828,10.81979828,1,163.341433,1,1,2,1,1,2,5,0.378607,0.394397,0,No
8363,luxuriant,1,15.09653218,1,10.81979828,10.81979828,1,163.341433,1,1,2,1,1,2,5,0.331268,0.335748,0,No
8371,lusty,1,15.09653218,1,10.81979828,10.81979828,1,163.341433,1,1,2,1,1,2,5,0.384246,0.400407,0,No
8372,lustrous,1,15.09653218,1,10.81979828,10.81979828,1,163.341433,1,1,2,1,1,2,5,0.322863,0.326357,0,No
8375,luscious,1,15.09653218,1,10.81979828,10.81979828,1,163.341433,1,1,2,1,1,2,6,0.248335,0.250116,0,No
8379,lupine,1,15.09653218,1,10.81979828,10.81979828,1,163.341433,0,1,1,0,1,1,5,0.360828,0.373485,0,No
8385,lunatic,1,15.09653218,1,10.81979828,10.81979828,1,163.341433,0,0,0,0,0,0,0,0,0,0,No
8388,lunacy,1,15.09653218,1,10.81979828,10.81979828,1,163.341433,1,1,2,1,1,2,5,0.325683,0.329079,0,No
8394,luminescent,1,15.09653218,1,10.81979828,10.81979828,1,163.341433,1,1,2,1,1,2,5,0.325611,0.330111,0,No
8396,lumberman,1,15.09653218,1,10.81979828,10.81979828,1,163.341433,1,1,2,1,1,2,5,0.384229,0.400392,0,No
8402,lull,1,15.09653218,1,10.81979828,10.81979828,1,163.341433,1,1,2,1,1,2,5,0.360829,0.373487,0,No
8408,lug,1,15.09653218,1,10.81979828,10.81979828,1,163.341433,1,1,2,1,1,2,5,0.375317,0.391855,0,No
8415,lucrative,1,15.09653218,1,10.81979828,10.81979828,1,163.341433,1,1,2,1,1,2,5,0.320508,0.32409,0,No
8429,lsi,1,15.09653218,1,10.81979828,10.81979828,1,163.341433,1,0,1,1,0,1,0,0,0,0,No
8430,lozenge,1,15.09653218,1,10.81979828,10.81979828,1,163.341433,1,0,1,1,0,1,0,0,0,0,No
8433,loy,1,15.09653218,1,10.81979828,10.81979828,1,163.341433,0,1,1,0,1,1,5,0.319925,0.323292,0,No
8434,lox,1,15.09653218,1,10.81979828,10.81979828,1,163.341433,1,0,1,1,0,1,0,0,0,0,No
8455,lottie,1,15.09653218,1,10.81979828,10.81979828,1,163.341433,1,1,2,1,1,2,5,0.319073,0.322521,0,No
8472,lop,1,15.09653218,1,10.81979828,10.81979828,1,163.341433,1,1,2,1,1,2,5,0.398076,0.415824,0,No
8474,loosestrife,1,15.09653218,1,10.81979828,10.81979828,1,163.341433,0,1,1,0,1,1,5,0.384234,0.400398,0,No
8486,longstanding,1,15.09653218,1,10.81979828,10.81979828,1,163.341433,1,0,1,1,0,1,0,0,0,0,No
8489,longish,1,15.09653218,1,10.81979828,10.81979828,1,163.341433,1,1,2,1,1,2,5,0.324551,0.327914,0,No
8497,lome,1,15.09653218,1,10.81979828,10.81979828,1,163.341433,1,1,2,1,1,2,5,0.316778,0.320553,0,No
8500,lolly,1,15.09653218,1,10.81979828,10.81979828,1,163.341433,1,1,2,1,1,2,5,0.384237,0.400402,0,No
8506,loincloth,1,15.09653218,1,10.81979828,10.81979828,1,163.341433,1,1,2,1,1,2,5,0.384237,0.400402,0,No
8507,logistic,1,15.09653218,1,10.81979828,10.81979828,1,163.341433,1,1,2,1,1,2,5,0.31817,0.321778,0,No
8519,loft,1,15.09653218,1,10.81979828,10.81979828,1,163.341433,1,1,2,1,1,2,5,0.326347,0.330278,0,No
8520,loess,1,15.09653218,1,10.81979828,10.81979828,1,163.341433,0,1,1,0,1,1,5,0.375314,0.391852,0,No
8523,lodestone,1,15.09653218,1,10.81979828,10.81979828,1,163.341433,0,1,1,0,1,1,5,0.329461,0.333471,0,No
8546,loath,1,15.09653218,1,10.81979828,10.81979828,1,163.341433,1,1,2,1,1,2,5,0.359172,0.371523,0,No
8550,loam,1,15.09653218,1,10.81979828,10.81979828,1,163.341433,1,1,2,1,1,2,5,0.345606,0.354483,0,No
8559,livre,1,15.09653218,1,10.81979828,10.81979828,1,163.341433,0,1,1,0,1,1,5,0.313169,0.317494,0,No
8561,livid,1,15.09653218,1,10.81979828,10.81979828,1,163.341433,0,1,1,0,1,1,5,0.345598,0.354477,0,No
8562,liveth,1,15.09653218,1,10.81979828,10.81979828,1,163.341433,1,1,2,1,1,2,5,0.320415,0.324339,0,No
8573,litmus,1,15.09653218,1,10.81979828,10.81979828,1,163.341433,1,1,2,1,1,2,5,0.322564,0.325719,0,No
8575,lithospheric,1,15.09653218,1,10.81979828,10.81979828,1,163.341433,1,1,2,1,1,2,5,0.314016,0.31816,0,No
8578,lithograph,1,15.09653218,1,10.81979828,10.81979828,1,163.341433,1,0,1,1,0,1,0,0,0,0,No
8581,lithe,1,15.09653218,1,10.81979828,10.81979828,1,163.341433,1,1,2,1,1,2,5,0.384237,0.400402,0,No
8587,litany,1,15.09653218,1,10.81979828,10.81979828,1,163.341433,1,1,2,1,1,2,5,0.321879,0.325211,0,No
8599,liquefaction,1,15.09653218,1,10.81979828,10.81979828,1,163.341433,1,1,2,1,1,2,5,0.319033,0.322533,0,No
8600,lipton,1,15.09653218,1,10.81979828,10.81979828,1,163.341433,1,1,2,1,1,2,5,0.301883,0.307558,0,No
8613,linoleum,1,15.09653218,1,10.81979828,10.81979828,1,163.341433,0,1,1,0,1,1,5,0.343984,0.352403,0,No
8614,linoleic,1,15.09653218,1,10.81979828,10.81979828,1,163.341433,1,1,2,1,1,2,5,0.318232,0.321883,0,No
8618,lingual,1,15.09653218,1,10.81979828,10.81979828,1,163.341433,1,1,2,1,1,2,5,0.320259,0.323557,0,No
8620,lingo,1,15.09653218,1,10.81979828,10.81979828,1,163.341433,1,1,2,1,1,2,5,0.360829,0.373487,0,No
8622,linger,1,15.09653218,1,10.81979828,10.81979828,1,163.341433,1,1,2,1,1,2,5,0.360829,0.373487,0,No
8625,linemen,1,15.09653218,1,10.81979828,10.81979828,1,163.341433,1,1,2,1,1,2,5,0.326185,0.333913,0,No
8634,lindquist,1,15.09653218,1,10.81979828,10.81979828,1,163.341433,1,1,2,1,1,2,5,0.349987,0.359713,0,No
8637,lindberg,1,15.09653218,1,10.81979828,10.81979828,1,163.341433,0,0,0,0,0,0,0,0,0,0,No
8642,limpid,1,15.09653218,1,10.81979828,10.81979828,1,163.341433,0,1,1,0,1,1,6,0.244266,0.245729,0,No
8651,limbo,1,15.09653218,1,10.81979828,10.81979828,1,163.341433,1,1,2,1,1,2,5,0.375309,0.391846,0,No
8652,limbic,1,15.09653218,1,10.81979828,10.81979828,1,163.341433,1,1,2,1,1,2,5,0.325575,0.32918,0,No
8670,lighten,1,15.09653218,1,10.81979828,10.81979828,1,163.341433,1,1,2,1,1,2,5,0.313351,0.318139,0,No
8676,lifo,1,15.09653218,1,10.81979828,10.81979828,1,163.341433,1,0,1,1,0,1,0,0,0,0,No
8685,lieu,1,15.09653218,1,10.81979828,10.81979828,1,163.341433,1,0,1,1,0,1,0,0,0,0,No
8693,licensor,1,15.09653218,1,10.81979828,10.81979828,1,163.341433,1,1,2,1,1,2,5,0.384237,0.400402,0,No
8703,libido,1,15.09653218,1,10.81979828,10.81979828,1,163.341433,0,1,1,0,1,1,5,0.398072,0.415819,0,No
8717,lexicography,1,15.09653218,1,10.81979828,10.81979828,1,163.341433,0,0,0,0,0,0,0,0,0,0,No
8723,levity,1,15.09653218,1,10.81979828,10.81979828,1,163.341433,1,1,2,1,1,2,5,0.384237,0.400402,0,No
8724,levitt,1,15.09653218,1,10.81979828,10.81979828,1,163.341433,1,1,2,1,1,2,5,0.384237,0.400402,0,No
8726,levitate,1,15.09653218,1,10.81979828,10.81979828,1,163.341433,1,1,2,1,1,2,5,0.297182,0.303189,0,No
8735,leucine,1,15.09653218,1,10.81979828,10.81979828,1,163.341433,1,0,1,1,0,1,0,0,0,0,No
8739,lethe,1,15.09653218,1,10.81979828,10.81979828,1,163.341433,1,1,2,1,1,2,5,0.398067,0.415814,0,No
8743,lest,1,15.09653218,1,10.81979828,10.81979828,1,163.341433,1,1,2,1,1,2,6,0.268714,0.273879,0,No
8747,lessee,1,15.09653218,1,10.81979828,10.81979828,1,163.341433,1,1,2,1,1,2,5,0.320415,0.324339,0,No
8751,lesion,1,15.09653218,1,10.81979828,10.81979828,1,163.341433,1,0,1,1,0,1,0,0,0,0,No
8767,lenticular,1,15.09653218,1,10.81979828,10.81979828,1,163.341433,1,0,1,1,0,1,0,0,0,0,No
8775,lenient,1,15.09653218,1,10.81979828,10.81979828,1,163.341433,1,1,2,1,1,2,5,0.343985,0.352404,0,No
8777,lengthwise,1,15.09653218,1,10.81979828,10.81979828,1,163.341433,1,1,2,1,1,2,5,0.324314,0.329355,0,No
8782,len,1,15.09653218,1,10.81979828,10.81979828,1,163.341433,0,0,0,0,0,0,0,0,0,0,No
8789,leitmotiv,1,15.09653218,1,10.81979828,10.81979828,1,163.341433,0,1,1,0,1,1,5,0.345598,0.354477,0,No
8796,lehman,1,15.09653218,1,10.81979828,10.81979828,1,163.341433,1,1,2,1,1,2,5,0.324908,0.329012,0,No
8804,leghorn,1,15.09653218,1,10.81979828,10.81979828,1,163.341433,0,0,0,0,0,0,0,0,0,0,No
8817,leery,1,15.09653218,1,10.81979828,10.81979828,1,163.341433,1,1,2,1,1,2,5,0.360829,0.373487,0,No
8827,lebensraum,1,15.09653218,1,10.81979828,10.81979828,1,163.341433,0,1,1,0,1,1,5,0.331268,0.335748,0,No
8839,leapt,1,15.09653218,1,10.81979828,10.81979828,1,163.341433,1,1,2,1,1,2,5,0.326419,0.330114,0,No
8878,laurentian,1,15.09653218,1,10.81979828,10.81979828,1,163.341433,1,1,2,1,1,2,5,0.318695,0.322338,0,No
8885,launder,1,15.09653218,1,10.81979828,10.81979828,1,163.341433,0,1,1,0,1,1,5,0.323587,0.3267,0,No
8888,laughlin,1,15.09653218,1,10.81979828,10.81979828,1,163.341433,1,1,2,1,1,2,5,0.323734,0.327116,0,No
8892,laudanum,1,15.09653218,1,10.81979828,10.81979828,1,163.341433,1,1,2,1,1,2,5,0.332161,0.339406,0,No
8903,laterite,1,15.09653218,1,10.81979828,10.81979828,1,163.341433,1,0,1,1,0,1,0,0,0,0,No
8916,larynges,1,15.09653218,1,10.81979828,10.81979828,1,163.341433,1,1,2,1,1,2,5,0.331144,0.336088,0,No
8927,lariat,1,15.09653218,1,10.81979828,10.81979828,1,163.341433,1,1,2,1,1,2,5,0.326353,0.32986,0,No
8937,lapel,1,15.09653218,1,10.81979828,10.81979828,1,163.341433,0,0,0,0,0,0,0,0,0,0,No
8946,lanky,1,15.09653218,1,10.81979828,10.81979828,1,163.341433,1,1,2,1,1,2,5,0.308316,0.313337,0,No
8949,languid,1,15.09653218,1,10.81979828,10.81979828,1,163.341433,1,1,2,1,1,2,6,0.247342,0.248962,0,No
8951,langmuir,1,15.09653218,1,10.81979828,10.81979828,1,163.341433,1,0,1,1,0,1,0,0,0,0,No
8968,lancet,1,15.09653218,1,10.81979828,10.81979828,1,163.341433,0,1,1,0,1,1,5,0.320694,0.323932,0,No
8974,lamprey,1,15.09653218,1,10.81979828,10.81979828,1,163.341433,1,1,2,1,1,2,5,0.332161,0.339406,0,No
8978,lamentation,1,15.09653218,1,10.81979828,10.81979828,1,163.341433,1,1,2,1,1,2,5,0.398076,0.415824,0,No
8987,lakh,1,15.09653218,1,10.81979828,10.81979828,1,163.341433,0,1,1,0,1,1,5,0.315121,0.319142,0,No
8990,laity,1,15.09653218,1,10.81979828,10.81979828,1,163.341433,1,0,1,1,0,1,0,0,0,0,No
8991,lair,1,15.09653218,1,10.81979828,10.81979828,1,163.341433,1,1,2,1,1,2,5,0.378607,0.394397,0,No
8993,laidlaw,1,15.09653218,1,10.81979828,10.81979828,1,163.341433,0,0,0,0,0,0,0,0,0,0,No
9000,lagging,1,15.09653218,1,10.81979828,10.81979828,1,163.341433,0,1,1,0,1,1,5,0.319372,0.322967,0,No
9013,lacquer,1,15.09653218,1,10.81979828,10.81979828,1,163.341433,1,0,1,1,0,1,0,0,0,0,No
9014,laconic,1,15.09653218,1,10.81979828,10.81979828,1,163.341433,1,0,1,1,0,1,0,0,0,0,No
9029,laban,1,15.09653218,1,10.81979828,10.81979828,1,163.341433,1,1,2,1,1,2,5,0.326359,0.329865,0,No
9042,kuhn,1,15.09653218,1,10.81979828,10.81979828,1,163.341433,1,1,2,1,1,2,5,0.32071,0.32465,0,No
9043,kudzu,1,15.09653218,1,10.81979828,10.81979828,1,163.341433,1,0,1,1,0,1,0,0,0,0,No
9044,kudo,1,15.09653218,1,10.81979828,10.81979828,1,163.341433,0,1,1,0,1,1,5,0.324902,0.329008,0,No
9050,kronecker,1,15.09653218,1,10.81979828,10.81979828,1,163.341433,1,1,2,1,1,2,5,0.324902,0.329008,0,No
9058,kraut,1,15.09653218,1,10.81979828,10.81979828,1,163.341433,1,0,1,1,0,1,0,0,0,0,No
9065,kowalski,1,15.09653218,1,10.81979828,10.81979828,1,163.341433,1,0,1,1,0,1,0,0,0,0,No
9072,kombu,1,15.09653218,1,10.81979828,10.81979828,1,163.341433,0,1,1,0,1,1,5,0.291695,0.297996,0,No
9077,kochab,1,15.09653218,1,10.81979828,10.81979828,1,163.341433,0,1,1,0,1,1,5,0.331268,0.335748,0,No
9105,kneecap,1,15.09653218,1,10.81979828,10.81979828,1,163.341433,1,1,2,1,1,2,5,0.360829,0.373487,0,No
9112,kleenex,1,15.09653218,1,10.81979828,10.81979828,1,163.341433,1,1,2,1,1,2,5,0.336021,0.342018,0,No
9117,kivu,1,15.09653218,1,10.81979828,10.81979828,1,163.341433,1,1,2,1,1,2,5,0.32281,0.326129,0,No
9118,kiva,1,15.09653218,1,10.81979828,10.81979828,1,163.341433,1,0,1,1,0,1,0,0,0,0,No
9122,kitchenette,1,15.09653218,1,10.81979828,10.81979828,1,163.341433,1,1,2,1,1,2,6,0.243946,0.245487,0,No
9139,kinkajou,1,15.09653218,1,10.81979828,10.81979828,1,163.341433,0,0,0,0,0,0,0,0,0,0,No
9143,kingpin,1,15.09653218,1,10.81979828,10.81979828,1,163.341433,0,1,1,0,1,1,5,0.334224,0.341137,0,No
9163,kieffer,1,15.09653218,1,10.81979828,10.81979828,1,163.341433,1,1,2,1,1,2,5,0.311831,0.316327,0,No
9170,kickoff,1,15.09653218,1,10.81979828,10.81979828,1,163.341433,0,1,1,0,1,1,5,0.398072,0.415819,0,No
9172,kibbutzim,1,15.09653218,1,10.81979828,10.81979828,1,163.341433,1,1,2,1,1,2,5,0.345599,0.354479,0,No
9190,ketone,1,15.09653218,1,10.81979828,10.81979828,1,163.341433,0,1,1,0,1,1,5,0.360828,0.373485,0,No
9194,kessler,1,15.09653218,1,10.81979828,10.81979828,1,163.341433,1,1,2,1,1,2,5,0.384237,0.400402,0,No
9249,karp,1,15.09653218,1,10.81979828,10.81979828,1,163.341433,0,1,1,0,1,1,5,0.378604,0.394393,0,No
9255,karamazov,1,15.09653218,1,10.81979828,10.81979828,1,163.341433,0,1,1,0,1,1,5,0.297847,0.303863,0,No
9261,kaolin,1,15.09653218,1,10.81979828,10.81979828,1,163.341433,1,1,2,1,1,2,5,0.384237,0.400402,0,No
9272,kalmia,1,15.09653218,1,10.81979828,10.81979828,1,163.341433,1,0,1,1,0,1,0,0,0,0,No
9273,kaleidoscope,1,15.09653218,1,10.81979828,10.81979828,1,163.341433,1,1,2,1,1,2,5,0.375317,0.391855,0,No
9278,kafkaesque,1,15.09653218,1,10.81979828,10.81979828,1,163.341433,1,0,1,1,0,1,0,0,0,0,No
9283,juxtaposition,1,15.09653218,1,10.81979828,10.81979828,1,163.341433,1,1,2,1,1,2,5,0.359172,0.371523,0,No
9287,jut,1,15.09653218,1,10.81979828,10.81979828,1,163.341433,1,1,2,1,1,2,5,0.324628,0.32797,0,No
9306,jungian,1,15.09653218,1,10.81979828,10.81979828,1,163.341433,1,1,2,1,1,2,5,0.320334,0.323511,0,No
9314,jumble,1,15.09653218,1,10.81979828,10.81979828,1,163.341433,1,1,2,1,1,2,5,0.338882,0.345659,0,No
9329,juggernaut,1,15.09653218,1,10.81979828,10.81979828,1,163.341433,0,1,1,0,1,1,5,0.360828,0.373485,0,No
9332,judson,1,15.09653218,1,10.81979828,10.81979828,1,163.341433,0,1,1,0,1,1,5,0.320897,0.324288,0,No
9353,jovial,1,15.09653218,1,10.81979828,10.81979828,1,163.341433,1,0,1,1,0,1,0,0,0,0,No
9355,jovanovich,1,15.09653218,1,10.81979828,10.81979828,1,163.341433,1,0,1,1,0,1,0,0,0,0,No
9360,jot,1,15.09653218,1,10.81979828,10.81979828,1,163.341433,1,1,2,1,1,2,5,0.328747,0.332973,0,No
9365,josephson,1,15.09653218,1,10.81979828,10.81979828,1,163.341433,1,0,1,1,0,1,0,0,0,0,No
9401,jockstrap,1,15.09653218,1,10.81979828,10.81979828,1,163.341433,1,1,2,1,1,2,5,0.280648,0.286728,0,No
9422,jibe,1,15.09653218,1,10.81979828,10.81979828,1,163.341433,1,0,1,1,0,1,0,0,0,0,No
9428,jetliner,1,15.09653218,1,10.81979828,10.81979828,1,163.341433,1,1,2,1,1,2,5,0.334937,0.340901,0,No
9446,jensen,1,15.09653218,1,10.81979828,10.81979828,1,163.341433,1,1,2,1,1,2,5,0.360829,0.373487,0,No
9502,jacobian,1,15.09653218,1,10.81979828,10.81979828,1,163.341433,1,1,2,1,1,2,5,0.305058,0.310494,0,No
9512,jackdaw,1,15.09653218,1,10.81979828,10.81979828,1,163.341433,1,0,1,1,0,1,0,0,0,0,No
9522,iverson,1,15.09653218,1,10.81979828,10.81979828,1,163.341433,1,0,1,1,0,1,0,0,0,0,No
9528,itinerary,1,15.09653218,1,10.81979828,10.81979828,1,163.341433,1,1,2,1,1,2,5,0.398067,0.415814,0,No
9568,irruption,1,15.09653218,1,10.81979828,10.81979828,1,163.341433,1,1,2,1,1,2,5,0.378607,0.394397,0,No
9574,irresponsible,1,15.09653218,1,10.81979828,10.81979828,1,163.341433,1,0,1,1,0,1,0,0,0,0,No
9576,irrepressible,1,15.09653218,1,10.81979828,10.81979828,1,163.341433,1,1,2,1,1,2,5,0.291526,0.297801,0,No
9580,irrefutable,1,15.09653218,1,10.81979828,10.81979828,1,163.341433,0,1,1,0,1,1,5,0.325976,0.330995,0,No
9583,irreconcilable,1,15.09653218,1,10.81979828,10.81979828,1,163.341433,1,0,1,1,0,1,0,0,0,0,No
9590,ironbound,1,15.09653218,1,10.81979828,10.81979828,1,163.341433,0,1,1,0,1,1,5,0.398072,0.415819,0,No
9593,irishmen,1,15.09653218,1,10.81979828,10.81979828,1,163.341433,0,1,1,0,1,1,5,0.312778,0.317223,0,No
9601,irate,1,15.09653218,1,10.81979828,10.81979828,1,163.341433,0,0,0,0,0,0,0,0,0,0,No
9609,ipecac,1,15.09653218,1,10.81979828,10.81979828,1,163.341433,0,1,1,0,1,1,5,0.398072,0.415819,0,No
9612,ionospheric,1,15.09653218,1,10.81979828,10.81979828,1,163.341433,0,0,0,0,0,0,0,0,0,0,No
9620,invulnerable,1,15.09653218,1,10.81979828,10.81979828,1,163.341433,1,0,1,1,0,1,0,0,0,0,No
9622,involute,1,15.09653218,1,10.81979828,10.81979828,1,163.341433,1,1,2,1,1,2,5,0.290172,0.296398,0,No
9624,invoke,1,15.09653218,1,10.81979828,10.81979828,1,163.341433,1,0,1,1,0,1,0,0,0,0,No
9634,invertible,1,15.09653218,1,10.81979828,10.81979828,1,163.341433,1,1,2,1,1,2,5,0.384237,0.400402,0,No
9636,invert,1,15.09653218,1,10.81979828,10.81979828,1,163.341433,0,1,1,0,1,1,5,0.375314,0.391852,0,No
9647,invariant,1,15.09653218,1,10.81979828,10.81979828,1,163.341433,1,1,2,1,1,2,5,0.321367,0.324586,0,No
9655,intrude,1,15.09653218,1,10.81979828,10.81979828,1,163.341433,1,1,2,1,1,2,5,0.324308,0.32935,0,No
9657,introit,1,15.09653218,1,10.81979828,10.81979828,1,163.341433,1,1,2,1,1,2,5,0.280804,0.286924,0,No
9663,intricate,1,15.09653218,1,10.81979828,10.81979828,1,163.341433,1,0,1,1,0,1,0,0,0,0,No
9664,intrepid,1,15.09653218,1,10.81979828,10.81979828,1,163.341433,1,1,2,1,1,2,5,0.341779,0.349674,0,No
9665,intractable,1,15.09653218,1,10.81979828,10.81979828,1,163.341433,1,1,2,1,1,2,5,0.31577,0.319696,0,No
9666,intra,1,15.09653218,1,10.81979828,10.81979828,1,163.341433,1,0,1,1,0,1,0,0,0,0,No
9667,intolerant,1,15.09653218,1,10.81979828,10.81979828,1,163.341433,1,1,2,1,1,2,5,0.378607,0.394397,0,No
9675,interviewee,1,15.09653218,1,10.81979828,10.81979828,1,163.341433,1,1,2,1,1,2,5,0.320201,0.323757,0,No
9684,interpretive,1,15.09653218,1,10.81979828,10.81979828,1,163.341433,1,0,1,1,0,1,0,0,0,0,No
9695,interferon,1,15.09653218,1,10.81979828,10.81979828,1,163.341433,1,1,2,1,1,2,5,0.296993,0.302892,0,No
9703,intercept,1,15.09653218,1,10.81979828,10.81979828,1,163.341433,1,1,2,1,1,2,5,0.345599,0.354479,0,No
9712,intelligentsia,1,15.09653218,1,10.81979828,10.81979828,1,163.341433,1,0,1,1,0,1,0,0,0,0,No
9716,integument,1,15.09653218,1,10.81979828,10.81979828,1,163.341433,1,0,1,1,0,1,0,0,0,0,No
9732,insufferable,1,15.09653218,1,10.81979828,10.81979828,1,163.341433,0,0,0,0,0,0,0,0,0,0,No
9741,instep,1,15.09653218,1,10.81979828,10.81979828,1,163.341433,1,1,2,1,1,2,5,0.384237,0.400402,0,No
9743,instar,1,15.09653218,1,10.81979828,10.81979828,1,163.341433,1,1,2,1,1,2,5,0.398076,0.415824,0,No
9748,instable,1,15.09653218,1,10.81979828,10.81979828,1,163.341433,1,1,2,1,1,2,5,0.326545,0.330109,0,No
9752,inspect,1,15.09653218,1,10.81979828,10.81979828,1,163.341433,1,1,2,1,1,2,5,0.331268,0.335748,0,No
9757,insolent,1,15.09653218,1,10.81979828,10.81979828,1,163.341433,1,1,2,1,1,2,5,0.324622,0.327807,0,No
9777,inquire,1,15.09653218,1,10.81979828,10.81979828,1,163.341433,0,1,1,0,1,1,5,0.324309,0.329351,0,No
9779,inputting,1,15.09653218,1,10.81979828,10.81979828,1,163.341433,1,1,2,1,1,2,5,0.318506,0.322042,0,No
9782,innumerable,1,15.09653218,1,10.81979828,10.81979828,1,163.341433,1,0,1,1,0,1,0,0,0,0,No
9784,innovate,1,15.09653218,1,10.81979828,10.81979828,1,163.341433,1,1,2,1,1,2,5,0.35519,0.366885,0,No
9785,innocuous,1,15.09653218,1,10.81979828,10.81979828,1,163.341433,1,1,2,1,1,2,5,0.322581,0.32589,0,No
9807,inhibitory,1,15.09653218,1,10.81979828,10.81979828,1,163.341433,1,0,1,1,0,1,0,0,0,0,No
9810,inhibit,1,15.09653218,1,10.81979828,10.81979828,1,163.341433,1,1,2,1,1,2,5,0.375317,0.391855,0,No
9820,ingram,1,15.09653218,1,10.81979828,10.81979828,1,163.341433,1,0,1,1,0,1,0,0,0,0,No
9823,ingersoll,1,15.09653218,1,10.81979828,10.81979828,1,163.341433,1,0,1,1,0,1,0,0,0,0,No
9824,ingenuity,1,15.09653218,1,10.81979828,10.81979828,1,163.341433,1,1,2,1,1,2,5,0.309003,0.313861,0,No
9826,infusoria,1,15.09653218,1,10.81979828,10.81979828,1,163.341433,1,0,1,1,0,1,0,0,0,0,No
9828,infuse,1,15.09653218,1,10.81979828,10.81979828,1,163.341433,1,1,2,1,1,2,5,0.398076,0.415824,0,No
9832,infra,1,15.09653218,1,10.81979828,10.81979828,1,163.341433,1,0,1,1,0,1,0,0,0,0,No
9839,influx,1,15.09653218,1,10.81979828,10.81979828,1,163.341433,1,1,2,1,1,2,5,0.336021,0.342018,0,No
9850,infirm,1,15.09653218,1,10.81979828,10.81979828,1,163.341433,1,1,2,1,1,2,5,0.359172,0.371523,0,No
9858,infest,1,15.09653218,1,10.81979828,10.81979828,1,163.341433,0,0,0,0,0,0,0,0,0,0,No
9864,inferential,1,15.09653218,1,10.81979828,10.81979828,1,163.341433,0,0,0,0,0,0,0,0,0,0,No
9866,infer,1,15.09653218,1,10.81979828,10.81979828,1,163.341433,1,0,1,1,0,1,0,0,0,0,No
9869,infeasible,1,15.09653218,1,10.81979828,10.81979828,1,163.341433,0,1,1,0,1,1,5,0.35917,0.371521,0,No
9874,infanticide,1,15.09653218,1,10.81979828,10.81979828,1,163.341433,1,0,1,1,0,1,0,0,0,0,No
9879,inexperience,1,15.09653218,1,10.81979828,10.81979828,1,163.341433,1,0,1,1,0,1,0,0,0,0,No
9881,inexhaustible,1,15.09653218,1,10.81979828,10.81979828,1,163.341433,0,1,1,0,1,1,5,0.319585,0.322829,0,No
9882,inevitable,1,15.09653218,1,10.81979828,10.81979828,1,163.341433,0,0,0,0,0,0,0,0,0,0,No
9887,inept,1,15.09653218,1,10.81979828,10.81979828,1,163.341433,1,1,2,1,1,2,5,0.35519,0.366885,0,No
9888,ineligible,1,15.09653218,1,10.81979828,10.81979828,1,163.341433,1,1,2,1,1,2,5,0.35519,0.366885,0,No
9892,inedible,1,15.09653218,1,10.81979828,10.81979828,1,163.341433,1,0,1,1,0,1,0,0,0,0,No
9900,induct,1,15.09653218,1,10.81979828,10.81979828,1,163.341433,1,1,2,1,1,2,5,0.398076,0.415824,0,No
9910,indistinguishable,1,15.09653218,1,10.81979828,10.81979828,1,163.341433,1,1,2,1,1,2,5,0.384237,0.400402,0,No
9911,indistinct,1,15.09653218,1,10.81979828,10.81979828,1,163.341433,1,1,2,1,1,2,5,0.331268,0.335748,0,No
9912,indispensable,1,15.09653218,1,10.81979828,10.81979828,1,163.341433,0,1,1,0,1,1,5,0.35917,0.371521,0,No
9916,indignation,1,15.09653218,1,10.81979828,10.81979828,1,163.341433,1,1,2,1,1,2,5,0.378607,0.394397,0,No
9917,indigestion,1,15.09653218,1,10.81979828,10.81979828,1,163.341433,0,1,1,0,1,1,5,0.311526,0.316082,0,No
9919,indifferent,1,15.09653218,1,10.81979828,10.81979828,1,163.341433,1,1,2,1,1,2,5,0.322306,0.325459,0,No
9929,indescribable,1,15.09653218,1,10.81979828,10.81979828,1,163.341433,1,1,2,1,1,2,5,0.329699,0.333965,0,No
9931,indentation,1,15.09653218,1,10.81979828,10.81979828,1,163.341433,1,1,2,1,1,2,5,0.330602,0.335239,0,No
9932,indemnity,1,15.09653218,1,10.81979828,10.81979828,1,163.341433,1,1,2,1,1,2,5,0.304848,0.310205,0,No
9934,indefatigable,1,15.09653218,1,10.81979828,10.81979828,1,163.341433,1,1,2,1,1,2,5,0.32071,0.32465,0,No
9941,incubate,1,15.09653218,1,10.81979828,10.81979828,1,163.341433,0,1,1,0,1,1,5,0.384234,0.400398,0,No
9948,inconsiderate,1,15.09653218,1,10.81979828,10.81979828,1,163.341433,1,0,1,1,0,1,0,0,0,0,No
9949,incongruous,1,15.09653218,1,10.81979828,10.81979828,1,163.341433,1,1,2,1,1,2,5,0.322025,0.325094,0,No
9952,incomprehensible,1,15.09653218,1,10.81979828,10.81979828,1,163.341433,0,1,1,0,1,1,5,0.384234,0.400398,0,No
9956,incomparable,1,15.09653218,1,10.81979828,10.81979828,1,163.341433,1,1,2,1,1,2,5,0.31793,0.321564,0,No
9959,incognito,1,15.09653218,1,10.81979828,10.81979828,1,163.341433,0,1,1,0,1,1,5,0.360828,0.373485,0,No
9965,incite,1,15.09653218,1,10.81979828,10.81979828,1,163.341433,1,1,2,1,1,2,5,0.375317,0.391855,0,No
9966,incisor,1,15.09653218,1,10.81979828,10.81979828,1,163.341433,1,1,2,1,1,2,5,0.321559,0.324691,0,No
9967,incisive,1,15.09653218,1,10.81979828,10.81979828,1,163.341433,1,1,2,1,1,2,5,0.312953,0.317241,0,No
9971,incestuous,1,15.09653218,1,10.81979828,10.81979828,1,163.341433,1,1,2,1,1,2,5,0.315967,0.320281,0,No
9978,incapacity,1,15.09653218,1,10.81979828,10.81979828,1,163.341433,0,1,1,0,1,1,5,0.375314,0.391852,0,No
9979,incapacitate,1,15.09653218,1,10.81979828,10.81979828,1,163.341433,1,1,2,1,1,2,5,0.331788,0.336492,0,No
9981,incantation,1,15.09653218,1,10.81979828,10.81979828,1,163.341433,1,1,2,1,1,2,5,0.32681,0.33159,0,No
9985,inbreed,1,15.09653218,1,10.81979828,10.81979828,1,163.341433,1,0,1,1,0,1,0,0,0,0,No
9987,inaugurate,1,15.09653218,1,10.81979828,10.81979828,1,163.341433,1,1,2,1,1,2,5,0.323345,0.326531,0,No
9992,inadequacy,1,15.09653218,1,10.81979828,10.81979828,1,163.341433,0,1,1,0,1,1,5,0.384234,0.400398,0,No
9994,inactivate,1,15.09653218,1,10.81979828,10.81979828,1,163.341433,1,1,2,1,1,2,6,0.257,0.260398,0,No
10005,impudent,1,15.09653218,1,10.81979828,10.81979828,1,163.341433,1,1,2,1,1,2,5,0.322986,0.326298,0,No
10006,imprudent,1,15.09653218,1,10.81979828,10.81979828,1,163.341433,1,1,2,1,1,2,5,0.320734,0.323987,0,No
10011,improbable,1,15.09653218,1,10.81979828,10.81979828,1,163.341433,1,1,2,1,1,2,5,0.343985,0.352404,0,No
10017,impresario,1,15.09653218,1,10.81979828,10.81979828,1,163.341433,1,1,2,1,1,2,5,0.378607,0.394397,0,No
10018,impregnable,1,15.09653218,1,10.81979828,10.81979828,1,163.341433,1,1,2,1,1,2,5,0.320705,0.324646,0,No
10020,impracticable,1,15.09653218,1,10.81979828,10.81979828,1,163.341433,1,1,2,1,1,2,5,0.336028,0.342206,0,No
10023,importation,1,15.09653218,1,10.81979828,10.81979828,1,163.341433,1,1,2,1,1,2,5,0.378607,0.394397,0,No
10026,impolite,1,15.09653218,1,10.81979828,10.81979828,1,163.341433,1,1,2,1,1,2,5,0.328145,0.333093,0,No
10030,implausible,1,15.09653218,1,10.81979828,10.81979828,1,163.341433,1,1,2,1,1,2,5,0.35519,0.366885,0,No
10032,impertinent,1,15.09653218,1,10.81979828,10.81979828,1,163.341433,0,1,1,0,1,1,6,0.277644,0.283553,0,No
10033,impersonal,1,15.09653218,1,10.81979828,10.81979828,1,163.341433,1,0,1,1,0,1,0,0,0,0,No
10034,imperishable,1,15.09653218,1,10.81979828,10.81979828,1,163.341433,1,1,2,1,1,2,6,0.242978,0.244756,0,No
10038,impediment,1,15.09653218,1,10.81979828,10.81979828,1,163.341433,0,1,1,0,1,1,5,0.334224,0.341137,0,No
10045,impair,1,15.09653218,1,10.81979828,10.81979828,1,163.341433,1,1,2,1,1,2,5,0.375317,0.391855,0,No
10053,immobile,1,15.09653218,1,10.81979828,10.81979828,1,163.341433,0,1,1,0,1,1,5,0.321687,0.324837,0,No
10054,immiscible,1,15.09653218,1,10.81979828,10.81979828,1,163.341433,1,0,1,1,0,1,0,0,0,0,No
10062,immeasurable,1,15.09653218,1,10.81979828,10.81979828,1,163.341433,1,1,2,1,1,2,5,0.322201,0.325318,0,No
10064,immaterial,1,15.09653218,1,10.81979828,10.81979828,1,163.341433,1,1,2,1,1,2,5,0.325277,0.32902,0,No
10076,illusionary,1,15.09653218,1,10.81979828,10.81979828,1,163.341433,1,1,2,1,1,2,5,0.329124,0.333234,0,No
10078,illuminate,1,15.09653218,1,10.81979828,10.81979828,1,163.341433,1,0,1,1,0,1,0,0,0,0,No
10103,idyll,1,15.09653218,1,10.81979828,10.81979828,1,163.341433,1,1,2,1,1,2,5,0.319377,0.322971,0,No
10113,ideogram,1,15.09653218,1,10.81979828,10.81979828,1,163.341433,1,1,2,1,1,2,5,0.338882,0.345659,0,No
10125,iconoclast,1,15.09653218,1,10.81979828,10.81979828,1,163.341433,0,1,1,0,1,1,5,0.322418,0.325658,0,No
10132,icecap,1,15.09653218,1,10.81979828,10.81979828,1,163.341433,1,1,2,1,1,2,5,0.320595,0.324754,0,No
10133,icebox,1,15.09653218,1,10.81979828,10.81979828,1,163.341433,1,1,2,1,1,2,5,0.331788,0.336492,0,No
10148,hysteresis,1,15.09653218,1,10.81979828,10.81979828,1,163.341433,1,0,1,1,0,1,0,0,0,0,No
10156,hypocrite,1,15.09653218,1,10.81979828,10.81979828,1,163.341433,1,0,1,1,0,1,0,0,0,0,No
10166,hymnal,1,15.09653218,1,10.81979828,10.81979828,1,163.341433,1,1,2,1,1,2,5,0.333603,0.339086,0,No
10169,hyman,1,15.09653218,1,10.81979828,10.81979828,1,163.341433,1,0,1,1,0,1,0,0,0,0,No
10170,hygroscopic,1,15.09653218,1,10.81979828,10.81979828,1,163.341433,1,0,1,1,0,1,0,0,0,0,No
10171,hygrometer,1,15.09653218,1,10.81979828,10.81979828,1,163.341433,1,1,2,1,1,2,5,0.332391,0.337648,0,No
10176,hydrous,1,15.09653218,1,10.81979828,10.81979828,1,163.341433,1,1,2,1,1,2,5,0.291444,0.297644,0,No
10180,hydronium,1,15.09653218,1,10.81979828,10.81979828,1,163.341433,1,0,1,1,0,1,0,0,0,0,No
10181,hydrometer,1,15.09653218,1,10.81979828,10.81979828,1,163.341433,1,1,2,1,1,2,5,0.325976,0.330994,0,No
10185,hydrofluoric,1,15.09653218,1,10.81979828,10.81979828,1,163.341433,1,1,2,1,1,2,5,0.318238,0.321893,0,No
10198,hyannis,1,15.09653218,1,10.81979828,10.81979828,1,163.341433,1,1,2,1,1,2,5,0.318592,0.322359,0,No
10199,hyacinth,1,15.09653218,1,10.81979828,10.81979828,1,163.341433,1,1,2,1,1,2,5,0.345599,0.354479,0,No
10242,humiliate,1,15.09653218,1,10.81979828,10.81979828,1,163.341433,1,1,2,1,1,2,5,0.375317,0.391855,0,No
10251,hullabaloo,1,15.09653218,1,10.81979828,10.81979828,1,163.341433,1,0,1,1,0,1,0,0,0,0,No
10254,huh,1,15.09653218,1,10.81979828,10.81979828,1,163.341433,0,1,1,0,1,1,5,0.326048,0.329684,0,No
10263,huff,1,15.09653218,1,10.81979828,10.81979828,1,163.341433,1,1,2,1,1,2,5,0.332391,0.337648,0,No
10266,huddle,1,15.09653218,1,10.81979828,10.81979828,1,163.341433,1,1,2,1,1,2,5,0.319004,0.322539,0,No
10269,hubris,1,15.09653218,1,10.81979828,10.81979828,1,163.341433,1,0,1,1,0,1,0,0,0,0,No
10287,housework,1,15.09653218,1,10.81979828,10.81979828,1,163.341433,1,1,2,1,1,2,5,0.384237,0.400402,0,No
10293,houseboat,1,15.09653218,1,10.81979828,10.81979828,1,163.341433,1,1,2,1,1,2,5,0.345075,0.35368,0,No
10299,hough,1,15.09653218,1,10.81979828,10.81979828,1,163.341433,0,1,1,0,1,1,5,0.322723,0.32586,0,No
10301,hothouse,1,15.09653218,1,10.81979828,10.81979828,1,163.341433,1,1,2,1,1,2,5,0.345599,0.354479,0,No
10316,horsetail,1,15.09653218,1,10.81979828,10.81979828,1,163.341433,1,1,2,1,1,2,6,0.285409,0.291662,0,No
10327,horology,1,15.09653218,1,10.81979828,10.81979828,1,163.341433,1,1,2,1,1,2,5,0.398076,0.415824,0,No
10356,honorarium,1,15.09653218,1,10.81979828,10.81979828,1,163.341433,1,1,2,1,1,2,5,0.317538,0.321301,0,No
10376,homology,1,15.09653218,1,10.81979828,10.81979828,1,163.341433,0,0,0,0,0,0,0,0,0,0,No
10380,homogeneity,1,15.09653218,1,10.81979828,10.81979828,1,163.341433,1,1,2,1,1,2,5,0.345599,0.354479,0,No
10392,homebound,1,15.09653218,1,10.81979828,10.81979828,1,163.341433,1,0,1,1,0,1,0,0,0,0,No
10395,hom,1,15.09653218,1,10.81979828,10.81979828,1,163.341433,1,1,2,1,1,2,5,0.311623,0.316239,0,No
10410,hollyhock,1,15.09653218,1,10.81979828,10.81979828,1,163.341433,0,0,0,0,0,0,0,0,0,0,No
10416,holler,1,15.09653218,1,10.81979828,10.81979828,1,163.341433,1,1,2,1,1,2,5,0.338889,0.345664,0,No
10440,hob,1,15.09653218,1,10.81979828,10.81979828,1,163.341433,1,1,2,1,1,2,5,0.289774,0.296013,0,No
10442,hoarse,1,15.09653218,1,10.81979828,10.81979828,1,163.341433,1,1,2,1,1,2,5,0.321372,0.324529,0,No
10458,histamine,1,15.09653218,1,10.81979828,10.81979828,1,163.341433,0,1,1,0,1,1,5,0.341779,0.349673,0,No
10475,hinterland,1,15.09653218,1,10.81979828,10.81979828,1,163.341433,1,1,2,1,1,2,5,0.398076,0.415824,0,No
10478,hines,1,15.09653218,1,10.81979828,10.81979828,1,163.341433,1,1,2,1,1,2,5,0.384237,0.400402,0,No
10481,hindsight,1,15.09653218,1,10.81979828,10.81979828,1,163.341433,1,1,2,1,1,2,5,0.398076,0.415824,0,No
10496,hillcrest,1,15.09653218,1,10.81979828,10.81979828,1,163.341433,0,1,1,0,1,1,5,0.317011,0.32075,0,No
10511,hieratic,1,15.09653218,1,10.81979828,10.81979828,1,163.341433,1,0,1,1,0,1,0,0,0,0,No
10513,hideout,1,15.09653218,1,10.81979828,10.81979828,1,163.341433,1,1,2,1,1,2,5,0.360829,0.373487,0,No
10522,hibernia,1,15.09653218,1,10.81979828,10.81979828,1,163.341433,1,1,2,1,1,2,5,0.316378,0.320145,0,No
10526,hiatt,1,15.09653218,1,10.81979828,10.81979828,1,163.341433,1,1,2,1,1,2,5,0.321035,0.327202,0,No
10530,hexane,1,15.09653218,1,10.81979828,10.81979828,1,163.341433,0,0,0,0,0,0,0,0,0,0,No
10531,hexameter,1,15.09653218,1,10.81979828,10.81979828,1,163.341433,1,1,2,1,1,2,5,0.331268,0.335748,0,No
10534,hexafluoride,1,15.09653218,1,10.81979828,10.81979828,1,163.341433,1,0,1,1,0,1,0,0,0,0,No
10544,heterogeneous,1,15.09653218,1,10.81979828,10.81979828,1,163.341433,1,0,1,1,0,1,0,0,0,0,No
10545,heterocyclic,1,15.09653218,1,10.81979828,10.81979828,1,163.341433,1,0,1,1,0,1,0,0,0,0,No
10550,hesperus,1,15.09653218,1,10.81979828,10.81979828,1,163.341433,1,1,2,1,1,2,5,0.320913,0.3242,0,No
10552,hesitant,1,15.09653218,1,10.81979828,10.81979828,1,163.341433,1,1,2,1,1,2,5,0.319994,0.32339,0,No
10553,hertzog,1,15.09653218,1,10.81979828,10.81979828,1,163.341433,0,1,1,0,1,1,5,0.323652,0.327242,0,No
10556,hershel,1,15.09653218,1,10.81979828,10.81979828,1,163.341433,1,0,1,1,0,1,0,0,0,0,No
10587,hereby,1,15.09653218,1,10.81979828,10.81979828,1,163.341433,1,0,1,1,0,1,0,0,0,0,No
10590,herdsman,1,15.09653218,1,10.81979828,10.81979828,1,163.341433,1,1,2,1,1,2,5,0.378607,0.394397,0,No
10603,heptane,1,15.09653218,1,10.81979828,10.81979828,1,163.341433,0,0,0,0,0,0,0,0,0,0,No
10617,henbane,1,15.09653218,1,10.81979828,10.81979828,1,163.341433,1,0,1,1,0,1,0,0,0,0,No
10625,hem,1,15.09653218,1,10.81979828,10.81979828,1,163.341433,1,1,2,1,1,2,5,0.378607,0.394397,0,No
10626,helvetica,1,15.09653218,1,10.81979828,10.81979828,1,163.341433,0,1,1,0,1,1,5,0.336028,0.342206,0,No
10635,hellish,1,15.09653218,1,10.81979828,10.81979828,1,163.341433,1,1,2,1,1,2,5,0.326545,0.330109,0,No
10637,hellespont,1,15.09653218,1,10.81979828,10.81979828,1,163.341433,1,1,2,1,1,2,5,0.384237,0.400402,0,No
10639,hellbender,1,15.09653218,1,10.81979828,10.81979828,1,163.341433,1,1,2,1,1,2,5,0.384237,0.400402,0,No
10643,heliotrope,1,15.09653218,1,10.81979828,10.81979828,1,163.341433,1,1,2,1,1,2,5,0.332391,0.337648,0,No
10644,heliocentric,1,15.09653218,1,10.81979828,10.81979828,1,163.341433,1,0,1,1,0,1,0,0,0,0,No
10659,heifer,1,15.09653218,1,10.81979828,10.81979828,1,163.341433,1,0,1,1,0,1,0,0,0,0,No
10663,hefty,1,15.09653218,1,10.81979828,10.81979828,1,163.341433,1,1,2,1,1,2,5,0.321076,0.324396,0,No
10664,heft,1,15.09653218,1,10.81979828,10.81979828,1,163.341433,0,0,0,0,0,0,0,0,0,0,No
10666,heed,1,15.09653218,1,10.81979828,10.81979828,1,163.341433,1,1,2,1,1,2,5,0.398076,0.415824,0,No
10667,hedonist,1,15.09653218,1,10.81979828,10.81979828,1,163.341433,1,0,1,1,0,1,0,0,0,0,No
10673,hectic,1,15.09653218,1,10.81979828,10.81979828,1,163.341433,0,1,1,0,1,1,5,0.384234,0.400398,0,No
10678,hebraic,1,15.09653218,1,10.81979828,10.81979828,1,163.341433,1,1,2,1,1,2,5,0.328145,0.333093,0,No
10694,hearse,1,15.09653218,1,10.81979828,10.81979828,1,163.341433,1,1,2,1,1,2,5,0.359179,0.371527,0,No
10701,healthful,1,15.09653218,1,10.81979828,10.81979828,1,163.341433,0,1,1,0,1,1,5,0.323234,0.326478,0,No
10713,headlong,1,15.09653218,1,10.81979828,10.81979828,1,163.341433,1,1,2,1,1,2,5,0.326053,0.329688,0,No
10720,hazelnut,1,15.09653218,1,10.81979828,10.81979828,1,163.341433,1,1,2,1,1,2,5,0.398076,0.415824,0,No
10727,hayfield,1,15.09653218,1,10.81979828,10.81979828,1,163.341433,1,1,2,1,1,2,5,0.359172,0.371523,0,No
10734,hawley,1,15.09653218,1,10.81979828,10.81979828,1,163.341433,1,0,1,1,0,1,0,0,0,0,No
10739,haw,1,15.09653218,1,10.81979828,10.81979828,1,163.341433,1,0,1,1,0,1,0,0,0,0,No
10742,haversack,1,15.09653218,1,10.81979828,10.81979828,1,163.341433,1,1,2,1,1,2,5,0.355198,0.36689,0,No
10747,haunt,1,15.09653218,1,10.81979828,10.81979828,1,163.341433,1,1,2,1,1,2,5,0.378607,0.394397,0,No
10748,haulage,1,15.09653218,1,10.81979828,10.81979828,1,163.341433,1,1,2,1,1,2,5,0.305457,0.31085,0,No
10751,hattiesburg,1,15.09653218,1,10.81979828,10.81979828,1,163.341433,0,1,1,0,1,1,5,0.315216,0.319163,0,No
10761,hatchway,1,15.09653218,1,10.81979828,10.81979828,1,163.341433,1,0,1,1,0,1,0,0,0,0,No
10767,haste,1,15.09653218,1,10.81979828,10.81979828,1,163.341433,1,1,2,1,1,2,5,0.304331,0.309672,0,No
10772,harvestman,1,15.09653218,1,10.81979828,10.81979828,1,163.341433,0,1,1,0,1,1,5,0.297189,0.30314,0,No
10786,harriman,1,15.09653218,1,10.81979828,10.81979828,1,163.341433,1,1,2,1,1,2,5,0.321471,0.324728,0,No
10804,harelip,1,15.09653218,1,10.81979828,10.81979828,1,163.341433,1,1,2,1,1,2,5,0.306358,0.311657,0,No
10810,hardtop,1,15.09653218,1,10.81979828,10.81979828,1,163.341433,1,1,2,1,1,2,5,0.320022,0.323285,0,No
10811,hardscrabble,1,15.09653218,1,10.81979828,10.81979828,1,163.341433,1,1,2,1,1,2,5,0.327691,0.331792,0,No
10815,hardbound,1,15.09653218,1,10.81979828,10.81979828,1,163.341433,0,0,0,0,0,0,0,0,0,0,No
10818,harbinger,1,15.09653218,1,10.81979828,10.81979828,1,163.341433,1,1,2,1,1,2,5,0.360829,0.373487,0,No
10821,harangue,1,15.09653218,1,10.81979828,10.81979828,1,163.341433,0,1,1,0,1,1,5,0.355189,0.366884,0,No
10829,hansel,1,15.09653218,1,10.81979828,10.81979828,1,163.341433,1,1,2,1,1,2,5,0.384237,0.400402,0,No
10841,hangmen,1,15.09653218,1,10.81979828,10.81979828,1,163.341433,1,1,2,1,1,2,5,0.384237,0.400402,0,No
10843,hangar,1,15.09653218,1,10.81979828,10.81979828,1,163.341433,0,1,1,0,1,1,5,0.378604,0.394393,0,No
10846,haney,1,15.09653218,1,10.81979828,10.81979828,1,163.341433,1,1,2,1,1,2,5,0.349987,0.359713,0,No
10852,handset,1,15.09653218,1,10.81979828,10.81979828,1,163.341433,1,1,2,1,1,2,5,0.319999,0.323243,0,No
10853,handmaiden,1,15.09653218,1,10.81979828,10.81979828,1,163.341433,1,1,2,1,1,2,5,0.320415,0.324339,0,No
10855,handlebar,1,15.09653218,1,10.81979828,10.81979828,1,163.341433,1,1,2,1,1,2,5,0.331268,0.335748,0,No
10857,handkerchief,1,15.09653218,1,10.81979828,10.81979828,1,163.341433,1,0,1,1,0,1,0,0,0,0,No
10864,handcuff,1,15.09653218,1,10.81979828,10.81979828,1,163.341433,1,0,1,1,0,1,0,0,0,0,No
10880,hamal,1,15.09653218,1,10.81979828,10.81979828,1,163.341433,0,1,1,0,1,1,5,0.309198,0.314096,0,No
10882,halve,1,15.09653218,1,10.81979828,10.81979828,1,163.341433,1,1,2,1,1,2,5,0.398085,0.415828,0,No
10885,halpern,1,15.09653218,1,10.81979828,10.81979828,1,163.341433,1,1,2,1,1,2,5,0.32071,0.32465,0,No
10891,hallucinate,1,15.09653218,1,10.81979828,10.81979828,1,163.341433,1,1,2,1,1,2,5,0.384237,0.400402,0,No
10904,halcyon,1,15.09653218,1,10.81979828,10.81979828,1,163.341433,0,0,0,0,0,0,0,0,0,0,No
10909,hairpin,1,15.09653218,1,10.81979828,10.81979828,1,163.341433,1,1,2,1,1,2,5,0.314416,0.318541,0,No
10910,hairdo,1,15.09653218,1,10.81979828,10.81979828,1,163.341433,1,0,1,1,0,1,0,0,0,0,No
10920,haggis,1,15.09653218,1,10.81979828,10.81979828,1,163.341433,1,1,2,1,1,2,5,0.398076,0.415824,0,No
10934,hack,1,15.09653218,1,10.81979828,10.81979828,1,163.341433,1,1,2,1,1,2,5,0.328412,0.333573,0,No
10946,gyroscope,1,15.09653218,1,10.81979828,10.81979828,1,163.341433,1,0,1,1,0,1,0,0,0,0,No
10948,gyrate,1,15.09653218,1,10.81979828,10.81979828,1,163.341433,1,0,1,1,0,1,0,0,0,0,No
10952,gymnastic,1,15.09653218,1,10.81979828,10.81979828,1,163.341433,1,1,2,1,1,2,5,0.359172,0.371523,0,No
10956,gwyn,1,15.09653218,1,10.81979828,10.81979828,1,163.341433,1,1,2,1,1,2,5,0.355198,0.36689,0,No
10968,gust,1,15.09653218,1,10.81979828,10.81979828,1,163.341433,1,1,2,1,1,2,5,0.320479,0.323837,0,No
10972,gurkha,1,15.09653218,1,10.81979828,10.81979828,1,163.341433,1,1,2,1,1,2,5,0.321669,0.324822,0,No
10976,gunpoint,1,15.09653218,1,10.81979828,10.81979828,1,163.341433,1,1,2,1,1,2,6,0.278486,0.284467,0,No
10977,gunplay,1,15.09653218,1,10.81979828,10.81979828,1,163.341433,1,1,2,1,1,2,5,0.323422,0.326862,0,No
10978,gunnery,1,15.09653218,1,10.81979828,10.81979828,1,163.341433,1,1,2,1,1,2,5,0.307963,0.3129,0,No
10983,gunderson,1,15.09653218,1,10.81979828,10.81979828,1,163.341433,1,1,2,1,1,2,6,0.238762,0.240724,0,No
10986,gumdrop,1,15.09653218,1,10.81979828,10.81979828,1,163.341433,1,1,2,1,1,2,5,0.375317,0.391855,0,No
10987,gumbo,1,15.09653218,1,10.81979828,10.81979828,1,163.341433,1,1,2,1,1,2,5,0.398076,0.415824,0,No
10990,gullible,1,15.09653218,1,10.81979828,10.81979828,1,163.341433,1,1,2,1,1,2,5,0.384237,0.400402,0,No
10991,gullet,1,15.09653218,1,10.81979828,10.81979828,1,163.341433,1,1,2,1,1,2,5,0.331268,0.335748,0,No
10995,gules,1,15.09653218,1,10.81979828,10.81979828,1,163.341433,1,1,2,1,1,2,5,0.322236,0.32571,0,No
11007,guile,1,15.09653218,1,10.81979828,10.81979828,1,163.341433,0,1,1,0,1,1,5,0.384234,0.400398,0,No
11011,guidebook,1,15.09653218,1,10.81979828,10.81979828,1,163.341433,0,0,0,0,0,0,0,0,0,0,No
11021,gubernatorial,1,15.09653218,1,10.81979828,10.81979828,1,163.341433,0,1,1,0,1,1,5,0.317954,0.321575,0,No
11036,gruff,1,15.09653218,1,10.81979828,10.81979828,1,163.341433,1,1,2,1,1,2,5,0.384237,0.400402,0,No
11052,grouchy,1,15.09653218,1,10.81979828,10.81979828,1,163.341433,1,1,2,1,1,2,5,0.326191,0.330218,0,No
11053,grouch,1,15.09653218,1,10.81979828,10.81979828,1,163.341433,1,1,2,1,1,2,5,0.324379,0.327729,0,No
11057,grossman,1,15.09653218,1,10.81979828,10.81979828,1,163.341433,1,1,2,1,1,2,5,0.398076,0.415824,0,No
11061,grommet,1,15.09653218,1,10.81979828,10.81979828,1,163.341433,0,1,1,0,1,1,5,0.31916,0.322882,0,No
11065,groat,1,15.09653218,1,10.81979828,10.81979828,1,163.341433,1,1,2,1,1,2,5,0.331274,0.335753,0,No
11068,grit,1,15.09653218,1,10.81979828,10.81979828,1,163.341433,0,0,0,0,0,0,0,0,0,0,No
11072,grisly,1,15.09653218,1,10.81979828,10.81979828,1,163.341433,1,1,2,1,1,2,5,0.312876,0.317269,0,No
11074,gripe,1,15.09653218,1,10.81979828,10.81979828,1,163.341433,0,1,1,0,1,1,5,0.326048,0.329684,0,No
11088,grievance,1,15.09653218,1,10.81979828,10.81979828,1,163.341433,1,1,2,1,1,2,5,0.317606,0.321192,0,No
11090,gridiron,1,15.09653218,1,10.81979828,10.81979828,1,163.341433,0,1,1,0,1,1,5,0.320503,0.324086,0,No
11093,greylag,1,15.09653218,1,10.81979828,10.81979828,1,163.341433,1,1,2,1,1,2,5,0.296324,0.302311,0,No
11106,gregarious,1,15.09653218,1,10.81979828,10.81979828,1,163.341433,1,1,2,1,1,2,5,0.384237,0.400402,0,No
11127,grecian,1,15.09653218,1,10.81979828,10.81979828,1,163.341433,1,0,1,1,0,1,0,0,0,0,No
11142,grater,1,15.09653218,1,10.81979828,10.81979828,1,163.341433,1,1,2,1,1,2,5,0.316333,0.320121,0,No
11144,grate,1,15.09653218,1,10.81979828,10.81979828,1,163.341433,0,1,1,0,1,1,5,0.323222,0.326578,0,No
11152,grapheme,1,15.09653218,1,10.81979828,10.81979828,1,163.341433,1,1,2,1,1,2,5,0.323599,0.326828,0,No
11161,granny,1,15.09653218,1,10.81979828,10.81979828,1,163.341433,1,1,2,1,1,2,5,0.305841,0.311052,0,No
11170,grandiose,1,15.09653218,1,10.81979828,10.81979828,1,163.341433,1,1,2,1,1,2,5,0.384237,0.400402,0,No
11181,grainy,1,15.09653218,1,10.81979828,10.81979828,1,163.341433,0,1,1,0,1,1,5,0.307176,0.312218,0,No
11185,graft,1,15.09653218,1,10.81979828,10.81979828,1,163.341433,1,1,2,1,1,2,5,0.311569,0.317811,0,No
11186,graff,1,15.09653218,1,10.81979828,10.81979828,1,163.341433,1,1,2,1,1,2,5,0.384237,0.400402,0,No
11220,gorham,1,15.09653218,1,10.81979828,10.81979828,1,163.341433,1,1,2,1,1,2,5,0.384237,0.400402,0,No
11233,goof,1,15.09653218,1,10.81979828,10.81979828,1,163.341433,1,1,2,1,1,2,5,0.323929,0.327182,0,No
11250,goleta,1,15.09653218,1,10.81979828,10.81979828,1,163.341433,0,1,1,0,1,1,6,0.280757,0.286857,0,No
11257,goldenrod,1,15.09653218,1,10.81979828,10.81979828,1,163.341433,1,1,2,1,1,2,5,0.31692,0.320705,0,No
11262,gogo,1,15.09653218,1,10.81979828,10.81979828,1,163.341433,1,0,1,1,0,1,0,0,0,0,No
11264,gog,1,15.09653218,1,10.81979828,10.81979828,1,163.341433,1,1,2,1,1,2,5,0.384237,0.400402,0,No
11265,goff,1,15.09653218,1,10.81979828,10.81979828,1,163.341433,1,1,2,1,1,2,5,0.325683,0.329051,0,No
11269,godson,1,15.09653218,1,10.81979828,10.81979828,1,163.341433,1,0,1,1,0,1,0,0,0,0,No
11280,gobbledygook,1,15.09653218,1,10.81979828,10.81979828,1,163.341433,1,1,2,1,1,2,5,0.375317,0.391855,0,No
11284,goad,1,15.09653218,1,10.81979828,10.81979828,1,163.341433,1,0,1,1,0,1,0,0,0,0,No
11288,gnp,1,15.09653218,1,10.81979828,10.81979828,1,163.341433,0,1,1,0,1,1,5,0.3224,0.325531,0,No
11301,glutton,1,15.09653218,1,10.81979828,10.81979828,1,163.341433,1,0,1,1,0,1,0,0,0,0,No
11304,glutamic,1,15.09653218,1,10.81979828,10.81979828,1,163.341433,0,1,1,0,1,1,5,0.318239,0.321893,0,No
11317,glorify,1,15.09653218,1,10.81979828,10.81979828,1,163.341433,1,1,2,1,1,2,5,0.326185,0.333913,0,No
11319,gloomy,1,15.09653218,1,10.81979828,10.81979828,1,163.341433,0,1,1,0,1,1,5,0.355189,0.366884,0,No
11320,globule,1,15.09653218,1,10.81979828,10.81979828,1,163.341433,1,1,2,1,1,2,5,0.378607,0.394397,0,No
11329,glibly,1,15.09653218,1,10.81979828,10.81979828,1,163.341433,1,0,1,1,0,1,0,0,0,0,No
11334,glee,1,15.09653218,1,10.81979828,10.81979828,1,163.341433,1,1,2,1,1,2,5,0.300051,0.305821,0,No
11335,gleason,1,15.09653218,1,10.81979828,10.81979828,1,163.341433,1,0,1,1,0,1,0,0,0,0,No
11337,glaucous,1,15.09653218,1,10.81979828,10.81979828,1,163.341433,1,1,2,1,1,2,5,0.360829,0.373487,0,No
11338,glaucoma,1,15.09653218,1,10.81979828,10.81979828,1,163.341433,1,1,2,1,1,2,5,0.320705,0.324646,0,No
11359,giveth,1,15.09653218,1,10.81979828,10.81979828,1,163.341433,1,1,2,1,1,2,5,0.384237,0.400402,0,No
11385,gilbertson,1,15.09653218,1,10.81979828,10.81979828,1,163.341433,0,1,1,0,1,1,5,0.281849,0.288158,0,No
11389,gigawatt,1,15.09653218,1,10.81979828,10.81979828,1,163.341433,1,0,1,1,0,1,0,0,0,0,No
11401,gibberellin,1,15.09653218,1,10.81979828,10.81979828,1,163.341433,1,1,2,1,1,2,5,0.329467,0.333476,0,No
11409,ghastly,1,15.09653218,1,10.81979828,10.81979828,1,163.341433,0,0,0,0,0,0,0,0,0,0,No
11413,getty,1,15.09653218,1,10.81979828,10.81979828,1,163.341433,0,1,1,0,1,1,5,0.349979,0.359707,0,No
11424,germinal,1,15.09653218,1,10.81979828,10.81979828,1,163.341433,0,1,1,0,1,1,5,0.3055,0.311144,0,No
11431,gerhardt,1,15.09653218,1,10.81979828,10.81979828,1,163.341433,1,1,2,1,1,2,5,0.324997,0.329247,0,No
11444,geometer,1,15.09653218,1,10.81979828,10.81979828,1,163.341433,1,1,2,1,1,2,5,0.320705,0.324646,0,No
11488,gelatine,1,15.09653218,1,10.81979828,10.81979828,1,163.341433,0,0,0,0,0,0,0,0,0,0,No
11493,gegenschein,1,15.09653218,1,10.81979828,10.81979828,1,163.341433,1,0,1,1,0,1,0,0,0,0,No
11501,gaze,1,15.09653218,1,10.81979828,10.81979828,1,163.341433,1,1,2,1,1,2,5,0.320705,0.324646,0,No
11502,gaylord,1,15.09653218,1,10.81979828,10.81979828,1,163.341433,1,0,1,1,0,1,0,0,0,0,No
11511,gaur,1,15.09653218,1,10.81979828,10.81979828,1,163.341433,0,0,0,0,0,0,0,0,0,0,No
11519,gauche,1,15.09653218,1,10.81979828,10.81979828,1,163.341433,1,1,2,1,1,2,5,0.314082,0.319063,0,No
11521,gatlinburg,1,15.09653218,1,10.81979828,10.81979828,1,163.341433,1,1,2,1,1,2,5,0.315489,0.319652,0,No
11525,gatekeeper,1,15.09653218,1,10.81979828,10.81979828,1,163.341433,1,1,2,1,1,2,5,0.319688,0.323642,0,No
11530,gasp,1,15.09653218,1,10.81979828,10.81979828,1,163.341433,1,1,2,1,1,2,5,0.345075,0.35368,0,No
11532,gaslight,1,15.09653218,1,10.81979828,10.81979828,1,163.341433,0,1,1,0,1,1,5,0.297,0.302903,0,No
11533,gash,1,15.09653218,1,10.81979828,10.81979828,1,163.341433,0,1,1,0,1,1,5,0.360828,0.373485,0,No
11550,garish,1,15.09653218,1,10.81979828,10.81979828,1,163.341433,1,1,2,1,1,2,5,0.345075,0.35368,0,No
11559,gape,1,15.09653218,1,10.81979828,10.81979828,1,163.341433,0,1,1,0,1,1,5,0.326924,0.33095,0,No
11564,gannet,1,15.09653218,1,10.81979828,10.81979828,1,163.341433,0,1,1,0,1,1,5,0.324813,0.328196,0,No
11570,gamut,1,15.09653218,1,10.81979828,10.81979828,1,163.341433,1,1,2,1,1,2,5,0.311848,0.316363,0,No
11579,galvanometer,1,15.09653218,1,10.81979828,10.81979828,1,163.341433,1,1,2,1,1,2,5,0.345599,0.354479,0,No
11584,gallup,1,15.09653218,1,10.81979828,10.81979828,1,163.341433,1,1,2,1,1,2,5,0.321128,0.32449,0,No
11592,gallantry,1,15.09653218,1,10.81979828,10.81979828,1,163.341433,0,1,1,0,1,1,5,0.384234,0.400398,0,No
11610,gaithersburg,1,15.09653218,1,10.81979828,10.81979828,1,163.341433,1,0,1,1,0,1,0,0,0,0,No
11638,fuss,1,15.09653218,1,10.81979828,10.81979828,1,163.341433,1,1,2,1,1,2,5,0.360829,0.373487,0,No
11650,furman,1,15.09653218,1,10.81979828,10.81979828,1,163.341433,1,1,2,1,1,2,5,0.319999,0.323609,0,No
11659,fungicide,1,15.09653218,1,10.81979828,10.81979828,1,163.341433,1,1,2,1,1,2,5,0.345599,0.354479,0,No
11668,functionary,1,15.09653218,1,10.81979828,10.81979828,1,163.341433,1,1,2,1,1,2,5,0.345599,0.354479,0,No
11693,fruition,1,15.09653218,1,10.81979828,10.81979828,1,163.341433,1,0,1,1,0,1,0,0,0,0,No
11696,frugal,1,15.09653218,1,10.81979828,10.81979828,1,163.341433,1,1,2,1,1,2,6,0.28501,0.291428,0,No
11700,frothy,1,15.09653218,1,10.81979828,10.81979828,1,163.341433,0,1,1,0,1,1,5,0.308655,0.313574,0,No
11701,froth,1,15.09653218,1,10.81979828,10.81979828,1,163.341433,1,1,2,1,1,2,5,0.338882,0.345659,0,No
11702,frosty,1,15.09653218,1,10.81979828,10.81979828,1,163.341433,1,1,2,1,1,2,5,0.398076,0.415824,0,No
11705,frontiersman,1,15.09653218,1,10.81979828,10.81979828,1,163.341433,1,1,2,1,1,2,5,0.318067,0.321741,0,No
11708,frontage,1,15.09653218,1,10.81979828,10.81979828,1,163.341433,0,1,1,0,1,1,5,0.355189,0.366884,0,No
11711,frolic,1,15.09653218,1,10.81979828,10.81979828,1,163.341433,1,1,2,1,1,2,5,0.323723,0.327913,0,No
11713,frock,1,15.09653218,1,10.81979828,10.81979828,1,163.341433,1,1,2,1,1,2,5,0.35519,0.366885,0,No
11715,frizzy,1,15.09653218,1,10.81979828,10.81979828,1,163.341433,1,1,2,1,1,2,5,0.320838,0.324501,0,No
11717,frivolity,1,15.09653218,1,10.81979828,10.81979828,1,163.341433,1,1,2,1,1,2,5,0.378607,0.394397,0,No
11719,fritillary,1,15.09653218,1,10.81979828,10.81979828,1,163.341433,1,1,2,1,1,2,5,0.30767,0.312678,0,No
11720,frisky,1,15.09653218,1,10.81979828,10.81979828,1,163.341433,0,1,1,0,1,1,5,0.281175,0.287302,0,No
11723,frilly,1,15.09653218,1,10.81979828,10.81979828,1,163.341433,1,0,1,1,0,1,0,0,0,0,No
11725,frigid,1,15.09653218,1,10.81979828,10.81979828,1,163.341433,1,0,1,1,0,1,0,0,0,0,No
11726,frightful,1,15.09653218,1,10.81979828,10.81979828,1,163.341433,0,1,1,0,1,1,5,0.313689,0.317865,0,No
11729,frigga,1,15.09653218,1,10.81979828,10.81979828,1,163.341433,1,1,2,1,1,2,5,0.345599,0.354479,0,No
11755,freon,1,15.09653218,1,10.81979828,10.81979828,1,163.341433,1,0,1,1,0,1,0,0,0,0,No
11788,frantic,1,15.09653218,1,10.81979828,10.81979828,1,163.341433,0,1,1,0,1,1,5,0.308232,0.313169,0,No
11795,francoise,1,15.09653218,1,10.81979828,10.81979828,1,163.341433,1,0,1,1,0,1,0,0,0,0,No
11819,foxy,1,15.09653218,1,10.81979828,10.81979828,1,163.341433,1,1,2,1,1,2,5,0.320415,0.323718,0,No
11830,fountainhead,1,15.09653218,1,10.81979828,10.81979828,1,163.341433,1,1,2,1,1,2,5,0.312661,0.317121,0,No
11832,fount,1,15.09653218,1,10.81979828,10.81979828,1,163.341433,1,1,2,1,1,2,5,0.345599,0.354479,0,No
11834,foundling,1,15.09653218,1,10.81979828,10.81979828,1,163.341433,1,1,2,1,1,2,5,0.375309,0.391846,0,No
11852,fortify,1,15.09653218,1,10.81979828,10.81979828,1,163.341433,1,1,2,1,1,2,5,0.316649,0.320677,0,No
11856,fortescue,1,15.09653218,1,10.81979828,10.81979828,1,163.341433,1,1,2,1,1,2,5,0.315691,0.32052,0,No
11859,forsythe,1,15.09653218,1,10.81979828,10.81979828,1,163.341433,1,1,2,1,1,2,5,0.375325,0.39186,0,No
11861,formulate,1,15.09653218,1,10.81979828,10.81979828,1,163.341433,1,1,2,1,1,2,5,0.320577,0.323842,0,No
11874,forklift,1,15.09653218,1,10.81979828,10.81979828,1,163.341433,1,0,1,1,0,1,0,0,0,0,No
11881,forgetful,1,15.09653218,1,10.81979828,10.81979828,1,163.341433,1,1,2,1,1,2,5,0.294334,0.300469,0,No
11895,forcible,1,15.09653218,1,10.81979828,10.81979828,1,163.341433,1,1,2,1,1,2,6,0.288775,0.294998,0,No
11902,forbearance,1,15.09653218,1,10.81979828,10.81979828,1,163.341433,1,1,2,1,1,2,5,0.384229,0.400392,0,No
11903,foray,1,15.09653218,1,10.81979828,10.81979828,1,163.341433,1,1,2,1,1,2,5,0.324308,0.32935,0,No
11909,footstool,1,15.09653218,1,10.81979828,10.81979828,1,163.341433,1,1,2,1,1,2,5,0.378607,0.394397,0,No
11913,footmen,1,15.09653218,1,10.81979828,10.81979828,1,163.341433,1,1,2,1,1,2,5,0.315108,0.319047,0,No
11914,footman,1,15.09653218,1,10.81979828,10.81979828,1,163.341433,1,1,2,1,1,2,5,0.384237,0.400402,0,No
11916,footfall,1,15.09653218,1,10.81979828,10.81979828,1,163.341433,0,1,1,0,1,1,5,0.327027,0.330665,0,No
11933,follicular,1,15.09653218,1,10.81979828,10.81979828,1,163.341433,1,1,2,1,1,2,5,0.321687,0.324836,0,No
11942,foliate,1,15.09653218,1,10.81979828,10.81979828,1,163.341433,1,1,2,1,1,2,5,0.320908,0.324352,0,No
11946,foist,1,15.09653218,1,10.81979828,10.81979828,1,163.341433,1,1,2,1,1,2,5,0.324083,0.327372,0,No
11956,fob,1,15.09653218,1,10.81979828,10.81979828,1,163.341433,1,1,2,1,1,2,5,0.345599,0.354479,0,No
11967,fluorspar,1,15.09653218,1,10.81979828,10.81979828,1,163.341433,1,1,2,1,1,2,5,0.310305,0.315069,0,No
11968,fluorocarbon,1,15.09653218,1,10.81979828,10.81979828,1,163.341433,0,1,1,0,1,1,5,0.343984,0.352403,0,No
11983,flowery,1,15.09653218,1,10.81979828,10.81979828,1,163.341433,0,1,1,0,1,1,5,0.331268,0.335748,0,No
11984,flowerpot,1,15.09653218,1,10.81979828,10.81979828,1,163.341433,1,1,2,1,1,2,5,0.317135,0.320855,0,No
11990,flotilla,1,15.09653218,1,10.81979828,10.81979828,1,163.341433,1,1,2,1,1,2,5,0.375317,0.391855,0,No
11991,flotation,1,15.09653218,1,10.81979828,10.81979828,1,163.341433,1,1,2,1,1,2,6,0.262682,0.267024,0,No
11993,florin,1,15.09653218,1,10.81979828,10.81979828,1,163.341433,1,1,2,1,1,2,5,0.304675,0.309998,0,No
11994,floridian,1,15.09653218,1,10.81979828,10.81979828,1,163.341433,0,1,1,0,1,1,5,0.323446,0.326562,0,No
12004,floodwater,1,15.09653218,1,10.81979828,10.81979828,1,163.341433,1,1,2,1,1,2,5,0.398076,0.415824,0,No
12005,floodlight,1,15.09653218,1,10.81979828,10.81979828,1,163.341433,1,1,2,1,1,2,5,0.345599,0.354479,0,No
12008,floe,1,15.09653218,1,10.81979828,10.81979828,1,163.341433,0,1,1,0,1,1,5,0.360828,0.373485,0,No
12012,flirtatious,1,15.09653218,1,10.81979828,10.81979828,1,163.341433,1,1,2,1,1,2,5,0.33386,0.339705,0,No
12013,flirtation,1,15.09653218,1,10.81979828,10.81979828,1,163.341433,0,1,1,0,1,1,5,0.384234,0.400398,0,No
12018,flimsy,1,15.09653218,1,10.81979828,10.81979828,1,163.341433,1,1,2,1,1,2,5,0.384237,0.400402,0,No
12021,flexure,1,15.09653218,1,10.81979828,10.81979828,1,163.341433,1,0,1,1,0,1,0,0,0,0,No
12042,flatus,1,15.09653218,1,10.81979828,10.81979828,1,163.341433,1,1,2,1,1,2,5,0.345599,0.354479,0,No
12043,flatulent,1,15.09653218,1,10.81979828,10.81979828,1,163.341433,1,1,2,1,1,2,5,0.283562,0.289943,0,No
12045,flatland,1,15.09653218,1,10.81979828,10.81979828,1,163.341433,1,0,1,1,0,1,0,0,0,0,No
12056,flange,1,15.09653218,1,10.81979828,10.81979828,1,163.341433,1,1,2,1,1,2,5,0.32681,0.33159,0,No
12070,flagging,1,15.09653218,1,10.81979828,10.81979828,1,163.341433,1,1,2,1,1,2,5,0.320496,0.323751,0,No
12093,fishy,1,15.09653218,1,10.81979828,10.81979828,1,163.341433,1,0,1,1,0,1,0,0,0,0,No
12094,fishmonger,1,15.09653218,1,10.81979828,10.81979828,1,163.341433,1,1,2,1,1,2,5,0.375309,0.391846,0,No
12110,firepower,1,15.09653218,1,10.81979828,10.81979828,1,163.341433,0,1,1,0,1,1,5,0.313274,0.31799,0,No
12121,finnegan,1,15.09653218,1,10.81979828,10.81979828,1,163.341433,0,1,1,0,1,1,5,0.375314,0.391852,0,No
12128,finial,1,15.09653218,1,10.81979828,10.81979828,1,163.341433,1,0,1,1,0,1,0,0,0,0,No
12143,filthy,1,15.09653218,1,10.81979828,10.81979828,1,163.341433,1,1,2,1,1,2,5,0.324628,0.327812,0,No
12147,filly,1,15.09653218,1,10.81979828,10.81979828,1,163.341433,1,1,2,1,1,2,5,0.384237,0.400402,0,No
12148,fillet,1,15.09653218,1,10.81979828,10.81979828,1,163.341433,1,0,1,1,0,1,0,0,0,0,No
12151,filigree,1,15.09653218,1,10.81979828,10.81979828,1,163.341433,1,1,2,1,1,2,5,0.316389,0.320189,0,No
12152,filibuster,1,15.09653218,1,10.81979828,10.81979828,1,163.341433,1,1,2,1,1,2,5,0.360837,0.373492,0,No
12153,filet,1,15.09653218,1,10.81979828,10.81979828,1,163.341433,0,0,0,0,0,0,0,0,0,0,No
12169,fifo,1,15.09653218,1,10.81979828,10.81979828,1,163.341433,0,1,1,0,1,1,5,0.329106,0.333412,0,No
12179,fidget,1,15.09653218,1,10.81979828,10.81979828,1,163.341433,1,1,2,1,1,2,5,0.306416,0.311606,0,No
12186,fickle,1,15.09653218,1,10.81979828,10.81979828,1,163.341433,1,1,2,1,1,2,5,0.312166,0.316638,0,No
12189,fibrin,1,15.09653218,1,10.81979828,10.81979828,1,163.341433,1,0,1,1,0,1,0,0,0,0,No
12194,fiance,1,15.09653218,1,10.81979828,10.81979828,1,163.341433,1,1,2,1,1,2,5,0.345599,0.354479,0,No
12200,fetter,1,15.09653218,1,10.81979828,10.81979828,1,163.341433,1,1,2,1,1,2,5,0.345606,0.354483,0,No
12230,fenugreek,1,15.09653218,1,10.81979828,10.81979828,1,163.341433,1,1,2,1,1,2,5,0.384246,0.400407,0,No
12233,fennec,1,15.09653218,1,10.81979828,10.81979828,1,163.341433,0,0,0,0,0,0,0,0,0,0,No
12236,femoral,1,15.09653218,1,10.81979828,10.81979828,1,163.341433,1,1,2,1,1,2,5,0.305783,0.310978,0,No
12243,felon,1,15.09653218,1,10.81979828,10.81979828,1,163.341433,1,1,2,1,1,2,5,0.315629,0.319859,0,No
12249,felice,1,15.09653218,1,10.81979828,10.81979828,1,163.341433,1,0,1,1,0,1,0,0,0,0,No
12261,fecund,1,15.09653218,1,10.81979828,10.81979828,1,163.341433,0,0,0,0,0,0,0,0,0,0,No
12263,fecal,1,15.09653218,1,10.81979828,10.81979828,1,163.341433,1,0,1,1,0,1,0,0,0,0,No
12286,faustian,1,15.09653218,1,10.81979828,10.81979828,1,163.341433,0,1,1,0,1,1,5,0.345598,0.354477,0,No
12296,fatten,1,15.09653218,1,10.81979828,10.81979828,1,163.341433,1,1,2,1,1,2,5,0.321349,0.324693,0,No
12311,farsighted,1,15.09653218,1,10.81979828,10.81979828,1,163.341433,1,1,2,1,1,2,5,0.398076,0.415824,0,No
12324,farce,1,15.09653218,1,10.81979828,10.81979828,1,163.341433,1,1,2,1,1,2,5,0.318529,0.3223,0,No
12325,farber,1,15.09653218,1,10.81979828,10.81979828,1,163.341433,1,1,2,1,1,2,5,0.307414,0.312577,0,No
12343,falter,1,15.09653218,1,10.81979828,10.81979828,1,163.341433,1,1,2,1,1,2,5,0.384237,0.400402,0,No
12362,fairport,1,15.09653218,1,10.81979828,10.81979828,1,163.341433,0,1,1,0,1,1,5,0.316779,0.320554,0,No
12370,faience,1,15.09653218,1,10.81979828,10.81979828,1,163.341433,0,1,1,0,1,1,5,0.384234,0.400398,0,No
12372,fahey,1,15.09653218,1,10.81979828,10.81979828,1,163.341433,0,1,1,0,1,1,5,0.32103,0.327198,0,No
12385,facilitate,1,15.09653218,1,10.81979828,10.81979828,1,163.341433,1,1,2,1,1,2,5,0.323116,0.326233,0,No
12387,facet,1,15.09653218,1,10.81979828,10.81979828,1,163.341433,1,0,1,1,0,1,0,0,0,0,No
12406,eyeball,1,15.09653218,1,10.81979828,10.81979828,1,163.341433,1,1,2,1,1,2,5,0.360829,0.373487,0,No
12409,exude,1,15.09653218,1,10.81979828,10.81979828,1,163.341433,1,1,2,1,1,2,6,0.243598,0.245105,0,No
12412,extrusion,1,15.09653218,1,10.81979828,10.81979828,1,163.341433,1,1,2,1,1,2,5,0.345599,0.354479,0,No
12413,extrovert,1,15.09653218,1,10.81979828,10.81979828,1,163.341433,1,1,2,1,1,2,5,0.322804,0.326184,0,No
12417,extravagant,1,15.09653218,1,10.81979828,10.81979828,1,163.341433,1,1,2,1,1,2,5,0.325229,0.328695,0,No
12420,extramarital,1,15.09653218,1,10.81979828,10.81979828,1,163.341433,1,1,2,1,1,2,5,0.305451,0.310719,0,No
12421,extradition,1,15.09653218,1,10.81979828,10.81979828,1,163.341433,0,0,0,0,0,0,0,0,0,0,No
12422,extracurricular,1,15.09653218,1,10.81979828,10.81979828,1,163.341433,1,1,2,1,1,2,5,0.318999,0.32248,0,No
12433,extensor,1,15.09653218,1,10.81979828,10.81979828,1,163.341433,1,0,1,1,0,1,0,0,0,0,No
12458,explicable,1,15.09653218,1,10.81979828,10.81979828,1,163.341433,1,0,1,1,0,1,0,0,0,0,No
12459,expletive,1,15.09653218,1,10.81979828,10.81979828,1,163.341433,1,1,2,1,1,2,5,0.398076,0.415824,0,No
12462,expiry,1,15.09653218,1,10.81979828,10.81979828,1,163.341433,1,1,2,1,1,2,5,0.321058,0.324289,0,No
12477,expedient,1,15.09653218,1,10.81979828,10.81979828,1,163.341433,1,1,2,1,1,2,5,0.375317,0.391855,0,No
12483,expanse,1,15.09653218,1,10.81979828,10.81979828,1,163.341433,0,1,1,0,1,1,5,0.345598,0.354477,0,No
12490,exorcise,1,15.09653218,1,10.81979828,10.81979828,1,163.341433,1,0,1,1,0,1,0,0,0,0,No
12507,exemplary,1,15.09653218,1,10.81979828,10.81979828,1,163.341433,1,0,1,1,0,1,0,0,0,0,No
12515,excretory,1,15.09653218,1,10.81979828,10.81979828,1,163.341433,1,1,2,1,1,2,5,0.325575,0.32918,0,No
12517,excrete,1,15.09653218,1,10.81979828,10.81979828,1,163.341433,1,0,1,1,0,1,0,0,0,0,No
12519,excommunicate,1,15.09653218,1,10.81979828,10.81979828,1,163.341433,1,1,2,1,1,2,5,0.316976,0.321064,0,No
12521,exclusionary,1,15.09653218,1,10.81979828,10.81979828,1,163.341433,1,1,2,1,1,2,5,0.322189,0.325372,0,No
12526,excitation,1,15.09653218,1,10.81979828,10.81979828,1,163.341433,1,1,2,1,1,2,5,0.378607,0.394397,0,No
12536,excelling,1,15.09653218,1,10.81979828,10.81979828,1,163.341433,1,1,2,1,1,2,5,0.34998,0.359708,0,No
12546,exalt,1,15.09653218,1,10.81979828,10.81979828,1,163.341433,0,1,1,0,1,1,5,0.398072,0.415819,0,No
12549,exacerbate,1,15.09653218,1,10.81979828,10.81979828,1,163.341433,1,0,1,1,0,1,0,0,0,0,No
12555,evoke,1,15.09653218,1,10.81979828,10.81979828,1,163.341433,1,1,2,1,1,2,5,0.319372,0.322739,0,No
12557,evidential,1,15.09653218,1,10.81979828,10.81979828,1,163.341433,1,1,2,1,1,2,5,0.321233,0.324362,0,No
12559,evict,1,15.09653218,1,10.81979828,10.81979828,1,163.341433,1,1,2,1,1,2,5,0.398076,0.415824,0,No
12571,eventide,1,15.09653218,1,10.81979828,10.81979828,1,163.341433,1,1,2,1,1,2,5,0.398067,0.415814,0,No
12572,eventful,1,15.09653218,1,10.81979828,10.81979828,1,163.341433,1,1,2,1,1,2,5,0.312821,0.317329,0,No
12578,evasion,1,15.09653218,1,10.81979828,10.81979828,1,163.341433,1,1,2,1,1,2,5,0.34714,0.356196,0,No
12583,evangelic,1,15.09653218,1,10.81979828,10.81979828,1,163.341433,0,1,1,0,1,1,5,0.308141,0.31306,0,No
12584,evangel,1,15.09653218,1,10.81979828,10.81979828,1,163.341433,1,0,1,1,0,1,0,0,0,0,No
12585,evanescent,1,15.09653218,1,10.81979828,10.81979828,1,163.341433,0,1,1,0,1,1,5,0.321431,0.324637,0,No
12587,evade,1,15.09653218,1,10.81979828,10.81979828,1,163.341433,1,1,2,1,1,2,5,0.314427,0.318671,0,No
12590,euthanasia,1,15.09653218,1,10.81979828,10.81979828,1,163.341433,0,1,1,0,1,1,5,0.328619,0.333504,0,No
12592,europium,1,15.09653218,1,10.81979828,10.81979828,1,163.341433,1,1,2,1,1,2,5,0.345599,0.354479,0,No
12603,euphonious,1,15.09653218,1,10.81979828,10.81979828,1,163.341433,1,0,1,1,0,1,0,0,0,0,No
12606,eulogy,1,15.09653218,1,10.81979828,10.81979828,1,163.341433,0,0,0,0,0,0,0,0,0,0,No
12607,eulerian,1,15.09653218,1,10.81979828,10.81979828,1,163.341433,1,1,2,1,1,2,5,0.319418,0.322778,0,No
12620,etude,1,15.09653218,1,10.81979828,10.81979828,1,163.341433,1,1,2,1,1,2,5,0.305504,0.311148,0,No
12627,ethnomusicology,1,15.09653218,1,10.81979828,10.81979828,1,163.341433,1,1,2,1,1,2,5,0.35519,0.366885,0,No
12628,ethnography,1,15.09653218,1,10.81979828,10.81979828,1,163.341433,1,1,2,1,1,2,5,0.327999,0.3324,0,No
12633,ethereal,1,15.09653218,1,10.81979828,10.81979828,1,163.341433,0,1,1,0,1,1,5,0.318696,0.322338,0,No
12647,estrous,1,15.09653218,1,10.81979828,10.81979828,1,163.341433,1,1,2,1,1,2,5,0.32078,0.32396,0,No
12665,espouse,1,15.09653218,1,10.81979828,10.81979828,1,163.341433,0,1,1,0,1,1,5,0.375314,0.391852,0,No
12668,especial,1,15.09653218,1,10.81979828,10.81979828,1,163.341433,1,1,2,1,1,2,5,0.315422,0.320038,0,No
12671,escrow,1,15.09653218,1,10.81979828,10.81979828,1,163.341433,1,1,2,1,1,2,5,0.326347,0.330278,0,No
12676,escalate,1,15.09653218,1,10.81979828,10.81979828,1,163.341433,1,1,2,1,1,2,5,0.34998,0.359708,0,No
12682,erroneous,1,15.09653218,1,10.81979828,10.81979828,1,163.341433,0,1,1,0,1,1,5,0.329461,0.333471,0,No
12686,err,1,15.09653218,1,10.81979828,10.81979828,1,163.341433,1,1,2,1,1,2,5,0.398076,0.415824,0,No
12704,erg,1,15.09653218,1,10.81979828,10.81979828,1,163.341433,1,1,2,1,1,2,5,0.325772,0.32925,0,No
12706,ere,1,15.09653218,1,10.81979828,10.81979828,1,163.341433,0,1,1,0,1,1,5,0.333596,0.339081,0,No
12708,erbium,1,15.09653218,1,10.81979828,10.81979828,1,163.341433,0,1,1,0,1,1,5,0.345598,0.354477,0,No
12715,erasable,1,15.09653218,1,10.81979828,10.81979828,1,163.341433,1,1,2,1,1,2,5,0.398076,0.415824,0,No
12718,equivocal,1,15.09653218,1,10.81979828,10.81979828,1,163.341433,0,1,1,0,1,1,5,0.310741,0.315327,0,No
12722,equipping,1,15.09653218,1,10.81979828,10.81979828,1,163.341433,1,0,1,1,0,1,0,0,0,0,No
12725,equip,1,15.09653218,1,10.81979828,10.81979828,1,163.341433,1,1,2,1,1,2,5,0.328321,0.332281,0,No
12732,equanimity,1,15.09653218,1,10.81979828,10.81979828,1,163.341433,1,1,2,1,1,2,5,0.32071,0.32465,0,No
12739,epochal,1,15.09653218,1,10.81979828,10.81979828,1,163.341433,0,1,1,0,1,1,5,0.318034,0.321585,0,No
12752,epiphytic,1,15.09653218,1,10.81979828,10.81979828,1,163.341433,1,0,1,1,0,1,0,0,0,0,No
12758,epigraph,1,15.09653218,1,10.81979828,10.81979828,1,163.341433,1,1,2,1,1,2,5,0.398076,0.415824,0,No
12759,epigram,1,15.09653218,1,10.81979828,10.81979828,1,163.341433,1,1,2,1,1,2,5,0.331274,0.335753,0,No
12760,epigenetic,1,15.09653218,1,10.81979828,10.81979828,1,163.341433,1,0,1,1,0,1,0,0,0,0,No
12770,ephemeral,1,15.09653218,1,10.81979828,10.81979828,1,163.341433,1,1,2,1,1,2,6,0.284344,0.290584,0,No
12776,envious,1,15.09653218,1,10.81979828,10.81979828,1,163.341433,1,0,1,1,0,1,0,0,0,0,No
12778,enumerable,1,15.09653218,1,10.81979828,10.81979828,1,163.341433,0,1,1,0,1,1,5,0.320416,0.32434,0,No
12781,entrepreneurial,1,15.09653218,1,10.81979828,10.81979828,1,163.341433,1,1,2,1,1,2,5,0.32311,0.326221,0,No
12783,entrant,1,15.09653218,1,10.81979828,10.81979828,1,163.341433,0,1,1,0,1,1,5,0.326402,0.330412,0,No
12792,enthalpy,1,15.09653218,1,10.81979828,10.81979828,1,163.341433,0,1,1,0,1,1,5,0.378604,0.394393,0,No
12800,enos,1,15.09653218,1,10.81979828,10.81979828,1,163.341433,0,1,1,0,1,1,5,0.384234,0.400398,0,No
12802,enormity,1,15.09653218,1,10.81979828,10.81979828,1,163.341433,1,1,2,1,1,2,5,0.378607,0.394397,0,No
12804,enigmatic,1,15.09653218,1,10.81979828,10.81979828,1,163.341433,1,1,2,1,1,2,5,0.398076,0.415824,0,No
12812,engle,1,15.09653218,1,10.81979828,10.81979828,1,163.341433,1,1,2,1,1,2,5,0.322804,0.326088,0,No
12820,enforceable,1,15.09653218,1,10.81979828,10.81979828,1,163.341433,1,1,2,1,1,2,5,0.305514,0.31126,0,No
12827,endosperm,1,15.09653218,1,10.81979828,10.81979828,1,163.341433,1,1,2,1,1,2,5,0.360829,0.373487,0,No
12829,endogenous,1,15.09653218,1,10.81979828,10.81979828,1,163.341433,1,1,2,1,1,2,5,0.302892,0.308419,0,No
12830,endicott,1,15.09653218,1,10.81979828,10.81979828,1,163.341433,1,1,2,1,1,2,6,0.290928,0.297241,0,No
12838,enchantress,1,15.09653218,1,10.81979828,10.81979828,1,163.341433,1,1,2,1,1,2,5,0.355198,0.36689,0,No
12846,empower,1,15.09653218,1,10.81979828,10.81979828,1,163.341433,1,1,2,1,1,2,5,0.331788,0.336492,0,No
12872,emigre,1,15.09653218,1,10.81979828,10.81979828,1,163.341433,0,1,1,0,1,1,5,0.324338,0.328425,0,No
12875,emetic,1,15.09653218,1,10.81979828,10.81979828,1,163.341433,1,1,2,1,1,2,5,0.306147,0.311344,0,No
12881,emcee,1,15.09653218,1,10.81979828,10.81979828,1,163.341433,1,1,2,1,1,2,5,0.35519,0.366885,0,No
12887,emboss,1,15.09653218,1,10.81979828,10.81979828,1,163.341433,1,1,2,1,1,2,5,0.384237,0.400402,0,No
12891,ember,1,15.09653218,1,10.81979828,10.81979828,1,163.341433,0,1,1,0,1,1,5,0.35917,0.371521,0,No
12892,embedding,1,15.09653218,1,10.81979828,10.81979828,1,163.341433,1,0,1,1,0,1,0,0,0,0,No
12903,elver,1,15.09653218,1,10.81979828,10.81979828,1,163.341433,1,1,2,1,1,2,5,0.343985,0.352404,0,No
12906,elsie,1,15.09653218,1,10.81979828,10.81979828,1,163.341433,1,1,2,1,1,2,6,0.242918,0.244542,0,No
12908,elsevier,1,15.09653218,1,10.81979828,10.81979828,1,163.341433,1,0,1,1,0,1,0,0,0,0,No
12910,eloquent,1,15.09653218,1,10.81979828,10.81979828,1,163.341433,1,1,2,1,1,2,5,0.319803,0.323627,0,No
12911,elongate,1,15.09653218,1,10.81979828,10.81979828,1,163.341433,1,1,2,1,1,2,5,0.32946,0.333471,0,No
12913,elmira,1,15.09653218,1,10.81979828,10.81979828,1,163.341433,1,1,2,1,1,2,6,0.278994,0.285019,0,No
12922,ellipsoidal,1,15.09653218,1,10.81979828,10.81979828,1,163.341433,0,0,0,0,0,0,0,0,0,0,No
12936,elision,1,15.09653218,1,10.81979828,10.81979828,1,163.341433,0,1,1,0,1,1,5,0.331268,0.335748,0,No
12963,electrocardiogram,1,15.09653218,1,10.81979828,10.81979828,1,163.341433,1,1,2,1,1,2,5,0.311481,0.316293,0,No
12965,electrify,1,15.09653218,1,10.81979828,10.81979828,1,163.341433,1,1,2,1,1,2,5,0.326185,0.333913,0,No
12974,eleazar,1,15.09653218,1,10.81979828,10.81979828,1,163.341433,0,0,0,0,0,0,0,0,0,0,No
12986,ejector,1,15.09653218,1,10.81979828,10.81979828,1,163.341433,1,1,2,1,1,2,5,0.35519,0.366885,0,No
12987,eject,1,15.09653218,1,10.81979828,10.81979828,1,163.341433,1,1,2,1,1,2,5,0.332391,0.337648,0,No
13008,egress,1,15.09653218,1,10.81979828,10.81979828,1,163.341433,1,0,1,1,0,1,0,0,0,0,No
13009,egocentric,1,15.09653218,1,10.81979828,10.81979828,1,163.341433,1,1,2,1,1,2,5,0.2996,0.3054,0,No
13017,effusive,1,15.09653218,1,10.81979828,10.81979828,1,163.341433,1,1,2,1,1,2,5,0.384237,0.400402,0,No
13019,effluent,1,15.09653218,1,10.81979828,10.81979828,1,163.341433,0,1,1,0,1,1,6,0.279938,0.286948,0,No
13024,effeminate,1,15.09653218,1,10.81979828,10.81979828,1,163.341433,1,0,1,1,0,1,0,0,0,0,No
13027,eerie,1,15.09653218,1,10.81979828,10.81979828,1,163.341433,1,0,1,1,0,1,0,0,0,0,No
13029,edwina,1,15.09653218,1,10.81979828,10.81979828,1,163.341433,1,0,1,1,0,1,0,0,0,0,No
13074,echinoderm,1,15.09653218,1,10.81979828,10.81979828,1,163.341433,1,1,2,1,1,2,5,0.320334,0.323512,0,No
13082,ebb,1,15.09653218,1,10.81979828,10.81979828,1,163.341433,1,1,2,1,1,2,5,0.310153,0.314834,0,No
13084,eavesdrop,1,15.09653218,1,10.81979828,10.81979828,1,163.341433,1,1,2,1,1,2,5,0.338011,0.344413,0,No
13089,easygoing,1,15.09653218,1,10.81979828,10.81979828,1,163.341433,1,1,2,1,1,2,5,0.323599,0.326828,0,No
13096,eastbound,1,15.09653218,1,10.81979828,10.81979828,1,163.341433,1,1,2,1,1,2,5,0.384229,0.400392,0,No
13105,earsplitting,1,15.09653218,1,10.81979828,10.81979828,1,163.341433,1,1,2,1,1,2,5,0.323233,0.326477,0,No
13106,earshot,1,15.09653218,1,10.81979828,10.81979828,1,163.341433,1,1,2,1,1,2,5,0.32223,0.325706,0,No
13108,earphone,1,15.09653218,1,10.81979828,10.81979828,1,163.341433,1,1,2,1,1,2,5,0.35519,0.366885,0,No
13116,eagan,1,15.09653218,1,10.81979828,10.81979828,1,163.341433,1,1,2,1,1,2,5,0.316282,0.320253,0,No
13141,dutiful,1,15.09653218,1,10.81979828,10.81979828,1,163.341433,0,1,1,0,1,1,6,0.266719,0.271688,0,No
13148,dusky,1,15.09653218,1,10.81979828,10.81979828,1,163.341433,1,0,1,1,0,1,0,0,0,0,No
13153,duress,1,15.09653218,1,10.81979828,10.81979828,1,163.341433,1,1,2,1,1,2,5,0.384237,0.400402,0,No
13158,duquesne,1,15.09653218,1,10.81979828,10.81979828,1,163.341433,1,1,2,1,1,2,5,0.341779,0.349674,0,No
13161,duplex,1,15.09653218,1,10.81979828,10.81979828,1,163.341433,0,1,1,0,1,1,5,0.384234,0.400398,0,No
13177,dumpty,1,15.09653218,1,10.81979828,10.81979828,1,163.341433,1,0,1,1,0,1,0,0,0,0,No
13178,dumpster,1,15.09653218,1,10.81979828,10.81979828,1,163.341433,1,0,1,1,0,1,0,0,0,0,No
13185,duly,1,15.09653218,1,10.81979828,10.81979828,1,163.341433,1,1,2,1,1,2,5,0.314439,0.31876,0,No
13189,dugout,1,15.09653218,1,10.81979828,10.81979828,1,163.341433,1,1,2,1,1,2,5,0.332161,0.339406,0,No
13194,duffel,1,15.09653218,1,10.81979828,10.81979828,1,163.341433,1,1,2,1,1,2,5,0.345599,0.354479,0,No
13200,dud,1,15.09653218,1,10.81979828,10.81979828,1,163.341433,1,1,2,1,1,2,5,0.321029,0.327198,0,No
13208,dubhe,1,15.09653218,1,10.81979828,10.81979828,1,163.341433,1,1,2,1,1,2,5,0.384237,0.400402,0,No
13226,drugging,1,15.09653218,1,10.81979828,10.81979828,1,163.341433,1,0,1,1,0,1,0,0,0,0,No
13243,drippy,1,15.09653218,1,10.81979828,10.81979828,1,163.341433,1,1,2,1,1,2,5,0.35519,0.366885,0,No
13255,dreamboat,1,15.09653218,1,10.81979828,10.81979828,1,163.341433,1,1,2,1,1,2,5,0.303275,0.308753,0,No
13259,drawstring,1,15.09653218,1,10.81979828,10.81979828,1,163.341433,1,1,2,1,1,2,5,0.325976,0.330994,0,No
13261,drawbridge,1,15.09653218,1,10.81979828,10.81979828,1,163.341433,1,1,2,1,1,2,5,0.32681,0.33159,0,No
13267,drape,1,15.09653218,1,10.81979828,10.81979828,1,163.341433,0,1,1,0,1,1,6,0.26549,0.270284,0,No
13278,dragnet,1,15.09653218,1,10.81979828,10.81979828,1,163.341433,1,1,2,1,1,2,5,0.323941,0.327144,0,No
13281,draftsman,1,15.09653218,1,10.81979828,10.81979828,1,163.341433,1,1,2,1,1,2,5,0.384237,0.400402,0,No
13290,downwind,1,15.09653218,1,10.81979828,10.81979828,1,163.341433,1,1,2,1,1,2,5,0.31768,0.321244,0,No
13296,downplay,1,15.09653218,1,10.81979828,10.81979828,1,163.341433,1,1,2,1,1,2,5,0.398076,0.415824,0,No
13302,dowel,1,15.09653218,1,10.81979828,10.81979828,1,163.341433,1,1,2,1,1,2,5,0.322534,0.328145,0,No
13306,dour,1,15.09653218,1,10.81979828,10.81979828,1,163.341433,1,1,2,1,1,2,5,0.345599,0.354479,0,No
13313,douce,1,15.09653218,1,10.81979828,10.81979828,1,163.341433,1,1,2,1,1,2,5,0.326047,0.329684,0,No
13321,dossier,1,15.09653218,1,10.81979828,10.81979828,1,163.341433,1,1,2,1,1,2,5,0.318936,0.322395,0,No
13336,doreen,1,15.09653218,1,10.81979828,10.81979828,1,163.341433,1,0,1,1,0,1,0,0,0,0,No
13346,doormen,1,15.09653218,1,10.81979828,10.81979828,1,163.341433,0,1,1,0,1,1,5,0.333854,0.3397,0,No
13348,doorknob,1,15.09653218,1,10.81979828,10.81979828,1,163.341433,1,1,2,1,1,2,5,0.345599,0.354479,0,No
13349,doorbell,1,15.09653218,1,10.81979828,10.81979828,1,163.341433,1,1,2,1,1,2,5,0.309294,0.31412,0,No
13375,domesticate,1,15.09653218,1,10.81979828,10.81979828,1,163.341433,1,1,2,1,1,2,5,0.322242,0.326421,0,No
13389,dolan,1,15.09653218,1,10.81979828,10.81979828,1,163.341433,1,1,2,1,1,2,5,0.321128,0.32449,0,No
13392,dogmatism,1,15.09653218,1,10.81979828,10.81979828,1,163.341433,1,1,2,1,1,2,5,0.333854,0.3397,0,No
13395,doghouse,1,15.09653218,1,10.81979828,10.81979828,1,163.341433,1,1,2,1,1,2,5,0.328747,0.332973,0,No
13396,dogfish,1,15.09653218,1,10.81979828,10.81979828,1,163.341433,0,1,1,0,1,1,5,0.384234,0.400398,0,No
13400,dodson,1,15.09653218,1,10.81979828,10.81979828,1,163.341433,1,1,2,1,1,2,5,0.34998,0.359708,0,No
13422,djakarta,1,15.09653218,1,10.81979828,10.81979828,1,163.341433,1,1,2,1,1,2,5,0.35519,0.366885,0,No
13436,divest,1,15.09653218,1,10.81979828,10.81979828,1,163.341433,1,1,2,1,1,2,5,0.321349,0.324693,0,No
13440,diverge,1,15.09653218,1,10.81979828,10.81979828,1,163.341433,1,1,2,1,1,2,5,0.341779,0.349674,0,No
13450,distributive,1,15.09653218,1,10.81979828,10.81979828,1,163.341433,1,0,1,1,0,1,0,0,0,0,No
13459,dissuade,1,15.09653218,1,10.81979828,10.81979828,1,163.341433,1,1,2,1,1,2,5,0.398076,0.415824,0,No
13460,dissociate,1,15.09653218,1,10.81979828,10.81979828,1,163.341433,1,1,2,1,1,2,5,0.331268,0.335748,0,No
13465,disseminate,1,15.09653218,1,10.81979828,10.81979828,1,163.341433,1,0,1,1,0,1,0,0,0,0,No
13468,disrupt,1,15.09653218,1,10.81979828,10.81979828,1,163.341433,1,1,2,1,1,2,5,0.384237,0.400402,0,No
13476,dispelling,1,15.09653218,1,10.81979828,10.81979828,1,163.341433,1,1,2,1,1,2,5,0.398076,0.415824,0,No
13478,disparate,1,15.09653218,1,10.81979828,10.81979828,1,163.341433,1,0,1,1,0,1,0,0,0,0,No
13493,discretion,1,15.09653218,1,10.81979828,10.81979828,1,163.341433,1,1,2,1,1,2,5,0.338011,0.344413,0,No
13499,discernible,1,15.09653218,1,10.81979828,10.81979828,1,163.341433,0,1,1,0,1,1,5,0.360828,0.373485,0,No
13500,discern,1,15.09653218,1,10.81979828,10.81979828,1,163.341433,0,1,1,0,1,1,5,0.301137,0.306813,0,No
13512,dire,1,15.09653218,1,10.81979828,10.81979828,1,163.341433,1,1,2,1,1,2,5,0.287685,0.294229,0,No
13524,diorama,1,15.09653218,1,10.81979828,10.81979828,1,163.341433,1,1,2,1,1,2,5,0.384246,0.400407,0,No
13525,diophantine,1,15.09653218,1,10.81979828,10.81979828,1,163.341433,0,0,0,0,0,0,0,0,0,0,No
13533,dinnertime,1,15.09653218,1,10.81979828,10.81979828,1,163.341433,1,0,1,1,0,1,0,0,0,0,No
13540,dimple,1,15.09653218,1,10.81979828,10.81979828,1,163.341433,1,1,2,1,1,2,5,0.338011,0.344413,0,No
13552,diligent,1,15.09653218,1,10.81979828,10.81979828,1,163.341433,1,1,2,1,1,2,5,0.308777,0.313623,0,No
13555,digram,1,15.09653218,1,10.81979828,10.81979828,1,163.341433,1,1,2,1,1,2,5,0.341779,0.349674,0,No
13564,digestible,1,15.09653218,1,10.81979828,10.81979828,1,163.341433,1,1,2,1,1,2,5,0.347133,0.356191,0,No
13574,differentiable,1,15.09653218,1,10.81979828,10.81979828,1,163.341433,1,0,1,1,0,1,0,0,0,0,No
13579,dietician,1,15.09653218,1,10.81979828,10.81979828,1,163.341433,1,0,1,1,0,1,0,0,0,0,No
13586,diebold,1,15.09653218,1,10.81979828,10.81979828,1,163.341433,1,0,1,1,0,1,0,0,0,0,No
13592,diction,1,15.09653218,1,10.81979828,10.81979828,1,163.341433,0,1,1,0,1,1,5,0.281211,0.287513,0,No
13594,dictate,1,15.09653218,1,10.81979828,10.81979828,1,163.341433,1,1,2,1,1,2,5,0.398076,0.415824,0,No
13595,dicotyledon,1,15.09653218,1,10.81979828,10.81979828,1,163.341433,1,0,1,1,0,1,0,0,0,0,No
13601,dichotomy,1,15.09653218,1,10.81979828,10.81979828,1,163.341433,1,1,2,1,1,2,5,0.360829,0.373487,0,No
13603,diatonic,1,15.09653218,1,10.81979828,10.81979828,1,163.341433,1,0,1,1,0,1,0,0,0,0,No
13610,dianne,1,15.09653218,1,10.81979828,10.81979828,1,163.341433,1,1,2,1,1,2,5,0.287205,0.293478,0,No
13615,diamagnetism,1,15.09653218,1,10.81979828,10.81979828,1,163.341433,0,1,1,0,1,1,5,0.343984,0.352403,0,No
13616,diamagnetic,1,15.09653218,1,10.81979828,10.81979828,1,163.341433,0,0,0,0,0,0,0,0,0,0,No
13618,dialup,1,15.09653218,1,10.81979828,10.81979828,1,163.341433,1,1,2,1,1,2,5,0.319389,0.322739,0,No
13629,diadem,1,15.09653218,1,10.81979828,10.81979828,1,163.341433,1,1,2,1,1,2,5,0.345599,0.354479,0,No
13631,diabetic,1,15.09653218,1,10.81979828,10.81979828,1,163.341433,1,1,2,1,1,2,5,0.384237,0.400402,0,No
13635,dey,1,15.09653218,1,10.81979828,10.81979828,1,163.341433,1,0,1,1,0,1,0,0,0,0,No
13649,devolve,1,15.09653218,1,10.81979828,10.81979828,1,163.341433,1,1,2,1,1,2,5,0.359172,0.371523,0,No
13651,devise,1,15.09653218,1,10.81979828,10.81979828,1,163.341433,1,1,2,1,1,2,5,0.313113,0.318837,0,No
13656,deviant,1,15.09653218,1,10.81979828,10.81979828,1,163.341433,1,1,2,1,1,2,5,0.31355,0.318123,0,No
13667,detest,1,15.09653218,1,10.81979828,10.81979828,1,163.341433,1,1,2,1,1,2,5,0.311536,0.316083,0,No
13668,deterrent,1,15.09653218,1,10.81979828,10.81979828,1,163.341433,1,1,2,1,1,2,5,0.321757,0.326069,0,No
13670,deteriorate,1,15.09653218,1,10.81979828,10.81979828,1,163.341433,1,1,2,1,1,2,5,0.398076,0.415824,0,No
13678,destruct,1,15.09653218,1,10.81979828,10.81979828,1,163.341433,1,1,2,1,1,2,5,0.345606,0.354483,0,No
13685,despise,1,15.09653218,1,10.81979828,10.81979828,1,163.341433,1,1,2,1,1,2,5,0.398076,0.415824,0,No
13689,desolate,1,15.09653218,1,10.81979828,10.81979828,1,163.341433,1,1,2,1,1,2,5,0.309213,0.314008,0,No
13695,desiccate,1,15.09653218,1,10.81979828,10.81979828,1,163.341433,1,1,2,1,1,2,5,0.305983,0.311244,0,No
13707,dervish,1,15.09653218,1,10.81979828,10.81979828,1,163.341433,1,1,2,1,1,2,5,0.35519,0.366885,0,No
13712,derisive,1,15.09653218,1,10.81979828,10.81979828,1,163.341433,1,1,2,1,1,2,5,0.323947,0.327997,0,No
13713,derelict,1,15.09653218,1,10.81979828,10.81979828,1,163.341433,1,1,2,1,1,2,5,0.32403,0.327593,0,No
13717,derail,1,15.09653218,1,10.81979828,10.81979828,1,163.341433,1,1,2,1,1,2,5,0.316943,0.320896,0,No
13723,depressant,1,15.09653218,1,10.81979828,10.81979828,1,163.341433,1,1,2,1,1,2,5,0.35519,0.366885,0,No
13743,denudation,1,15.09653218,1,10.81979828,10.81979828,1,163.341433,1,1,2,1,1,2,5,0.30768,0.312715,0,No
13757,deneb,1,15.09653218,1,10.81979828,10.81979828,1,163.341433,1,1,2,1,1,2,5,0.316643,0.320468,0,No
13763,demountable,1,15.09653218,1,10.81979828,10.81979828,1,163.341433,1,0,1,1,0,1,0,0,0,0,No
13772,demographer,1,15.09653218,1,10.81979828,10.81979828,1,163.341433,1,1,2,1,1,2,5,0.384237,0.400402,0,No
13782,demagogue,1,15.09653218,1,10.81979828,10.81979828,1,163.341433,1,1,2,1,1,2,5,0.326047,0.329684,0,No
13788,delphine,1,15.09653218,1,10.81979828,10.81979828,1,163.341433,1,0,1,1,0,1,0,0,0,0,No
13789,delphic,1,15.09653218,1,10.81979828,10.81979828,1,163.341433,1,1,2,1,1,2,6,0.280351,0.2865,0,No
13798,delirious,1,15.09653218,1,10.81979828,10.81979828,1,163.341433,1,0,1,1,0,1,0,0,0,0,No
13799,deliquescent,1,15.09653218,1,10.81979828,10.81979828,1,163.341433,1,1,2,1,1,2,5,0.384237,0.400402,0,No
13800,delineate,1,15.09653218,1,10.81979828,10.81979828,1,163.341433,1,1,2,1,1,2,5,0.307307,0.312586,0,No
13805,delicti,1,15.09653218,1,10.81979828,10.81979828,1,163.341433,1,1,2,1,1,2,5,0.375317,0.391855,0,No
13814,deletion,1,15.09653218,1,10.81979828,10.81979828,1,163.341433,0,1,1,0,1,1,5,0.326348,0.330278,0,No
13837,deflate,1,15.09653218,1,10.81979828,10.81979828,1,163.341433,1,1,2,1,1,2,5,0.345599,0.354479,0,No
13845,deferring,1,15.09653218,1,10.81979828,10.81979828,1,163.341433,1,1,2,1,1,2,5,0.310153,0.314794,0,No
13853,deerskin,1,15.09653218,1,10.81979828,10.81979828,1,163.341433,1,1,2,1,1,2,5,0.327691,0.331792,0,No
13858,deduct,1,15.09653218,1,10.81979828,10.81979828,1,163.341433,1,0,1,1,0,1,0,0,0,0,No
13888,decennial,1,15.09653218,1,10.81979828,10.81979828,1,163.341433,1,1,2,1,1,2,5,0.321128,0.32432,0,No
13890,decelerate,1,15.09653218,1,10.81979828,10.81979828,1,163.341433,1,1,2,1,1,2,5,0.343985,0.352404,0,No
13893,decedent,1,15.09653218,1,10.81979828,10.81979828,1,163.341433,1,1,2,1,1,2,5,0.378607,0.394397,0,No
13905,debunk,1,15.09653218,1,10.81979828,10.81979828,1,163.341433,1,1,2,1,1,2,5,0.384237,0.400402,0,No
13918,debater,1,15.09653218,1,10.81979828,10.81979828,1,163.341433,1,1,2,1,1,2,5,0.384237,0.400402,0,No
13920,debacle,1,15.09653218,1,10.81979828,10.81979828,1,163.341433,1,1,2,1,1,2,5,0.33386,0.339705,0,No
13923,dearth,1,15.09653218,1,10.81979828,10.81979828,1,163.341433,1,1,2,1,1,2,5,0.331002,0.335599,0,No
13924,dearie,1,15.09653218,1,10.81979828,10.81979828,1,163.341433,1,0,1,1,0,1,0,0,0,0,No
13937,deactivate,1,15.09653218,1,10.81979828,10.81979828,1,163.341433,1,0,1,1,0,1,0,0,0,0,No
13952,davit,1,15.09653218,1,10.81979828,10.81979828,1,163.341433,0,0,0,0,0,0,0,0,0,0,No
13964,datura,1,15.09653218,1,10.81979828,10.81979828,1,163.341433,0,0,0,0,0,0,0,0,0,0,No
13972,darwinian,1,15.09653218,1,10.81979828,10.81979828,1,163.341433,1,1,2,1,1,2,5,0.316943,0.320653,0,No
13976,darry,1,15.09653218,1,10.81979828,10.81979828,1,163.341433,1,0,1,1,0,1,0,0,0,0,No
13978,darpa,1,15.09653218,1,10.81979828,10.81979828,1,163.341433,0,1,1,0,1,1,5,0.331268,0.335748,0,No
13979,darn,1,15.09653218,1,10.81979828,10.81979828,1,163.341433,1,1,2,1,1,2,5,0.319907,0.323327,0,No
13987,dapper,1,15.09653218,1,10.81979828,10.81979828,1,163.341433,1,1,2,1,1,2,5,0.305999,0.311327,0,No
13998,dangle,1,15.09653218,1,10.81979828,10.81979828,1,163.341433,1,1,2,1,1,2,5,0.359165,0.371513,0,No
14009,damselfly,1,15.09653218,1,10.81979828,10.81979828,1,163.341433,1,1,2,1,1,2,5,0.343985,0.352404,0,No
14011,dampen,1,15.09653218,1,10.81979828,10.81979828,1,163.341433,1,1,2,1,1,2,5,0.328321,0.332281,0,No
14023,dally,1,15.09653218,1,10.81979828,10.81979828,1,163.341433,1,1,2,1,1,2,5,0.345599,0.354479,0,No
14026,daley,1,15.09653218,1,10.81979828,10.81979828,1,163.341433,1,1,2,1,1,2,5,0.322869,0.327329,0,No
14033,dainty,1,15.09653218,1,10.81979828,10.81979828,1,163.341433,1,0,1,1,0,1,0,0,0,0,No
14035,dailey,1,15.09653218,1,10.81979828,10.81979828,1,163.341433,1,1,2,1,1,2,6,0.284686,0.29102,0,No
14058,cz,1,15.09653218,1,10.81979828,10.81979828,1,163.341433,0,0,0,0,0,0,0,0,0,0,No
14061,cysteine,1,15.09653218,1,10.81979828,10.81979828,1,163.341433,0,0,0,0,0,0,0,0,0,0,No
14075,cyclotomic,1,15.09653218,1,10.81979828,10.81979828,1,163.341433,1,0,1,1,0,1,0,0,0,0,No
14076,cyclorama,1,15.09653218,1,10.81979828,10.81979828,1,163.341433,1,1,2,1,1,2,5,0.324765,0.329004,0,No
14083,cybernetic,1,15.09653218,1,10.81979828,10.81979828,1,163.341433,1,0,1,1,0,1,0,0,0,0,No
14085,cyanate,1,15.09653218,1,10.81979828,10.81979828,1,163.341433,1,1,2,1,1,2,5,0.332161,0.339406,0,No
14090,cutthroat,1,15.09653218,1,10.81979828,10.81979828,1,163.341433,1,1,2,1,1,2,5,0.384237,0.400402,0,No
14094,cutlass,1,15.09653218,1,10.81979828,10.81979828,1,163.341433,0,1,1,0,1,1,5,0.316632,0.320462,0,No
14110,curtail,1,15.09653218,1,10.81979828,10.81979828,1,163.341433,1,1,2,1,1,2,5,0.334225,0.341138,0,No
14132,curate,1,15.09653218,1,10.81979828,10.81979828,1,163.341433,1,1,2,1,1,2,5,0.326485,0.329725,0,No
14133,cur,1,15.09653218,1,10.81979828,10.81979828,1,163.341433,0,1,1,0,1,1,5,0.322137,0.325273,0,No
14144,cumbersome,1,15.09653218,1,10.81979828,10.81979828,1,163.341433,1,1,2,1,1,2,5,0.384237,0.400402,0,No
14146,culvert,1,15.09653218,1,10.81979828,10.81979828,1,163.341433,1,1,2,1,1,2,5,0.398076,0.415824,0,No
14157,cudgel,1,15.09653218,1,10.81979828,10.81979828,1,163.341433,1,1,2,1,1,2,5,0.29677,0.302756,0,No
14158,cuddly,1,15.09653218,1,10.81979828,10.81979828,1,163.341433,1,1,2,1,1,2,5,0.312732,0.317152,0,No
14166,cubby,1,15.09653218,1,10.81979828,10.81979828,1,163.341433,1,1,2,1,1,2,5,0.285478,0.291723,0,No
14171,crystallite,1,15.09653218,1,10.81979828,10.81979828,1,163.341433,1,0,1,1,0,1,0,0,0,0,No
14182,cryogenic,1,15.09653218,1,10.81979828,10.81979828,1,163.341433,1,1,2,1,1,2,5,0.321047,0.324438,0,No
14186,crutch,1,15.09653218,1,10.81979828,10.81979828,1,163.341433,1,1,2,1,1,2,5,0.325814,0.329544,0,No
14195,crump,1,15.09653218,1,10.81979828,10.81979828,1,163.341433,1,1,2,1,1,2,5,0.301713,0.307346,0,No
14210,crowfoot,1,15.09653218,1,10.81979828,10.81979828,1,163.341433,1,1,2,1,1,2,5,0.325688,0.329029,0,No
14217,crosstalk,1,15.09653218,1,10.81979828,10.81979828,1,163.341433,1,1,2,1,1,2,5,0.360829,0.373487,0,No
14227,cromwellian,1,15.09653218,1,10.81979828,10.81979828,1,163.341433,1,0,1,1,0,1,0,0,0,0,No
14235,crockery,1,15.09653218,1,10.81979828,10.81979828,1,163.341433,1,1,2,1,1,2,5,0.338018,0.344417,0,No
14238,croak,1,15.09653218,1,10.81979828,10.81979828,1,163.341433,1,1,2,1,1,2,5,0.328412,0.333573,0,No
14248,cripple,1,15.09653218,1,10.81979828,10.81979828,1,163.341433,1,1,2,1,1,2,5,0.35519,0.366885,0,No
14255,crewmen,1,15.09653218,1,10.81979828,10.81979828,1,163.341433,1,1,2,1,1,2,5,0.330941,0.335429,0,No
14264,crept,1,15.09653218,1,10.81979828,10.81979828,1,163.341433,1,1,2,1,1,2,5,0.324314,0.329355,0,No
14267,creon,1,15.09653218,1,10.81979828,10.81979828,1,163.341433,1,1,2,1,1,2,5,0.360829,0.373487,0,No
14269,crematory,1,15.09653218,1,10.81979828,10.81979828,1,163.341433,1,0,1,1,0,1,0,0,0,0,No
14279,credential,1,15.09653218,1,10.81979828,10.81979828,1,163.341433,1,1,2,1,1,2,5,0.398076,0.415824,0,No
14280,creche,1,15.09653218,1,10.81979828,10.81979828,1,163.341433,1,0,1,1,0,1,0,0,0,0,No
14286,creaky,1,15.09653218,1,10.81979828,10.81979828,1,163.341433,1,1,2,1,1,2,5,0.327388,0.3313,0,No
14304,crania,1,15.09653218,1,10.81979828,10.81979828,1,163.341433,0,1,1,0,1,1,5,0.321344,0.325025,0,No
14307,crandall,1,15.09653218,1,10.81979828,10.81979828,1,163.341433,0,0,0,0,0,0,0,0,0,0,No
14309,cram,1,15.09653218,1,10.81979828,10.81979828,1,163.341433,1,1,2,1,1,2,5,0.32597,0.329306,0,No
14311,crag,1,15.09653218,1,10.81979828,10.81979828,1,163.341433,1,0,1,1,0,1,0,0,0,0,No
14313,craftspeople,1,15.09653218,1,10.81979828,10.81979828,1,163.341433,1,1,2,1,1,2,5,0.35519,0.366885,0,No
14319,crabapple,1,15.09653218,1,10.81979828,10.81979828,1,163.341433,0,1,1,0,1,1,5,0.326576,0.330278,0,No
14322,cpa,1,15.09653218,1,10.81979828,10.81979828,1,163.341433,1,1,2,1,1,2,5,0.345606,0.354483,0,No
14323,coypu,1,15.09653218,1,10.81979828,10.81979828,1,163.341433,1,1,2,1,1,2,5,0.35519,0.366885,0,No
14328,cowpoke,1,15.09653218,1,10.81979828,10.81979828,1,163.341433,1,1,2,1,1,2,5,0.360829,0.373487,0,No
14330,cowlick,1,15.09653218,1,10.81979828,10.81979828,1,163.341433,1,1,2,1,1,2,5,0.334225,0.341138,0,No
14333,cowardice,1,15.09653218,1,10.81979828,10.81979828,1,163.341433,1,1,2,1,1,2,5,0.336028,0.342206,0,No
14345,couturier,1,15.09653218,1,10.81979828,10.81979828,1,163.341433,1,1,2,1,1,2,5,0.325271,0.328541,0,No
14347,couscous,1,15.09653218,1,10.81979828,10.81979828,1,163.341433,0,1,1,0,1,1,5,0.331268,0.335748,0,No
14361,coupon,1,15.09653218,1,10.81979828,10.81979828,1,163.341433,1,1,2,1,1,2,5,0.355183,0.366876,0,No
14367,countrymen,1,15.09653218,1,10.81979828,10.81979828,1,163.341433,1,1,2,1,1,2,5,0.320589,0.32475,0,No
14371,countersunk,1,15.09653218,1,10.81979828,10.81979828,1,163.341433,1,1,2,1,1,2,5,0.334943,0.340906,0,No
14372,countersink,1,15.09653218,1,10.81979828,10.81979828,1,163.341433,1,1,2,1,1,2,5,0.304143,0.309561,0,No
14377,counterattack,1,15.09653218,1,10.81979828,10.81979828,1,163.341433,1,1,2,1,1,2,5,0.308188,0.313116,0,No
14379,countenance,1,15.09653218,1,10.81979828,10.81979828,1,163.341433,1,1,2,1,1,2,5,0.307291,0.312473,0,No
14399,cot,1,15.09653218,1,10.81979828,10.81979828,1,163.341433,1,0,1,1,0,1,0,0,0,0,No
14416,corvallis,1,15.09653218,1,10.81979828,10.81979828,1,163.341433,1,1,2,1,1,2,5,0.31292,0.317165,0,No
14428,corroboree,1,15.09653218,1,10.81979828,10.81979828,1,163.341433,1,1,2,1,1,2,5,0.315495,0.319405,0,No
14433,corral,1,15.09653218,1,10.81979828,10.81979828,1,163.341433,1,1,2,1,1,2,6,0.262077,0.266306,0,No
14437,corporeal,1,15.09653218,1,10.81979828,10.81979828,1,163.341433,1,1,2,1,1,2,5,0.325581,0.328889,0,No
14441,coronet,1,15.09653218,1,10.81979828,10.81979828,1,163.341433,1,1,2,1,1,2,5,0.378607,0.394397,0,No
14444,coronado,1,15.09653218,1,10.81979828,10.81979828,1,163.341433,1,1,2,1,1,2,5,0.317828,0.321433,0,No
14446,corollary,1,15.09653218,1,10.81979828,10.81979828,1,163.341433,1,1,2,1,1,2,5,0.345606,0.354483,0,No
14450,cornmeal,1,15.09653218,1,10.81979828,10.81979828,1,163.341433,0,1,1,0,1,1,5,0.349979,0.359707,0,No
14452,cornflower,1,15.09653218,1,10.81979828,10.81979828,1,163.341433,1,0,1,1,0,1,0,0,0,0,No
14462,corkscrew,1,15.09653218,1,10.81979828,10.81979828,1,163.341433,1,1,2,1,1,2,5,0.3215,0.324725,0,No
14469,cordon,1,15.09653218,1,10.81979828,10.81979828,1,163.341433,0,0,0,0,0,0,0,0,0,0,No
14475,copywriter,1,15.09653218,1,10.81979828,10.81979828,1,163.341433,1,0,1,1,0,1,0,0,0,0,No
14477,copybook,1,15.09653218,1,10.81979828,10.81979828,1,163.341433,0,0,0,0,0,0,0,0,0,0,No
14479,copulate,1,15.09653218,1,10.81979828,10.81979828,1,163.341433,1,1,2,1,1,2,5,0.326816,0.331594,0,No
14480,coprocessor,1,15.09653218,1,10.81979828,10.81979828,1,163.341433,1,1,2,1,1,2,5,0.338882,0.345659,0,No
14494,coop,1,15.09653218,1,10.81979828,10.81979828,1,163.341433,1,1,2,1,1,2,5,0.331943,0.336969,0,No
14497,cooley,1,15.09653218,1,10.81979828,10.81979828,1,163.341433,1,0,1,1,0,1,0,0,0,0,No
14498,coolant,1,15.09653218,1,10.81979828,10.81979828,1,163.341433,1,0,1,1,0,1,0,0,0,0,No
14508,convolution,1,15.09653218,1,10.81979828,10.81979828,1,163.341433,1,1,2,1,1,2,5,0.31187,0.316346,0,No
14511,conveyor,1,15.09653218,1,10.81979828,10.81979828,1,163.341433,1,0,1,1,0,1,0,0,0,0,No
14512,conveyance,1,15.09653218,1,10.81979828,10.81979828,1,163.341433,0,0,0,0,0,0,0,0,0,0,No
14525,convene,1,15.09653218,1,10.81979828,10.81979828,1,163.341433,1,1,2,1,1,2,5,0.326191,0.333917,0,No
14526,convalescent,1,15.09653218,1,10.81979828,10.81979828,1,163.341433,1,1,2,1,1,2,5,0.323935,0.327149,0,No
14528,conundrum,1,15.09653218,1,10.81979828,10.81979828,1,163.341433,0,1,1,0,1,1,5,0.325265,0.328537,0,No
14529,contusion,1,15.09653218,1,10.81979828,10.81979828,1,163.341433,1,1,2,1,1,2,5,0.35519,0.366885,0,No
14535,controllable,1,15.09653218,1,10.81979828,10.81979828,1,163.341433,1,1,2,1,1,2,6,0.247749,0.249418,0,No
14537,contrition,1,15.09653218,1,10.81979828,10.81979828,1,163.341433,1,1,2,1,1,2,5,0.360829,0.373487,0,No
14542,contravention,1,15.09653218,1,10.81979828,10.81979828,1,163.341433,1,1,2,1,1,2,5,0.378607,0.394397,0,No
14573,contend,1,15.09653218,1,10.81979828,10.81979828,1,163.341433,0,1,1,0,1,1,5,0.338882,0.345659,0,No
14580,contagion,1,15.09653218,1,10.81979828,10.81979828,1,163.341433,1,1,2,1,1,2,5,0.384237,0.400402,0,No
14583,consummate,1,15.09653218,1,10.81979828,10.81979828,1,163.341433,1,1,2,1,1,2,5,0.398076,0.415824,0,No
14593,constructible,1,15.09653218,1,10.81979828,10.81979828,1,163.341433,1,1,2,1,1,2,5,0.331268,0.335748,0,No
14596,constrict,1,15.09653218,1,10.81979828,10.81979828,1,163.341433,1,1,2,1,1,2,5,0.322634,0.326458,0,No
14605,conspirator,1,15.09653218,1,10.81979828,10.81979828,1,163.341433,1,0,1,1,0,1,0,0,0,0,No
14628,conscript,1,15.09653218,1,10.81979828,10.81979828,1,163.341433,1,1,2,1,1,2,5,0.343985,0.352404,0,No
14638,connors,1,15.09653218,1,10.81979828,10.81979828,1,163.341433,1,1,2,1,1,2,5,0.326545,0.330109,0,No
14654,congressmen,1,15.09653218,1,10.81979828,10.81979828,1,163.341433,1,1,2,1,1,2,5,0.338011,0.344413,0,No
14664,congeal,1,15.09653218,1,10.81979828,10.81979828,1,163.341433,1,1,2,1,1,2,5,0.321111,0.325062,0,No
14671,confound,1,15.09653218,1,10.81979828,10.81979828,1,163.341433,1,1,2,1,1,2,5,0.398076,0.415824,0,No
14672,conformal,1,15.09653218,1,10.81979828,10.81979828,1,163.341433,1,0,1,1,0,1,0,0,0,0,No
14675,conflagrate,1,15.09653218,1,10.81979828,10.81979828,1,163.341433,0,1,1,0,1,1,5,0.318536,0.322097,0,No
14676,confiscate,1,15.09653218,1,10.81979828,10.81979828,1,163.341433,1,1,2,1,1,2,5,0.398076,0.415824,0,No
14683,confidante,1,15.09653218,1,10.81979828,10.81979828,1,163.341433,0,1,1,0,1,1,5,0.30055,0.306253,0,No
14684,confidant,1,15.09653218,1,10.81979828,10.81979828,1,163.341433,0,0,0,0,0,0,0,0,0,0,No
14690,confer,1,15.09653218,1,10.81979828,10.81979828,1,163.341433,0,1,1,0,1,1,6,0.246347,0.24778,0,No
14695,conestoga,1,15.09653218,1,10.81979828,10.81979828,1,163.341433,1,0,1,1,0,1,0,0,0,0,No
14708,concurring,1,15.09653218,1,10.81979828,10.81979828,1,163.341433,1,1,2,1,1,2,5,0.35519,0.366885,0,No
14710,concur,1,15.09653218,1,10.81979828,10.81979828,1,163.341433,1,1,2,1,1,2,5,0.360829,0.373487,0,No
14714,concomitant,1,15.09653218,1,10.81979828,10.81979828,1,163.341433,1,1,2,1,1,2,5,0.317299,0.320978,0,No
14720,concierge,1,15.09653218,1,10.81979828,10.81979828,1,163.341433,1,1,2,1,1,2,5,0.332161,0.339406,0,No
14743,compulsion,1,15.09653218,1,10.81979828,10.81979828,1,163.341433,0,1,1,0,1,1,5,0.360828,0.373485,0,No
14755,comprehend,1,15.09653218,1,10.81979828,10.81979828,1,163.341433,1,0,1,1,0,1,0,0,0,0,No
14763,compline,1,15.09653218,1,10.81979828,10.81979828,1,163.341433,1,1,2,1,1,2,5,0.338882,0.345659,0,No
14764,complimentary,1,15.09653218,1,10.81979828,10.81979828,1,163.341433,1,1,2,1,1,2,5,0.31901,0.322543,0,No
14765,compliment,1,15.09653218,1,10.81979828,10.81979828,1,163.341433,1,1,2,1,1,2,5,0.398076,0.415824,0,No
14766,complicity,1,15.09653218,1,10.81979828,10.81979828,1,163.341433,1,1,2,1,1,2,5,0.327334,0.331133,0,No
14767,complicate,1,15.09653218,1,10.81979828,10.81979828,1,163.341433,1,1,2,1,1,2,5,0.317913,0.321553,0,No
14777,complainant,1,15.09653218,1,10.81979828,10.81979828,1,163.341433,1,1,2,1,1,2,5,0.375309,0.391846,0,No
14790,compel,1,15.09653218,1,10.81979828,10.81979828,1,163.341433,1,1,2,1,1,2,5,0.398076,0.415824,0,No
14799,comparator,1,15.09653218,1,10.81979828,10.81979828,1,163.341433,1,1,2,1,1,2,5,0.345599,0.354479,0,No
14821,commissariat,1,15.09653218,1,10.81979828,10.81979828,1,163.341433,1,1,2,1,1,2,5,0.343985,0.352404,0,No
14827,commensurable,1,15.09653218,1,10.81979828,10.81979828,1,163.341433,1,1,2,1,1,2,5,0.320421,0.324344,0,No
14829,commendation,1,15.09653218,1,10.81979828,10.81979828,1,163.341433,1,1,2,1,1,2,5,0.343985,0.352404,0,No
14830,commend,1,15.09653218,1,10.81979828,10.81979828,1,163.341433,1,1,2,1,1,2,5,0.288925,0.296061,0,No
14833,commandeer,1,15.09653218,1,10.81979828,10.81979828,1,163.341433,0,1,1,0,1,1,5,0.326186,0.333913,0,No
14839,cometary,1,15.09653218,1,10.81979828,10.81979828,1,163.341433,1,1,2,1,1,2,5,0.310609,0.315302,0,No
14848,combatant,1,15.09653218,1,10.81979828,10.81979828,1,163.341433,1,1,2,1,1,2,5,0.360829,0.373487,0,No
14864,coloratura,1,15.09653218,1,10.81979828,10.81979828,1,163.341433,1,1,2,1,1,2,5,0.307867,0.312894,0,No
14867,colonnade,1,15.09653218,1,10.81979828,10.81979828,1,163.341433,1,1,2,1,1,2,5,0.345599,0.354479,0,No
14875,collusion,1,15.09653218,1,10.81979828,10.81979828,1,163.341433,1,1,2,1,1,2,5,0.345599,0.354479,0,No
14878,colloq,1,15.09653218,1,10.81979828,10.81979828,1,163.341433,0,1,1,0,1,1,5,0.349979,0.359707,0,No
14881,collinear,1,15.09653218,1,10.81979828,10.81979828,1,163.341433,0,1,1,0,1,1,5,0.325605,0.330106,0,No
14885,collet,1,15.09653218,1,10.81979828,10.81979828,1,163.341433,1,0,1,1,0,1,0,0,0,0,No
14893,collard,1,15.09653218,1,10.81979828,10.81979828,1,163.341433,1,0,1,1,0,1,0,0,0,0,No
14917,cohomology,1,15.09653218,1,10.81979828,10.81979828,1,163.341433,1,1,2,1,1,2,5,0.345599,0.354479,0,No
14927,cog,1,15.09653218,1,10.81979828,10.81979828,1,163.341433,1,1,2,1,1,2,5,0.340155,0.347429,0,No
14931,coffer,1,15.09653218,1,10.81979828,10.81979828,1,163.341433,1,1,2,1,1,2,5,0.321035,0.327202,0,No
14933,cofactor,1,15.09653218,1,10.81979828,10.81979828,1,163.341433,1,1,2,1,1,2,5,0.375309,0.391846,0,No
14938,coed,1,15.09653218,1,10.81979828,10.81979828,1,163.341433,0,1,1,0,1,1,5,0.355189,0.366884,0,No
14943,codeword,1,15.09653218,1,10.81979828,10.81979828,1,163.341433,0,0,0,0,0,0,0,0,0,0,No
14956,cochran,1,15.09653218,1,10.81979828,10.81979828,1,163.341433,1,0,1,1,0,1,0,0,0,0,No
14961,cobweb,1,15.09653218,1,10.81979828,10.81979828,1,163.341433,1,1,2,1,1,2,5,0.384237,0.400402,0,No
14970,coax,1,15.09653218,1,10.81979828,10.81979828,1,163.341433,1,1,2,1,1,2,5,0.325605,0.330106,0,No
14971,coauthor,1,15.09653218,1,10.81979828,10.81979828,1,163.341433,1,1,2,1,1,2,5,0.345068,0.353675,0,No
14994,clubroom,1,15.09653218,1,10.81979828,10.81979828,1,163.341433,0,1,1,0,1,1,5,0.313075,0.317426,0,No
14997,clownish,1,15.09653218,1,10.81979828,10.81979828,1,163.341433,1,1,2,1,1,2,5,0.323599,0.326828,0,No
15005,clothesline,1,15.09653218,1,10.81979828,10.81979828,1,163.341433,1,1,2,1,1,2,5,0.311274,0.315793,0,No
15023,clipboard,1,15.09653218,1,10.81979828,10.81979828,1,163.341433,1,1,2,1,1,2,5,0.345599,0.354479,0,No
15030,clinch,1,15.09653218,1,10.81979828,10.81979828,1,163.341433,1,1,2,1,1,2,5,0.326347,0.330278,0,No
15056,cleat,1,15.09653218,1,10.81979828,10.81979828,1,163.341433,0,1,1,0,1,1,5,0.375314,0.391852,0,No
15061,cleanse,1,15.09653218,1,10.81979828,10.81979828,1,163.341433,1,1,2,1,1,2,5,0.31005,0.314825,0,No
15067,claustrophobic,1,15.09653218,1,10.81979828,10.81979828,1,163.341433,0,0,0,0,0,0,0,0,0,0,No
15068,claustrophobia,1,15.09653218,1,10.81979828,10.81979828,1,163.341433,1,1,2,1,1,2,5,0.345599,0.354479,0,No
15070,clausen,1,15.09653218,1,10.81979828,10.81979828,1,163.341433,1,1,2,1,1,2,5,0.384237,0.400402,0,No
15076,classy,1,15.09653218,1,10.81979828,10.81979828,1,163.341433,1,1,2,1,1,2,5,0.29177,0.297998,0,No
15078,classmate,1,15.09653218,1,10.81979828,10.81979828,1,163.341433,1,1,2,1,1,2,6,0.241895,0.243655,0,No
15094,clapeyron,1,15.09653218,1,10.81979828,10.81979828,1,163.341433,0,1,1,0,1,1,5,0.360828,0.373485,0,No
15102,clairvoyant,1,15.09653218,1,10.81979828,10.81979828,1,163.341433,1,1,2,1,1,2,5,0.31117,0.31583,0,No
15106,cladophora,1,15.09653218,1,10.81979828,10.81979828,1,163.341433,1,0,1,1,0,1,0,0,0,0,No
15119,citizenry,1,15.09653218,1,10.81979828,10.81979828,1,163.341433,0,1,1,0,1,1,5,0.345598,0.354477,0,No
15124,cit,1,15.09653218,1,10.81979828,10.81979828,1,163.341433,1,1,2,1,1,2,5,0.323906,0.327121,0,No
15125,cistern,1,15.09653218,1,10.81979828,10.81979828,1,163.341433,1,1,2,1,1,2,5,0.398076,0.415824,0,No
15129,circumscription,1,15.09653218,1,10.81979828,10.81979828,1,163.341433,1,0,1,1,0,1,0,0,0,0,No
15137,circlet,1,15.09653218,1,10.81979828,10.81979828,1,163.341433,1,1,2,1,1,2,5,0.341779,0.349674,0,No
15145,cinerama,1,15.09653218,1,10.81979828,10.81979828,1,163.341433,1,1,2,1,1,2,5,0.324255,0.327681,0,No
15152,ciliate,1,15.09653218,1,10.81979828,10.81979828,1,163.341433,0,0,0,0,0,0,0,0,0,0,No
15158,cicada,1,15.09653218,1,10.81979828,10.81979828,1,163.341433,1,1,2,1,1,2,5,0.321035,0.327202,0,No
15164,churchmen,1,15.09653218,1,10.81979828,10.81979828,1,163.341433,1,1,2,1,1,2,5,0.331943,0.336969,0,No
15168,chunky,1,15.09653218,1,10.81979828,10.81979828,1,163.341433,1,1,2,1,1,2,5,0.327636,0.331417,0,No
15171,chum,1,15.09653218,1,10.81979828,10.81979828,1,163.341433,1,1,2,1,1,2,5,0.30881,0.313735,0,No
15172,chug,1,15.09653218,1,10.81979828,10.81979828,1,163.341433,1,1,2,1,1,2,5,0.345599,0.354479,0,No
15175,chrysolite,1,15.09653218,1,10.81979828,10.81979828,1,163.341433,1,1,2,1,1,2,5,0.345599,0.354479,0,No
15185,chromic,1,15.09653218,1,10.81979828,10.81979828,1,163.341433,1,1,2,1,1,2,5,0.318244,0.321897,0,No
15188,chromatin,1,15.09653218,1,10.81979828,10.81979828,1,163.341433,1,1,2,1,1,2,5,0.325605,0.330106,0,No
15197,christiana,1,15.09653218,1,10.81979828,10.81979828,1,163.341433,1,1,2,1,1,2,5,0.31334,0.317621,0,No
15203,chowder,1,15.09653218,1,10.81979828,10.81979828,1,163.341433,0,1,1,0,1,1,5,0.305937,0.311128,0,No
15240,chitinous,1,15.09653218,1,10.81979828,10.81979828,1,163.341433,0,1,1,0,1,1,5,0.311106,0.315647,0,No
15245,chiropractor,1,15.09653218,1,10.81979828,10.81979828,1,163.341433,1,1,2,1,1,2,5,0.338018,0.344417,0,No
15247,chipmunk,1,15.09653218,1,10.81979828,10.81979828,1,163.341433,1,1,2,1,1,2,5,0.345599,0.354479,0,No
15250,chink,1,15.09653218,1,10.81979828,10.81979828,1,163.341433,1,1,2,1,1,2,5,0.329259,0.333546,0,No
15254,chinaman,1,15.09653218,1,10.81979828,10.81979828,1,163.341433,1,1,2,1,1,2,5,0.314094,0.318199,0,No
15261,chilly,1,15.09653218,1,10.81979828,10.81979828,1,163.341433,1,1,2,1,1,2,5,0.323416,0.326858,0,No
15272,chicory,1,15.09653218,1,10.81979828,10.81979828,1,163.341433,1,1,2,1,1,2,5,0.319309,0.322651,0,No
15309,chemise,1,15.09653218,1,10.81979828,10.81979828,1,163.341433,1,0,1,1,0,1,0,0,0,0,No
15323,checkout,1,15.09653218,1,10.81979828,10.81979828,1,163.341433,1,0,1,1,0,1,0,0,0,0,No
15330,chautauqua,1,15.09653218,1,10.81979828,10.81979828,1,163.341433,1,1,2,1,1,2,5,0.308279,0.313293,0,No
15331,chauncey,1,15.09653218,1,10.81979828,10.81979828,1,163.341433,1,0,1,1,0,1,0,0,0,0,No
15332,chauffeur,1,15.09653218,1,10.81979828,10.81979828,1,163.341433,1,1,2,1,1,2,5,0.345599,0.354479,0,No
15334,chatty,1,15.09653218,1,10.81979828,10.81979828,1,163.341433,1,1,2,1,1,2,5,0.324628,0.327812,0,No
15371,chaperon,1,15.09653218,1,10.81979828,10.81979828,1,163.341433,1,1,2,1,1,2,5,0.312776,0.317135,0,No
15373,chapati,1,15.09653218,1,10.81979828,10.81979828,1,163.341433,1,1,2,1,1,2,5,0.336028,0.342206,0,No
15374,chap,1,15.09653218,1,10.81979828,10.81979828,1,163.341433,1,0,1,1,0,1,0,0,0,0,No
15378,chantry,1,15.09653218,1,10.81979828,10.81979828,1,163.341433,1,0,1,1,0,1,0,0,0,0,No
15387,chandelier,1,15.09653218,1,10.81979828,10.81979828,1,163.341433,1,0,1,1,0,1,0,0,0,0,No
15397,chamomile,1,15.09653218,1,10.81979828,10.81979828,1,163.341433,1,1,2,1,1,2,5,0.301365,0.306978,0,No
15400,chambermaid,1,15.09653218,1,10.81979828,10.81979828,1,163.341433,1,1,2,1,1,2,5,0.334225,0.341138,0,No
15405,chalky,1,15.09653218,1,10.81979828,10.81979828,1,163.341433,1,0,1,1,0,1,0,0,0,0,No
15408,chaise,1,15.09653218,1,10.81979828,10.81979828,1,163.341433,1,1,2,1,1,2,5,0.345599,0.354479,0,No
15431,certiorari,1,15.09653218,1,10.81979828,10.81979828,1,163.341433,1,1,2,1,1,2,5,0.375317,0.391855,0,No
15438,cereus,1,15.09653218,1,10.81979828,10.81979828,1,163.341433,1,1,2,1,1,2,5,0.326816,0.331594,0,No
15472,cellophane,1,15.09653218,1,10.81979828,10.81979828,1,163.341433,1,0,1,1,0,1,0,0,0,0,No
15479,celebratory,1,15.09653218,1,10.81979828,10.81979828,1,163.341433,1,1,2,1,1,2,5,0.325128,0.328385,0,No
15481,celebrant,1,15.09653218,1,10.81979828,10.81979828,1,163.341433,1,1,2,1,1,2,5,0.398076,0.415824,0,No
15483,celandine,1,15.09653218,1,10.81979828,10.81979828,1,163.341433,0,0,0,0,0,0,0,0,0,0,No
15493,cayuga,1,15.09653218,1,10.81979828,10.81979828,1,163.341433,0,0,0,0,0,0,0,0,0,0,No
15499,cavemen,1,15.09653218,1,10.81979828,10.81979828,1,163.341433,1,0,1,1,0,1,0,0,0,0,No
15504,cavalcade,1,15.09653218,1,10.81979828,10.81979828,1,163.341433,0,1,1,0,1,1,5,0.316125,0.320223,0,No
15516,cauchy,1,15.09653218,1,10.81979828,10.81979828,1,163.341433,1,1,2,1,1,2,5,0.318426,0.321966,0,No
15522,catskill,1,15.09653218,1,10.81979828,10.81979828,1,163.341433,1,0,1,1,0,1,0,0,0,0,No
15523,catnip,1,15.09653218,1,10.81979828,10.81979828,1,163.341433,1,1,2,1,1,2,5,0.35519,0.366885,0,No
15538,catbird,1,15.09653218,1,10.81979828,10.81979828,1,163.341433,0,1,1,0,1,1,5,0.320908,0.324195,0,No
15546,catalysis,1,15.09653218,1,10.81979828,10.81979828,1,163.341433,1,1,2,1,1,2,5,0.345606,0.354483,0,No
15547,catalpa,1,15.09653218,1,10.81979828,10.81979828,1,163.341433,0,1,1,0,1,1,5,0.29364,0.299778,0,No
15551,cataclysmic,1,15.09653218,1,10.81979828,10.81979828,1,163.341433,1,1,2,1,1,2,6,0.281753,0.288236,0,No
15556,castrate,1,15.09653218,1,10.81979828,10.81979828,1,163.341433,0,1,1,0,1,1,5,0.322049,0.325491,0,No
15561,castanet,1,15.09653218,1,10.81979828,10.81979828,1,163.341433,1,0,1,1,0,1,0,0,0,0,No
15564,cassiopeia,1,15.09653218,1,10.81979828,10.81979828,1,163.341433,0,1,1,0,1,1,5,0.384234,0.400398,0,No
15579,casbah,1,15.09653218,1,10.81979828,10.81979828,1,163.341433,1,1,2,1,1,2,5,0.322745,0.32609,0,No
15583,cartwheel,1,15.09653218,1,10.81979828,10.81979828,1,163.341433,1,1,2,1,1,2,5,0.319982,0.323217,0,No
15602,carrel,1,15.09653218,1,10.81979828,10.81979828,1,163.341433,1,1,2,1,1,2,5,0.325886,0.32922,0,No
15605,carpetbagger,1,15.09653218,1,10.81979828,10.81979828,1,163.341433,1,1,2,1,1,2,5,0.2955,0.301683,0,No
15620,carne,1,15.09653218,1,10.81979828,10.81979828,1,163.341433,1,1,2,1,1,2,5,0.326557,0.330056,0,No
15638,cargoes,1,15.09653218,1,10.81979828,10.81979828,1,163.341433,1,1,2,1,1,2,5,0.313113,0.318837,0,No
15655,cardamom,1,15.09653218,1,10.81979828,10.81979828,1,163.341433,1,1,2,1,1,2,5,0.331268,0.335748,0,No
15661,carboxylic,1,15.09653218,1,10.81979828,10.81979828,1,163.341433,1,1,2,1,1,2,5,0.318244,0.321897,0,No
15680,captor,1,15.09653218,1,10.81979828,10.81979828,1,163.341433,1,1,2,1,1,2,5,0.29585,0.302353,0,No
15686,capstone,1,15.09653218,1,10.81979828,10.81979828,1,163.341433,1,1,2,1,1,2,5,0.320126,0.323562,0,No
15690,capitulate,1,15.09653218,1,10.81979828,10.81979828,1,163.341433,1,1,2,1,1,2,5,0.306692,0.311822,0,No
15718,canonic,1,15.09653218,1,10.81979828,10.81979828,1,163.341433,0,0,0,0,0,0,0,0,0,0,No
15727,canker,1,15.09653218,1,10.81979828,10.81979828,1,163.341433,1,1,2,1,1,2,6,0.269003,0.274267,0,No
15764,cameroun,1,15.09653218,1,10.81979828,10.81979828,1,163.341433,0,0,0,0,0,0,0,0,0,0,No
15784,calve,1,15.09653218,1,10.81979828,10.81979828,1,163.341433,0,0,0,0,0,0,0,0,0,0,No
15785,calvary,1,15.09653218,1,10.81979828,10.81979828,1,163.341433,1,1,2,1,1,2,5,0.347133,0.356191,0,No
15789,caloric,1,15.09653218,1,10.81979828,10.81979828,1,163.341433,1,1,2,1,1,2,5,0.311508,0.316076,0,No
15791,callus,1,15.09653218,1,10.81979828,10.81979828,1,163.341433,1,1,2,1,1,2,5,0.347133,0.356191,0,No
15797,calla,1,15.09653218,1,10.81979828,10.81979828,1,163.341433,1,1,2,1,1,2,5,0.303244,0.308716,0,No
15799,calisthenic,1,15.09653218,1,10.81979828,10.81979828,1,163.341433,1,0,1,1,0,1,0,0,0,0,No
15805,calibre,1,15.09653218,1,10.81979828,10.81979828,1,163.341433,1,0,1,1,0,1,0,0,0,0,No
15811,calendrical,1,15.09653218,1,10.81979828,10.81979828,1,163.341433,1,0,1,1,0,1,0,0,0,0,No
15819,calculi,1,15.09653218,1,10.81979828,10.81979828,1,163.341433,0,0,0,0,0,0,0,0,0,0,No
15821,calculable,1,15.09653218,1,10.81979828,10.81979828,1,163.341433,1,1,2,1,1,2,5,0.320415,0.324339,0,No
15843,cadre,1,15.09653218,1,10.81979828,10.81979828,1,163.341433,1,1,2,1,1,2,5,0.398076,0.415824,0,No
15847,caddy,1,15.09653218,1,10.81979828,10.81979828,1,163.341433,1,1,2,1,1,2,5,0.32071,0.32465,0,No
15868,bystander,1,15.09653218,1,10.81979828,10.81979828,1,163.341433,0,1,1,0,1,1,5,0.333854,0.3397,0,No
15876,buzzy,1,15.09653218,1,10.81979828,10.81979828,1,163.341433,1,0,1,1,0,1,0,0,0,0,No
15877,buzzword,1,15.09653218,1,10.81979828,10.81979828,1,163.341433,1,0,1,1,0,1,0,0,0,0,No
15885,buttery,1,15.09653218,1,10.81979828,10.81979828,1,163.341433,1,1,2,1,1,2,5,0.326197,0.330223,0,No
15899,bustle,1,15.09653218,1,10.81979828,10.81979828,1,163.341433,0,0,0,0,0,0,0,0,0,0,No
15902,businesswomen,1,15.09653218,1,10.81979828,10.81979828,1,163.341433,1,0,1,1,0,1,0,0,0,0,No
15944,buret,1,15.09653218,1,10.81979828,10.81979828,1,163.341433,0,1,1,0,1,1,5,0.345598,0.354477,0,No
15955,bunt,1,15.09653218,1,10.81979828,10.81979828,1,163.341433,1,1,2,1,1,2,5,0.30972,0.314621,0,No
15968,bumble,1,15.09653218,1,10.81979828,10.81979828,1,163.341433,0,1,1,0,1,1,5,0.286161,0.292519,0,No
15969,bum,1,15.09653218,1,10.81979828,10.81979828,1,163.341433,1,1,2,1,1,2,5,0.312958,0.317326,0,No
15973,bullrush,1,15.09653218,1,10.81979828,10.81979828,1,163.341433,1,1,2,1,1,2,5,0.355198,0.36689,0,No
15993,bugging,1,15.09653218,1,10.81979828,10.81979828,1,163.341433,1,1,2,1,1,2,5,0.30958,0.31463,0,No
15995,buffoon,1,15.09653218,1,10.81979828,10.81979828,1,163.341433,1,1,2,1,1,2,5,0.345599,0.354479,0,No
16011,bucolic,1,15.09653218,1,10.81979828,10.81979828,1,163.341433,1,1,2,1,1,2,5,0.384237,0.400402,0,No
16013,buckskin,1,15.09653218,1,10.81979828,10.81979828,1,163.341433,1,1,2,1,1,2,5,0.345068,0.353675,0,No
16014,buckshot,1,15.09653218,1,10.81979828,10.81979828,1,163.341433,0,1,1,0,1,1,5,0.355189,0.366884,0,No
16015,bucknell,1,15.09653218,1,10.81979828,10.81979828,1,163.341433,0,0,0,0,0,0,0,0,0,0,No
16021,buchwald,1,15.09653218,1,10.81979828,10.81979828,1,163.341433,0,1,1,0,1,1,5,0.326552,0.330051,0,No
16029,bryophyte,1,15.09653218,1,10.81979828,10.81979828,1,163.341433,1,1,2,1,1,2,5,0.320253,0.324833,0,No
16039,brushy,1,15.09653218,1,10.81979828,10.81979828,1,163.341433,0,0,0,0,0,0,0,0,0,0,No
16044,brunhilde,1,15.09653218,1,10.81979828,10.81979828,1,163.341433,0,1,1,0,1,1,5,0.398072,0.415819,0,No
16048,brucellosis,1,15.09653218,1,10.81979828,10.81979828,1,163.341433,1,1,2,1,1,2,6,0.24093,0.242607,0,No
16053,brownian,1,15.09653218,1,10.81979828,10.81979828,1,163.341433,1,1,2,1,1,2,5,0.320386,0.323705,0,No
16054,brownell,1,15.09653218,1,10.81979828,10.81979828,1,163.341433,1,1,2,1,1,2,5,0.309386,0.314414,0,No
16072,bronco,1,15.09653218,1,10.81979828,10.81979828,1,163.341433,1,1,2,1,1,2,5,0.345599,0.354479,0,No
16078,brokerage,1,15.09653218,1,10.81979828,10.81979828,1,163.341433,1,0,1,1,0,1,0,0,0,0,No
16083,brochure,1,15.09653218,1,10.81979828,10.81979828,1,163.341433,0,1,1,0,1,1,5,0.338011,0.344412,0,No
16087,broaden,1,15.09653218,1,10.81979828,10.81979828,1,163.341433,1,1,2,1,1,2,5,0.331268,0.335748,0,No
16090,broach,1,15.09653218,1,10.81979828,10.81979828,1,163.341433,1,1,2,1,1,2,5,0.326924,0.330949,0,No
16101,bristlecone,1,15.09653218,1,10.81979828,10.81979828,1,163.341433,1,1,2,1,1,2,5,0.297611,0.303566,0,No
16104,briny,1,15.09653218,1,10.81979828,10.81979828,1,163.341433,1,1,2,1,1,2,5,0.320409,0.323865,0,No
16110,brillouin,1,15.09653218,1,10.81979828,10.81979828,1,163.341433,0,0,0,0,0,0,0,0,0,0,No
16121,briefcase,1,15.09653218,1,10.81979828,10.81979828,1,163.341433,1,1,2,1,1,2,5,0.345068,0.353675,0,No
16133,bricklayer,1,15.09653218,1,10.81979828,10.81979828,1,163.341433,1,0,1,1,0,1,0,0,0,0,No
16154,breezy,1,15.09653218,1,10.81979828,10.81979828,1,163.341433,0,0,0,0,0,0,0,0,0,0,No
16160,breathy,1,15.09653218,1,10.81979828,10.81979828,1,163.341433,1,0,1,1,0,1,0,0,0,0,No
16161,breathtaking,1,15.09653218,1,10.81979828,10.81979828,1,163.341433,1,1,2,1,1,2,5,0.320687,0.323893,0,No
16164,breastplate,1,15.09653218,1,10.81979828,10.81979828,1,163.341433,1,1,2,1,1,2,5,0.325128,0.32874,0,No
16166,bream,1,15.09653218,1,10.81979828,10.81979828,1,163.341433,1,0,1,1,0,1,0,0,0,0,No
16167,breakwater,1,15.09653218,1,10.81979828,10.81979828,1,163.341433,1,1,2,1,1,2,5,0.326816,0.331594,0,No
16171,breakneck,1,15.09653218,1,10.81979828,10.81979828,1,163.341433,1,1,2,1,1,2,5,0.314183,0.318427,0,No
16184,brazen,1,15.09653218,1,10.81979828,10.81979828,1,163.341433,0,0,0,0,0,0,0,0,0,0,No
16193,brasilia,1,15.09653218,1,10.81979828,10.81979828,1,163.341433,0,1,1,0,1,1,5,0.360828,0.373485,0,No
16194,brash,1,15.09653218,1,10.81979828,10.81979828,1,163.341433,1,1,2,1,1,2,5,0.34998,0.359708,0,No
16195,brant,1,15.09653218,1,10.81979828,10.81979828,1,163.341433,1,1,2,1,1,2,5,0.326485,0.329725,0,No
16207,brainwash,1,15.09653218,1,10.81979828,10.81979828,1,163.341433,1,1,2,1,1,2,5,0.398076,0.415824,0,No
16208,brainstorm,1,15.09653218,1,10.81979828,10.81979828,1,163.341433,1,1,2,1,1,2,5,0.375317,0.391855,0,No
16209,brainchild,1,15.09653218,1,10.81979828,10.81979828,1,163.341433,1,1,2,1,1,2,5,0.378607,0.394397,0,No
16216,bragging,1,15.09653218,1,10.81979828,10.81979828,1,163.341433,0,0,0,0,0,0,0,0,0,0,No
16228,bracken,1,15.09653218,1,10.81979828,10.81979828,1,163.341433,0,0,0,0,0,0,0,0,0,0,No
16232,boylston,1,15.09653218,1,10.81979828,10.81979828,1,163.341433,0,1,1,0,1,1,5,0.320705,0.324646,0,No
16234,boyish,1,15.09653218,1,10.81979828,10.81979828,1,163.341433,1,1,2,1,1,2,5,0.360829,0.373487,0,No
16238,boyar,1,15.09653218,1,10.81979828,10.81979828,1,163.341433,1,0,1,1,0,1,0,0,0,0,No
16240,boxcar,1,15.09653218,1,10.81979828,10.81979828,1,163.341433,1,0,1,1,0,1,0,0,0,0,No
16242,bowmen,1,15.09653218,1,10.81979828,10.81979828,1,163.341433,0,0,0,0,0,0,0,0,0,0,No
16246,bowfin,1,15.09653218,1,10.81979828,10.81979828,1,163.341433,0,0,0,0,0,0,0,0,0,0,No
16254,bourn,1,15.09653218,1,10.81979828,10.81979828,1,163.341433,0,0,0,0,0,0,0,0,0,0,No
16263,bouncy,1,15.09653218,1,10.81979828,10.81979828,1,163.341433,1,1,2,1,1,2,5,0.321082,0.324371,0,No
16269,bough,1,15.09653218,1,10.81979828,10.81979828,1,163.341433,1,1,2,1,1,2,5,0.378607,0.394397,0,No
16273,bottleneck,1,15.09653218,1,10.81979828,10.81979828,1,163.341433,0,0,0,0,0,0,0,0,0,0,No
16277,botfly,1,15.09653218,1,10.81979828,10.81979828,1,163.341433,1,1,2,1,1,2,5,0.315798,0.319692,0,No
16287,bosom,1,15.09653218,1,10.81979828,10.81979828,1,163.341433,1,1,2,1,1,2,5,0.331739,0.337353,0,No
16298,boric,1,15.09653218,1,10.81979828,10.81979828,1,163.341433,0,1,1,0,1,1,5,0.318239,0.321893,0,No
16301,boreas,1,15.09653218,1,10.81979828,10.81979828,1,163.341433,0,1,1,0,1,1,5,0.336021,0.342018,0,No
16311,borax,1,15.09653218,1,10.81979828,10.81979828,1,163.341433,1,1,2,1,1,2,5,0.280719,0.28691,0,No
16315,bootlegging,1,15.09653218,1,10.81979828,10.81979828,1,163.341433,0,1,1,0,1,1,5,0.328412,0.333573,0,No
16325,booky,1,15.09653218,1,10.81979828,10.81979828,1,163.341433,1,0,1,1,0,1,0,0,0,0,No
16328,bookshelves,1,15.09653218,1,10.81979828,10.81979828,1,163.341433,1,1,2,1,1,2,5,0.33386,0.339705,0,No
16332,bookend,1,15.09653218,1,10.81979828,10.81979828,1,163.341433,1,1,2,1,1,2,5,0.323221,0.326578,0,No
16351,bonaventure,1,15.09653218,1,10.81979828,10.81979828,1,163.341433,1,1,2,1,1,2,5,0.313168,0.317493,0,No
16358,bombard,1,15.09653218,1,10.81979828,10.81979828,1,163.341433,1,0,1,1,0,1,0,0,0,0,No
16360,boltzmann,1,15.09653218,1,10.81979828,10.81979828,1,163.341433,1,0,1,1,0,1,0,0,0,0,No
16365,bolometer,1,15.09653218,1,10.81979828,10.81979828,1,163.341433,0,1,1,0,1,1,6,0.261563,0.265812,0,No
16369,boletus,1,15.09653218,1,10.81979828,10.81979828,1,163.341433,0,1,1,0,1,1,5,0.291695,0.297996,0,No
16381,boggy,1,15.09653218,1,10.81979828,10.81979828,1,163.341433,0,1,1,0,1,1,5,0.304478,0.309815,0,No
16382,bogeyman,1,15.09653218,1,10.81979828,10.81979828,1,163.341433,1,1,2,1,1,2,5,0.398067,0.415814,0,No
16391,bodice,1,15.09653218,1,10.81979828,10.81979828,1,163.341433,0,1,1,0,1,1,5,0.321344,0.325025,0,No
16396,bobolink,1,15.09653218,1,10.81979828,10.81979828,1,163.341433,1,1,2,1,1,2,5,0.384237,0.400402,0,No
16399,bobble,1,15.09653218,1,10.81979828,10.81979828,1,163.341433,1,1,2,1,1,2,5,0.316513,0.320432,0,No
16403,boathouse,1,15.09653218,1,10.81979828,10.81979828,1,163.341433,1,1,2,1,1,2,5,0.338011,0.344413,0,No
16405,boastful,1,15.09653218,1,10.81979828,10.81979828,1,163.341433,1,1,2,1,1,2,5,0.375317,0.391855,0,No
16406,boast,1,15.09653218,1,10.81979828,10.81979828,1,163.341433,1,0,1,1,0,1,0,0,0,0,No
16407,boardinghouse,1,15.09653218,1,10.81979828,10.81979828,1,163.341433,1,1,2,1,1,2,5,0.378607,0.394397,0,No
16413,blvd,1,15.09653218,1,10.81979828,10.81979828,1,163.341433,0,0,0,0,0,0,0,0,0,0,No
16414,blutwurst,1,15.09653218,1,10.81979828,10.81979828,1,163.341433,1,1,2,1,1,2,5,0.345599,0.354479,0,No
16415,blush,1,15.09653218,1,10.81979828,10.81979828,1,163.341433,0,0,0,0,0,0,0,0,0,0,No
16419,blunder,1,15.09653218,1,10.81979828,10.81979828,1,163.341433,1,0,1,1,0,1,0,0,0,0,No
16443,bloodstone,1,15.09653218,1,10.81979828,10.81979828,1,163.341433,1,0,1,1,0,1,0,0,0,0,No
16446,bloodletting,1,15.09653218,1,10.81979828,10.81979828,1,163.341433,0,0,0,0,0,0,0,0,0,0,No
16451,blomberg,1,15.09653218,1,10.81979828,10.81979828,1,163.341433,1,1,2,1,1,2,5,0.325479,0.328869,0,No
16452,bloke,1,15.09653218,1,10.81979828,10.81979828,1,163.341433,0,1,1,0,1,1,5,0.341779,0.349673,0,No
16460,bloat,1,15.09653218,1,10.81979828,10.81979828,1,163.341433,1,1,2,1,1,2,5,0.301647,0.307249,0,No
16468,blindfold,1,15.09653218,1,10.81979828,10.81979828,1,163.341433,1,1,2,1,1,2,5,0.320577,0.323851,0,No
16477,bled,1,15.09653218,1,10.81979828,10.81979828,1,163.341433,0,1,1,0,1,1,5,0.35917,0.371521,0,No
16482,blatant,1,15.09653218,1,10.81979828,10.81979828,1,163.341433,0,0,0,0,0,0,0,0,0,0,No
16483,blastula,1,15.09653218,1,10.81979828,10.81979828,1,163.341433,1,1,2,1,1,2,5,0.375317,0.391855,0,No
16487,blaspheme,1,15.09653218,1,10.81979828,10.81979828,1,163.341433,1,1,2,1,1,2,5,0.384237,0.400402,0,No
16493,blanch,1,15.09653218,1,10.81979828,10.81979828,1,163.341433,1,1,2,1,1,2,5,0.326816,0.331594,0,No
16508,blackguard,1,15.09653218,1,10.81979828,10.81979828,1,163.341433,1,1,2,1,1,2,6,0.279099,0.285104,0,No
16511,blackbody,1,15.09653218,1,10.81979828,10.81979828,1,163.341433,1,0,1,1,0,1,0,0,0,0,No
16522,bituminous,1,15.09653218,1,10.81979828,10.81979828,1,163.341433,1,0,1,1,0,1,0,0,0,0,No
16530,bisque,1,15.09653218,1,10.81979828,10.81979828,1,163.341433,0,1,1,0,1,1,5,0.355189,0.366884,0,No
16533,bismark,1,15.09653218,1,10.81979828,10.81979828,1,163.341433,1,1,2,1,1,2,5,0.345599,0.354479,0,No
16540,birthrate,1,15.09653218,1,10.81979828,10.81979828,1,163.341433,1,0,1,1,0,1,0,0,0,0,No
16565,binaural,1,15.09653218,1,10.81979828,10.81979828,1,163.341433,1,1,2,1,1,2,5,0.308134,0.313131,0,No
16568,bimonthly,1,15.09653218,1,10.81979828,10.81979828,1,163.341433,1,1,2,1,1,2,5,0.321693,0.324979,0,No
16569,bimetallic,1,15.09653218,1,10.81979828,10.81979828,1,163.341433,1,1,2,1,1,2,5,0.31936,0.322689,0,No
16575,billet,1,15.09653218,1,10.81979828,10.81979828,1,163.341433,0,0,0,0,0,0,0,0,0,0,No
16586,bigotry,1,15.09653218,1,10.81979828,10.81979828,1,163.341433,1,1,2,1,1,2,5,0.329253,0.333542,0,No
16589,biggs,1,15.09653218,1,10.81979828,10.81979828,1,163.341433,1,0,1,1,0,1,0,0,0,0,No
16594,bien,1,15.09653218,1,10.81979828,10.81979828,1,163.341433,0,0,0,0,0,0,0,0,0,0,No
16595,bidirectional,1,15.09653218,1,10.81979828,10.81979828,1,163.341433,1,1,2,1,1,2,5,0.321041,0.324372,0,No
16596,bide,1,15.09653218,1,10.81979828,10.81979828,1,163.341433,1,1,2,1,1,2,5,0.345075,0.35368,0,No
16597,biddy,1,15.09653218,1,10.81979828,10.81979828,1,163.341433,0,1,1,0,1,1,5,0.290284,0.296524,0,No
16610,bialystok,1,15.09653218,1,10.81979828,10.81979828,1,163.341433,1,0,1,1,0,1,0,0,0,0,No
16612,bhagavadgita,1,15.09653218,1,10.81979828,10.81979828,1,163.341433,1,1,2,1,1,2,5,0.375317,0.391855,0,No
16622,betrothal,1,15.09653218,1,10.81979828,10.81979828,1,163.341433,1,1,2,1,1,2,5,0.336021,0.342018,0,No
16635,bestial,1,15.09653218,1,10.81979828,10.81979828,1,163.341433,1,0,1,1,0,1,0,0,0,0,No
16656,berra,1,15.09653218,1,10.81979828,10.81979828,1,163.341433,1,1,2,1,1,2,5,0.375317,0.391855,0,No
16661,bernice,1,15.09653218,1,10.81979828,10.81979828,1,163.341433,0,1,1,0,1,1,5,0.316542,0.320342,0,No
16673,berkowitz,1,15.09653218,1,10.81979828,10.81979828,1,163.341433,1,1,2,1,1,2,5,0.323929,0.327182,0,No
16705,beneficiary,1,15.09653218,1,10.81979828,10.81979828,1,163.341433,1,1,2,1,1,2,5,0.375317,0.391855,0,No
16707,benefice,1,15.09653218,1,10.81979828,10.81979828,1,163.341433,1,1,2,1,1,2,5,0.34998,0.359708,0,No
16710,benediction,1,15.09653218,1,10.81979828,10.81979828,1,163.341433,1,1,2,1,1,2,5,0.333854,0.3397,0,No
16719,bemoan,1,15.09653218,1,10.81979828,10.81979828,1,163.341433,1,1,2,1,1,2,5,0.398076,0.415824,0,No
16720,bema,1,15.09653218,1,10.81979828,10.81979828,1,163.341433,1,1,2,1,1,2,5,0.359172,0.371523,0,No
16730,bellum,1,15.09653218,1,10.81979828,10.81979828,1,163.341433,0,0,0,0,0,0,0,0,0,0,No
16731,bellow,1,15.09653218,1,10.81979828,10.81979828,1,163.341433,1,1,2,1,1,2,5,0.328753,0.332977,0,No
16732,bellman,1,15.09653218,1,10.81979828,10.81979828,1,163.341433,1,1,2,1,1,2,5,0.35519,0.366885,0,No
16735,belligerent,1,15.09653218,1,10.81979828,10.81979828,1,163.341433,1,1,2,1,1,2,5,0.323445,0.326642,0,No
16736,bellhop,1,15.09653218,1,10.81979828,10.81979828,1,163.341433,0,1,1,0,1,1,5,0.286563,0.293037,0,No
16737,bellflower,1,15.09653218,1,10.81979828,10.81979828,1,163.341433,1,1,2,1,1,2,5,0.324581,0.327869,0,No
16766,begot,1,15.09653218,1,10.81979828,10.81979828,1,163.341433,1,1,2,1,1,2,5,0.378607,0.394397,0,No
16767,begonia,1,15.09653218,1,10.81979828,10.81979828,1,163.341433,0,1,1,0,1,1,5,0.325689,0.32903,0,No
16773,beget,1,15.09653218,1,10.81979828,10.81979828,1,163.341433,1,1,2,1,1,2,5,0.323994,0.327549,0,No
16776,befriend,1,15.09653218,1,10.81979828,10.81979828,1,163.341433,0,1,1,0,1,1,5,0.304025,0.30942,0,No
16779,befit,1,15.09653218,1,10.81979828,10.81979828,1,163.341433,1,1,2,1,1,2,5,0.375317,0.391855,0,No
16785,beep,1,15.09653218,1,10.81979828,10.81979828,1,163.341433,1,1,2,1,1,2,5,0.331268,0.335748,0,No
16795,bedstraw,1,15.09653218,1,10.81979828,10.81979828,1,163.341433,0,1,1,0,1,1,5,0.355189,0.366884,0,No
16796,bedspread,1,15.09653218,1,10.81979828,10.81979828,1,163.341433,1,1,2,1,1,2,5,0.384237,0.400402,0,No
16812,beaux,1,15.09653218,1,10.81979828,10.81979828,1,163.341433,1,0,1,1,0,1,0,0,0,0,No
16814,beautify,1,15.09653218,1,10.81979828,10.81979828,1,163.341433,1,1,2,1,1,2,5,0.331268,0.335748,0,No
16820,beatnik,1,15.09653218,1,10.81979828,10.81979828,1,163.341433,1,0,1,1,0,1,0,0,0,0,No
16833,beady,1,15.09653218,1,10.81979828,10.81979828,1,163.341433,0,1,1,0,1,1,5,0.321199,0.324427,0,No
16837,beachhead,1,15.09653218,1,10.81979828,10.81979828,1,163.341433,1,1,2,1,1,2,5,0.321227,0.324501,0,No
16846,bayberry,1,15.09653218,1,10.81979828,10.81979828,1,163.341433,0,1,1,0,1,1,5,0.325689,0.32903,0,No
16849,bawdy,1,15.09653218,1,10.81979828,10.81979828,1,163.341433,1,1,2,1,1,2,5,0.32511,0.328363,0,No
16855,bauble,1,15.09653218,1,10.81979828,10.81979828,1,163.341433,1,1,2,1,1,2,5,0.35519,0.366885,0,No
16860,batten,1,15.09653218,1,10.81979828,10.81979828,1,163.341433,1,1,2,1,1,2,5,0.324296,0.327581,0,No
16861,battelle,1,15.09653218,1,10.81979828,10.81979828,1,163.341433,1,1,2,1,1,2,5,0.313445,0.317871,0,No
16863,batt,1,15.09653218,1,10.81979828,10.81979828,1,163.341433,1,1,2,1,1,2,5,0.384237,0.400402,0,No
16869,bathrobe,1,15.09653218,1,10.81979828,10.81979828,1,163.341433,0,0,0,0,0,0,0,0,0,0,No
16872,bateau,1,15.09653218,1,10.81979828,10.81979828,1,163.341433,0,0,0,0,0,0,0,0,0,0,No
16903,bartok,1,15.09653218,1,10.81979828,10.81979828,1,163.341433,1,1,2,1,1,2,5,0.291258,0.297728,0,No
16909,barstow,1,15.09653218,1,10.81979828,10.81979828,1,163.341433,1,0,1,1,0,1,0,0,0,0,No
16920,barracuda,1,15.09653218,1,10.81979828,10.81979828,1,163.341433,1,1,2,1,1,2,5,0.345599,0.354479,0,No
16929,barnyard,1,15.09653218,1,10.81979828,10.81979828,1,163.341433,0,1,1,0,1,1,5,0.282518,0.288717,0,No
16936,barnacle,1,15.09653218,1,10.81979828,10.81979828,1,163.341433,1,1,2,1,1,2,5,0.345599,0.354479,0,No
16951,barbiturate,1,15.09653218,1,10.81979828,10.81979828,1,163.341433,1,0,1,1,0,1,0,0,0,0,No
16952,barberry,1,15.09653218,1,10.81979828,10.81979828,1,163.341433,1,1,2,1,1,2,5,0.345599,0.354479,0,No
16954,barbell,1,15.09653218,1,10.81979828,10.81979828,1,163.341433,1,1,2,1,1,2,5,0.341779,0.349674,0,No
16962,baptistery,1,15.09653218,1,10.81979828,10.81979828,1,163.341433,1,1,2,1,1,2,5,0.378607,0.394397,0,No
16971,bannock,1,15.09653218,1,10.81979828,10.81979828,1,163.341433,1,1,2,1,1,2,5,0.318535,0.322096,0,No
16984,bandwagon,1,15.09653218,1,10.81979828,10.81979828,1,163.341433,1,1,2,1,1,2,5,0.326053,0.329688,0,No
16997,balzac,1,15.09653218,1,10.81979828,10.81979828,1,163.341433,1,0,1,1,0,1,0,0,0,0,No
16998,balustrade,1,15.09653218,1,10.81979828,10.81979828,1,163.341433,1,1,2,1,1,2,5,0.326353,0.32986,0,No
17014,balk,1,15.09653218,1,10.81979828,10.81979828,1,163.341433,0,0,0,0,0,0,0,0,0,0,No
17018,baleful,1,15.09653218,1,10.81979828,10.81979828,1,163.341433,1,1,2,1,1,2,5,0.306612,0.311694,0,No
17021,baldy,1,15.09653218,1,10.81979828,10.81979828,1,163.341433,1,0,1,1,0,1,0,0,0,0,No
17029,bakhtiari,1,15.09653218,1,10.81979828,10.81979828,1,163.341433,1,0,1,1,0,1,0,0,0,0,No
17041,bah,1,15.09653218,1,10.81979828,10.81979828,1,163.341433,0,1,1,0,1,1,5,0.384234,0.400398,0,No
17047,bagatelle,1,15.09653218,1,10.81979828,10.81979828,1,163.341433,1,1,2,1,1,2,5,0.360829,0.373487,0,No
17059,backwater,1,15.09653218,1,10.81979828,10.81979828,1,163.341433,1,1,2,1,1,2,5,0.398076,0.415824,0,No
17065,backslide,1,15.09653218,1,10.81979828,10.81979828,1,163.341433,1,1,2,1,1,2,5,0.345599,0.354479,0,No
17074,backboard,1,15.09653218,1,10.81979828,10.81979828,1,163.341433,1,1,2,1,1,2,5,0.333854,0.3397,0,No
17077,bacilli,1,15.09653218,1,10.81979828,10.81979828,1,163.341433,0,1,1,0,1,1,5,0.340155,0.347428,0,No
17082,babysitting,1,15.09653218,1,10.81979828,10.81979828,1,163.341433,1,1,2,1,1,2,5,0.345606,0.354483,0,No
17083,babysat,1,15.09653218,1,10.81979828,10.81979828,1,163.341433,1,1,2,1,1,2,5,0.347133,0.356191,0,No
17086,baboon,1,15.09653218,1,10.81979828,10.81979828,1,163.341433,1,1,2,1,1,2,5,0.320902,0.324877,0,No
17094,azimuthal,1,15.09653218,1,10.81979828,10.81979828,1,163.341433,1,1,2,1,1,2,5,0.31376,0.317979,0,No
17095,azimuth,1,15.09653218,1,10.81979828,10.81979828,1,163.341433,1,1,2,1,1,2,5,0.318592,0.322049,0,No
17101,aye,1,15.09653218,1,10.81979828,10.81979828,1,163.341433,0,1,1,0,1,1,5,0.322541,0.326808,0,No
17106,axiomatic,1,15.09653218,1,10.81979828,10.81979828,1,163.341433,1,0,1,1,0,1,0,0,0,0,No
17108,axiology,1,15.09653218,1,10.81979828,10.81979828,1,163.341433,1,1,2,1,1,2,5,0.32681,0.33159,0,No
17111,ax,1,15.09653218,1,10.81979828,10.81979828,1,163.341433,1,1,2,1,1,2,5,0.345599,0.354479,0,No
17112,awry,1,15.09653218,1,10.81979828,10.81979828,1,163.341433,1,0,1,1,0,1,0,0,0,0,No
17114,awn,1,15.09653218,1,10.81979828,10.81979828,1,163.341433,0,1,1,0,1,1,5,0.307591,0.312631,0,No
17115,awl,1,15.09653218,1,10.81979828,10.81979828,1,163.341433,0,1,1,0,1,1,5,0.324309,0.329351,0,No
17121,awash,1,15.09653218,1,10.81979828,10.81979828,1,163.341433,1,1,2,1,1,2,5,0.321897,0.32525,0,No
17126,await,1,15.09653218,1,10.81979828,10.81979828,1,163.341433,1,1,2,1,1,2,5,0.324077,0.327367,0,No
17139,avert,1,15.09653218,1,10.81979828,10.81979828,1,163.341433,1,0,1,1,0,1,0,0,0,0,No
17140,aversion,1,15.09653218,1,10.81979828,10.81979828,1,163.341433,1,1,2,1,1,2,5,0.359172,0.371523,0,No
17142,aver,1,15.09653218,1,10.81979828,10.81979828,1,163.341433,1,0,1,1,0,1,0,0,0,0,No
17158,automorphism,1,15.09653218,1,10.81979828,10.81979828,1,163.341433,1,1,2,1,1,2,5,0.345599,0.354479,0,No
17166,autocrat,1,15.09653218,1,10.81979828,10.81979828,1,163.341433,1,1,2,1,1,2,5,0.328619,0.333504,0,No
17184,austere,1,15.09653218,1,10.81979828,10.81979828,1,163.341433,1,1,2,1,1,2,5,0.317583,0.321309,0,No
17192,aural,1,15.09653218,1,10.81979828,10.81979828,1,163.341433,1,1,2,1,1,2,5,0.31308,0.31743,0,No
17201,augmentation,1,15.09653218,1,10.81979828,10.81979828,1,163.341433,1,1,2,1,1,2,5,0.35519,0.366885,0,No
17203,augean,1,15.09653218,1,10.81979828,10.81979828,1,163.341433,1,0,1,1,0,1,0,0,0,0,No
17222,atwood,1,15.09653218,1,10.81979828,10.81979828,1,163.341433,1,0,1,1,0,1,0,0,0,0,No
17233,attentive,1,15.09653218,1,10.81979828,10.81979828,1,163.341433,1,0,1,1,0,1,0,0,0,0,No
17238,attainder,1,15.09653218,1,10.81979828,10.81979828,1,163.341433,1,1,2,1,1,2,5,0.296899,0.302951,0,No
17268,atchison,1,15.09653218,1,10.81979828,10.81979828,1,163.341433,1,1,2,1,1,2,5,0.302804,0.308438,0,No
17272,asymptotic,1,15.09653218,1,10.81979828,10.81979828,1,163.341433,0,1,1,0,1,1,5,0.384234,0.400398,0,No
17273,asymptote,1,15.09653218,1,10.81979828,10.81979828,1,163.341433,1,1,2,1,1,2,5,0.33386,0.339705,0,No
17286,astringent,1,15.09653218,1,10.81979828,10.81979828,1,163.341433,0,0,0,0,0,0,0,0,0,0,No
17294,aster,1,15.09653218,1,10.81979828,10.81979828,1,163.341433,1,1,2,1,1,2,5,0.301975,0.307538,0,No
17310,assert,1,15.09653218,1,10.81979828,10.81979828,1,163.341433,0,0,0,0,0,0,0,0,0,0,No
17319,assai,1,15.09653218,1,10.81979828,10.81979828,1,163.341433,1,1,2,1,1,2,5,0.315714,0.319659,0,No
17322,aspire,1,15.09653218,1,10.81979828,10.81979828,1,163.341433,1,1,2,1,1,2,5,0.359172,0.371523,0,No
17335,ashman,1,15.09653218,1,10.81979828,10.81979828,1,163.341433,1,1,2,1,1,2,5,0.384237,0.400402,0,No
17341,aseptic,1,15.09653218,1,10.81979828,10.81979828,1,163.341433,1,1,2,1,1,2,5,0.288133,0.294392,0,No
17342,ascomycetes,1,15.09653218,1,10.81979828,10.81979828,1,163.341433,1,1,2,1,1,2,5,0.398076,0.415824,0,No
17347,ascendant,1,15.09653218,1,10.81979828,10.81979828,1,163.341433,1,1,2,1,1,2,5,0.35519,0.366885,0,No
17361,articulatory,1,15.09653218,1,10.81979828,10.81979828,1,163.341433,0,0,0,0,0,0,0,0,0,0,No
17362,articulate,1,15.09653218,1,10.81979828,10.81979828,1,163.341433,1,0,1,1,0,1,0,0,0,0,No
17368,artful,1,15.09653218,1,10.81979828,10.81979828,1,163.341433,1,1,2,1,1,2,6,0.258697,0.262403,0,No
17376,arsenate,1,15.09653218,1,10.81979828,10.81979828,1,163.341433,1,1,2,1,1,2,5,0.345068,0.353675,0,No
17389,arpa,1,15.09653218,1,10.81979828,10.81979828,1,163.341433,0,0,0,0,0,0,0,0,0,0,No
17401,armoire,1,15.09653218,1,10.81979828,10.81979828,1,163.341433,1,1,2,1,1,2,6,0.276858,0.282856,0,No
17403,armful,1,15.09653218,1,10.81979828,10.81979828,1,163.341433,1,1,2,1,1,2,5,0.378607,0.394397,0,No
17405,armchair,1,15.09653218,1,10.81979828,10.81979828,1,163.341433,1,1,2,1,1,2,5,0.345068,0.353675,0,No
17406,armature,1,15.09653218,1,10.81979828,10.81979828,1,163.341433,0,1,1,0,1,1,5,0.355189,0.366884,0,No
17422,arisen,1,15.09653218,1,10.81979828,10.81979828,1,163.341433,1,1,2,1,1,2,5,0.343985,0.352404,0,No
17431,argumentation,1,15.09653218,1,10.81979828,10.81979828,1,163.341433,1,1,2,1,1,2,5,0.345599,0.354479,0,No
17435,argonne,1,15.09653218,1,10.81979828,10.81979828,1,163.341433,1,1,2,1,1,2,5,0.384229,0.400392,0,No
17447,arduous,1,15.09653218,1,10.81979828,10.81979828,1,163.341433,1,1,2,1,1,2,5,0.317691,0.32128,0,No
17476,arbitrage,1,15.09653218,1,10.81979828,10.81979828,1,163.341433,1,0,1,1,0,1,0,0,0,0,No
17477,arbiter,1,15.09653218,1,10.81979828,10.81979828,1,163.341433,1,1,2,1,1,2,5,0.316344,0.32029,0,No
17480,araby,1,15.09653218,1,10.81979828,10.81979828,1,163.341433,0,0,0,0,0,0,0,0,0,0,No
17496,apse,1,15.09653218,1,10.81979828,10.81979828,1,163.341433,1,1,2,1,1,2,5,0.336021,0.342018,0,No
17501,approximant,1,15.09653218,1,10.81979828,10.81979828,1,163.341433,0,1,1,0,1,1,5,0.398072,0.415819,0,No
17508,appreciable,1,15.09653218,1,10.81979828,10.81979828,1,163.341433,1,0,1,1,0,1,0,0,0,0,No
17523,appendices,1,15.09653218,1,10.81979828,10.81979828,1,163.341433,1,1,2,1,1,2,5,0.384237,0.400402,0,No
17525,append,1,15.09653218,1,10.81979828,10.81979828,1,163.341433,1,1,2,1,1,2,5,0.375317,0.391855,0,No
17538,apotheosis,1,15.09653218,1,10.81979828,10.81979828,1,163.341433,1,1,2,1,1,2,5,0.378607,0.394397,0,No
17547,apologia,1,15.09653218,1,10.81979828,10.81979828,1,163.341433,1,1,2,1,1,2,5,0.322534,0.328145,0,No
17555,apiary,1,15.09653218,1,10.81979828,10.81979828,1,163.341433,1,1,2,1,1,2,5,0.398076,0.415824,0,No
17560,aphasia,1,15.09653218,1,10.81979828,10.81979828,1,163.341433,1,1,2,1,1,2,5,0.317566,0.32123,0,No
17566,apathetic,1,15.09653218,1,10.81979828,10.81979828,1,163.341433,1,0,1,1,0,1,0,0,0,0,No
17574,anyplace,1,15.09653218,1,10.81979828,10.81979828,1,163.341433,1,1,2,1,1,2,5,0.319855,0.323314,0,No
17595,antipodal,1,15.09653218,1,10.81979828,10.81979828,1,163.341433,1,1,2,1,1,2,5,0.315215,0.319162,0,No
17596,antipasto,1,15.09653218,1,10.81979828,10.81979828,1,163.341433,0,0,0,0,0,0,0,0,0,0,No
17600,antigorite,1,15.09653218,1,10.81979828,10.81979828,1,163.341433,0,1,1,0,1,1,6,0.284779,0.291208,0,No
17604,anticonvulsant,1,15.09653218,1,10.81979828,10.81979828,1,163.341433,0,0,0,0,0,0,0,0,0,0,No
17605,anticipate,1,15.09653218,1,10.81979828,10.81979828,1,163.341433,1,1,2,1,1,2,5,0.384237,0.400402,0,No
17611,anthropoid,1,15.09653218,1,10.81979828,10.81979828,1,163.341433,1,0,1,1,0,1,0,0,0,0,No
17629,antacid,1,15.09653218,1,10.81979828,10.81979828,1,163.341433,1,1,2,1,1,2,5,0.32946,0.333471,0,No
17632,ansi,1,15.09653218,1,10.81979828,10.81979828,1,163.341433,0,1,1,0,1,1,5,0.29259,0.298785,0,No
17636,anorthosite,1,15.09653218,1,10.81979828,10.81979828,1,163.341433,1,1,2,1,1,2,5,0.294593,0.300646,0,No
17643,anomalous,1,15.09653218,1,10.81979828,10.81979828,1,163.341433,1,0,1,1,0,1,0,0,0,0,No
17644,anodic,1,15.09653218,1,10.81979828,10.81979828,1,163.341433,0,1,1,0,1,1,6,0.278664,0.284709,0,No
17647,annulling,1,15.09653218,1,10.81979828,10.81979828,1,163.341433,0,1,1,0,1,1,5,0.398072,0.415819,0,No
17649,annuli,1,15.09653218,1,10.81979828,10.81979828,1,163.341433,0,1,1,0,1,1,5,0.29697,0.302996,0,No
17652,annuity,1,15.09653218,1,10.81979828,10.81979828,1,163.341433,1,1,2,1,1,2,5,0.345599,0.354479,0,No
17666,annal,1,15.09653218,1,10.81979828,10.81979828,1,163.341433,1,1,2,1,1,2,5,0.343985,0.352404,0,No
17731,anatomic,1,15.09653218,1,10.81979828,10.81979828,1,163.341433,1,1,2,1,1,2,5,0.308992,0.313934,0,No
17744,analects,1,15.09653218,1,10.81979828,10.81979828,1,163.341433,1,1,2,1,1,2,5,0.336021,0.342018,0,No
17764,ampersand,1,15.09653218,1,10.81979828,10.81979828,1,163.341433,1,1,2,1,1,2,5,0.35519,0.366885,0,No
17766,amperage,1,15.09653218,1,10.81979828,10.81979828,1,163.341433,1,0,1,1,0,1,0,0,0,0,No
17774,amok,1,15.09653218,1,10.81979828,10.81979828,1,163.341433,0,0,0,0,0,0,0,0,0,0,No
17778,amoco,1,15.09653218,1,10.81979828,10.81979828,1,163.341433,1,0,1,1,0,1,0,0,0,0,No
17780,amniocentesis,1,15.09653218,1,10.81979828,10.81979828,1,163.341433,1,1,2,1,1,2,5,0.328412,0.333573,0,No
17791,amiss,1,15.09653218,1,10.81979828,10.81979828,1,163.341433,1,0,1,1,0,1,0,0,0,0,No
17794,amide,1,15.09653218,1,10.81979828,10.81979828,1,163.341433,1,1,2,1,1,2,5,0.320207,0.323466,0,No
17810,amble,1,15.09653218,1,10.81979828,10.81979828,1,163.341433,0,0,0,0,0,0,0,0,0,0,No
17834,alumina,1,15.09653218,1,10.81979828,10.81979828,1,163.341433,0,1,1,0,1,1,5,0.384234,0.400398,0,No
17836,altruist,1,15.09653218,1,10.81979828,10.81979828,1,163.341433,1,1,2,1,1,2,5,0.271626,0.277124,0,No
17862,aloof,1,15.09653218,1,10.81979828,10.81979828,1,163.341433,1,1,2,1,1,2,5,0.384237,0.400402,0,No
17867,aloft,1,15.09653218,1,10.81979828,10.81979828,1,163.341433,1,1,2,1,1,2,5,0.398076,0.415824,0,No
17874,almaden,1,15.09653218,1,10.81979828,10.81979828,1,163.341433,1,0,1,1,0,1,0,0,0,0,No
17876,allyl,1,15.09653218,1,10.81979828,10.81979828,1,163.341433,1,0,1,1,0,1,0,0,0,0,No
17880,allusive,1,15.09653218,1,10.81979828,10.81979828,1,163.341433,1,1,2,1,1,2,5,0.331268,0.335748,0,No
17894,alleviate,1,15.09653218,1,10.81979828,10.81979828,1,163.341433,1,1,2,1,1,2,5,0.334225,0.341138,0,No
17913,alimony,1,15.09653218,1,10.81979828,10.81979828,1,163.341433,1,1,2,1,1,2,5,0.375325,0.39186,0,No
17917,alight,1,15.09653218,1,10.81979828,10.81979828,1,163.341433,1,0,1,1,0,1,0,0,0,0,No
17918,alienate,1,15.09653218,1,10.81979828,10.81979828,1,163.341433,1,1,2,1,1,2,5,0.398076,0.415824,0,No
17932,alginate,1,15.09653218,1,10.81979828,10.81979828,1,163.341433,1,1,2,1,1,2,5,0.341779,0.349674,0,No
17962,aldehyde,1,15.09653218,1,10.81979828,10.81979828,1,163.341433,0,0,0,0,0,0,0,0,0,0,No
17987,alastair,1,15.09653218,1,10.81979828,10.81979828,1,163.341433,1,1,2,1,1,2,5,0.306231,0.311459,0,No
18015,airmail,1,15.09653218,1,10.81979828,10.81979828,1,163.341433,1,1,2,1,1,2,5,0.31554,0.319586,0,No
18016,airlock,1,15.09653218,1,10.81979828,10.81979828,1,163.341433,1,1,2,1,1,2,5,0.398076,0.415824,0,No
18027,aile,1,15.09653218,1,10.81979828,10.81979828,1,163.341433,0,0,0,0,0,0,0,0,0,0,No
18042,agreeable,1,15.09653218,1,10.81979828,10.81979828,1,163.341433,1,1,2,1,1,2,5,0.359172,0.371523,0,No
18044,agrarian,1,15.09653218,1,10.81979828,10.81979828,1,163.341433,1,1,2,1,1,2,5,0.398076,0.415824,0,No
18055,aggravate,1,15.09653218,1,10.81979828,10.81979828,1,163.341433,1,1,2,1,1,2,5,0.398076,0.415824,0,No
18070,afterimage,1,15.09653218,1,10.81979828,10.81979828,1,163.341433,1,1,2,1,1,2,5,0.378607,0.394397,0,No
18076,afresh,1,15.09653218,1,10.81979828,10.81979828,1,163.341433,0,0,0,0,0,0,0,0,0,0,No
18078,aforementioned,1,15.09653218,1,10.81979828,10.81979828,1,163.341433,1,0,1,1,0,1,0,0,0,0,No
18082,aficionado,1,15.09653218,1,10.81979828,10.81979828,1,163.341433,1,0,1,1,0,1,0,0,0,0,No
18092,affidavit,1,15.09653218,1,10.81979828,10.81979828,1,163.341433,1,1,2,1,1,2,5,0.326347,0.330278,0,No
18103,aerofoil,1,15.09653218,1,10.81979828,10.81979828,1,163.341433,1,1,2,1,1,2,5,0.360829,0.373487,0,No
18107,aeolus,1,15.09653218,1,10.81979828,10.81979828,1,163.341433,1,1,2,1,1,2,5,0.325193,0.328843,0,No
18127,adventitious,1,15.09653218,1,10.81979828,10.81979828,1,163.341433,0,0,0,0,0,0,0,0,0,0,No
18140,adorn,1,15.09653218,1,10.81979828,10.81979828,1,163.341433,0,0,0,0,0,0,0,0,0,0,No
18165,adjourn,1,15.09653218,1,10.81979828,10.81979828,1,163.341433,1,1,2,1,1,2,5,0.322728,0.325864,0,No
18174,adept,1,15.09653218,1,10.81979828,10.81979828,1,163.341433,1,1,2,1,1,2,5,0.345599,0.354479,0,No
18181,addressee,1,15.09653218,1,10.81979828,10.81979828,1,163.341433,1,1,2,1,1,2,5,0.300391,0.306093,0,No
18195,adagio,1,15.09653218,1,10.81979828,10.81979828,1,163.341433,0,1,1,0,1,1,5,0.316898,0.32076,0,No
18212,acrylate,1,15.09653218,1,10.81979828,10.81979828,1,163.341433,1,1,2,1,1,2,6,0.281044,0.287234,0,No
18215,acrophobia,1,15.09653218,1,10.81979828,10.81979828,1,163.341433,0,1,1,0,1,1,5,0.331788,0.336492,0,No
18230,ackerman,1,15.09653218,1,10.81979828,10.81979828,1,163.341433,0,1,1,0,1,1,5,0.384234,0.400398,0,No
18237,ache,1,15.09653218,1,10.81979828,10.81979828,1,163.341433,0,0,0,0,0,0,0,0,0,0,No
18240,acetone,1,15.09653218,1,10.81979828,10.81979828,1,163.341433,1,1,2,1,1,2,5,0.384237,0.400402,0,No
18246,accusative,1,15.09653218,1,10.81979828,10.81979828,1,163.341433,1,1,2,1,1,2,5,0.321926,0.325123,0,No
18264,accolade,1,15.09653218,1,10.81979828,10.81979828,1,163.341433,1,1,2,1,1,2,5,0.32681,0.33159,0,No
18267,accipiter,1,15.09653218,1,10.81979828,10.81979828,1,163.341433,1,1,2,1,1,2,5,0.384237,0.400402,0,No
18276,accentuate,1,15.09653218,1,10.81979828,10.81979828,1,163.341433,1,1,2,1,1,2,5,0.398076,0.415824,0,No
18279,accede,1,15.09653218,1,10.81979828,10.81979828,1,163.341433,1,1,2,1,1,2,5,0.334231,0.341142,0,No
18281,acanthus,1,15.09653218,1,10.81979828,10.81979828,1,163.341433,1,1,2,1,1,2,5,0.378607,0.394397,0,No
18291,abysmal,1,15.09653218,1,10.81979828,10.81979828,1,163.341433,1,1,2,1,1,2,5,0.314517,0.318588,0,No
18300,abstention,1,15.09653218,1,10.81979828,10.81979828,1,163.341433,1,1,2,1,1,2,5,0.341779,0.349674,0,No
18302,absorptive,1,15.09653218,1,10.81979828,10.81979828,1,163.341433,0,0,0,0,0,0,0,0,0,0,No
18306,absolve,1,15.09653218,1,10.81979828,10.81979828,1,163.341433,1,1,2,1,1,2,5,0.375317,0.391855,0,No
18310,absentee,1,15.09653218,1,10.81979828,10.81979828,1,163.341433,1,1,2,1,1,2,6,0.258976,0.262688,0,No
18312,abscess,1,15.09653218,1,10.81979828,10.81979828,1,163.341433,1,0,1,1,0,1,0,0,0,0,No
18319,aboveground,1,15.09653218,1,10.81979828,10.81979828,1,163.341433,1,0,1,1,0,1,0,0,0,0,No
18335,ablaze,1,15.09653218,1,10.81979828,10.81979828,1,163.341433,1,1,2,1,1,2,5,0.302996,0.308526,0,No
18340,abeyance,1,15.09653218,1,10.81979828,10.81979828,1,163.341433,1,1,2,1,1,2,5,0.325479,0.328821,0,No
18341,aberrant,1,15.09653218,1,10.81979828,10.81979828,1,163.341433,1,1,2,1,1,2,5,0.318175,0.321788,0,No
18344,abelson,1,15.09653218,1,10.81979828,10.81979828,1,163.341433,1,1,2,1,1,2,6,0.260126,0.264062,0,No
18358,abate,1,15.09653218,1,10.81979828,10.81979828,1,163.341433,1,0,1,1,0,1,0,0,0,0,No
