tf,df,tdf,indegree,outdegree,Degree,weighted-indegree,weighted-outdegree,Weighted-Degree,Eccentricity,closnesscentrality,harmonicclosnesscentrality,betweenesscentrality,stopword
12902,8618,111189436,3707,2819,6526,12902,12902,25804,7,0.51497,0.565268,0.17947,yes
15812,9794,154862728,3496,1725,5221,15812,15812,31624,7,0.477995,0.519087,0.131525,yes
14208,9002,127900416,2749,1864,4613,14208,14208,28416,6,0.487668,0.528597,0.115147,yes
16937,10498,177804626,2181,2199,4380,16937,16937,33874,7,0.496017,0.54102,0.108896,yes
12481,8437,105302197,2775,1354,4129,12481,12481,24962,7,0.431789,0.475839,0.087007,yes
3802,3147,11964894,805,1255,2060,3802,3802,7604,7,0.452,0.490367,0.047531,yes
5087,4041,20556567,1110,1261,2371,5087,5087,10174,7,0.465059,0.500681,0.045824,yes
5848,4661,27257528,1935,750,2685,5848,5848,11696,7,0.44931,0.478144,0.045519,yes
5872,4380,25719360,1468,823,2291,5872,5872,11744,7,0.404797,0.439837,0.043405,yes
3950,3266,12900700,1542,718,2260,3950,3950,7900,7,0.447836,0.47637,0.040316,yes
4237,3527,14943899,1428,451,1879,4237,4237,8474,6,0.421038,0.447616,0.031967,yes
4151,3499,14524349,1539,442,1981,4151,4151,8302,7,0.435469,0.460805,0.02739,yes
3321,2801,9302121,879,698,1577,3321,3321,6642,7,0.436048,0.466286,0.027346,yes
3545,3134,11110030,1231,680,1911,3545,3545,7090,7,0.464729,0.488825,0.026717,yes
2880,2455,7070400,936,400,1336,2880,2880,5760,8,0.367444,0.392824,0.023406,yes
4078,3326,13563428,1253,477,1730,4078,4078,8156,7,0.378429,0.405949,0.021398,yes
3231,2753,8894943,1127,504,1631,3231,3231,6462,7,0.386443,0.415349,0.021385,yes
2553,2384,6086352,1175,464,1639,2553,2553,5106,7,0.456633,0.478402,0.020497,yes
2685,2390,6417150,1214,341,1555,2685,2685,5370,8,0.367294,0.391464,0.020202,yes
2218,1836,4072248,500,645,1145,2218,2218,4436,7,0.40695,0.43855,0.019141,yes
3420,2859,9777780,737,747,1484,3420,3420,6840,7,0.461449,0.487702,0.018822,yes
4059,3356,13622004,851,658,1509,4059,4059,8118,7,0.442253,0.470708,0.017896,yes
2212,1949,4311188,1035,398,1433,2212,2212,4424,7,0.373411,0.398685,0.017405,yes
2248,1973,4435304,678,495,1173,2248,2248,4496,7,0.395627,0.424409,0.016772,yes
1775,1645,2919875,766,460,1226,1775,1775,3550,8,0.436349,0.462154,0.014314,yes
4301,3715,15978215,385,711,1096,4301,4301,8602,7,0.466024,0.490433,0.014111,No
979,864,845856,624,391,1015,979,979,1958,7,0.450758,0.472281,0.013955,yes
1361,1226,1668586,452,417,869,1361,1361,2722,7,0.446196,0.469154,0.013052,yes
2456,2099,5155144,588,530,1118,2456,2456,4912,7,0.458942,0.481538,0.012665,No
1300,1187,1543100,178,484,662,1300,1300,2600,7,0.420323,0.44766,0.012406,No
1484,1361,2019724,719,400,1119,1484,1484,2968,7,0.40631,0.432978,0.012189,yes
1488,1332,1982016,570,303,873,1488,1488,2976,7,0.383283,0.408137,0.010305,yes
1300,1160,1508000,375,436,811,1300,1300,2600,7,0.449204,0.471933,0.010186,yes
1273,1209,1539057,501,429,930,1273,1273,2546,6,0.454698,0.476186,0.009474,yes
1121,1025,1149025,374,361,735,1121,1121,2242,7,0.420354,0.445784,0.009075,yes
857,759,650463,281,338,619,857,857,1714,7,0.412978,0.438001,0.008662,yes
1186,971,1151606,376,327,703,1186,1186,2372,7,0.42802,0.45198,0.008562,yes
1101,988,1087788,536,263,799,1101,1101,2202,7,0.372132,0.394657,0.00834,yes
645,509,328305,153,348,501,645,645,1290,7,0.34858,0.369385,0.008256,yes
2905,2552,7413560,347,534,881,2905,2905,5810,7,0.45738,0.480375,0.007627,No
956,914,873784,535,252,787,956,956,1912,7,0.436115,0.457567,0.00742,No
852,840,715680,495,265,760,852,852,1704,7,0.444673,0.464893,0.006992,No
556,419,232964,361,232,593,556,556,1112,7,0.420768,0.443476,0.006911,yes
786,745,585570,318,263,581,786,786,1572,7,0.428202,0.450695,0.006629,yes
885,847,749595,533,211,744,885,885,1770,7,0.435903,0.456524,0.006313,No
1034,973,1006082,506,234,740,1034,1034,2068,7,0.445742,0.465177,0.00626,No
1313,1164,1528332,352,242,594,1313,1313,2626,7,0.441829,0.462059,0.006191,No
991,926,917666,108,309,417,991,991,1982,7,0.448731,0.469058,0.006079,No
462,436,201432,191,222,413,462,462,924,7,0.407163,0.430241,0.005874,yes
1020,942,960840,442,124,566,1020,1020,2040,7,0.403686,0.425305,0.005856,No
1338,1282,1715316,300,329,629,1338,1338,2676,7,0.448118,0.468965,0.005538,yes
1669,1482,2473458,197,328,525,1669,1669,3338,8,0.357572,0.379797,0.005479,yes
739,683,504737,351,165,516,739,739,1478,8,0.343583,0.36063,0.005335,yes
1593,1425,2270025,230,277,507,1593,1593,3186,8,0.368158,0.39107,0.005242,yes
1071,973,1042083,238,289,527,1071,1071,2142,7,0.438987,0.460668,0.005205,yes
739,650,480350,287,272,559,739,739,1478,7,0.402486,0.427077,0.005071,yes
998,875,873250,98,259,357,998,998,1996,7,0.441806,0.462416,0.005058,No
513,502,257526,240,189,429,513,513,1026,7,0.431789,0.452436,0.004979,No
578,558,322524,333,138,471,578,578,1156,7,0.421319,0.44223,0.004925,yes
711,642,456462,154,240,394,711,711,1422,7,0.419609,0.442375,0.004847,yes
960,900,864000,149,331,480,960,960,1920,7,0.447284,0.468335,0.004735,No
394,343,135142,71,249,320,394,394,788,8,0.359312,0.381226,0.00471,yes
1124,856,962144,282,273,555,1124,1124,2248,7,0.434372,0.456559,0.004685,yes
473,447,211431,301,139,440,473,473,946,7,0.366505,0.385872,0.00447,yes
910,768,698880,297,245,542,910,910,1820,7,0.427259,0.449776,0.004412,yes
873,793,692289,368,172,540,873,873,1746,7,0.366741,0.386932,0.004225,yes
656,637,417872,320,157,477,656,656,1312,7,0.433038,0.45302,0.004062,yes
379,352,133408,245,111,356,379,379,758,8,0.323267,0.3343,0.00398,yes
755,717,541335,161,217,378,755,755,1510,7,0.42276,0.444848,0.003755,No
413,370,152810,273,150,423,413,413,826,8,0.334812,0.348524,0.003638,yes
1076,982,1056632,145,185,330,1076,1076,2152,8,0.351307,0.369887,0.003635,yes
573,499,285927,270,144,414,573,573,1146,7,0.387408,0.409092,0.003494,yes
840,776,651840,182,195,377,840,840,1680,7,0.402287,0.425071,0.003453,yes
751,643,482893,169,227,396,751,751,1502,7,0.437681,0.458212,0.003395,yes
453,411,186183,273,184,457,453,453,906,8,0.397276,0.420119,0.003389,yes
1057,963,1017891,60,269,329,1057,1057,2114,7,0.445987,0.466021,0.003287,No
467,457,213419,212,161,373,467,467,934,7,0.413088,0.43496,0.003229,No
955,906,865230,243,237,480,955,955,1910,7,0.440734,0.461021,0.003174,yes
398,341,135718,214,79,293,398,398,796,8,0.381296,0.400746,0.003065,No
420,400,168000,97,147,244,420,420,840,8,0.342095,0.357717,0.003034,yes
192,166,31872,48,131,179,192,192,384,8,0.327876,0.340298,0.003,yes
501,476,238476,233,176,409,501,501,1002,7,0.414674,0.43686,0.002935,yes
466,444,206904,238,160,398,466,466,932,7,0.439066,0.458273,0.002858,yes
600,539,323400,191,208,399,600,600,1200,7,0.43702,0.45742,0.002774,yes
439,422,185258,142,213,355,439,439,878,7,0.434029,0.454956,0.002773,No
368,348,128064,163,165,328,368,368,736,7,0.417627,0.439402,0.002762,No
260,243,63180,137,149,286,260,260,520,7,0.38503,0.406186,0.002707,yes
471,431,203001,202,92,294,471,471,942,7,0.417372,0.437724,0.002686,No
318,300,95400,91,156,247,318,318,636,7,0.414583,0.43608,0.002668,yes
465,423,196695,127,157,284,465,465,930,7,0.399948,0.422176,0.002659,yes
1021,970,990370,155,200,355,1021,1021,2042,7,0.435436,0.455691,0.002656,No
334,309,103206,88,177,265,334,334,668,7,0.37525,0.396492,0.002573,yes
393,382,150126,213,81,294,393,393,786,8,0.341212,0.355933,0.00255,yes
504,458,230832,169,200,369,504,504,1008,7,0.433842,0.454494,0.002488,yes
817,787,642979,151,194,345,817,817,1634,7,0.438052,0.457867,0.002484,No
422,389,164158,111,136,247,422,422,844,7,0.388971,0.410229,0.002434,yes
814,715,582010,83,204,287,814,814,1628,7,0.441201,0.460756,0.002407,No
862,766,660292,82,227,309,862,862,1724,7,0.446057,0.465306,0.002398,No
412,390,160680,244,52,296,412,412,824,7,0.394283,0.413824,0.002397,yes
543,501,272043,198,162,360,543,543,1086,7,0.429712,0.450089,0.002326,No
404,395,159580,185,152,337,404,404,808,7,0.392406,0.415216,0.002299,yes
444,418,185592,80,161,241,444,444,888,7,0.435525,0.455074,0.002264,No
292,278,81176,155,144,299,292,292,584,7,0.387136,0.408898,0.002251,yes
744,678,504432,135,153,288,744,744,1488,7,0.392361,0.41433,0.002239,yes
356,328,116768,189,135,324,356,356,712,7,0.411732,0.433434,0.002232,No
316,298,94168,129,165,294,316,316,632,7,0.41404,0.435874,0.002195,yes
784,726,569184,216,170,386,784,784,1568,7,0.406727,0.429367,0.002147,No
285,265,75525,128,126,254,285,285,570,7,0.422435,0.443151,0.002127,No
329,323,106267,159,124,283,329,329,658,7,0.408303,0.429816,0.002036,yes
696,639,444744,41,200,241,696,696,1392,7,0.44293,0.462116,0.002032,No
159,158,25122,80,74,154,159,159,318,7,0.360816,0.377682,0.001988,No
355,343,121765,165,159,324,355,355,710,7,0.43702,0.456509,0.001984,No
778,691,537598,71,199,270,778,778,1556,7,0.443967,0.462953,0.001982,No
346,340,117640,159,154,313,346,346,692,7,0.436416,0.4558,0.001975,yes
723,623,450429,56,235,291,723,723,1446,7,0.439632,0.460095,0.001951,No
253,243,61479,117,94,211,253,253,506,7,0.417341,0.437612,0.001909,No
398,383,152434,192,155,347,398,398,796,7,0.365829,0.385932,0.001905,yes
796,755,600980,117,210,327,796,796,1592,7,0.444754,0.463831,0.001903,No
266,243,64638,154,90,244,266,266,532,7,0.359516,0.37659,0.001885,yes
179,176,31504,135,86,221,179,179,358,8,0.332424,0.343682,0.001853,yes
617,574,354158,81,197,278,617,617,1234,7,0.438108,0.458203,0.00181,No
429,415,178035,69,168,237,429,429,858,7,0.413448,0.435425,0.001744,No
248,245,60760,81,101,182,248,248,496,7,0.373411,0.392639,0.001738,No
196,192,37632,135,90,225,196,196,392,7,0.345699,0.359487,0.001704,yes
225,219,49275,131,104,235,225,225,450,7,0.378019,0.399653,0.001699,yes
476,421,200396,116,115,231,476,476,952,8,0.337094,0.350599,0.001684,yes
146,133,19418,61,77,138,146,146,292,8,0.361405,0.378475,0.001677,yes
590,556,328040,35,189,224,590,590,1180,7,0.438942,0.458583,0.001663,No
771,723,557433,140,151,291,771,771,1542,8,0.35086,0.368135,0.001649,yes
219,216,47304,110,95,205,219,219,438,7,0.36838,0.386595,0.00164,No
513,468,240084,85,156,241,513,513,1026,7,0.436193,0.455603,0.00163,No
156,151,23556,83,88,171,156,156,312,8,0.336555,0.349734,0.001619,No
202,195,39390,135,98,233,202,202,404,7,0.413208,0.433666,0.001605,No
733,645,472785,79,131,210,733,733,1466,7,0.429604,0.44945,0.001602,No
476,420,199920,59,133,192,476,476,952,7,0.438818,0.457529,0.001589,No
319,315,100485,158,123,281,319,319,638,7,0.429939,0.449507,0.001581,No
118,116,13688,22,84,106,118,118,236,8,0.351749,0.367043,0.001558,No
287,277,79499,59,95,154,287,287,574,7,0.417852,0.437877,0.001557,No
279,274,76446,150,68,218,279,279,558,8,0.324447,0.334673,0.001542,No
416,410,170560,26,123,149,416,416,832,7,0.422069,0.44258,0.001537,No
321,294,94374,41,137,178,321,321,642,7,0.427419,0.447522,0.001531,No
352,324,114048,69,132,201,352,352,704,7,0.436439,0.455305,0.00153,No
351,326,114426,91,141,232,351,351,702,7,0.407923,0.429403,0.001528,No
251,237,59487,86,101,187,251,251,502,7,0.399742,0.420858,0.001523,No
418,394,164692,101,142,243,418,418,836,7,0.426543,0.447081,0.00152,No
372,365,135780,162,131,293,372,372,744,7,0.419218,0.440287,0.001515,No
209,181,37829,94,119,213,209,209,418,7,0.421319,0.441982,0.001507,No
438,406,177828,185,65,250,438,438,876,8,0.34009,0.352783,0.001505,No
470,447,210090,57,137,194,470,470,940,7,0.435547,0.454677,0.001504,No
443,421,186503,32,160,192,443,443,886,7,0.425639,0.446705,0.001461,No
224,223,49952,166,105,271,224,224,448,7,0.409656,0.430698,0.001443,No
422,411,173442,125,111,236,422,422,844,7,0.425554,0.445411,0.001441,No
525,481,252525,117,167,284,525,525,1050,7,0.415158,0.436828,0.001418,yes
181,171,30951,115,27,142,181,181,362,7,0.383844,0.402657,0.001416,No
326,301,98126,83,142,225,326,326,652,7,0.42185,0.442861,0.001381,No
653,588,383964,71,138,209,653,653,1306,7,0.432676,0.452234,0.001363,No
361,311,112271,72,118,190,361,361,722,8,0.355435,0.373434,0.00136,yes
193,184,35512,73,123,196,193,193,386,7,0.362842,0.380522,0.001347,yes
230,220,50600,95,116,211,230,230,460,8,0.375523,0.396305,0.001332,No
242,227,54934,74,104,178,242,242,484,7,0.390101,0.410685,0.001325,yes
458,441,201978,137,59,196,458,458,916,8,0.390181,0.41031,0.001322,No
179,175,31325,125,81,206,179,179,358,8,0.387531,0.407931,0.001313,No
802,755,605510,9,192,201,802,802,1604,7,0.437345,0.457337,0.001297,No
254,234,59436,66,118,184,254,254,508,7,0.380259,0.400527,0.001283,yes
115,111,12765,48,75,123,115,115,230,7,0.389308,0.409549,0.001265,No
152,138,20976,64,81,145,152,152,304,7,0.387399,0.407818,0.001259,yes
204,194,39576,118,78,196,204,204,408,7,0.412219,0.432737,0.001257,yes
149,148,22052,54,61,115,149,149,298,7,0.40845,0.428388,0.00125,No
86,81,6966,60,60,120,86,86,172,7,0.39246,0.412569,0.001242,yes
205,196,40180,103,87,190,205,205,410,7,0.392325,0.413212,0.001235,No
373,281,104813,25,131,156,373,373,746,7,0.432084,0.451545,0.001225,No
249,234,58266,29,119,148,249,249,498,7,0.433115,0.452253,0.001216,No
206,204,42024,110,67,177,206,206,412,7,0.393229,0.41352,0.001215,No
211,197,41567,114,48,162,211,211,422,8,0.354762,0.370277,0.001212,yes
196,182,35672,90,83,173,196,196,392,8,0.372043,0.391446,0.001211,No
363,342,124146,75,72,147,363,363,726,7,0.357887,0.37496,0.001203,yes
215,201,43215,80,108,188,215,215,430,7,0.407825,0.428805,0.001201,yes
238,219,52122,137,36,173,238,238,476,7,0.349294,0.364187,0.001194,No
319,302,96338,47,110,157,319,319,638,7,0.419002,0.439222,0.001162,No
145,133,19285,55,66,121,145,145,290,8,0.35734,0.374154,0.001157,No
170,144,24480,82,88,170,170,170,340,7,0.423389,0.443165,0.001152,No
164,158,25912,60,77,137,164,164,328,8,0.351004,0.36725,0.001145,No
338,298,100724,136,128,264,338,338,676,7,0.381731,0.402049,0.001143,yes
276,270,74520,140,71,211,276,276,552,7,0.402448,0.423177,0.001132,yes
480,458,219840,18,171,189,480,480,960,7,0.438209,0.457638,0.001125,No
604,571,344884,150,157,307,604,604,1208,7,0.413749,0.435552,0.001124,No
215,212,45580,96,90,186,215,215,430,7,0.411812,0.43224,0.001111,No
282,270,76140,53,94,147,282,282,564,7,0.423106,0.44299,0.001102,No
202,201,40602,123,93,216,202,202,404,7,0.414332,0.434917,0.001098,No
340,323,109820,51,133,184,340,340,680,7,0.422623,0.443315,0.001092,No
241,232,55912,69,77,146,241,241,482,8,0.37284,0.392662,0.001088,No
189,179,33831,50,114,164,189,189,378,8,0.336934,0.350833,0.001086,yes
334,270,90180,108,99,207,334,334,668,7,0.419795,0.440061,0.001086,No
101,96,9696,54,54,108,101,101,202,7,0.354821,0.370682,0.00108,No
394,332,130808,60,85,145,394,394,788,7,0.415492,0.435889,0.001074,No
209,202,42218,105,59,164,209,209,418,8,0.361826,0.380209,0.001064,yes
379,346,131134,36,149,185,379,379,758,7,0.427451,0.447871,0.001041,No
347,328,113816,36,133,169,347,347,694,7,0.435347,0.454401,0.001032,No
366,121,44286,92,73,165,366,366,732,7,0.423883,0.443214,0.00103,No
451,400,180400,36,140,176,451,451,902,7,0.432972,0.45249,0.001029,No
155,140,21700,66,63,129,155,155,310,7,0.393003,0.413689,0.001018,yes
221,213,47073,20,136,156,221,221,442,8,0.368746,0.388292,0.001018,No
199,187,37213,101,94,195,199,199,398,7,0.388564,0.408815,0.001013,No
226,209,47234,85,100,185,226,226,452,6,0.423925,0.443804,0.00101,No
250,231,57750,30,108,138,250,250,500,7,0.430775,0.450049,0.001001,No
326,311,101386,158,68,226,326,326,652,7,0.414845,0.434618,0.001,No
287,246,70602,86,110,196,287,287,574,7,0.423284,0.443527,0.000999,No
433,401,173633,51,135,186,433,433,866,7,0.42743,0.447607,0.000997,No
495,466,230670,170,12,182,495,495,990,8,0.338874,0.351656,0.000995,No
340,330,112200,92,125,217,340,340,680,7,0.421788,0.442083,0.000966,No
193,182,35126,111,46,157,193,193,386,7,0.392172,0.411425,0.000962,No
215,210,45150,79,87,166,215,215,430,7,0.427173,0.446352,0.000962,No
258,228,58824,33,119,152,258,258,516,7,0.425426,0.445484,0.000961,No
146,122,17812,64,62,126,146,146,292,7,0.411216,0.431188,0.000948,No
118,102,12036,45,70,115,118,118,236,7,0.410198,0.43056,0.000941,No
347,337,116939,68,68,136,347,347,694,7,0.423915,0.442992,0.000936,No
132,116,15312,41,64,105,132,132,264,7,0.413598,0.433278,0.00093,No
108,99,10692,79,47,126,108,108,216,8,0.320625,0.329713,0.000927,yes
250,226,56500,29,106,135,250,250,500,7,0.428052,0.447423,0.000927,No
128,120,15360,30,64,94,128,128,256,7,0.412888,0.432711,0.000925,No
138,136,18768,101,54,155,138,138,276,7,0.401577,0.421527,0.000916,No
130,125,16250,71,66,137,130,130,260,7,0.419692,0.439194,0.000915,No
210,202,42420,46,79,125,210,210,420,7,0.414171,0.434375,0.00091,No
178,155,27590,84,81,165,178,178,356,7,0.413739,0.433991,0.000909,No
439,429,188331,21,115,136,439,439,878,7,0.43108,0.450365,0.000905,No
301,296,89096,89,95,184,301,301,602,7,0.420675,0.440633,0.000902,No
183,167,30561,14,94,108,183,183,366,7,0.42107,0.440974,0.000899,No
249,203,50547,73,105,178,249,249,498,7,0.421309,0.441654,0.000899,No
170,155,26350,53,72,125,170,170,340,7,0.418683,0.438472,0.000887,No
242,237,57354,76,87,163,242,242,484,7,0.419444,0.43928,0.000879,No
167,164,27388,127,37,164,167,167,334,8,0.362249,0.37885,0.00087,No
359,323,115957,135,46,181,359,359,718,7,0.377125,0.395843,0.000864,yes
465,445,206925,140,46,186,465,465,930,8,0.364259,0.381364,0.000863,No
137,135,18495,84,53,137,137,137,274,8,0.327272,0.337404,0.000863,No
270,255,68850,39,84,123,270,270,540,7,0.416455,0.436723,0.000853,No
98,85,8330,27,47,74,98,98,196,7,0.403447,0.423498,0.000844,No
297,292,86724,79,83,162,297,297,594,7,0.421309,0.440934,0.000841,No
382,349,133318,10,133,143,382,382,764,7,0.431789,0.451503,0.000836,No
174,173,30102,119,100,219,174,174,348,7,0.417597,0.438297,0.000832,No
177,159,28143,73,56,129,177,177,354,8,0.322442,0.331542,0.00083,yes
196,186,36456,61,83,144,196,196,392,7,0.383197,0.403179,0.000821,yes
678,580,393240,45,114,159,678,678,1356,7,0.421205,0.441582,0.000818,No
100,96,9600,50,65,115,100,100,200,7,0.369113,0.386892,0.000809,No
116,114,13224,41,51,92,116,116,232,7,0.411276,0.430932,0.000796,No
182,180,32760,97,63,160,182,182,364,7,0.40102,0.421199,0.000793,No
287,283,81221,72,103,175,287,287,574,7,0.403915,0.424627,0.000793,No
188,183,34404,30,73,103,188,188,376,7,0.411712,0.432036,0.000787,No
133,129,17157,38,60,98,133,133,266,7,0.418057,0.437616,0.000783,No
459,420,192780,16,154,170,459,459,918,7,0.437333,0.456576,0.000782,No
492,465,228780,21,132,153,492,492,984,7,0.435658,0.454678,0.00078,No
260,245,63700,86,101,187,260,260,520,7,0.416923,0.437164,0.000776,No
152,143,21736,50,52,102,152,152,304,7,0.412259,0.432107,0.000774,No
193,191,36863,47,63,110,193,193,386,7,0.364244,0.381993,0.00077,No
209,189,39501,31,78,109,209,209,418,7,0.42025,0.440027,0.000768,No
131,129,16899,102,60,162,131,131,262,7,0.402838,0.423229,0.000756,No
87,86,7482,57,48,105,87,87,174,7,0.403925,0.423911,0.000756,No
256,247,63232,70,83,153,256,256,512,7,0.397119,0.418308,0.000753,No
308,301,92708,73,89,162,308,308,616,7,0.41412,0.434555,0.000751,No
226,215,48590,54,65,119,226,226,452,7,0.395215,0.415163,0.000749,No
137,131,17947,91,27,118,137,137,274,8,0.374402,0.392743,0.000749,No
165,160,26400,100,70,170,165,165,330,7,0.384692,0.404573,0.000747,No
181,177,32037,59,62,121,181,181,362,8,0.315847,0.324305,0.000732,yes
299,290,86710,119,97,216,299,299,598,7,0.391992,0.412935,0.000724,No
220,195,42900,29,87,116,220,220,440,7,0.411762,0.432297,0.000721,No
76,73,5548,65,37,102,76,76,152,7,0.399845,0.419313,0.00072,No
132,132,17424,24,67,91,131,132,263,7,0.411553,0.431473,0.00072,No
392,373,146216,120,104,224,392,392,784,7,0.385369,0.406057,0.000708,No
443,410,181630,15,103,118,443,443,886,7,0.426383,0.446022,0.000702,No
129,127,16383,78,66,144,129,129,258,7,0.412299,0.43237,0.000697,No
641,618,396138,125,135,260,641,641,1282,7,0.37497,0.395289,0.000696,No
484,455,220220,29,91,120,484,484,968,7,0.42023,0.440174,0.000695,No
90,77,6930,25,47,72,90,90,180,7,0.392181,0.412289,0.000688,No
184,183,33672,83,106,189,184,184,368,7,0.407484,0.428562,0.000685,No
104,100,10400,56,44,100,104,104,208,7,0.406001,0.425731,0.000683,No
283,272,76976,99,84,183,283,283,566,7,0.383818,0.40397,0.000683,No
115,110,12650,79,39,118,115,115,230,7,0.349229,0.363046,0.000683,No
437,432,188784,36,167,203,437,437,874,7,0.426106,0.446982,0.000675,No
159,152,24168,19,57,76,159,159,318,7,0.406591,0.426629,0.000673,No
89,87,7743,49,40,89,89,89,178,7,0.385709,0.405224,0.00066,No
345,336,115920,116,94,210,345,345,690,7,0.411404,0.432094,0.000658,yes
261,216,56376,36,82,118,261,261,522,7,0.419744,0.43975,0.000658,No
263,217,57071,27,90,117,263,263,526,7,0.423116,0.442717,0.000655,No
229,191,43739,33,85,118,229,229,458,7,0.423074,0.442784,0.000652,No
128,120,15360,28,49,77,128,128,256,7,0.404241,0.424388,0.00065,No
315,300,94500,21,108,129,315,315,630,7,0.427334,0.447051,0.000645,No
152,140,21280,14,84,98,152,152,304,7,0.412858,0.433356,0.000641,No
280,277,77560,75,87,162,280,280,560,7,0.405316,0.425803,0.000633,No
242,224,54208,90,112,202,242,242,484,7,0.416425,0.43731,0.000631,No
129,123,15867,28,61,89,129,129,258,7,0.408001,0.427817,0.000629,No
185,174,32190,36,86,122,185,185,370,7,0.421882,0.441674,0.000626,No
132,130,17160,70,60,130,132,132,264,7,0.373394,0.392009,0.000623,No
90,87,7830,36,54,90,90,90,180,7,0.409155,0.429005,0.000623,No
86,79,6794,27,59,86,86,86,172,7,0.418088,0.437598,0.000614,No
54,53,2862,28,44,72,54,54,108,8,0.362973,0.380069,0.000613,yes
199,197,39203,75,82,157,199,199,398,8,0.374509,0.394615,0.000611,No
176,158,27808,31,76,107,176,176,352,7,0.416059,0.436072,0.000608,No
117,115,13455,76,71,147,117,117,234,7,0.415108,0.435205,0.000608,No
105,101,10605,47,43,90,105,105,210,7,0.411127,0.430949,0.000601,yes
149,146,21754,43,76,119,149,149,298,7,0.408675,0.429045,0.0006,No
254,244,61976,37,83,120,254,254,508,7,0.419506,0.439546,0.000595,No
348,319,111012,27,129,156,348,348,696,7,0.430525,0.450251,0.000594,No
175,161,28175,32,66,98,175,175,350,7,0.410504,0.430545,0.000594,No
156,153,23868,44,65,109,156,156,312,7,0.400907,0.420926,0.000588,No
90,90,8100,76,40,116,90,90,180,8,0.327882,0.337292,0.000586,No
67,65,4355,29,46,75,67,67,134,7,0.405028,0.425042,0.000584,No
170,165,28050,28,43,71,170,170,340,7,0.408245,0.427848,0.000578,No
49,41,2009,9,31,40,49,49,98,7,0.400832,0.420537,0.000575,No
203,194,39382,38,73,111,203,203,406,7,0.42341,0.442826,0.000575,No
119,113,13447,24,58,82,119,119,238,7,0.410662,0.430623,0.000572,No
84,78,6552,21,45,66,84,84,168,7,0.406892,0.426679,0.000563,No
48,48,2304,36,24,60,48,48,96,7,0.379828,0.398491,0.00056,No
152,137,20824,61,67,128,152,152,304,7,0.368627,0.386538,0.000558,yes
93,92,8556,33,35,68,93,93,186,7,0.400935,0.420377,0.000549,No
51,51,2601,37,35,72,51,51,102,7,0.379321,0.397404,0.000547,No
90,88,7920,21,44,65,90,90,180,7,0.403085,0.423412,0.000546,No
66,64,4224,37,32,69,66,66,132,7,0.391668,0.411173,0.000545,No
174,172,29928,90,35,125,174,174,348,8,0.358451,0.375087,0.000543,yes
75,75,5625,34,42,76,75,75,150,7,0.33915,0.350807,0.000543,No
135,132,17820,65,60,125,135,135,270,7,0.365947,0.383359,0.00054,yes
146,145,21170,105,45,150,146,146,292,7,0.393166,0.412815,0.000532,No
81,78,6318,49,48,97,81,81,162,7,0.403161,0.423098,0.000532,No
48,47,2256,26,28,54,48,48,96,7,0.389771,0.408871,0.000531,No
179,170,30430,38,73,111,179,179,358,7,0.418447,0.438345,0.00053,No
82,82,6724,30,46,76,82,82,164,7,0.378505,0.39744,0.00053,No
57,57,3249,45,37,82,57,57,114,7,0.357116,0.372861,0.000524,No
142,135,19170,56,51,107,142,142,284,7,0.406882,0.42699,0.000522,No
107,106,11342,25,60,85,107,107,214,8,0.376193,0.39505,0.000521,No
77,65,5005,20,48,68,77,77,154,7,0.402069,0.422155,0.000519,No
153,146,22338,65,68,133,153,153,306,7,0.414644,0.43486,0.000518,No
344,308,105952,27,104,131,344,344,688,7,0.427516,0.447072,0.000518,No
39,35,1365,19,21,40,39,39,78,7,0.377826,0.39646,0.000515,No
127,121,15367,79,70,149,127,127,254,7,0.414966,0.435053,0.000514,No
143,123,17589,26,53,79,143,143,286,7,0.410395,0.430138,0.000514,No
126,121,15246,17,45,62,126,126,252,7,0.394301,0.414153,0.00051,No
59,59,3481,25,31,56,59,59,118,7,0.394056,0.413935,0.000507,No
122,110,13420,21,62,83,122,122,244,7,0.407348,0.427543,0.000505,No
99,91,9009,26,50,76,99,99,198,7,0.401095,0.421172,0.0005,No
317,297,94149,44,43,87,317,317,634,7,0.382913,0.403084,0.0005,No
111,106,11766,51,50,101,111,111,222,7,0.411812,0.431427,0.000499,No
174,139,24186,23,70,93,174,174,348,7,0.420789,0.440325,0.000499,No
76,74,5624,49,35,84,76,76,152,7,0.363166,0.379969,0.000499,No
127,122,15494,11,60,71,127,127,254,7,0.41775,0.43739,0.000497,No
71,70,4970,37,37,74,71,71,142,8,0.318607,0.32671,0.000496,No
137,135,18495,82,30,112,137,137,274,8,0.387831,0.407582,0.000492,No
169,164,27716,54,65,119,169,169,338,7,0.413038,0.43282,0.000492,No
57,54,3078,15,41,56,57,57,114,8,0.393193,0.413336,0.000487,No
48,46,2208,34,28,62,48,48,96,7,0.386294,0.405217,0.000481,No
66,62,4092,21,29,50,66,66,132,7,0.390359,0.410246,0.000478,No
109,107,11663,72,62,134,109,109,218,7,0.414765,0.43458,0.000476,yes
79,77,6083,34,36,70,79,79,158,7,0.394046,0.413493,0.000475,No
135,135,18225,78,23,101,135,135,270,7,0.369561,0.386809,0.000474,No
63,58,3654,21,37,58,63,63,126,7,0.393955,0.413751,0.000474,No
12,12,144,12,10,22,12,12,24,8,0.294749,0.30416,0.000471,No
252,234,58968,28,83,111,252,252,504,7,0.421965,0.441668,0.00047,No
134,121,16214,27,35,62,134,134,268,7,0.394584,0.413839,0.00047,No
5,4,20,5,4,9,5,5,10,8,0.254774,0.260148,0.000469,No
48,44,2112,12,30,42,48,48,96,8,0.391677,0.411714,0.000469,No
89,88,7832,60,51,111,89,89,178,7,0.394447,0.414433,0.000467,No
47,47,2209,16,24,40,47,47,94,8,0.390699,0.410163,0.000466,No
198,189,37422,28,67,95,198,198,396,7,0.409038,0.429487,0.000465,No
111,106,11766,43,71,114,111,111,222,8,0.37911,0.398664,0.000463,yes
196,193,37828,29,71,100,196,196,392,7,0.421288,0.440863,0.000463,No
30,27,810,18,19,37,30,30,60,7,0.377225,0.395658,0.000458,No
139,128,17792,35,45,80,139,139,278,7,0.410514,0.430157,0.000458,No
145,131,18995,22,66,88,145,145,290,7,0.416354,0.436065,0.000457,No
128,121,15488,23,61,84,128,128,256,7,0.399181,0.419552,0.000455,No
109,105,11445,21,55,76,109,109,218,7,0.402486,0.422885,0.000455,No
43,32,1376,27,18,45,43,43,86,7,0.378614,0.397026,0.000454,No
53,52,2756,18,27,45,53,53,106,8,0.3636,0.380286,0.000453,No
70,68,4760,57,44,101,70,70,140,7,0.392244,0.411876,0.000452,No
100,90,9000,19,56,75,100,100,200,7,0.405615,0.425581,0.000451,No
140,135,18900,50,66,116,140,140,280,7,0.39662,0.416378,0.000451,No
281,270,75870,62,50,112,281,281,562,7,0.40521,0.425026,0.000449,No
82,80,6560,21,45,66,82,82,164,7,0.402325,0.422343,0.000449,No
71,65,4615,15,35,50,71,71,142,7,0.386242,0.405207,0.000447,No
67,61,4087,19,44,63,67,67,134,7,0.399377,0.419409,0.000443,No
301,275,82775,47,32,79,301,301,602,7,0.391992,0.411629,0.000442,No
49,47,2303,19,29,48,49,49,98,8,0.373713,0.392424,0.000442,No
46,44,2024,25,33,58,46,46,92,8,0.360687,0.378139,0.000441,No
83,82,6806,38,45,83,83,83,166,7,0.40845,0.428358,0.000439,No
101,92,9292,22,64,86,101,101,202,7,0.402828,0.423198,0.000436,No
50,47,2350,18,25,43,50,50,100,7,0.393456,0.412643,0.000434,No
159,149,23691,24,64,88,159,159,318,7,0.409155,0.429244,0.000434,No
137,130,17810,33,72,105,137,137,274,7,0.413809,0.433995,0.000433,No
108,94,10152,20,51,71,108,108,216,7,0.401794,0.421544,0.000433,No
259,259,67081,182,10,192,259,259,518,7,0.343984,0.355998,0.000431,No
62,61,3782,49,38,87,62,62,124,8,0.386373,0.405827,0.00043,No
113,108,12204,22,62,84,113,113,226,7,0.419496,0.439,0.000428,No
25,25,625,20,21,41,25,25,50,8,0.344012,0.35814,0.000426,No
91,90,8190,65,46,111,90,90,180,8,0.323844,0.332394,0.000425,No
101,68,6868,45,40,85,101,101,202,7,0.354939,0.370817,0.000418,No
146,144,21024,27,58,85,146,146,292,7,0.404893,0.425016,0.000418,No
11,11,121,5,4,9,11,11,22,8,0.349616,0.363803,0.000418,No
206,199,40994,23,62,85,206,206,412,7,0.403753,0.423615,0.000418,No
63,57,3591,30,30,60,63,63,126,8,0.335787,0.348572,0.000417,yes
356,327,116412,27,85,112,356,356,712,7,0.41857,0.438795,0.000417,No
77,77,5929,41,48,89,77,77,154,7,0.417873,0.437175,0.000415,yes
126,126,15876,38,40,78,126,126,252,7,0.400117,0.419684,0.000415,No
44,44,1936,35,34,69,44,44,88,7,0.387514,0.407415,0.000413,No
77,76,5852,47,46,93,77,77,154,7,0.375647,0.394256,0.000412,No
74,69,5106,65,35,100,74,74,148,7,0.380641,0.399401,0.000411,No
208,191,39728,44,58,102,208,208,416,7,0.420447,0.439687,0.00041,No
124,111,13764,41,41,82,124,124,248,7,0.399798,0.419667,0.00041,No
140,131,18340,29,54,83,140,140,280,7,0.402277,0.422299,0.000408,No
111,109,12099,48,49,97,111,111,222,7,0.357041,0.37273,0.000408,No
130,123,15990,24,69,93,130,130,260,7,0.41534,0.435184,0.000406,No
47,43,2021,25,36,61,47,47,94,8,0.372717,0.392325,0.000404,No
268,248,66464,10,107,117,268,268,536,7,0.428859,0.448279,0.000401,No
43,43,1849,36,9,45,43,43,86,8,0.320113,0.328228,0.000399,No
140,126,17640,9,66,75,140,140,280,7,0.409804,0.430055,0.000397,No
102,100,10200,61,39,100,102,102,204,7,0.374312,0.392644,0.000396,No
92,91,8372,14,59,73,92,92,184,7,0.401227,0.421735,0.000395,No
28,28,784,25,21,46,28,28,56,8,0.368707,0.385681,0.000394,No
178,170,30260,20,83,103,178,178,356,7,0.422644,0.44218,0.000392,No
103,101,10403,16,49,65,103,103,206,7,0.404365,0.42408,0.000391,No
23,20,460,9,17,26,23,23,46,8,0.347699,0.362004,0.000387,No
53,45,2385,28,37,65,53,53,106,7,0.403934,0.42399,0.000387,No
169,142,23998,28,66,94,169,169,338,7,0.408851,0.429088,0.000386,No
145,143,20735,53,46,99,145,145,290,7,0.387144,0.406775,0.000384,No
238,194,46172,24,71,95,238,238,476,8,0.361259,0.379061,0.000383,yes
89,84,7476,38,59,97,89,89,178,7,0.404816,0.42526,0.000382,No
102,99,10098,54,52,106,102,102,204,8,0.3851,0.405069,0.000381,yes
196,193,37828,76,18,94,196,196,392,7,0.361244,0.377409,0.000381,No
59,57,3363,14,33,47,59,59,118,8,0.359501,0.376605,0.000379,No
75,73,5475,26,32,58,75,75,150,7,0.398622,0.417933,0.000379,No
29,28,812,18,21,39,29,29,58,7,0.384978,0.404126,0.000378,No
304,294,89376,84,82,166,304,304,608,7,0.356847,0.373344,0.000378,No
139,133,18487,43,59,102,139,139,278,7,0.414432,0.434001,0.000377,No
49,40,1960,26,20,46,49,49,98,7,0.364034,0.380145,0.000375,No
84,81,6804,17,55,72,84,84,168,7,0.407358,0.42758,0.000374,No
164,155,25420,115,24,139,164,164,328,8,0.373076,0.390724,0.000374,No
59,57,3363,25,27,52,59,59,118,7,0.386846,0.40616,0.000372,No
91,86,7826,23,38,61,91,91,182,7,0.404586,0.424306,0.000372,No
105,105,11025,33,60,93,105,105,210,8,0.398603,0.419289,0.000372,No
45,45,2025,22,30,52,45,45,90,7,0.353945,0.369171,0.000372,No
272,266,72352,52,84,136,272,272,544,7,0.40729,0.427506,0.000372,No
122,121,14762,30,42,72,122,122,244,7,0.402363,0.422578,0.00037,No
103,101,10403,33,61,94,103,103,206,8,0.37284,0.392317,0.000369,yes
344,324,111456,26,75,101,344,344,688,7,0.419548,0.439454,0.000369,No
79,77,6083,17,49,66,79,79,158,7,0.41531,0.434704,0.000368,No
230,226,51980,65,76,141,230,230,460,7,0.407309,0.427823,0.000366,No
40,35,1400,22,20,42,40,40,80,7,0.370419,0.387277,0.000364,No
64,60,3840,31,28,59,64,64,128,7,0.394831,0.413946,0.000362,No
210,205,43050,29,54,83,210,210,420,7,0.407796,0.42757,0.00036,No
95,82,7790,28,48,76,95,95,190,8,0.408255,0.428259,0.000359,No
207,190,39330,18,67,85,207,207,414,8,0.346936,0.362319,0.000358,No
143,140,20020,38,59,97,143,143,286,7,0.400314,0.420102,0.000357,No
102,91,9282,23,37,60,102,102,204,7,0.400709,0.420688,0.000357,No
95,94,8930,41,30,71,95,95,190,7,0.388263,0.407231,0.000354,No
11,11,121,6,8,14,11,11,22,7,0.35435,0.369495,0.000354,No
153,129,19737,16,60,76,153,153,306,7,0.409755,0.429724,0.000352,No
3,3,9,1,3,4,3,3,6,10,0.199537,0.202008,0.000352,No
104,93,9672,15,38,53,104,104,208,7,0.403342,0.422953,0.000351,No
73,70,5110,6,32,38,73,73,146,8,0.382073,0.402166,0.000351,No
62,57,3534,10,33,43,62,62,124,7,0.401652,0.421382,0.00035,No
376,365,137240,58,72,130,376,376,752,7,0.414281,0.434082,0.000349,No
290,285,82650,19,67,86,290,290,580,7,0.414362,0.434142,0.000348,No
110,100,11000,21,54,75,110,110,220,7,0.41406,0.433687,0.000347,No
115,112,12880,43,57,100,115,115,230,7,0.404711,0.424819,0.000347,No
121,117,14157,39,48,87,121,121,242,7,0.406639,0.426444,0.000345,No
107,100,10700,43,43,86,107,107,214,7,0.402296,0.422473,0.000345,No
50,48,2400,8,32,40,50,50,100,7,0.395187,0.414823,0.000343,No
83,82,6806,36,34,70,83,83,166,7,0.388025,0.407236,0.000343,No
152,139,21128,29,70,99,152,152,304,7,0.422247,0.441705,0.000343,No
105,101,10605,19,47,66,105,105,210,7,0.404634,0.424385,0.000342,No
125,109,13625,15,62,77,125,125,250,7,0.418201,0.437768,0.000342,No
51,47,2397,16,33,49,51,51,102,7,0.386592,0.406454,0.000342,No
38,36,1368,22,19,41,38,38,76,8,0.377952,0.396652,0.000342,No
99,96,9504,35,59,94,99,99,198,7,0.395206,0.415151,0.000341,yes
56,53,2968,21,24,45,56,56,112,7,0.347919,0.362168,0.000341,No
162,155,25110,11,64,75,162,162,324,7,0.402059,0.42229,0.000341,No
102,102,10404,71,51,122,102,102,204,8,0.355538,0.371249,0.000339,No
91,88,8008,17,50,67,91,91,182,7,0.376442,0.395061,0.000338,No
29,29,841,24,18,42,29,29,58,8,0.35065,0.365076,0.000338,No
57,56,3192,13,39,52,57,57,114,7,0.380888,0.399914,0.000338,No
36,34,1224,24,17,41,36,36,72,7,0.388989,0.408224,0.000337,No
150,146,21900,38,33,71,150,150,300,7,0.393828,0.413167,0.000336,No
80,76,6080,37,31,68,80,80,160,7,0.389557,0.408839,0.000334,No
34,32,1088,8,18,26,34,34,68,7,0.363894,0.380215,0.000333,No
118,107,12626,29,47,76,118,118,236,7,0.390833,0.410402,0.000333,No
159,158,25122,10,77,87,159,159,318,7,0.407747,0.427996,0.000332,No
42,41,1722,21,28,49,42,42,84,8,0.362664,0.379916,0.000332,No
134,127,17018,29,49,78,134,134,268,7,0.406698,0.42688,0.000332,No
127,121,15367,12,57,69,127,127,254,7,0.409961,0.430129,0.000331,No
52,51,2652,16,31,47,52,52,104,7,0.400408,0.420018,0.000331,No
98,95,9310,21,45,66,98,98,196,7,0.399845,0.419743,0.00033,No
96,96,9216,23,45,68,96,96,192,7,0.402572,0.422627,0.00033,No
52,51,2652,9,30,39,52,52,104,7,0.394986,0.414854,0.000328,No
56,56,3136,40,31,71,56,56,112,7,0.378538,0.397055,0.000328,No
57,56,3192,45,15,60,57,57,114,8,0.35758,0.372658,0.000327,No
103,103,10609,52,44,96,103,103,206,7,0.385962,0.405025,0.000327,No
43,41,1763,23,24,47,43,43,86,8,0.326971,0.335609,0.000326,No
105,100,10500,5,50,55,105,105,210,7,0.396068,0.415754,0.000326,No
52,47,2444,21,4,25,52,52,104,8,0.322955,0.330405,0.000325,No
31,31,961,17,19,36,31,31,62,7,0.353023,0.367816,0.000325,No
105,93,9765,19,45,64,105,105,210,7,0.393202,0.41306,0.000325,No
62,57,3534,26,39,65,62,62,124,7,0.401709,0.421402,0.000323,No
101,98,9898,48,37,85,101,101,202,7,0.402743,0.422376,0.000323,No
73,67,4891,43,22,65,73,73,146,8,0.328818,0.33854,0.000322,No
80,77,6160,20,48,68,80,80,160,7,0.403114,0.423168,0.000322,No
88,88,7744,16,45,61,88,88,176,7,0.405875,0.425646,0.000322,No
234,225,52650,38,55,93,234,234,468,7,0.408176,0.427924,0.00032,No
128,126,16128,43,44,87,128,128,256,7,0.396832,0.416609,0.00032,No
30,30,900,19,14,33,30,30,60,7,0.36568,0.38279,0.000318,No
452,440,198880,51,64,115,452,452,904,7,0.417239,0.436721,0.000316,No
129,122,15738,38,47,85,129,129,258,7,0.406359,0.426036,0.000315,No
13,13,169,11,10,21,13,13,26,8,0.318262,0.328427,0.000315,No
100,96,9600,42,36,78,100,100,200,7,0.397091,0.41673,0.000314,No
111,104,11544,34,53,87,111,111,222,7,0.414775,0.434274,0.000313,No
48,44,2112,22,24,46,48,48,96,8,0.352716,0.368266,0.000311,No
45,45,2025,23,32,55,45,45,90,7,0.348573,0.362456,0.000311,No
119,112,13328,30,44,74,119,119,238,7,0.395013,0.414743,0.00031,No
45,43,1935,25,30,55,45,45,90,7,0.348965,0.363441,0.000307,yes
96,96,9216,23,50,73,96,96,192,7,0.404739,0.424854,0.000307,No
107,97,10379,37,36,73,107,107,214,7,0.403171,0.422883,0.000307,No
137,131,17947,49,43,92,137,137,274,7,0.398092,0.417604,0.000306,No
64,63,4032,29,33,62,64,64,128,7,0.375895,0.394242,0.000305,No
65,63,4095,18,44,62,65,65,130,7,0.406339,0.426033,0.000304,No
65,63,4095,29,31,60,65,65,130,7,0.390628,0.4098,0.000304,No
54,52,2808,32,17,49,54,54,108,7,0.380226,0.398485,0.000304,No
48,46,2208,15,29,44,48,48,96,7,0.376326,0.395191,0.000303,No
76,75,5700,28,36,64,76,76,152,7,0.395636,0.41541,0.000302,No
74,70,5180,13,32,45,74,74,148,7,0.403619,0.423353,0.000302,No
30,30,900,16,19,35,30,30,60,7,0.35867,0.373921,0.000301,No
95,79,7505,24,35,59,95,95,190,7,0.391102,0.410467,0.000299,No
114,113,12882,29,51,80,114,114,228,7,0.389664,0.410035,0.000299,No
10,9,90,4,9,13,10,10,20,8,0.362133,0.377875,0.000299,No
128,125,16000,37,48,85,128,128,256,7,0.395389,0.414791,0.000297,No
64,61,3904,32,30,62,64,64,128,8,0.33172,0.343725,0.000297,No
185,164,30340,17,28,45,185,185,370,7,0.388759,0.408067,0.000295,No
2,2,4,2,2,4,2,2,4,8,0.331629,0.343145,0.000293,No
66,61,4026,13,35,48,66,66,132,7,0.38821,0.407338,0.000293,No
3,3,9,3,3,6,3,3,6,8,0.290005,0.297585,0.000293,No
75,70,5250,34,47,81,75,75,150,8,0.379456,0.39836,0.000292,No
61,56,3416,37,27,64,61,61,122,8,0.362218,0.378697,0.000292,No
79,78,6162,25,45,70,79,79,158,8,0.403992,0.424123,0.000292,No
76,75,5700,13,45,58,76,76,152,7,0.351677,0.365857,0.000291,No
70,70,4900,24,36,60,70,70,140,7,0.388573,0.407621,0.00029,No
75,68,5100,23,36,59,75,75,150,7,0.401237,0.42115,0.00029,No
24,24,576,17,16,33,24,24,48,7,0.37869,0.397347,0.000289,No
53,52,2756,29,37,66,53,53,106,7,0.402762,0.423014,0.000289,No
94,94,8836,39,49,88,94,94,188,7,0.404768,0.425066,0.000289,No
48,45,2160,14,34,48,48,48,96,7,0.379169,0.398031,0.000289,No
25,25,625,13,14,27,25,25,50,7,0.332379,0.342712,0.000288,No
169,155,26195,36,64,100,169,169,338,7,0.390538,0.410382,0.000287,yes
233,217,50561,26,78,104,233,233,466,7,0.419465,0.439251,0.000286,No
76,74,5624,31,23,54,76,76,152,8,0.382056,0.400973,0.000286,No
74,72,5328,19,41,60,74,74,148,7,0.395756,0.415663,0.000286,No
70,68,4760,32,29,61,70,70,140,7,0.393102,0.412182,0.000285,No
37,34,1258,11,27,38,37,37,74,7,0.397294,0.417007,0.000285,No
86,83,7138,21,51,72,86,86,172,7,0.401095,0.421314,0.000284,No
58,55,3190,20,29,49,58,58,116,7,0.368571,0.385781,0.000284,No
78,74,5772,10,36,46,78,78,156,7,0.396556,0.415911,0.000282,No
98,96,9408,13,38,51,98,98,196,7,0.393628,0.413452,0.000282,No
38,34,1292,11,23,34,38,38,76,7,0.373623,0.392474,0.000281,No
121,117,14157,39,41,80,121,121,242,7,0.411157,0.430715,0.000281,No
70,68,4760,5,49,54,70,70,140,7,0.403123,0.423075,0.000281,No
120,118,14160,31,32,63,120,120,240,7,0.403323,0.422985,0.00028,No
94,89,8366,18,37,55,94,94,188,7,0.391272,0.410579,0.00028,No
56,55,3080,25,26,51,56,56,112,7,0.326708,0.336724,0.000279,No
17,17,289,13,14,27,17,17,34,8,0.323573,0.332535,0.000279,No
74,67,4958,18,42,60,74,74,148,7,0.394183,0.413792,0.000278,No
45,44,1980,16,27,43,45,45,90,7,0.393175,0.412579,0.000278,No
14,13,182,7,12,19,14,14,28,8,0.363724,0.380652,0.000277,No
114,109,12426,36,38,74,114,114,228,7,0.363321,0.380546,0.000276,No
68,66,4488,5,49,54,68,68,136,7,0.403266,0.423487,0.000275,No
73,73,5329,30,26,56,73,73,146,7,0.394393,0.413944,0.000275,No
18,17,306,11,10,21,18,18,36,7,0.348111,0.361799,0.000274,No
562,514,288868,17,54,71,562,562,1124,7,0.402164,0.42202,0.000273,No
21,21,441,11,15,26,21,21,42,7,0.369153,0.386228,0.000272,No
68,65,4420,26,35,61,68,68,136,7,0.409391,0.428982,0.000271,No
84,84,7056,28,33,61,84,84,168,7,0.396703,0.41627,0.000271,No
42,39,1638,17,26,43,42,42,84,7,0.39674,0.416427,0.00027,No
80,73,5840,29,46,75,80,80,160,7,0.407971,0.427923,0.00027,No
162,154,24948,16,56,72,162,162,324,7,0.40946,0.429418,0.00027,No
21,21,441,12,16,28,21,21,42,7,0.358128,0.375412,0.000268,No
91,84,7644,38,46,84,91,91,182,7,0.394229,0.413569,0.000267,No
127,125,15875,36,70,106,127,127,254,7,0.412429,0.432672,0.000267,No
42,42,1764,20,25,45,42,42,84,7,0.390476,0.409486,0.000266,No
89,87,7743,20,33,53,89,89,178,8,0.315637,0.323503,0.000265,yes
54,53,2862,31,30,61,54,54,108,8,0.337193,0.349995,0.000265,yes
61,60,3660,35,22,57,61,61,122,8,0.367159,0.384098,0.000265,No
87,86,7482,21,47,68,87,87,174,7,0.397036,0.417361,0.000264,No
18,16,288,13,14,27,18,18,36,8,0.365649,0.383428,0.000264,No
182,173,31486,46,32,78,182,182,364,7,0.39698,0.416283,0.000263,No
12,12,144,10,10,20,12,12,24,8,0.369473,0.386919,0.000263,No
51,50,2550,20,32,52,51,51,102,7,0.393547,0.413507,0.000262,No
13,13,169,12,7,19,13,13,26,8,0.353835,0.369053,0.000262,No
63,62,3906,12,21,33,63,63,126,7,0.370967,0.388247,0.000261,No
61,61,3721,37,18,55,61,61,122,8,0.355154,0.370573,0.000261,No
41,41,1681,9,28,37,41,41,82,7,0.383507,0.402595,0.000261,No
72,57,4104,29,39,68,72,72,144,7,0.400935,0.420901,0.00026,No
39,34,1326,10,25,35,39,39,78,7,0.394338,0.413743,0.00026,No
94,93,8742,16,35,51,94,94,188,7,0.379321,0.398518,0.000259,No
23,23,529,23,14,37,23,23,46,7,0.362634,0.378396,0.000259,No
80,75,6000,36,28,64,80,80,160,7,0.380905,0.399264,0.000259,No
89,75,6675,39,6,45,89,89,178,7,0.338814,0.351393,0.000259,No
31,31,961,11,24,35,31,31,62,7,0.383042,0.401709,0.000259,No
14,13,182,12,11,23,14,14,28,7,0.361229,0.377361,0.000259,No
157,142,22294,11,67,78,157,157,314,8,0.354718,0.370623,0.000258,yes
82,78,6396,17,42,59,82,82,164,7,0.416252,0.435502,0.000257,No
86,84,7224,51,58,109,86,86,172,7,0.371589,0.390112,0.000257,No
25,24,600,16,17,33,25,25,50,7,0.380073,0.398864,0.000257,No
54,50,2700,25,39,64,54,54,108,8,0.398194,0.418391,0.000256,No
113,100,11300,36,44,80,113,113,226,7,0.397008,0.417144,0.000256,No
31,27,837,14,17,31,31,31,62,7,0.361366,0.378363,0.000256,No
62,60,3720,17,25,42,62,62,124,7,0.39228,0.41182,0.000255,No
93,90,8370,22,49,71,93,93,186,7,0.413248,0.432901,0.000255,No
14,13,182,7,13,20,14,14,28,8,0.336356,0.347204,0.000255,No
160,145,23200,74,64,138,160,160,320,7,0.38059,0.400059,0.000254,No
24,24,576,13,15,28,24,24,48,8,0.32054,0.327887,0.000252,yes
174,172,29928,53,39,92,174,174,348,7,0.405249,0.424887,0.000252,No
28,28,784,19,18,37,28,28,56,8,0.321937,0.331618,0.000252,No
37,28,1036,15,27,42,37,37,74,7,0.386548,0.405592,0.000251,No
57,54,3078,27,41,68,57,57,114,8,0.356236,0.372536,0.00025,yes
113,100,11300,58,75,133,113,113,226,7,0.398612,0.418972,0.00025,No
77,76,5852,21,38,59,77,77,154,7,0.405634,0.425298,0.00025,No
34,33,1122,27,12,39,34,34,68,8,0.361091,0.377373,0.000249,No
51,50,2550,23,30,53,51,51,102,7,0.379963,0.398673,0.000249,No
189,169,31941,8,88,96,189,189,378,8,0.347997,0.363283,0.000248,No
76,73,5548,14,42,56,76,76,152,7,0.397017,0.41685,0.000248,No
41,40,1640,13,20,33,41,41,82,7,0.384874,0.404567,0.000247,No
70,69,4830,19,35,54,70,70,140,7,0.402781,0.422304,0.000246,No
27,27,729,23,17,40,27,27,54,8,0.372238,0.38991,0.000245,No
105,101,10605,29,35,64,105,105,210,7,0.394694,0.414208,0.000245,No
137,128,17536,63,38,101,137,137,274,7,0.383145,0.401955,0.000244,No
103,103,10609,41,40,81,103,103,206,8,0.317398,0.325137,0.000244,No
118,111,13098,38,58,96,118,118,236,8,0.392316,0.4125,0.000242,No
136,135,18360,81,23,104,136,136,272,8,0.321343,0.329017,0.000242,No
98,92,9016,35,37,72,98,98,196,7,0.397331,0.41755,0.000242,No
38,37,1406,16,29,45,38,38,76,8,0.350061,0.364587,0.000241,No
32,31,992,16,21,37,32,32,64,7,0.378211,0.396667,0.000241,No
35,35,1225,21,12,33,35,35,70,8,0.346717,0.359999,0.000241,No
24,24,576,7,16,23,24,24,48,7,0.353023,0.36713,0.00024,No
45,45,2025,29,31,60,45,45,90,7,0.39086,0.410093,0.00024,No
58,51,2958,25,38,63,58,58,116,7,0.406417,0.426235,0.000239,No
95,94,8930,37,63,100,95,95,190,7,0.393565,0.413248,0.000239,No
9,9,81,3,8,11,9,9,18,8,0.318744,0.326958,0.000239,No
52,49,2548,15,31,46,52,52,104,7,0.392397,0.411674,0.000238,No
73,71,5183,53,21,74,73,73,146,8,0.352534,0.367516,0.000238,No
15,15,225,9,12,21,15,15,30,7,0.350773,0.365161,0.000237,No
20,20,400,19,17,36,20,20,40,8,0.375159,0.393198,0.000236,No
7,7,49,6,6,12,7,7,14,7,0.364166,0.380642,0.000236,No
65,64,4160,25,33,58,65,65,130,8,0.382133,0.400665,0.000235,No
6,6,36,6,6,12,6,6,12,7,0.356162,0.371469,0.000235,No
58,58,3364,46,29,75,58,58,116,8,0.318209,0.325678,0.000235,No
128,127,16256,6,67,73,128,128,256,7,0.420126,0.439756,0.000235,No
43,33,1419,17,34,51,43,43,86,7,0.365735,0.382939,0.000234,yes
5,5,25,4,3,7,5,5,10,8,0.240155,0.243425,0.000234,No
1,1,1,1,1,2,1,1,2,9,0.173611,0.175253,0.000234,No
1,1,1,1,1,2,1,1,2,9,0.253732,0.258593,0.000234,No
1,1,1,1,1,2,1,1,2,11,0.128881,0.129594,0.000234,No
1,1,1,1,1,2,1,1,2,8,0.210063,0.212954,0.000234,No
1,1,1,1,1,2,1,1,2,8,0.265891,0.271832,0.000234,No
1,1,1,1,1,2,1,1,2,10,0.147939,0.148978,0.000234,No
3,2,6,3,3,6,3,3,6,9,0.246031,0.250441,0.000234,No
1,1,1,1,1,2,1,1,2,10,0.202396,0.204838,0.000234,No
1,1,1,1,1,2,1,1,2,8,0.339961,0.352206,0.000234,No
1,1,1,1,1,2,1,1,2,11,0.168337,0.169757,0.000234,No
46,38,1748,31,36,67,46,46,92,7,0.39865,0.41877,0.000234,No
1,1,1,1,1,2,1,1,2,12,0.14409,0.145005,0.000234,No
126,123,15498,42,57,99,126,126,252,7,0.401832,0.42166,0.000233,No
39,38,1482,29,18,47,39,39,78,8,0.370002,0.38713,0.000232,No
71,64,4544,20,29,49,71,71,142,7,0.390047,0.409145,0.000232,No
52,44,2288,25,31,56,52,52,104,7,0.382596,0.401696,0.000232,No
306,299,91494,36,104,140,306,306,612,7,0.421132,0.441409,0.000231,No
9,9,81,7,6,13,9,9,18,8,0.346738,0.359975,0.000231,No
24,22,528,10,21,31,24,24,48,8,0.376983,0.395609,0.00023,No
60,54,3240,14,32,46,60,60,120,7,0.385814,0.404673,0.00023,No
118,117,13806,53,39,92,118,118,236,7,0.399359,0.418763,0.00023,No
25,25,625,11,19,30,25,25,50,8,0.355346,0.370019,0.00023,No
211,208,43888,22,52,74,211,211,422,7,0.392795,0.412815,0.00023,No
90,85,7650,15,38,53,90,90,180,8,0.39905,0.418834,0.000229,No
51,47,2397,34,31,65,51,51,102,7,0.388953,0.408254,0.000229,No
43,42,1806,33,26,59,43,43,86,7,0.382493,0.402482,0.000228,No
28,26,728,8,19,27,28,28,56,7,0.365696,0.382355,0.000227,No
148,135,19980,25,40,65,148,148,296,7,0.397646,0.417182,0.000227,No
76,73,5548,41,26,67,76,76,152,7,0.374591,0.392333,0.000226,No
28,28,784,17,17,34,28,28,56,7,0.371419,0.38917,0.000226,No
20,20,400,8,15,23,20,20,40,7,0.364524,0.38124,0.000225,No
44,43,1892,24,21,45,44,44,88,7,0.385308,0.404168,0.000224,No
33,29,957,13,25,38,33,33,66,7,0.375168,0.393047,0.000223,No
114,106,12084,39,55,94,114,114,228,7,0.406581,0.426581,0.000222,No
63,63,3969,34,26,60,63,63,126,7,0.357498,0.37268,0.000222,No
123,120,14760,32,39,71,123,123,246,7,0.387998,0.406929,0.000222,No
62,59,3658,15,26,41,62,62,124,7,0.395912,0.415409,0.000221,No
23,23,529,14,15,29,23,23,46,7,0.370886,0.388544,0.00022,No
117,115,13455,31,49,80,117,117,234,7,0.395416,0.415032,0.000219,No
32,26,832,8,21,29,32,32,64,7,0.388281,0.40716,0.000219,No
34,32,1088,10,23,33,34,34,68,7,0.377141,0.39546,0.000219,No
14,12,168,9,11,20,14,14,28,7,0.359736,0.375145,0.000218,No
50,40,2000,7,35,42,50,50,100,7,0.397008,0.417336,0.000218,No
51,43,2193,21,29,50,51,51,102,7,0.371371,0.38881,0.000218,No
59,55,3245,31,34,65,59,59,118,7,0.39722,0.416466,0.000217,No
38,37,1406,25,27,52,38,38,76,8,0.390914,0.410299,0.000217,No
20,17,340,10,13,23,20,20,40,8,0.363491,0.380411,0.000216,No
71,67,4757,38,35,73,71,71,142,7,0.394147,0.413645,0.000215,No
51,51,2601,23,34,57,51,51,102,7,0.399359,0.418829,0.000215,No
30,28,840,18,22,40,30,30,60,7,0.345349,0.358573,0.000214,No
21,18,378,10,14,24,21,21,42,8,0.36873,0.386042,0.000213,No
79,75,5925,26,42,68,79,79,158,7,0.386741,0.407159,0.000213,No
18,18,324,9,15,24,18,18,36,7,0.372978,0.39072,0.000213,No
14,14,196,12,9,21,14,14,28,7,0.339137,0.351565,0.000213,No
54,52,2808,28,29,57,54,54,108,7,0.368253,0.385503,0.000213,No
68,59,4012,14,35,49,68,68,136,7,0.407504,0.427045,0.000213,No
114,109,12426,8,55,63,114,114,228,7,0.41216,0.432206,0.000212,No
54,53,2862,19,27,46,54,54,108,7,0.369897,0.38792,0.000211,No
52,49,2548,15,20,35,52,52,104,8,0.366615,0.384413,0.000211,No
36,33,1188,18,18,36,36,36,72,7,0.386863,0.40581,0.000211,No
34,33,1122,16,30,46,34,34,68,7,0.36612,0.383752,0.00021,No
62,62,3844,25,38,63,62,62,124,8,0.369954,0.387494,0.00021,No
46,39,1794,15,21,36,46,46,92,7,0.390324,0.409524,0.00021,No
49,49,2401,16,30,46,49,49,98,8,0.379144,0.397974,0.000209,No
122,120,14640,23,27,50,122,122,244,8,0.367397,0.384563,0.000209,No
43,37,1591,15,23,38,43,43,86,7,0.365007,0.383277,0.000209,No
39,39,1521,20,21,41,39,39,78,7,0.379228,0.397742,0.000209,No
34,34,1156,22,25,47,34,34,68,7,0.370162,0.387562,0.000209,No
74,71,5254,25,31,56,74,74,148,7,0.383369,0.402128,0.000209,No
54,49,2646,30,27,57,54,54,108,7,0.344993,0.358505,0.000208,yes
123,120,14760,10,33,43,123,123,246,7,0.379726,0.397899,0.000208,No
63,61,3843,36,32,68,63,63,126,7,0.404107,0.423921,0.000208,No
66,64,4224,33,40,73,66,66,132,7,0.355191,0.370655,0.000208,No
19,19,361,15,13,28,19,19,38,7,0.374279,0.391691,0.000208,No
49,43,2107,21,29,50,49,49,98,8,0.378228,0.396732,0.000208,No
79,79,6241,36,23,59,79,79,158,7,0.373926,0.391829,0.000207,No
102,101,10302,14,52,66,102,102,204,8,0.40069,0.420826,0.000207,No
19,16,304,12,17,29,19,19,38,7,0.370782,0.388089,0.000207,No
124,119,14756,14,56,70,124,124,248,7,0.402524,0.422562,0.000207,No
25,23,575,5,21,26,25,25,50,8,0.349609,0.3632,0.000207,No
61,56,3416,24,23,47,61,61,122,7,0.391461,0.410858,0.000207,No
85,83,7055,22,38,60,85,85,170,7,0.388378,0.407735,0.000206,No
70,66,4620,42,28,70,70,70,140,7,0.378959,0.397282,0.000206,No
34,34,1156,22,27,49,34,34,68,7,0.378354,0.396798,0.000206,No
20,20,400,8,12,20,20,20,40,7,0.359017,0.374226,0.000206,No
83,77,6391,17,38,55,83,83,166,7,0.391066,0.41072,0.000205,No
101,100,10100,35,39,74,101,101,202,7,0.388794,0.407913,0.000205,No
27,27,729,10,23,33,27,27,54,8,0.389557,0.408961,0.000205,No
151,147,22197,51,55,106,151,151,302,7,0.410929,0.430851,0.000204,No
44,44,1936,14,37,51,44,44,88,7,0.408128,0.427877,0.000204,No
20,20,400,11,15,26,20,20,40,7,0.371694,0.389734,0.000202,No
60,60,3600,36,25,61,60,60,120,7,0.381928,0.400378,0.000201,No
32,32,1024,18,19,37,32,32,64,7,0.382647,0.401287,0.000201,No
45,43,1935,16,23,39,45,45,90,7,0.395068,0.414914,0.0002,No
29,27,783,17,18,35,29,29,58,7,0.373264,0.390421,0.0002,No
77,74,5698,11,43,54,77,77,154,7,0.415421,0.434858,0.0002,No
60,60,3600,36,19,55,60,60,120,8,0.347381,0.361647,0.000199,No
31,29,899,10,21,31,31,31,62,7,0.365845,0.38218,0.000198,No
60,48,2880,33,34,67,60,60,120,7,0.400832,0.420943,0.000198,No
17,14,238,5,11,16,17,17,34,7,0.361596,0.377358,0.000198,No
16,15,240,9,10,19,16,16,32,8,0.360002,0.375262,0.000198,No
71,67,4757,19,33,52,71,71,142,7,0.394046,0.413598,0.000198,No
75,70,5250,11,42,53,75,75,150,7,0.409145,0.428864,0.000197,No
135,125,16875,37,46,83,135,135,270,7,0.41084,0.430409,0.000197,No
46,44,2024,30,29,59,46,46,92,7,0.383593,0.402296,0.000197,No
42,40,1680,13,24,37,42,42,84,7,0.376775,0.394981,0.000197,No
15,15,225,6,10,16,15,15,30,8,0.359229,0.376345,0.000197,No
81,81,6561,60,19,79,81,81,162,7,0.361053,0.376374,0.000196,No
27,27,729,23,17,40,27,27,54,7,0.356154,0.371584,0.000196,No
110,107,11770,26,41,67,110,110,220,8,0.401501,0.42119,0.000196,No
66,62,4092,11,29,40,66,66,132,8,0.371913,0.390266,0.000195,No
18,18,324,10,10,20,18,18,36,7,0.360717,0.376539,0.000194,No
135,133,17955,46,49,95,135,135,270,7,0.410395,0.43013,0.000194,No
43,42,1806,36,5,41,43,43,86,7,0.342562,0.354382,0.000194,No
63,60,3780,15,27,42,63,63,126,7,0.402923,0.42274,0.000193,No
81,80,6480,39,26,65,81,81,162,7,0.382742,0.401128,0.000193,No
20,17,340,11,14,25,20,20,40,7,0.344707,0.358072,0.000193,No
19,19,361,9,14,23,19,19,38,7,0.320914,0.329636,0.000193,No
19,19,361,8,17,25,19,19,38,7,0.375415,0.393446,0.000192,No
129,124,15996,19,56,75,129,129,258,8,0.371759,0.390401,0.000192,No
72,72,5184,36,33,69,72,72,144,7,0.391605,0.411,0.000192,No
15,15,225,6,8,14,15,15,30,7,0.332282,0.343878,0.000192,No
165,156,25740,26,31,57,165,165,330,7,0.392406,0.412377,0.000192,No
59,57,3363,15,40,55,59,59,118,7,0.400963,0.421026,0.00019,No
83,79,6557,46,37,83,83,83,166,7,0.37054,0.387801,0.00019,No
118,116,13688,63,13,76,118,118,236,7,0.363043,0.379432,0.00019,No
46,46,2116,33,37,70,46,46,92,7,0.379946,0.398407,0.000189,No
54,51,2754,10,33,43,54,54,108,7,0.394803,0.414626,0.000189,No
43,41,1763,11,27,38,43,43,86,7,0.40241,0.421847,0.000188,No
49,49,2401,13,32,45,49,49,98,7,0.399555,0.419438,0.000188,No
52,46,2392,22,27,49,52,52,104,7,0.387831,0.407071,0.000188,No
19,19,361,15,17,32,19,19,38,7,0.363545,0.380801,0.000188,No
93,93,8649,9,55,64,93,93,186,7,0.403696,0.423757,0.000188,No
7,7,49,7,7,14,7,7,14,8,0.3089,0.315822,0.000188,No
84,79,6636,23,39,62,84,84,168,7,0.396943,0.41695,0.000187,No
232,223,51736,25,45,70,232,232,464,7,0.398398,0.418181,0.000187,No
49,49,2401,8,26,34,49,49,98,7,0.391012,0.410263,0.000187,No
4,4,16,4,4,8,4,4,8,8,0.287803,0.294932,0.000187,No
53,52,2756,34,30,64,53,53,106,7,0.383749,0.403294,0.000187,No
33,32,1056,20,21,41,33,33,66,7,0.379363,0.397719,0.000186,No
18,16,288,11,10,21,18,18,36,7,0.34312,0.355268,0.000186,No
53,52,2756,15,30,45,53,53,106,7,0.403171,0.422788,0.000186,No
9,9,81,7,7,14,9,9,18,7,0.365148,0.382122,0.000186,No
21,18,378,12,13,25,21,21,42,7,0.373231,0.391779,0.000186,No
130,126,16380,21,53,74,130,130,260,7,0.416333,0.436012,0.000185,No
8,7,56,5,7,12,8,8,16,7,0.349358,0.363504,0.000185,No
135,134,18090,40,28,68,135,135,270,8,0.387153,0.406096,0.000185,No
13,11,143,5,9,14,13,13,26,8,0.353037,0.367454,0.000185,No
139,132,18348,15,42,57,139,139,278,7,0.40039,0.419927,0.000184,No
102,102,10404,41,37,78,102,102,204,7,0.371905,0.389226,0.000184,No
25,25,625,13,13,26,25,25,50,8,0.314456,0.321692,0.000184,No
88,87,7656,32,27,59,88,88,176,7,0.385622,0.404773,0.000184,No
71,69,4899,25,35,60,71,71,142,7,0.382827,0.40169,0.000184,No
36,34,1224,15,18,33,36,36,72,7,0.386382,0.405106,0.000184,No
13,13,169,9,7,16,13,13,26,8,0.353447,0.368447,0.000183,No
9,8,72,3,9,12,9,9,18,8,0.358165,0.374535,0.000183,No
84,76,6384,21,34,55,84,84,168,7,0.401709,0.421549,0.000183,No
81,81,6561,6,45,51,81,81,162,7,0.403342,0.42336,0.000183,No
26,24,624,8,17,25,26,26,52,7,0.378002,0.397092,0.000182,No
30,30,900,25,24,49,30,30,60,8,0.368635,0.387251,0.000182,No
67,63,4221,7,42,49,67,67,134,7,0.392433,0.411681,0.000182,No
27,27,729,19,19,38,27,27,54,8,0.363267,0.380625,0.000182,No
12,10,120,6,8,14,12,12,24,8,0.36514,0.381696,0.000181,No
82,79,6478,29,33,62,82,82,164,7,0.394475,0.414001,0.000181,No
75,73,5475,19,28,47,75,75,150,7,0.386111,0.404657,0.000181,No
13,12,156,12,11,23,13,13,26,8,0.318096,0.329597,0.00018,No
7,7,49,5,5,10,7,7,14,8,0.311482,0.317932,0.00018,No
45,45,2025,15,19,34,45,45,90,7,0.384267,0.403147,0.00018,No
8,8,64,4,4,8,8,8,16,8,0.326902,0.337293,0.00018,No
13,12,156,8,8,16,13,13,26,7,0.343244,0.355252,0.00018,No
66,60,3960,19,37,56,66,66,132,7,0.38399,0.403789,0.00018,No
31,31,961,19,14,33,31,31,62,7,0.361305,0.37686,0.00018,No
4,4,16,3,4,7,4,4,8,8,0.339988,0.352321,0.00018,No
29,28,812,15,16,31,29,29,58,7,0.374271,0.391809,0.000179,No
52,52,2704,10,36,46,52,52,104,7,0.396731,0.41626,0.000179,No
25,24,600,12,20,32,25,25,50,7,0.380913,0.399045,0.000179,No
455,423,192465,25,48,73,455,455,910,7,0.393683,0.41333,0.000179,No
3,3,9,3,3,6,3,3,6,10,0.195309,0.197223,0.000178,No
81,80,6480,17,32,49,81,81,162,7,0.397174,0.416818,0.000178,No
80,78,6240,33,17,50,80,80,160,8,0.379372,0.397677,0.000178,No
53,49,2597,30,29,59,53,53,106,7,0.374033,0.391695,0.000178,No
39,33,1287,21,31,52,39,39,78,7,0.373027,0.391,0.000178,No
3,3,9,2,3,5,3,3,6,8,0.294973,0.302734,0.000178,No
7,7,49,6,6,12,7,7,14,7,0.337788,0.348606,0.000177,No
16,15,240,11,12,23,16,16,32,8,0.342356,0.355309,0.000177,No
41,39,1599,15,25,40,41,41,82,7,0.392091,0.411479,0.000177,No
7,7,49,5,6,11,7,7,14,8,0.335965,0.346884,0.000177,No
64,63,4032,17,30,47,64,64,128,7,0.382356,0.401159,0.000177,No
2,2,4,2,2,4,2,2,4,8,0.317481,0.327516,0.000176,No
1,1,1,1,1,2,1,1,2,10,0.186129,0.187976,0.000176,No
1,1,1,1,1,2,1,1,2,11,0.156929,0.158072,0.000176,No
12,10,120,4,7,11,12,12,24,8,0.318607,0.326686,0.000176,No
31,30,930,14,14,28,31,31,62,7,0.362749,0.37871,0.000176,No
1,1,1,1,1,2,1,1,2,9,0.228681,0.232028,0.000176,No
4,4,16,3,2,5,4,4,8,8,0.266851,0.272987,0.000176,No
4,4,16,3,2,5,4,4,8,9,0.249179,0.253891,0.000176,No
4,4,16,3,2,5,4,4,8,8,0.339968,0.352246,0.000176,No
3,3,9,3,3,6,3,3,6,9,0.258116,0.26374,0.000176,No
10,10,100,8,7,15,10,10,20,8,0.347919,0.362946,0.000176,No
3,3,9,3,2,5,3,3,6,8,0.314914,0.321909,0.000176,No
2,2,4,2,2,4,2,2,4,8,0.317309,0.324432,0.000176,No
1,1,1,1,1,2,1,1,2,8,0.296454,0.303652,0.000176,No
4,3,12,4,2,6,4,4,8,9,0.246305,0.251251,0.000176,No
85,76,6460,27,24,51,85,85,170,7,0.385901,0.405153,0.000175,No
28,28,784,17,14,31,28,28,56,8,0.359979,0.376612,0.000174,No
51,47,2397,37,27,64,51,51,102,7,0.397239,0.416726,0.000173,No
51,51,2601,23,27,50,51,51,102,7,0.37441,0.392274,0.000173,No
26,25,650,15,17,32,26,26,52,7,0.370218,0.387596,0.000173,No
56,54,3024,17,33,50,56,56,112,7,0.393965,0.41359,0.000172,No
19,18,342,14,18,32,19,19,38,8,0.372929,0.391051,0.000172,No
5,5,25,5,5,10,5,5,10,7,0.32057,0.330854,0.000172,No
124,122,15128,55,42,97,124,124,248,7,0.37492,0.393228,0.000171,yes
63,63,3969,23,32,55,63,63,126,8,0.367808,0.386236,0.000171,No
147,142,20874,18,44,62,147,147,294,7,0.398995,0.419257,0.000171,No
3,3,9,3,3,6,3,3,6,8,0.299772,0.307698,0.000171,No
98,94,9212,10,37,47,98,98,196,8,0.320161,0.328573,0.00017,No
72,63,4536,9,42,51,72,72,144,7,0.405509,0.425284,0.00017,No
42,42,1764,13,21,34,42,42,84,7,0.378077,0.396687,0.00017,No
36,36,1296,18,20,38,36,36,72,7,0.376658,0.394486,0.00017,No
60,56,3360,30,28,58,60,60,120,7,0.361481,0.377929,0.000169,yes
32,30,960,12,23,35,32,32,64,7,0.376102,0.394401,0.000169,No
36,36,1296,21,19,40,36,36,72,7,0.381799,0.400102,0.000169,No
59,57,3363,14,31,45,59,59,118,7,0.388883,0.407866,0.000169,No
68,64,4352,8,39,47,68,68,136,7,0.396298,0.415887,0.000169,No
34,29,986,19,20,39,34,34,68,7,0.362981,0.379054,0.000169,No
19,19,361,9,16,25,19,19,38,7,0.370259,0.387044,0.000169,No
87,84,7308,44,39,83,87,87,174,7,0.347848,0.36284,0.000168,yes
46,41,1886,11,26,37,46,46,92,7,0.382956,0.401686,0.000168,No
55,52,2860,18,32,50,55,55,110,8,0.390368,0.409964,0.000168,No
71,68,4828,38,21,59,71,71,142,8,0.376808,0.394645,0.000168,No
50,45,2250,25,21,46,50,50,100,7,0.365093,0.381492,0.000168,No
23,21,483,14,16,30,23,23,46,7,0.37418,0.392106,0.000167,No
24,24,576,16,19,35,24,24,48,8,0.352396,0.367877,0.000167,No
36,32,1152,11,21,32,36,36,72,7,0.384207,0.403532,0.000167,No
26,26,676,13,15,28,26,26,52,7,0.364906,0.381282,0.000167,No
47,45,2115,18,24,42,47,47,94,7,0.387725,0.406767,0.000167,No
56,56,3136,47,16,63,56,56,112,7,0.350809,0.365182,0.000166,No
94,90,8460,13,43,56,94,94,188,7,0.409371,0.429428,0.000166,No
11,11,121,8,8,16,11,11,22,8,0.360116,0.375465,0.000165,No
60,59,3540,20,24,44,60,60,120,7,0.388785,0.407803,0.000165,No
54,53,2862,22,27,49,54,54,108,7,0.387954,0.40718,0.000165,No
14,14,196,13,10,23,14,14,28,8,0.371832,0.389388,0.000165,No
77,77,5929,17,42,59,77,77,154,7,0.408567,0.428078,0.000164,No
14,14,196,7,8,15,14,14,28,8,0.330794,0.34172,0.000164,No
65,64,4160,17,19,36,65,65,130,7,0.365265,0.382018,0.000164,No
48,48,2304,9,21,30,48,48,96,7,0.384752,0.403359,0.000164,No
66,65,4290,39,14,53,66,66,132,7,0.367975,0.384767,0.000163,No
42,39,1638,18,26,44,42,42,84,7,0.381808,0.401001,0.000163,No
57,57,3249,21,31,52,57,57,114,7,0.386653,0.406005,0.000163,No
62,55,3410,20,22,42,62,62,124,7,0.389149,0.408524,0.000163,No
20,17,340,7,19,26,20,20,40,7,0.376119,0.394246,0.000163,No
71,70,4970,16,33,49,71,71,142,8,0.357168,0.372684,0.000162,No
29,29,841,17,18,35,29,29,58,7,0.391857,0.410931,0.000162,No
119,112,13328,33,50,83,119,119,238,8,0.375738,0.394892,0.000162,No
39,39,1521,18,22,40,39,39,78,7,0.371638,0.389168,0.000162,No
85,84,7140,14,35,49,85,85,170,8,0.368181,0.386222,0.000162,No
63,62,3906,13,28,41,63,63,126,7,0.40224,0.422208,0.000162,No
20,20,400,13,12,25,20,20,40,7,0.369841,0.386565,0.000162,No
45,42,1890,14,16,30,45,45,90,7,0.356735,0.372466,0.000161,No
27,27,729,16,20,36,27,27,54,8,0.374986,0.393481,0.000161,No
151,145,21895,30,46,76,151,151,302,7,0.403038,0.42266,0.000161,No
50,43,2150,13,27,40,50,50,100,7,0.387171,0.406254,0.00016,No
93,89,8277,32,34,66,93,93,186,7,0.393528,0.413183,0.00016,No
28,26,728,8,18,26,28,28,56,7,0.369753,0.386611,0.00016,No
104,100,10400,44,29,73,104,104,208,7,0.398045,0.417518,0.00016,No
69,67,4623,29,38,67,69,69,138,7,0.393238,0.412657,0.00016,No
77,73,5621,21,25,46,77,77,154,7,0.388201,0.406977,0.000159,No
48,47,2256,34,13,47,48,48,96,8,0.352979,0.368118,0.000159,No
18,17,306,8,16,24,18,18,36,7,0.355828,0.371493,0.000159,No
83,80,6640,23,21,44,83,83,166,7,0.385997,0.404881,0.000159,No
87,85,7395,16,18,34,87,87,174,7,0.375804,0.394272,0.000158,No
37,37,1369,15,23,38,37,37,74,7,0.385718,0.405485,0.000158,No
32,30,960,18,21,39,32,32,64,7,0.3956,0.414982,0.000158,No
18,18,324,12,9,21,18,18,36,7,0.366836,0.383431,0.000158,No
52,52,2704,29,27,56,52,52,104,7,0.37869,0.397661,0.000158,No
18,16,288,11,13,24,18,18,36,7,0.380769,0.399869,0.000157,No
24,24,576,12,19,31,24,24,48,7,0.383611,0.402448,0.000157,No
88,86,7568,21,35,56,88,87,175,7,0.388971,0.40806,0.000157,No
23,23,529,10,17,27,23,23,46,7,0.372181,0.38964,0.000157,No
37,37,1369,15,31,46,37,37,74,7,0.38215,0.400961,0.000157,No
42,36,1512,17,26,43,42,42,84,7,0.386513,0.405656,0.000157,No
33,32,1056,15,20,35,33,33,66,7,0.371897,0.389284,0.000156,No
49,39,1911,10,30,40,49,49,98,7,0.38769,0.40741,0.000156,No
29,27,783,11,19,30,29,29,58,7,0.382639,0.401274,0.000156,No
18,18,324,5,13,18,18,18,36,8,0.351727,0.366095,0.000155,No
107,106,11342,15,50,65,107,107,214,7,0.405953,0.425838,0.000155,No
35,35,1225,27,25,52,35,35,70,7,0.360793,0.376845,0.000155,No
25,25,625,5,18,23,25,25,50,8,0.37328,0.391972,0.000155,No
26,26,676,13,22,35,26,26,52,8,0.375771,0.394531,0.000154,No
67,53,3551,20,29,49,67,67,134,7,0.390449,0.409638,0.000154,No
42,41,1722,12,28,40,42,42,84,7,0.387478,0.406889,0.000154,No
37,34,1258,18,20,38,37,37,74,8,0.380845,0.399668,0.000154,No
11,7,77,5,9,14,11,11,22,8,0.326265,0.334836,0.000154,No
65,64,4160,33,10,43,65,65,130,8,0.36288,0.380275,0.000153,yes
68,65,4420,17,42,59,68,68,136,7,0.406882,0.426537,0.000153,No
58,53,3074,17,27,44,58,58,116,7,0.37869,0.397028,0.000153,No
11,11,121,7,7,14,11,11,22,7,0.362072,0.37818,0.000153,No
22,22,484,15,12,27,22,22,44,8,0.327958,0.336685,0.000152,No
47,47,2209,35,25,60,47,47,94,7,0.397869,0.417266,0.000152,No
56,54,3024,21,33,54,56,56,112,7,0.38543,0.405213,0.000152,No
20,20,400,15,10,25,20,20,40,7,0.340769,0.353819,0.000152,No
49,47,2303,18,28,46,49,49,98,8,0.386058,0.405715,0.000152,No
46,44,2024,20,22,42,46,46,92,7,0.37853,0.396707,0.000152,No
34,32,1088,15,21,36,34,34,68,7,0.375721,0.393882,0.000152,No
24,24,576,13,16,29,24,24,48,7,0.372238,0.390049,0.000152,No
74,71,5254,47,23,70,74,74,148,7,0.378513,0.397239,0.000151,No
47,44,2068,14,26,40,47,47,94,7,0.383611,0.40261,0.000151,No
30,28,840,10,19,29,30,30,60,7,0.374854,0.392865,0.000151,No
65,61,3965,26,32,58,65,65,130,7,0.382733,0.401195,0.000151,No
26,26,676,14,20,34,26,26,52,8,0.343839,0.357842,0.00015,yes
44,43,1892,25,25,50,44,44,88,8,0.384111,0.403094,0.00015,No
24,21,504,17,12,29,24,24,48,8,0.373902,0.392097,0.00015,No
26,23,598,13,18,31,26,26,52,7,0.387259,0.406085,0.00015,No
128,127,16256,25,52,77,128,128,256,8,0.390511,0.411311,0.00015,No
39,32,1248,10,16,26,39,39,78,7,0.375234,0.393522,0.00015,No
23,23,529,9,20,29,23,23,46,8,0.364392,0.380979,0.000149,No
21,20,420,9,14,23,21,21,42,7,0.369201,0.38652,0.000149,No
28,23,644,7,20,27,28,28,56,8,0.374591,0.39276,0.000149,No
49,48,2352,37,28,65,49,49,98,7,0.386067,0.404989,0.000149,No
17,16,272,9,15,24,17,17,34,8,0.368261,0.385352,0.000149,No
18,17,306,11,11,22,18,18,36,8,0.34507,0.359471,0.000149,No
43,38,1634,25,26,51,43,43,86,7,0.375151,0.393061,0.000148,yes
36,34,1224,17,21,38,36,36,72,7,0.377558,0.39541,0.000148,No
22,18,396,16,18,34,22,22,44,8,0.36727,0.384268,0.000148,No
36,35,1260,13,21,34,36,36,72,7,0.365015,0.381545,0.000148,No
28,27,756,12,15,27,28,28,56,7,0.364898,0.381914,0.000148,No
45,43,1935,25,31,56,45,45,90,7,0.378858,0.397369,0.000148,No
64,64,4096,6,35,41,64,64,128,7,0.394867,0.414452,0.000148,No
14,14,196,9,9,18,14,14,28,7,0.345167,0.35809,0.000148,No
45,42,1890,27,22,49,45,45,90,7,0.377659,0.39555,0.000148,No
13,13,169,5,11,16,13,13,26,8,0.35938,0.376162,0.000148,No
40,39,1560,24,18,42,40,40,80,7,0.333262,0.34363,0.000147,yes
37,35,1295,14,20,34,37,37,74,7,0.38852,0.407723,0.000147,No
74,73,5402,18,34,52,74,74,148,8,0.400371,0.420132,0.000147,No
28,28,784,16,22,38,28,28,56,7,0.381271,0.399828,0.000147,No
37,37,1369,21,18,39,37,37,74,7,0.375812,0.393555,0.000147,No
21,21,441,9,14,23,21,21,42,7,0.350147,0.363295,0.000147,No
47,45,2115,23,25,48,47,47,94,7,0.38197,0.400361,0.000146,No
49,48,2352,14,22,36,49,49,98,8,0.347388,0.362361,0.000146,No
25,25,625,14,22,36,25,25,50,7,0.369065,0.386762,0.000146,No
38,38,1444,19,22,41,38,38,76,8,0.37755,0.396457,0.000146,No
3,3,9,3,3,6,3,3,6,7,0.327901,0.338637,0.000146,No
24,24,576,10,14,24,24,24,48,8,0.371605,0.389893,0.000146,No
35,35,1225,14,25,39,35,35,70,8,0.383335,0.402286,0.000146,No
58,54,3132,9,19,28,58,58,116,7,0.371873,0.389722,0.000145,No
38,38,1444,31,19,50,38,38,76,8,0.368746,0.385947,0.000145,No
37,34,1258,14,28,42,37,37,74,7,0.386224,0.405723,0.000145,No
55,46,2530,16,23,39,55,55,110,8,0.368595,0.385858,0.000145,No
22,22,484,17,10,27,22,22,44,8,0.308019,0.314904,0.000145,No
225,225,50625,38,38,76,225,225,450,8,0.383361,0.402593,0.000145,No
41,41,1681,11,30,41,41,41,82,7,0.387593,0.40698,0.000145,No
75,75,5625,11,37,48,75,75,150,7,0.388475,0.408007,0.000145,No
64,63,4032,8,46,54,64,64,128,7,0.408861,0.428466,0.000145,No
44,42,1848,29,9,38,44,44,88,8,0.337494,0.349676,0.000144,No
7,7,49,5,5,10,7,7,14,8,0.329389,0.340669,0.000144,No
15,14,210,10,11,21,15,15,30,7,0.378027,0.396143,0.000144,No
31,29,899,12,20,32,31,31,62,7,0.369241,0.387245,0.000144,No
10,10,100,6,8,14,10,10,20,8,0.358572,0.375108,0.000144,No
118,109,12862,36,42,78,118,118,236,8,0.374962,0.394071,0.000143,No
3,3,9,3,2,5,3,3,6,7,0.352614,0.366956,0.000143,No
10,10,100,9,7,16,10,10,20,8,0.348232,0.362521,0.000143,No
88,76,6688,21,23,44,88,88,176,8,0.386259,0.405503,0.000143,No
55,55,3025,16,35,51,55,55,110,7,0.396676,0.416671,0.000143,No
33,33,1089,24,15,39,33,33,66,8,0.374057,0.39128,0.000142,No
4,4,16,3,4,7,4,4,8,8,0.327756,0.33888,0.000142,No
44,42,1848,24,15,39,44,44,88,8,0.366057,0.383375,0.000142,No
61,59,3599,9,29,38,61,61,122,7,0.39183,0.411366,0.000142,No
34,34,1156,12,15,27,34,34,68,7,0.359093,0.37483,0.000142,No
78,72,5616,14,41,55,78,78,156,7,0.399658,0.41965,0.000142,No
44,43,1892,8,28,36,44,44,88,7,0.398296,0.417943,0.000142,No
14,14,196,8,10,18,14,14,28,7,0.356758,0.37203,0.000142,No
32,30,960,13,18,31,32,32,64,7,0.372652,0.390434,0.000142,No
12,12,144,7,8,15,12,12,24,8,0.347459,0.362887,0.000142,No
24,21,504,8,17,25,24,24,48,7,0.37525,0.39295,0.000142,No
19,19,361,18,16,34,19,19,38,8,0.368031,0.38528,0.000142,No
127,126,16002,20,38,58,127,127,254,7,0.40153,0.421297,0.000141,No
34,34,1156,14,24,38,34,34,68,8,0.371371,0.389082,0.000141,No
15,12,180,5,14,19,15,15,30,7,0.372546,0.389701,0.000141,No
36,34,1224,15,22,37,36,36,72,7,0.382965,0.40234,0.000141,No
33,32,1056,10,25,35,33,33,66,8,0.376218,0.395401,0.000141,No
30,27,810,9,18,27,30,30,60,7,0.374287,0.392178,0.000141,No
15,13,195,10,12,22,15,15,30,7,0.371064,0.388572,0.000141,No
48,46,2208,29,28,57,48,48,96,8,0.392316,0.412443,0.000141,No
29,25,725,9,13,22,29,29,58,7,0.367713,0.384596,0.00014,No
25,18,450,10,16,26,25,25,50,8,0.360717,0.377523,0.00014,No
32,30,960,16,16,32,32,32,64,7,0.386863,0.405682,0.00014,No
37,33,1221,5,19,24,37,37,74,7,0.372254,0.38985,0.00014,No
72,70,5040,14,34,48,72,72,144,7,0.406011,0.425521,0.00014,No
10,10,100,6,9,15,10,10,20,7,0.310028,0.317689,0.00014,No
24,22,528,9,15,24,24,24,48,8,0.365845,0.383472,0.00014,No
7,7,49,7,7,14,7,7,14,8,0.317546,0.325724,0.000139,No
15,15,225,8,10,18,15,15,30,7,0.359592,0.376251,0.000139,No
45,45,2025,25,28,53,45,45,90,7,0.390074,0.40966,0.000139,No
15,12,180,6,11,17,15,15,30,8,0.365782,0.38317,0.000139,No
55,48,2640,12,26,38,55,55,110,7,0.393157,0.412918,0.000139,No
64,64,4096,26,26,52,64,64,128,7,0.399536,0.418919,0.000139,No
67,59,3953,22,28,50,67,67,134,7,0.392587,0.411764,0.000139,No
45,45,2025,15,30,45,45,45,90,7,0.383576,0.40386,0.000139,No
235,215,50525,2,48,50,235,235,470,7,0.408969,0.428711,0.000139,No
23,22,506,11,15,26,23,23,46,7,0.373166,0.391112,0.000139,No
22,22,484,15,14,29,22,22,44,8,0.353806,0.36908,0.000139,No
34,33,1122,9,21,30,34,34,68,7,0.393465,0.412935,0.000139,No
8,5,40,4,7,11,8,8,16,7,0.339522,0.352316,0.000138,No
65,61,3965,21,27,48,65,65,130,7,0.404874,0.424425,0.000138,No
47,47,2209,37,19,56,47,47,94,7,0.358414,0.374018,0.000138,No
34,34,1156,11,28,39,34,34,68,7,0.382639,0.400978,0.000138,No
15,15,225,7,9,16,15,15,30,8,0.347487,0.361654,0.000137,No
28,28,784,19,17,36,28,28,56,7,0.381697,0.400428,0.000137,No
30,28,840,6,19,25,30,30,60,7,0.374139,0.391409,0.000137,No
10,9,90,5,8,13,10,10,20,7,0.340735,0.352582,0.000137,No
27,27,729,18,20,38,27,27,54,8,0.329866,0.340197,0.000137,No
46,44,2024,25,34,59,46,46,92,7,0.398454,0.417863,0.000137,No
83,79,6557,34,35,69,83,83,166,7,0.389967,0.409226,0.000136,No
32,31,992,11,21,32,32,32,64,8,0.361527,0.37831,0.000136,No
24,24,576,13,16,29,24,24,48,7,0.3678,0.38503,0.000136,No
7,7,49,7,6,13,7,7,14,8,0.311511,0.318475,0.000136,No
75,75,5625,21,36,57,75,75,150,7,0.407076,0.426925,0.000136,No
15,15,225,5,15,20,15,15,30,8,0.350614,0.365573,0.000135,No
48,48,2304,28,33,61,48,48,96,8,0.335556,0.347193,0.000135,No
26,25,650,16,21,37,26,26,52,7,0.382888,0.401079,0.000135,No
54,49,2646,19,34,53,54,54,108,7,0.398911,0.418553,0.000135,No
11,11,121,9,9,18,11,11,22,7,0.351604,0.366403,0.000135,No
7,7,49,7,6,13,7,7,14,8,0.353498,0.368244,0.000134,No
28,26,728,12,21,33,28,28,56,7,0.384501,0.403088,0.000133,No
8,8,64,4,7,11,8,8,16,7,0.357932,0.373133,0.000133,No
67,62,4154,17,17,34,67,67,134,7,0.348623,0.362907,0.000133,No
11,11,121,7,9,16,11,11,22,7,0.366017,0.382504,0.000133,No
176,175,30800,13,72,85,176,176,352,7,0.38994,0.410919,0.000133,No
9,9,81,5,5,10,9,9,18,8,0.352119,0.366479,0.000133,No
105,93,9765,14,41,55,105,105,210,7,0.401974,0.422076,0.000132,No
25,24,600,12,14,26,25,25,50,8,0.356206,0.371698,0.000132,No
61,59,3599,11,32,43,61,61,122,7,0.393211,0.413106,0.000132,No
77,77,5929,22,35,57,77,77,154,7,0.397294,0.416791,0.000132,No
18,18,324,12,11,23,18,18,36,7,0.368293,0.385079,0.000132,No
26,26,676,16,14,30,26,26,52,7,0.356884,0.372113,0.000131,No
57,51,2907,11,26,37,57,57,114,7,0.378119,0.396138,0.000131,No
19,19,361,16,17,33,19,19,38,8,0.347912,0.363378,0.000131,No
33,32,1056,21,26,47,33,33,66,7,0.390306,0.409469,0.000131,No
7,7,49,7,5,12,7,7,14,8,0.300908,0.310007,0.000131,No
8,8,64,2,7,9,8,8,16,8,0.34272,0.356751,0.000131,No
9,9,81,7,8,15,9,9,18,8,0.342287,0.355535,0.00013,No
20,20,400,10,15,25,20,20,40,8,0.376675,0.395785,0.00013,No
13,13,169,11,8,19,13,13,26,7,0.356899,0.372907,0.00013,No
17,17,289,9,11,20,17,17,34,8,0.344965,0.358361,0.00013,No
17,17,289,16,11,27,17,17,34,8,0.340892,0.353372,0.00013,No
60,58,3480,34,28,62,60,60,120,7,0.38632,0.405216,0.00013,No
39,38,1482,12,27,39,39,39,78,7,0.403009,0.422657,0.00013,No
34,32,1088,17,11,28,34,34,68,8,0.376675,0.394774,0.00013,No
7,7,49,4,6,10,7,7,14,8,0.359797,0.376428,0.000129,No
20,20,400,10,12,22,20,20,40,7,0.37665,0.395228,0.000129,No
12,11,132,8,7,15,12,12,24,7,0.364797,0.381069,0.000129,No
11,11,121,7,7,14,11,11,22,8,0.337167,0.349042,0.000129,No
9,9,81,6,6,12,9,9,18,7,0.361359,0.376956,0.000129,No
37,35,1295,7,26,33,37,37,74,7,0.385161,0.404485,0.000129,No
33,30,990,15,26,41,33,33,66,7,0.386574,0.405664,0.000129,No
8,7,56,4,8,12,8,8,16,8,0.327738,0.339149,0.000129,No
12,12,144,10,9,19,12,12,24,8,0.365226,0.381735,0.000128,No
49,40,1960,27,23,50,49,49,98,7,0.385918,0.404985,0.000128,No
94,92,8648,37,29,66,94,94,188,7,0.386347,0.405058,0.000128,No
1,1,1,1,1,2,1,1,2,7,0.327826,0.338517,0.000128,No
22,22,484,14,11,25,22,22,44,7,0.369169,0.386614,0.000128,No
31,30,930,10,25,35,31,31,62,8,0.375605,0.393722,0.000128,No
45,43,1935,31,22,53,45,45,90,7,0.342376,0.354353,0.000128,No
9,9,81,8,8,16,9,9,18,7,0.357595,0.373084,0.000127,No
8,8,64,7,8,15,8,8,16,7,0.342672,0.35643,0.000127,No
11,9,99,9,7,16,11,11,22,8,0.350096,0.364104,0.000127,No
7,7,49,5,5,10,7,7,14,7,0.340158,0.353622,0.000127,No
64,62,3968,18,28,46,64,64,128,7,0.380556,0.399564,0.000127,No
5,5,25,5,5,10,5,5,10,8,0.346781,0.360747,0.000127,No
14,14,196,10,11,21,14,14,28,8,0.360954,0.377403,0.000127,No
25,24,600,7,11,18,25,25,50,8,0.359145,0.374785,0.000127,No
17,17,289,9,15,24,17,17,34,7,0.372897,0.390816,0.000127,No
50,47,2350,20,4,24,50,50,100,7,0.334772,0.346404,0.000127,No
27,27,729,9,21,30,27,27,54,7,0.373011,0.39087,0.000127,No
73,70,5110,31,32,63,73,73,146,8,0.347678,0.362382,0.000126,No
12,12,144,5,12,17,12,12,24,7,0.359721,0.374987,0.000126,No
8,8,64,7,6,13,8,8,16,7,0.364454,0.381224,0.000126,No
9,8,72,4,8,12,9,9,18,8,0.358964,0.375647,0.000126,No
45,44,1980,12,28,40,45,45,90,7,0.388025,0.407355,0.000126,No
54,54,2916,24,26,50,54,54,108,7,0.392028,0.411141,0.000126,No
52,51,2652,27,23,50,52,52,104,7,0.374394,0.392546,0.000125,No
7,7,49,6,6,12,7,7,14,8,0.367159,0.384592,0.000125,No
16,15,240,8,14,22,16,16,32,7,0.367959,0.384495,0.000125,No
97,97,9409,39,52,91,97,97,194,7,0.406436,0.426149,0.000125,No
44,41,1804,19,27,46,44,44,88,7,0.387399,0.406545,0.000125,No
16,15,240,10,6,16,16,16,32,7,0.351561,0.366414,0.000125,No
30,30,900,16,13,29,30,30,60,8,0.352367,0.366878,0.000125,No
27,26,702,18,12,30,27,27,54,8,0.353271,0.368317,0.000125,No
7,7,49,4,7,11,7,7,14,7,0.343652,0.356678,0.000125,No
20,20,400,4,16,20,20,20,40,8,0.359509,0.37559,0.000125,No
17,17,289,16,15,31,17,17,34,8,0.362587,0.379027,0.000125,No
10,10,100,5,8,13,10,10,20,8,0.34544,0.358509,0.000124,No
13,13,169,6,9,15,13,13,26,7,0.367025,0.38384,0.000124,No
26,19,494,10,24,34,26,26,52,7,0.375539,0.393507,0.000124,No
82,82,6724,14,38,52,82,82,164,7,0.385169,0.404133,0.000124,No
51,49,2499,16,22,38,51,51,102,7,0.383973,0.403027,0.000124,No
13,13,169,9,9,18,13,13,26,7,0.369553,0.386278,0.000124,No
12,12,144,4,7,11,12,12,24,8,0.34217,0.35494,0.000124,No
37,37,1369,21,8,29,37,37,74,7,0.352134,0.367413,0.000124,No
29,26,754,15,21,36,29,29,58,7,0.364399,0.381345,0.000123,yes
16,16,256,10,13,23,16,16,32,7,0.351604,0.366133,0.000123,No
5,5,25,3,5,8,5,5,10,8,0.3185,0.328655,0.000123,No
7,7,49,4,7,11,7,7,14,8,0.342589,0.354739,0.000123,No
6,6,36,3,5,8,6,6,12,8,0.339982,0.353472,0.000123,No
43,43,1849,6,29,35,43,43,86,8,0.38836,0.40774,0.000123,No
29,29,841,25,13,38,29,29,58,8,0.318595,0.325903,0.000123,No
4,4,16,3,3,6,4,4,8,8,0.323481,0.33454,0.000123,No
18,17,306,7,12,19,18,18,36,7,0.373893,0.391471,0.000123,No
6,6,36,4,6,10,6,6,12,8,0.344686,0.358099,0.000123,No
43,42,1806,20,30,50,43,43,86,8,0.387276,0.40681,0.000123,No
5,5,25,5,5,10,5,5,10,8,0.3113,0.319027,0.000122,No
51,50,2550,12,28,40,51,51,102,7,0.387171,0.406156,0.000122,No
22,22,484,14,14,28,22,22,44,8,0.35818,0.373833,0.000122,No
4,4,16,3,3,6,4,4,8,8,0.339975,0.352282,0.000122,No
12,11,132,5,7,12,12,12,24,7,0.342968,0.356365,0.000122,No
19,17,323,9,15,24,19,19,38,7,0.371403,0.38842,0.000122,No
5,5,25,3,5,8,5,5,10,8,0.321228,0.329497,0.000122,No
4,4,16,4,3,7,4,4,8,8,0.352025,0.36633,0.000122,No
9,9,81,8,7,15,9,9,18,8,0.305285,0.312025,0.000122,No
12,11,132,10,5,15,12,12,24,7,0.33827,0.349756,0.000122,No
7,7,49,4,6,10,7,7,14,7,0.338989,0.350729,0.000122,No
42,34,1428,7,27,34,42,42,84,7,0.386548,0.405319,0.000122,No
14,14,196,4,7,11,14,14,28,7,0.355701,0.370454,0.000121,No
8,8,64,5,5,10,8,8,16,8,0.331475,0.343965,0.000121,No
9,9,81,8,8,16,9,9,18,8,0.349287,0.363105,0.000121,No
9,9,81,8,8,16,9,9,18,7,0.352279,0.36625,0.000121,No
10,10,100,4,7,11,10,10,20,7,0.346746,0.361265,0.000121,No
4,3,12,3,4,7,4,4,8,8,0.343686,0.357039,0.000121,No
5,5,25,5,5,10,5,5,10,8,0.347997,0.361134,0.000121,No
9,9,81,7,7,14,9,9,18,8,0.334615,0.347491,0.000121,No
44,31,1364,9,23,32,44,44,88,7,0.389451,0.408792,0.000121,No
59,58,3422,31,30,61,59,59,118,7,0.372986,0.390492,0.000121,No
10,10,100,7,6,13,10,10,20,8,0.334982,0.345598,0.000121,No
5,5,25,4,5,9,5,5,10,8,0.320999,0.329076,0.00012,No
2,2,4,2,2,4,2,2,4,8,0.292315,0.300626,0.00012,No
29,25,725,19,16,35,29,29,58,7,0.376235,0.394587,0.00012,No
6,6,36,6,6,12,6,6,12,8,0.31423,0.321216,0.00012,No
35,35,1225,17,21,38,35,35,70,7,0.35539,0.371521,0.00012,No
2,2,4,2,2,4,2,2,4,8,0.27878,0.28832,0.00012,No
8,8,64,8,8,16,8,8,16,7,0.308431,0.316462,0.00012,No
2,2,4,2,2,4,2,2,4,7,0.327857,0.338574,0.00012,No
61,52,3172,15,29,44,61,61,122,7,0.393538,0.413253,0.00012,No
72,69,4968,5,48,53,72,72,144,7,0.404778,0.425095,0.00012,No
47,40,1880,10,27,37,47,47,94,7,0.385666,0.404454,0.00012,No
8,7,56,5,7,12,8,8,16,8,0.325468,0.334508,0.00012,No
6,4,24,5,5,10,6,6,12,7,0.332444,0.343451,0.000119,No
19,19,361,9,14,23,19,19,38,7,0.350542,0.364982,0.000119,No
220,214,47080,12,39,51,220,220,440,8,0.387558,0.406614,0.000119,No
14,14,196,8,7,15,14,14,28,8,0.338612,0.350749,0.000119,No
10,10,100,7,5,12,10,10,20,7,0.359403,0.375543,0.000119,No
13,13,169,8,7,15,13,13,26,8,0.363313,0.380603,0.000119,No
2,2,4,2,2,4,2,2,4,8,0.339941,0.352224,0.000119,No
7,7,49,6,5,11,7,7,14,8,0.330608,0.341386,0.000119,No
8,8,64,2,7,9,8,8,16,7,0.360047,0.376722,0.000119,No
8,6,48,6,5,11,8,8,16,8,0.352083,0.36682,0.000119,No
6,6,36,6,5,11,6,6,12,7,0.350478,0.364567,0.000119,No
3,3,9,3,3,6,3,3,6,8,0.348922,0.365083,0.000119,No
5,5,25,4,3,7,5,5,10,7,0.342239,0.354912,0.000119,No
7,7,49,5,4,9,7,7,14,7,0.330077,0.340615,0.000119,No
2,2,4,2,2,4,2,2,4,9,0.235527,0.239462,0.000119,No
6,6,36,4,6,10,6,6,12,8,0.351264,0.365656,0.000119,No
3,3,9,3,3,6,3,3,6,8,0.294515,0.301691,0.000119,No
67,66,4422,37,37,74,67,67,134,7,0.388617,0.407745,0.000119,No
50,46,2300,10,21,31,50,50,100,7,0.379938,0.398076,0.000119,No
6,5,30,6,5,11,6,6,12,7,0.330903,0.341771,0.000119,No
35,35,1225,15,21,36,35,35,70,7,0.386137,0.405005,0.000119,No
13,12,156,2,13,15,13,13,26,7,0.33829,0.35113,0.000119,No
3,3,9,3,3,6,3,3,6,7,0.320751,0.329153,0.000119,No
6,6,36,4,4,8,6,6,12,8,0.328097,0.337083,0.000118,No
4,4,16,4,4,8,4,4,8,8,0.340579,0.352837,0.000118,No
12,11,132,11,6,17,12,12,24,8,0.345755,0.359419,0.000118,No
2,2,4,2,2,4,2,2,4,8,0.243618,0.24796,0.000118,No
5,5,25,3,2,5,5,5,10,8,0.28109,0.288117,0.000118,No
15,15,225,6,10,16,15,15,30,8,0.351026,0.36455,0.000118,No
59,58,3422,11,27,38,59,59,118,8,0.382536,0.401082,0.000118,No
8,8,64,6,5,11,8,8,16,8,0.309297,0.318899,0.000118,No
10,10,100,8,8,16,10,10,20,8,0.338042,0.349698,0.000118,No
3,3,9,2,2,4,3,3,6,9,0.244333,0.24865,0.000118,No
8,8,64,8,7,15,8,8,16,7,0.359388,0.374571,0.000118,No
7,7,49,3,5,8,7,7,14,8,0.319646,0.327379,0.000118,No
77,69,5313,23,33,56,77,77,154,7,0.401993,0.421533,0.000118,No
8,8,64,4,5,9,8,8,16,8,0.346647,0.360519,0.000118,No
6,6,36,6,6,12,6,6,12,8,0.354151,0.369859,0.000118,No
9,9,81,4,6,10,9,9,18,8,0.327681,0.338661,0.000118,No
5,5,25,4,4,8,5,5,10,8,0.332586,0.344156,0.000118,No
9,9,81,5,4,9,9,9,18,7,0.335154,0.346072,0.000118,No
72,71,5112,29,31,60,72,72,144,7,0.387285,0.40627,0.000118,No
12,12,144,7,6,13,12,12,24,8,0.34736,0.361493,0.000118,No
2,2,4,2,2,4,2,2,4,9,0.271894,0.280228,0.000118,No
3,3,9,2,2,4,3,3,6,8,0.260182,0.265927,0.000118,No
2,2,4,2,2,4,2,2,4,9,0.2737,0.28046,0.000117,No
2,2,4,1,2,3,2,2,4,9,0.245507,0.250548,0.000117,No
3,3,9,1,3,4,3,3,6,8,0.343652,0.356964,0.000117,No
4,4,16,3,3,6,4,4,8,8,0.340104,0.352442,0.000117,No
2,2,4,2,2,4,2,2,4,9,0.249037,0.253753,0.000117,No
4,4,16,2,3,5,4,4,8,8,0.308414,0.322401,0.000117,No
2,2,4,2,2,4,2,2,4,9,0.24695,0.250762,0.000117,No
2,2,4,2,2,4,2,2,4,9,0.230684,0.234339,0.000117,No
1,1,1,1,1,2,1,1,2,10,0.202382,0.204831,0.000117,No
1,1,1,1,1,2,1,1,2,10,0.193123,0.194755,0.000117,No
4,4,16,2,2,4,4,4,8,8,0.246939,0.251378,0.000117,No
2,2,4,2,2,4,2,2,4,8,0.317463,0.327498,0.000117,No
1,1,1,1,1,2,1,1,2,9,0.23933,0.242366,0.000117,No
1,1,1,1,1,2,1,1,2,8,0.314601,0.32147,0.000117,No
3,3,9,3,3,6,3,3,6,8,0.271444,0.277977,0.000117,No
1,1,1,1,1,2,1,1,2,9,0.249062,0.253743,0.000117,No
3,3,9,2,3,5,3,3,6,7,0.31812,0.325331,0.000117,No
3,3,9,3,3,6,3,3,6,8,0.319855,0.329218,0.000117,No
30,30,900,23,12,35,30,30,60,8,0.346,0.360957,0.000117,No
2,2,4,2,2,4,2,2,4,8,0.339975,0.352256,0.000117,No
5,5,25,5,4,9,5,5,10,8,0.349301,0.364294,0.000117,No
3,3,9,3,3,6,3,3,6,8,0.303245,0.311577,0.000117,No
1,1,1,1,1,2,1,1,2,8,0.266901,0.272944,0.000117,No
2,2,4,1,2,3,2,2,4,9,0.253725,0.258629,0.000117,No
3,3,9,2,2,4,3,3,6,8,0.331604,0.343125,0.000117,No
1,1,1,1,1,2,1,1,2,8,0.331584,0.343081,0.000117,No
4,4,16,3,3,6,4,4,8,8,0.349616,0.363689,0.000117,No
2,2,4,2,2,4,2,2,4,8,0.310062,0.318741,0.000117,No
2,1,2,2,2,4,2,2,4,7,0.296315,0.304894,0.000117,No
3,3,9,3,3,6,3,3,6,8,0.336508,0.349325,0.000117,No
1,1,1,1,1,2,1,1,2,9,0.253717,0.258587,0.000117,No
2,2,4,1,2,3,2,2,4,8,0.304018,0.310624,0.000117,No
3,3,9,3,3,6,3,3,6,8,0.296583,0.306985,0.000117,No
3,3,9,3,3,6,3,3,6,8,0.295187,0.302195,0.000117,No
1,1,1,1,1,2,1,1,2,9,0.239511,0.24259,0.000117,No
1,1,1,1,1,2,1,1,2,8,0.258927,0.264407,0.000117,No
1,1,1,1,1,2,1,1,2,10,0.193241,0.194892,0.000117,No
2,2,4,2,1,3,2,2,4,9,0.233149,0.236188,0.000117,No
3,3,9,3,3,6,3,3,6,7,0.327857,0.3386,0.000117,No
1,1,1,1,1,2,1,1,2,11,0.161954,0.162961,0.000117,No
6,6,36,2,6,8,6,6,12,7,0.321743,0.331133,0.000117,No
1,1,1,1,1,2,1,1,2,10,0.199413,0.2018,0.000117,No
1,1,1,1,1,2,1,1,2,8,0.310728,0.31751,0.000117,No
2,2,4,2,2,4,2,2,4,8,0.306074,0.31346,0.000117,No
1,1,1,1,1,2,1,1,2,9,0.205685,0.208399,0.000117,No
3,3,9,3,3,6,3,3,6,8,0.280896,0.289786,0.000117,No
1,1,1,1,1,2,1,1,2,9,0.249029,0.253711,0.000117,No
1,1,1,1,1,2,1,1,2,10,0.199388,0.201777,0.000117,No
6,6,36,5,5,10,6,6,12,8,0.336635,0.349039,0.000117,No
2,2,4,2,2,4,2,2,4,8,0.277407,0.28433,0.000117,No
2,2,4,2,2,4,2,2,4,8,0.231237,0.235501,0.000117,No
3,3,9,3,3,6,3,3,6,7,0.339434,0.352238,0.000117,No
37,32,1184,9,23,32,37,37,74,7,0.389967,0.409322,0.000117,No
3,3,9,3,3,6,3,3,6,8,0.314543,0.321395,0.000117,No
2,2,4,2,2,4,2,2,4,9,0.245017,0.249119,0.000117,No
2,2,4,2,2,4,2,2,4,9,0.259092,0.264676,0.000117,No
1,1,1,1,1,2,1,1,2,10,0.191652,0.193301,0.000117,No
1,1,1,1,1,2,1,1,2,8,0.339948,0.352202,0.000117,No
1,1,1,1,1,2,1,1,2,10,0.174031,0.175696,0.000117,No
2,2,4,2,2,4,2,2,4,8,0.331591,0.343117,0.000117,No
1,1,1,1,1,2,1,1,2,11,0.166269,0.167671,0.000117,No
1,1,1,1,1,2,1,1,2,10,0.170604,0.172165,0.000117,No
2,2,4,2,2,4,2,2,4,8,0.34361,0.356903,0.000117,No
1,1,1,1,1,2,1,1,2,9,0.237078,0.240122,0.000117,No
2,2,4,2,2,4,2,2,4,8,0.340151,0.352466,0.000117,No
1,1,1,1,1,2,1,1,2,9,0.210686,0.213621,0.000117,No
4,3,12,4,2,6,4,4,8,8,0.323764,0.334715,0.000117,No
2,2,4,2,2,4,2,2,4,8,0.293002,0.300253,0.000117,No
9,9,81,3,9,12,9,9,18,8,0.35284,0.368136,0.000117,No
15,14,210,6,8,14,15,15,30,7,0.36761,0.384678,0.000116,No
107,104,11128,47,35,82,107,107,214,7,0.376086,0.393956,0.000116,No
42,42,1764,34,18,52,42,42,84,8,0.363793,0.38092,0.000116,No
50,48,2400,11,29,40,50,50,100,7,0.376658,0.395357,0.000116,No
51,50,2550,12,29,41,51,51,102,7,0.386128,0.405187,0.000116,No
25,22,550,9,12,21,25,25,50,7,0.37544,0.393826,0.000116,No
26,23,598,5,21,26,26,26,52,8,0.370991,0.389256,0.000116,No
24,24,576,12,20,32,24,24,48,7,0.349566,0.36262,0.000115,No
87,87,7569,65,9,74,87,87,174,7,0.360595,0.376281,0.000115,No
3,3,9,2,3,5,3,3,6,8,0.315193,0.323865,0.000115,No
36,32,1152,6,18,24,36,36,72,7,0.393774,0.41294,0.000115,No
67,64,4288,19,27,46,67,67,134,7,0.387241,0.406497,0.000115,No
53,48,2544,17,31,48,53,53,106,7,0.392172,0.411491,0.000115,No
11,9,99,6,6,12,11,11,22,8,0.347473,0.360891,0.000115,No
98,98,9604,72,6,78,98,98,196,7,0.341321,0.353617,0.000115,No
28,25,700,14,19,33,28,28,56,7,0.37297,0.391117,0.000114,No
106,98,10388,42,40,82,106,106,212,7,0.408969,0.428602,0.000114,No
66,63,4158,18,28,46,66,66,132,7,0.396722,0.416362,0.000114,No
26,25,650,18,13,31,26,26,52,7,0.359865,0.375143,0.000113,No
40,37,1480,10,24,34,40,40,80,7,0.376318,0.394749,0.000113,No
24,24,576,19,18,37,24,24,48,8,0.374739,0.392857,0.000113,No
25,25,625,9,13,22,25,25,50,8,0.363514,0.380013,0.000113,No
128,127,16256,30,36,66,128,128,256,7,0.394785,0.414385,0.000113,No
93,91,8463,36,41,77,93,93,186,7,0.397433,0.416956,0.000113,No
24,22,528,11,17,28,24,24,48,7,0.361596,0.377191,0.000113,No
18,18,324,12,12,24,18,18,36,8,0.370572,0.388708,0.000113,No
91,90,8190,29,21,50,91,91,182,7,0.391992,0.411324,0.000113,No
27,27,729,19,14,33,27,27,54,8,0.357985,0.373285,0.000113,No
58,57,3306,11,32,43,58,58,116,7,0.400737,0.420409,0.000112,No
42,42,1764,21,25,46,42,42,84,7,0.382991,0.402031,0.000112,No
1,1,1,1,1,2,1,1,2,8,0.323426,0.334429,0.000112,No
36,35,1260,22,18,40,36,36,72,7,0.378354,0.396688,0.000111,No
29,28,812,13,23,36,29,29,58,7,0.378824,0.397035,0.000111,No
103,103,10609,5,47,52,103,103,206,7,0.393819,0.413492,0.00011,No
27,26,702,17,16,33,27,27,54,7,0.373623,0.391188,0.00011,No
19,19,361,6,14,20,19,19,38,7,0.358098,0.373846,0.00011,No
67,63,4221,19,31,50,67,67,134,7,0.396445,0.416121,0.000109,No
11,11,121,7,7,14,11,11,22,8,0.358143,0.374098,0.000109,No
44,44,1936,30,17,47,44,44,88,8,0.338975,0.35209,0.000109,No
54,52,2808,11,16,27,54,54,108,7,0.372359,0.389878,0.000108,No
10,10,100,6,6,12,10,10,20,7,0.319837,0.326866,0.000108,No
45,44,1980,8,22,30,45,45,90,7,0.381253,0.40051,0.000108,No
47,43,2021,9,25,34,47,47,94,7,0.387531,0.406675,0.000108,No
56,53,2968,27,36,63,56,56,112,7,0.389904,0.409555,0.000108,No
201,201,40401,1,75,76,201,201,402,7,0.409676,0.430029,0.000108,No
22,21,462,12,18,30,22,22,44,7,0.36377,0.380142,0.000108,No
18,17,306,9,15,24,18,18,36,7,0.369161,0.386554,0.000107,No
55,54,2970,25,28,53,55,55,110,7,0.383602,0.402103,0.000107,No
20,20,400,13,16,29,20,20,40,7,0.381322,0.39927,0.000107,No
23,22,506,12,17,29,23,23,46,7,0.385091,0.404256,0.000106,No
31,31,961,2,24,26,31,31,62,8,0.346239,0.360044,0.000106,No
11,11,121,9,7,16,11,11,22,8,0.34272,0.356406,0.000106,No
18,17,306,6,15,21,18,18,36,8,0.367634,0.385169,0.000106,No
78,78,6084,27,40,67,78,78,156,7,0.389548,0.408892,0.000106,No
86,79,6794,34,27,61,86,86,172,7,0.387223,0.406241,0.000106,No
62,56,3472,28,28,56,62,62,124,7,0.374246,0.392945,0.000105,No
44,40,1760,14,28,42,44,44,88,8,0.374361,0.393361,0.000105,No
50,50,2500,16,26,42,50,50,100,7,0.38791,0.407303,0.000105,No
23,21,483,9,18,27,23,23,46,7,0.373353,0.391442,0.000105,No
23,23,529,12,16,28,23,23,46,7,0.370854,0.388294,0.000105,No
23,17,391,10,14,24,23,23,46,7,0.35907,0.374486,0.000105,No
6,6,36,6,5,11,6,6,12,7,0.346028,0.35893,0.000105,No
4,4,16,4,4,8,4,4,8,8,0.343638,0.356981,0.000105,No
60,59,3540,23,31,54,60,60,120,7,0.392082,0.411782,0.000104,No
20,19,380,12,5,17,20,20,40,7,0.330205,0.341477,0.000104,No
12,11,132,4,9,13,12,12,24,7,0.358203,0.373748,0.000104,No
17,17,289,15,14,29,17,17,34,7,0.365884,0.382764,0.000104,No
38,35,1330,19,22,41,38,38,76,8,0.369729,0.386605,0.000104,No
21,20,420,12,11,23,21,21,42,7,0.371694,0.389292,0.000103,No
26,23,598,14,13,27,26,26,52,7,0.375357,0.393182,0.000103,No
14,14,196,11,11,22,14,14,28,8,0.368842,0.386667,0.000103,No
45,45,2025,19,23,42,45,45,90,7,0.373828,0.391646,0.000103,No
38,36,1368,19,29,48,38,38,76,8,0.335107,0.347825,0.000103,No
22,22,484,15,14,29,22,22,44,7,0.362618,0.380085,0.000103,No
28,28,784,11,19,30,28,28,56,7,0.378127,0.396941,0.000103,No
20,19,380,9,19,28,20,20,40,7,0.37355,0.391024,0.000103,No
3,3,9,3,3,6,3,3,6,8,0.310129,0.318839,0.000102,No
20,20,400,3,10,13,20,20,40,8,0.354453,0.370315,0.000102,No
36,35,1260,7,24,31,36,36,72,7,0.376617,0.394973,0.000102,No
13,13,169,11,9,20,13,13,26,8,0.354711,0.369735,0.000102,No
17,17,289,9,12,21,17,17,34,7,0.374937,0.393616,0.000102,No
6,6,36,5,6,11,6,6,12,7,0.334247,0.345834,0.000102,No
9,9,81,7,7,14,9,9,18,7,0.361543,0.377574,0.000102,No
37,37,1369,22,23,45,37,37,74,7,0.388971,0.408592,0.000102,No
7,7,49,4,5,9,7,7,14,8,0.353652,0.368892,0.000101,No
96,94,9024,30,24,54,96,96,192,7,0.377233,0.394992,0.000101,No
23,23,529,6,11,17,23,23,46,7,0.363174,0.379068,0.000101,No
20,20,400,12,17,29,20,20,40,8,0.380973,0.399773,0.000101,No
62,62,3844,20,33,53,62,62,124,7,0.404174,0.423871,0.000101,No
31,31,961,11,11,22,31,31,62,7,0.361198,0.376802,0.000101,No
42,36,1512,16,21,37,42,42,84,7,0.386163,0.404996,0.000101,No
41,41,1681,20,25,45,41,41,82,7,0.383619,0.402154,0.000101,No
21,21,441,8,16,24,21,21,42,8,0.363646,0.381554,0.000101,No
32,31,992,10,12,22,32,32,64,8,0.35491,0.370141,0.0001,No
17,16,272,5,12,17,17,17,34,7,0.373133,0.390857,0.0001,No
36,31,1116,17,28,45,36,36,72,7,0.375796,0.394005,0.0001,No
21,19,399,10,14,24,21,21,42,8,0.350658,0.365009,0.0001,No
79,78,6162,32,37,69,79,79,158,8,0.381748,0.401052,0.0001,No
18,18,324,8,14,22,18,18,36,8,0.368126,0.385437,0.0001,No
18,17,306,11,11,22,18,18,36,8,0.370943,0.389018,0.0001,No
35,35,1225,15,22,37,35,35,70,7,0.389344,0.408589,0.0001,No
15,14,210,11,11,22,15,15,30,7,0.347678,0.361032,0.0001,No
39,37,1443,14,13,27,39,39,78,7,0.372498,0.389862,0.0001,No
20,18,360,12,15,27,20,20,40,8,0.37197,0.390387,0.000099,No
14,14,196,6,10,16,14,14,28,7,0.358346,0.373594,0.000099,No
42,38,1596,12,24,36,42,42,84,7,0.396703,0.416332,0.000099,No
31,30,930,24,21,45,31,31,62,8,0.327524,0.33704,0.000098,yes
36,35,1260,13,25,38,36,36,72,7,0.380531,0.399407,0.000098,No
46,45,2070,12,26,38,46,46,92,7,0.38374,0.40262,0.000098,No
16,16,256,8,12,20,16,16,32,8,0.351069,0.365052,0.000098,No
60,60,3600,50,18,68,60,60,120,8,0.319598,0.326848,0.000098,No
13,13,169,10,9,19,13,13,26,7,0.367278,0.384438,0.000098,No
45,43,1935,29,25,54,45,45,90,7,0.347268,0.360699,0.000098,No
9,9,81,4,9,13,9,9,18,7,0.327028,0.335469,0.000098,No
25,20,500,9,20,29,25,25,50,7,0.389842,0.409198,0.000097,No
24,24,576,14,19,33,24,24,48,8,0.337727,0.349459,0.000097,No
6,4,24,4,4,8,6,6,12,8,0.355294,0.370072,0.000097,No
25,24,600,9,19,28,25,25,50,7,0.379887,0.398261,0.000097,No
34,33,1122,9,23,32,34,34,68,7,0.366088,0.382572,0.000097,No
48,41,1968,14,26,40,48,48,96,7,0.371403,0.389075,0.000097,No
24,23,552,11,13,24,24,24,48,7,0.3889,0.408452,0.000097,No
41,38,1558,22,31,53,41,41,82,8,0.344839,0.358624,0.000097,No
29,28,812,25,14,39,29,29,58,8,0.334241,0.346125,0.000097,No
30,28,840,21,22,43,30,30,60,7,0.382167,0.400634,0.000097,No
6,5,30,3,6,9,6,6,12,8,0.353476,0.368023,0.000097,No
12,12,144,7,10,17,12,12,24,7,0.359229,0.375047,0.000097,No
16,16,256,9,12,21,16,16,32,7,0.343936,0.357234,0.000097,No
16,16,256,6,11,17,16,16,32,7,0.371727,0.389117,0.000096,No
31,27,837,11,17,28,31,31,62,7,0.375382,0.393186,0.000096,No
50,50,2500,15,21,36,50,50,100,7,0.378681,0.397088,0.000096,No
58,55,3190,21,11,32,58,58,116,8,0.360329,0.375411,0.000096,No
52,49,2548,25,12,37,52,52,104,8,0.357827,0.37482,0.000096,No
15,15,225,5,11,16,15,15,30,8,0.292746,0.300063,0.000095,yes
17,17,289,9,11,20,17,17,34,7,0.335846,0.347735,0.000095,yes
14,13,182,7,11,18,14,14,28,7,0.339927,0.353572,0.000095,No
32,31,992,6,17,23,32,32,64,7,0.366418,0.382795,0.000095,No
27,26,702,5,21,26,27,27,54,8,0.373166,0.390906,0.000095,No
49,49,2401,20,34,54,49,49,98,7,0.405567,0.425434,0.000095,No
26,26,676,9,19,28,26,26,52,7,0.36731,0.38411,0.000094,No
24,24,576,7,16,23,24,24,48,7,0.366899,0.384342,0.000094,No
29,27,783,16,22,38,29,29,58,8,0.367001,0.384127,0.000094,No
16,16,256,13,11,24,16,16,32,8,0.337133,0.348043,0.000094,No
127,124,15748,37,18,55,127,127,254,7,0.37568,0.394063,0.000094,No
29,27,783,15,22,37,29,29,58,7,0.381808,0.400826,0.000094,No
33,33,1089,7,17,24,33,33,66,7,0.366379,0.383072,0.000094,No
29,23,667,17,19,36,29,29,58,7,0.37735,0.395769,0.000094,No
6,6,36,6,5,11,6,6,12,8,0.325667,0.336403,0.000094,No
40,34,1360,9,21,30,40,40,80,7,0.378799,0.397193,0.000094,No
58,52,3016,20,32,52,58,58,116,7,0.401077,0.420533,0.000094,No
26,26,676,5,9,14,26,26,52,7,0.365735,0.382635,0.000094,No
25,24,600,10,17,27,25,25,50,8,0.3802,0.399103,0.000093,No
137,136,18632,17,11,28,137,137,274,7,0.368938,0.385545,0.000093,No
28,27,756,7,20,27,28,28,56,7,0.378757,0.397156,0.000093,No
18,16,288,4,13,17,18,18,36,8,0.350183,0.364293,0.000093,No
20,18,360,14,10,24,20,20,40,8,0.350391,0.364187,0.000093,No
27,24,648,17,25,42,27,27,54,7,0.374353,0.39356,0.000093,No
22,19,418,9,16,25,22,22,44,7,0.385413,0.405029,0.000093,No
22,22,484,18,15,33,22,22,44,8,0.382184,0.400921,0.000093,No
24,18,432,7,16,23,24,24,48,8,0.381851,0.400774,0.000093,No
14,14,196,9,8,17,14,14,28,7,0.332898,0.343237,0.000093,No
77,72,5544,17,45,62,77,77,154,7,0.409774,0.429855,0.000093,No
65,63,4095,17,35,52,65,65,130,7,0.397109,0.416968,0.000093,No
17,15,255,4,12,16,17,17,34,8,0.379481,0.398562,0.000092,No
4,4,16,3,4,7,4,4,8,8,0.306971,0.315491,0.000092,No
16,16,256,11,8,19,16,16,32,7,0.353887,0.368646,0.000092,No
9,9,81,4,9,13,9,9,18,8,0.356177,0.371992,0.000092,No
19,19,361,14,12,26,19,19,38,7,0.361773,0.37822,0.000092,No
13,13,169,9,13,22,13,13,26,8,0.363352,0.379881,0.000092,No
24,24,576,12,16,28,24,24,48,7,0.363677,0.380362,0.000092,No
29,26,754,6,19,25,29,29,58,7,0.390735,0.410102,0.000092,No
6,6,36,5,5,10,6,6,12,8,0.334208,0.346061,0.000092,No
15,15,225,8,13,21,15,15,30,7,0.38082,0.399649,0.000092,No
24,24,576,14,10,24,24,24,48,7,0.370951,0.389267,0.000092,No
14,14,196,5,8,13,14,14,28,7,0.36278,0.378645,0.000092,No
39,39,1521,14,25,39,39,39,78,7,0.396869,0.416299,0.000091,No
30,28,840,9,19,28,30,30,60,7,0.384857,0.403776,0.000091,No
55,54,2970,16,32,48,55,55,110,7,0.398789,0.418336,0.000091,No
49,47,2303,15,18,33,49,49,98,7,0.381024,0.399408,0.000091,No
27,27,729,15,17,32,27,27,54,7,0.375547,0.393333,0.000091,No
38,36,1368,13,28,41,38,38,76,7,0.37464,0.392359,0.00009,No
29,28,812,14,23,37,29,29,58,7,0.384207,0.40353,0.00009,No
29,29,841,11,23,34,29,29,58,8,0.37253,0.390402,0.00009,No
22,22,484,14,12,26,22,22,44,7,0.34986,0.363171,0.00009,No
36,36,1296,12,16,28,36,36,72,7,0.37125,0.388241,0.00009,No
21,21,441,12,11,23,21,21,42,7,0.379414,0.398073,0.00009,No
22,21,462,11,15,26,22,22,44,7,0.36893,0.385801,0.00009,No
28,26,728,3,20,23,28,28,56,8,0.364953,0.381328,0.00009,No
18,16,288,9,14,23,18,18,36,8,0.36061,0.378547,0.00009,No
24,21,504,5,12,17,24,24,48,7,0.366112,0.383357,0.00009,No
65,63,4095,15,31,46,65,65,130,7,0.39593,0.415791,0.00009,No
102,101,10302,22,35,57,102,102,204,7,0.403934,0.423636,0.00009,No
43,42,1806,15,26,41,43,43,86,8,0.378892,0.396954,0.000089,No
97,95,9215,25,39,64,97,97,194,7,0.402771,0.422778,0.000089,No
32,32,1024,18,23,41,32,32,64,7,0.356065,0.372032,0.000089,No
29,28,812,12,19,31,29,29,58,8,0.348837,0.363435,0.000089,No
42,40,1680,11,26,37,42,42,84,7,0.393075,0.41255,0.000089,No
27,27,729,5,14,19,27,27,54,7,0.369905,0.386707,0.000089,No
16,15,240,8,12,20,16,16,32,8,0.348566,0.362817,0.000089,No
55,55,3025,6,16,22,55,55,110,8,0.360671,0.376724,0.000089,No
25,23,575,20,18,38,25,25,50,7,0.357557,0.374274,0.000089,No
14,14,196,5,9,14,14,14,28,7,0.35449,0.368705,0.000089,No
91,90,8190,32,20,52,91,91,182,7,0.373386,0.390836,0.000089,No
8,8,64,3,6,9,8,8,16,8,0.343382,0.35655,0.000089,No
10,10,100,7,9,16,10,10,20,7,0.366986,0.384048,0.000089,No
17,17,289,13,7,20,17,17,34,7,0.36198,0.378286,0.000088,No
32,32,1024,16,17,33,32,32,64,7,0.375837,0.393439,0.000088,No
9,9,81,9,7,16,9,9,18,8,0.351648,0.366052,0.000088,No
79,77,6083,35,42,77,79,79,158,7,0.370339,0.388898,0.000088,No
28,28,784,19,23,42,28,28,56,7,0.372205,0.389483,0.000088,No
19,14,266,5,14,19,19,19,38,7,0.38009,0.398554,0.000088,No
37,36,1332,17,24,41,37,37,74,8,0.375936,0.394925,0.000088,No
38,36,1368,24,22,46,38,38,76,7,0.368627,0.385684,0.000088,No
37,34,1258,6,19,25,37,37,74,8,0.389878,0.409318,0.000088,No
1,1,1,1,1,2,1,1,2,8,0.331591,0.343083,0.000087,No
53,53,2809,13,26,39,53,53,106,7,0.38197,0.400833,0.000087,No
30,30,900,16,23,39,30,30,60,8,0.335424,0.348483,0.000087,No
1,1,1,1,1,2,1,1,2,8,0.331591,0.343083,0.000087,No
23,23,529,11,17,28,23,23,46,7,0.373084,0.391442,0.000087,No
1,1,1,1,1,2,1,1,2,9,0.249037,0.253714,0.000087,No
26,25,650,17,15,32,26,26,52,7,0.353352,0.368481,0.000087,No
38,38,1444,17,16,33,38,38,76,8,0.37587,0.394946,0.000087,No
4,4,16,4,4,8,4,4,8,8,0.314473,0.325675,0.000087,No
1,1,1,1,1,2,1,1,2,9,0.249037,0.253714,0.000087,No
48,47,2256,26,14,40,48,48,96,7,0.379195,0.397679,0.000087,No
38,29,1102,7,17,24,38,38,76,7,0.36004,0.37562,0.000086,No
30,28,840,10,18,28,30,30,60,7,0.3857,0.40492,0.000086,No
19,18,342,12,7,19,19,19,38,8,0.329135,0.339078,0.000086,No
26,25,650,15,16,31,26,26,52,8,0.352767,0.367686,0.000086,No
22,21,462,10,19,29,22,22,44,7,0.37587,0.393819,0.000086,No
39,38,1482,30,17,47,39,39,78,7,0.364992,0.381529,0.000086,No
38,38,1444,11,19,30,38,38,76,7,0.383913,0.403391,0.000086,No
96,93,8928,33,31,64,96,96,192,8,0.395141,0.414772,0.000086,No
15,14,210,10,11,21,15,15,30,8,0.359342,0.375307,0.000086,No
56,53,2968,48,10,58,56,56,112,7,0.341896,0.353572,0.000086,No
21,21,441,12,10,22,21,21,42,7,0.362942,0.378935,0.000086,No
29,29,841,16,17,33,29,29,58,7,0.390029,0.40939,0.000086,No
2,2,4,2,2,4,2,2,4,9,0.241258,0.244406,0.000085,No
28,28,784,18,15,33,28,28,56,7,0.368229,0.385188,0.000085,No
12,12,144,9,8,17,12,12,24,7,0.368476,0.385557,0.000085,No
49,49,2401,8,19,27,49,49,98,7,0.368667,0.386814,0.000085,No
15,14,210,6,9,15,15,15,30,8,0.359191,0.374216,0.000085,No
31,31,961,8,24,32,31,31,62,7,0.323549,0.333458,0.000084,yes
8,7,56,4,8,12,8,8,16,8,0.366907,0.383333,0.000084,No
20,19,380,12,9,21,20,20,40,7,0.364711,0.380646,0.000084,No
32,30,960,8,15,23,32,32,64,7,0.387434,0.406616,0.000084,No
8,8,64,5,6,11,8,8,16,8,0.320258,0.32816,0.000084,No
30,30,900,18,13,31,30,30,60,7,0.352418,0.367165,0.000084,No
12,12,144,7,10,17,12,12,24,8,0.358926,0.374103,0.000084,No
30,28,840,7,19,26,30,30,60,7,0.354637,0.368997,0.000083,No
18,18,324,4,11,15,18,18,36,7,0.367832,0.384343,0.000083,No
19,17,323,8,11,19,19,19,38,8,0.353659,0.367933,0.000083,No
58,56,3248,28,35,63,58,58,116,7,0.399359,0.419741,0.000083,No
8,7,56,6,7,13,8,8,16,7,0.380073,0.398261,0.000083,No
64,59,3776,28,37,65,64,64,128,7,0.395682,0.415195,0.000082,No
15,12,180,8,13,21,15,15,30,7,0.354689,0.369548,0.000082,No
26,26,676,8,18,26,26,26,52,7,0.381117,0.399647,0.000082,No
29,26,754,22,18,40,29,29,58,8,0.36188,0.377771,0.000082,No
17,17,289,14,17,31,17,17,34,8,0.354755,0.369933,0.000082,No
16,16,256,14,12,26,16,16,32,8,0.364859,0.38212,0.000082,No
23,23,529,12,14,26,23,23,46,7,0.367286,0.384515,0.000082,No
10,10,100,5,6,11,10,10,20,7,0.35818,0.37331,0.000082,No
62,62,3844,24,16,40,62,62,124,7,0.371282,0.388249,0.000082,No
40,40,1600,10,14,24,40,40,80,8,0.355265,0.370527,0.000082,No
34,33,1122,4,26,30,34,34,68,8,0.343203,0.356573,0.000081,No
7,6,42,4,7,11,7,7,14,8,0.344791,0.357776,0.000081,No
8,8,64,6,7,13,8,8,16,8,0.353191,0.368745,0.000081,No
12,9,108,9,9,18,12,12,24,8,0.341055,0.354247,0.000081,No
14,14,196,5,7,12,14,14,28,7,0.357176,0.372495,0.000081,No
42,42,1764,22,23,45,42,42,84,7,0.382381,0.401317,0.000081,No
13,13,169,9,9,18,13,13,26,8,0.357004,0.373851,0.000081,No
64,62,3968,17,39,56,64,64,128,7,0.397378,0.417485,0.000081,No
24,24,576,10,17,27,24,24,48,7,0.37125,0.388547,0.000081,No
51,51,2601,15,25,40,51,51,102,7,0.388263,0.40756,0.000081,No
12,12,144,8,8,16,12,12,24,8,0.33048,0.341299,0.000081,No
9,9,81,8,7,15,9,9,18,7,0.372962,0.390121,0.000081,No
18,17,306,9,10,19,18,18,36,7,0.36682,0.38332,0.000081,No
22,21,462,11,9,20,22,22,44,7,0.360367,0.375608,0.000081,No
51,50,2550,18,9,27,51,51,102,8,0.354225,0.369229,0.000081,No
49,47,2303,26,28,54,49,49,98,7,0.384259,0.403715,0.00008,No
17,15,255,8,13,21,17,17,34,7,0.369457,0.386109,0.00008,No
41,41,1681,17,23,40,41,41,82,8,0.384215,0.402795,0.00008,No
30,29,870,17,20,37,30,30,60,7,0.380973,0.399815,0.00008,No
43,42,1806,31,34,65,43,43,86,7,0.353469,0.367435,0.00008,No
15,15,225,8,9,17,15,15,30,8,0.353879,0.369449,0.00008,No
39,39,1521,16,15,31,39,39,78,7,0.376775,0.39499,0.00008,No
17,17,289,8,9,17,17,17,34,8,0.364275,0.381154,0.00008,No
19,18,342,15,13,28,19,19,38,8,0.368842,0.386681,0.00008,No
31,29,899,9,16,25,31,31,62,7,0.386285,0.405577,0.000079,No
15,14,210,10,13,23,15,15,30,7,0.373844,0.391986,0.000079,No
22,22,484,18,18,36,22,22,44,8,0.350766,0.367325,0.000079,No
54,53,2862,7,16,23,54,54,108,7,0.362249,0.378521,0.000079,No
12,10,120,7,11,18,12,12,24,7,0.352636,0.367832,0.000079,No
12,12,144,6,9,15,12,12,24,8,0.362734,0.379438,0.000079,No
27,27,729,7,15,22,27,27,54,7,0.380446,0.398963,0.000079,No
9,8,72,4,5,9,9,9,18,7,0.331494,0.34294,0.000079,No
61,59,3599,13,28,41,61,61,122,7,0.389896,0.409405,0.000079,No
23,19,437,4,19,23,23,23,46,8,0.34868,0.36283,0.000079,No
34,32,1088,11,10,21,34,34,68,7,0.366788,0.383363,0.000079,No
73,73,5329,5,15,20,73,73,146,7,0.349802,0.363824,0.000079,No
13,13,169,10,11,21,13,13,26,8,0.346901,0.361147,0.000079,No
16,16,256,8,14,22,16,16,32,7,0.370749,0.388505,0.000079,No
14,14,196,8,11,19,14,14,28,8,0.354578,0.369527,0.000079,No
9,9,81,8,8,16,9,9,18,8,0.363468,0.380351,0.000079,No
23,23,529,16,17,33,23,23,46,8,0.31718,0.325661,0.000079,No
11,11,121,4,7,11,11,11,22,8,0.354357,0.37,0.000079,No
34,33,1122,17,16,33,34,34,68,7,0.378455,0.396808,0.000079,No
29,29,841,19,19,38,29,29,58,8,0.370251,0.387341,0.000079,No
8,5,40,6,8,14,8,8,16,8,0.346316,0.360301,0.000079,No
20,20,400,10,12,22,20,20,40,7,0.352556,0.366588,0.000079,No
15,15,225,8,13,21,15,15,30,7,0.366836,0.383391,0.000078,No
14,12,168,7,6,13,14,14,28,7,0.362981,0.379579,0.000078,No
14,14,196,5,10,15,14,14,28,8,0.366962,0.383627,0.000078,No
6,6,36,5,4,9,6,6,12,8,0.328356,0.342201,0.000078,No
15,15,225,6,11,17,15,15,30,8,0.351213,0.365692,0.000078,No
20,20,400,5,9,14,20,20,40,8,0.357685,0.372714,0.000078,No
50,50,2500,16,27,43,50,50,100,7,0.400898,0.420905,0.000078,No
8,8,64,7,8,15,8,8,16,7,0.370725,0.38836,0.000078,No
31,28,868,24,16,40,31,31,62,8,0.356437,0.37205,0.000078,No
9,9,81,6,9,15,9,9,18,8,0.360618,0.376261,0.000078,No
24,22,528,12,13,25,24,24,48,7,0.350679,0.365387,0.000077,yes
17,17,289,15,13,28,17,17,34,8,0.343278,0.356271,0.000077,yes
75,72,5400,18,38,56,75,75,150,7,0.381629,0.400947,0.000077,No
22,19,418,9,16,25,22,22,44,8,0.379136,0.39825,0.000077,No
13,13,169,8,13,21,13,13,26,8,0.334169,0.344324,0.000077,No
10,6,60,4,10,14,10,10,20,8,0.348922,0.363232,0.000077,No
18,17,306,12,13,25,18,18,36,8,0.373109,0.391063,0.000077,No
13,13,169,7,10,17,13,13,26,7,0.357835,0.374065,0.000077,No
64,61,3904,20,32,52,64,64,128,7,0.372465,0.390597,0.000077,No
15,15,225,8,8,16,15,15,30,7,0.33181,0.342694,0.000077,No
22,22,484,16,16,32,22,22,44,8,0.384466,0.403173,0.000077,No
80,77,6160,30,24,54,80,80,160,7,0.37853,0.39767,0.000077,No
20,20,400,15,13,28,20,20,40,8,0.368762,0.386927,0.000077,No
17,16,272,11,7,18,17,17,34,8,0.340688,0.353705,0.000077,No
16,16,256,6,11,17,16,16,32,7,0.381339,0.399988,0.000077,No
5,4,20,3,5,8,5,5,10,8,0.309292,0.316764,0.000077,No
21,21,441,14,15,29,21,21,42,7,0.371735,0.389663,0.000077,No
72,71,5112,34,30,64,72,72,144,7,0.379802,0.398167,0.000076,No
21,20,420,14,10,24,21,21,42,7,0.348111,0.360882,0.000076,No
27,23,621,8,19,27,27,27,54,7,0.378421,0.396514,0.000076,No
13,13,169,8,7,15,13,13,26,8,0.350751,0.365857,0.000076,No
14,12,168,5,9,14,14,14,28,8,0.344923,0.359313,0.000076,No
76,74,5624,29,32,61,76,76,152,7,0.406756,0.426143,0.000076,No
9,9,81,6,7,13,9,9,18,7,0.349144,0.361964,0.000076,No
25,25,625,5,12,17,25,25,50,7,0.349423,0.362295,0.000076,No
8,7,56,4,7,11,8,8,16,8,0.318637,0.327678,0.000076,No
5,5,25,4,5,9,5,5,10,8,0.351091,0.366087,0.000076,No
17,17,289,8,14,22,17,17,34,8,0.348708,0.362423,0.000076,No
10,10,100,10,9,19,10,10,20,7,0.319287,0.328219,0.000076,No
19,19,361,9,12,21,19,19,38,8,0.359372,0.37552,0.000076,No
17,16,272,9,15,24,17,17,34,7,0.337928,0.34955,0.000076,No
88,87,7656,18,41,59,88,88,176,7,0.394484,0.414072,0.000076,No
19,17,323,9,3,12,19,19,38,7,0.332243,0.343574,0.000075,No
23,23,529,11,17,28,23,23,46,7,0.370846,0.388177,0.000075,No
44,44,1936,16,27,43,44,44,88,8,0.380234,0.398853,0.000075,No
37,37,1369,12,14,26,37,37,74,7,0.378027,0.395705,0.000075,No
23,21,483,16,13,29,23,23,46,7,0.360656,0.376117,0.000075,No
15,15,225,11,12,23,15,15,30,7,0.345496,0.359312,0.000075,No
9,8,72,5,6,11,9,9,18,8,0.341608,0.35529,0.000075,No
18,18,324,6,12,18,18,18,36,7,0.341718,0.353064,0.000075,No
20,20,400,13,14,27,20,20,40,7,0.371274,0.389057,0.000074,No
34,33,1122,24,12,36,34,34,68,7,0.363383,0.379267,0.000074,No
19,18,342,2,13,15,19,19,38,8,0.346148,0.360776,0.000074,No
39,39,1521,22,8,30,39,39,78,8,0.361267,0.377603,0.000074,No
12,12,144,10,9,19,12,12,24,8,0.367405,0.38365,0.000074,No
18,17,306,10,12,22,18,18,36,8,0.365476,0.383128,0.000074,No
15,15,225,8,9,17,15,15,30,7,0.371613,0.388575,0.000074,No
13,13,169,3,10,13,13,13,26,8,0.374822,0.392908,0.000074,No
32,31,992,20,14,34,32,32,64,7,0.356616,0.371157,0.000074,No
29,28,812,5,17,22,29,29,58,8,0.388298,0.407515,0.000074,No
62,60,3720,26,30,56,62,62,124,7,0.385369,0.404684,0.000074,No
43,41,1763,20,17,37,43,43,86,7,0.356006,0.370085,0.000074,No
6,4,24,5,3,8,6,6,12,7,0.327851,0.338595,0.000074,No
10,10,100,7,7,14,10,10,20,8,0.361581,0.378349,0.000074,No
9,9,81,7,9,16,9,9,18,8,0.319317,0.330208,0.000074,No
35,35,1225,3,26,29,35,35,70,7,0.377458,0.395904,0.000074,No
11,11,121,7,8,15,11,11,22,7,0.357168,0.372228,0.000074,No
28,28,784,14,12,26,28,28,56,7,0.363778,0.379891,0.000073,No
9,9,81,6,7,13,9,9,18,8,0.342198,0.354328,0.000073,No
18,18,324,6,14,20,18,18,36,7,0.362041,0.378189,0.000073,No
55,54,2970,10,35,45,55,55,110,7,0.396925,0.416462,0.000073,No
9,9,81,6,8,14,9,9,18,7,0.348616,0.362629,0.000073,No
17,15,255,5,9,14,17,17,34,8,0.349809,0.364735,0.000073,No
29,26,754,15,19,34,29,29,58,7,0.352862,0.367042,0.000073,No
12,12,144,7,9,16,12,12,24,7,0.35014,0.364062,0.000073,No
14,11,154,3,11,14,14,14,28,8,0.362395,0.379132,0.000073,No
103,103,10609,54,28,82,103,103,206,7,0.391344,0.410651,0.000073,No
37,30,1110,29,11,40,37,37,74,7,0.343728,0.355788,0.000073,No
11,11,121,8,9,17,11,11,22,8,0.342204,0.354912,0.000072,No
30,28,840,11,12,23,30,30,60,8,0.359903,0.375509,0.000072,No
29,29,841,13,8,21,29,29,58,8,0.337982,0.350826,0.000072,No
9,9,81,8,9,17,9,9,18,7,0.362103,0.378539,0.000072,No
50,50,2500,9,25,34,50,50,100,8,0.335483,0.346314,0.000072,No
18,12,216,6,10,16,18,18,36,8,0.351488,0.366709,0.000072,No
3,3,9,1,2,3,3,3,6,8,0.34193,0.354376,0.000072,No
8,7,56,6,8,14,8,8,16,7,0.35333,0.368257,0.000072,No
41,41,1681,30,11,41,41,41,82,8,0.37446,0.39278,0.000072,No
13,13,169,8,8,16,13,13,26,7,0.339137,0.352214,0.000072,No
26,20,520,4,14,18,26,26,52,7,0.381117,0.399584,0.000072,No
13,13,169,7,9,16,13,13,26,8,0.36026,0.377382,0.000072,No
7,7,49,6,6,12,7,7,14,7,0.343922,0.357034,0.000072,No
15,15,225,11,11,22,15,15,30,8,0.363043,0.380173,0.000072,No
10,10,100,8,6,14,10,10,20,8,0.344227,0.357092,0.000072,No
8,8,64,6,7,13,8,8,16,8,0.357572,0.373118,0.000072,No
30,29,870,19,4,23,30,30,60,7,0.337634,0.350017,0.000072,No
20,20,400,14,13,27,20,20,40,7,0.350514,0.364393,0.000072,No
15,15,225,5,12,17,15,15,30,7,0.374115,0.391457,0.000071,No
3,3,9,3,3,6,3,3,6,9,0.256347,0.262231,0.000071,No
26,26,676,6,7,13,26,26,52,8,0.297022,0.304246,0.000071,No
6,5,30,3,6,9,6,6,12,8,0.280208,0.287416,0.000071,No
10,9,90,6,9,15,10,10,20,7,0.353711,0.368975,0.000071,No
11,10,110,8,10,18,11,11,22,8,0.356922,0.372763,0.000071,No
19,19,361,9,13,22,19,19,38,7,0.357161,0.372643,0.000071,No
36,34,1224,14,21,35,36,36,72,8,0.353491,0.368798,0.000071,No
23,23,529,20,12,32,23,23,46,7,0.367294,0.384202,0.000071,No
19,19,361,14,5,19,19,19,38,7,0.355746,0.370343,0.000071,No
13,12,156,8,9,17,13,13,26,7,0.378161,0.396314,0.000071,No
8,8,64,5,6,11,8,8,16,7,0.353535,0.368045,0.000071,No
18,18,324,12,13,25,18,18,36,8,0.361918,0.379176,0.000071,No
21,21,441,16,14,30,21,21,42,7,0.379431,0.398414,0.000071,No
1,1,1,1,1,2,1,1,2,8,0.323426,0.334429,0.000071,No
9,9,81,8,7,15,9,9,18,8,0.340579,0.353495,0.000071,No
42,40,1680,17,14,31,42,42,84,7,0.370572,0.38771,0.000071,No
33,24,792,13,13,26,33,33,66,7,0.367397,0.384393,0.000071,No
12,12,144,10,9,19,12,12,24,7,0.372563,0.389655,0.000071,No
185,180,33300,5,10,15,185,185,370,7,0.36612,0.382962,0.000071,No
28,27,756,16,13,29,28,28,56,7,0.373615,0.39073,0.000071,No
12,11,132,10,10,20,12,12,24,8,0.371954,0.389103,0.00007,No
38,37,1406,7,19,26,38,38,76,7,0.375597,0.393851,0.00007,No
8,8,64,6,7,13,8,8,16,7,0.354895,0.369895,0.00007,No
9,9,81,6,4,10,9,9,18,8,0.354548,0.369497,0.00007,No
7,6,42,4,6,10,7,7,14,8,0.30275,0.312843,0.00007,No
6,6,36,3,6,9,6,6,12,8,0.31872,0.326884,0.00007,No
8,7,56,8,6,14,8,8,16,8,0.34011,0.352512,0.00007,No
14,14,196,5,9,14,14,14,28,8,0.37469,0.392607,0.00007,No
14,13,182,5,8,13,14,14,28,7,0.350708,0.364988,0.00007,No
13,11,143,8,12,20,13,13,26,8,0.366733,0.384523,0.00007,No
31,31,961,13,14,27,31,31,62,7,0.365664,0.382007,0.00007,No
12,12,144,10,5,15,12,12,24,7,0.349946,0.36358,0.00007,No
21,21,441,18,14,32,21,21,42,7,0.365672,0.382609,0.00007,No
5,5,25,5,5,10,5,5,10,8,0.328463,0.341458,0.00007,No
32,31,992,15,15,30,32,32,64,8,0.368611,0.385381,0.00007,No
14,14,196,12,11,23,14,14,28,8,0.349179,0.36422,0.00007,No
8,6,48,6,8,14,8,8,16,8,0.333914,0.345844,0.00007,No
22,18,396,13,11,24,22,22,44,8,0.353938,0.368159,0.00007,No
14,14,196,5,12,17,14,14,28,8,0.35463,0.372068,0.00007,No
42,41,1722,23,11,34,42,42,84,8,0.345049,0.358946,0.000069,No
22,19,418,3,14,17,22,22,44,8,0.356512,0.372207,0.000069,No
20,20,400,12,11,23,20,20,40,7,0.363035,0.379328,0.000069,No
28,28,784,17,12,29,28,28,56,7,0.356415,0.37122,0.000069,No
15,15,225,8,6,14,15,15,30,8,0.335048,0.34609,0.000069,No
7,7,49,5,3,8,7,7,14,8,0.341376,0.354024,0.000069,No
7,7,49,5,6,11,7,7,14,8,0.314897,0.323352,0.000069,No
15,15,225,8,5,13,15,15,30,8,0.358534,0.374372,0.000069,No
21,20,420,7,12,19,21,21,42,8,0.347338,0.36089,0.000069,No
4,4,16,4,4,8,4,4,8,8,0.28317,0.290436,0.000069,No
4,4,16,3,3,6,4,4,8,8,0.345867,0.358708,0.000069,No
14,14,196,4,9,13,14,14,28,8,0.341896,0.35459,0.000069,No
16,16,256,11,10,21,16,16,32,8,0.342472,0.354326,0.000069,No
10,9,90,7,10,17,10,10,20,7,0.359509,0.374986,0.000069,No
18,18,324,12,10,22,18,18,36,8,0.357872,0.373925,0.000069,No
33,31,1023,19,27,46,33,33,66,7,0.3838,0.402271,0.000069,No
7,7,49,3,5,8,7,7,14,8,0.34888,0.36235,0.000069,No
15,12,180,6,5,11,15,15,30,8,0.340967,0.35336,0.000069,No
12,11,132,4,8,12,12,12,24,8,0.349501,0.363328,0.000069,No
21,21,441,11,15,26,21,21,42,8,0.33621,0.347347,0.000069,No
19,18,342,10,11,21,19,19,38,8,0.371654,0.389222,0.000069,No
6,5,30,4,5,9,6,6,12,7,0.334254,0.345809,0.000069,No
18,18,324,12,14,26,18,18,36,7,0.363414,0.379701,0.000069,No
7,7,49,6,4,10,7,7,14,8,0.297286,0.308651,0.000069,No
8,8,64,7,7,14,8,8,16,8,0.338531,0.351038,0.000069,No
14,14,196,8,10,18,14,14,28,8,0.359357,0.375791,0.000069,No
20,20,400,6,7,13,20,20,40,8,0.324676,0.334963,0.000069,No
4,4,16,3,3,6,4,4,8,8,0.323457,0.334512,0.000069,No
43,39,1677,28,24,52,43,43,86,7,0.378934,0.397464,0.000069,No
11,10,110,6,10,16,11,11,22,7,0.353286,0.367944,0.000069,No
9,9,81,5,8,13,9,9,18,8,0.348908,0.363728,0.000069,No
5,5,25,5,5,10,5,5,10,8,0.311499,0.31955,0.000069,No
7,7,49,5,6,11,7,7,14,8,0.346253,0.359508,0.000068,No
24,21,504,4,15,19,24,24,48,8,0.384345,0.403647,0.000068,No
5,4,20,4,5,9,5,5,10,8,0.348765,0.362784,0.000068,No
21,21,441,15,15,30,21,21,42,7,0.359524,0.374823,0.000068,No
48,47,2256,7,30,37,48,48,96,7,0.397183,0.41697,0.000068,No
16,15,240,6,9,15,16,16,32,7,0.324873,0.334809,0.000068,No
11,11,121,6,11,17,11,11,22,8,0.359108,0.375483,0.000068,No
30,30,900,19,15,34,30,30,60,8,0.360374,0.376803,0.000068,No
12,9,108,5,9,14,12,12,24,8,0.353989,0.36973,0.000068,No
6,3,18,5,6,11,6,6,12,8,0.338625,0.352219,0.000068,No
12,6,72,2,6,8,12,12,24,8,0.340701,0.353225,0.000068,No
17,17,289,12,11,23,17,17,34,8,0.355546,0.371008,0.000068,No
11,11,121,9,6,15,11,11,22,7,0.343659,0.356925,0.000068,No
23,21,483,16,15,31,23,23,46,7,0.377709,0.395969,0.000068,No
43,36,1548,21,26,47,43,43,86,7,0.376916,0.396548,0.000068,No
13,13,169,9,11,20,13,13,26,7,0.36784,0.385257,0.000068,No
39,39,1521,20,28,48,39,39,78,7,0.387628,0.406831,0.000068,No
56,55,3080,17,13,30,56,56,112,8,0.370572,0.388234,0.000068,No
12,12,144,9,9,18,12,12,24,8,0.359964,0.376362,0.000068,No
11,11,121,5,10,15,11,11,22,8,0.312578,0.320147,0.000068,No
13,13,169,5,6,11,13,13,26,8,0.33698,0.349419,0.000068,No
26,26,676,11,20,31,26,26,52,7,0.376908,0.394583,0.000068,No
42,40,1680,7,25,32,42,42,84,8,0.383068,0.402141,0.000068,No
15,15,225,11,12,23,15,15,30,8,0.356303,0.371333,0.000068,No
7,7,49,6,6,12,7,7,14,8,0.365297,0.382325,0.000068,No
21,21,441,10,10,20,21,21,42,7,0.354947,0.370016,0.000068,No
24,24,576,15,18,33,24,24,48,7,0.34368,0.355911,0.000068,No
10,10,100,4,7,11,10,10,20,8,0.336754,0.349324,0.000068,No
13,13,169,4,7,11,13,13,26,8,0.351004,0.36502,0.000068,No
11,11,121,6,8,14,11,11,22,8,0.353227,0.367716,0.000068,No
17,17,289,13,10,23,17,17,34,7,0.325767,0.33667,0.000068,No
6,6,36,6,6,12,6,6,12,8,0.300675,0.310343,0.000068,No
39,38,1482,13,26,39,39,39,78,7,0.392496,0.411705,0.000068,No
61,61,3721,24,27,51,61,61,122,7,0.386697,0.40586,0.000068,No
7,7,49,3,7,10,7,7,14,8,0.35143,0.366224,0.000068,No
25,25,625,10,18,28,25,25,50,8,0.345056,0.359019,0.000067,yes
11,10,110,4,7,11,11,11,22,8,0.347126,0.360816,0.000067,No
19,19,361,12,12,24,19,19,38,7,0.368237,0.384648,0.000067,No
35,34,1190,15,19,34,35,35,70,7,0.378715,0.39675,0.000067,No
13,13,169,8,10,18,13,13,26,8,0.360306,0.376131,0.000067,No
22,22,484,10,18,28,22,22,44,7,0.363213,0.379381,0.000067,No
5,5,25,1,5,6,5,5,10,8,0.349687,0.364048,0.000067,No
35,33,1155,15,18,33,35,35,70,8,0.357079,0.372475,0.000067,No
61,59,3599,34,18,52,61,61,122,8,0.353359,0.368064,0.000067,No
11,5,55,3,7,10,11,11,22,8,0.342672,0.355502,0.000067,No
6,6,36,5,4,9,6,6,12,8,0.333125,0.34498,0.000067,No
17,17,289,5,9,14,17,17,34,7,0.369665,0.386626,0.000067,No
16,16,256,13,14,27,16,16,32,7,0.33048,0.341068,0.000067,No
12,12,144,8,9,17,12,12,24,7,0.335325,0.346671,0.000067,No
12,12,144,7,10,17,12,12,24,8,0.36746,0.384788,0.000067,No
30,29,870,10,20,30,30,30,60,7,0.371403,0.388724,0.000067,No
19,19,361,6,9,15,19,19,38,7,0.366994,0.383793,0.000067,No
20,20,400,9,13,22,20,20,40,8,0.375283,0.393718,0.000067,No
7,7,49,4,6,10,7,7,14,8,0.357468,0.372477,0.000067,No
11,11,121,6,8,14,11,11,22,7,0.346548,0.359841,0.000067,No
18,18,324,8,10,18,18,18,36,7,0.361282,0.37686,0.000067,No
6,6,36,4,6,10,6,6,12,8,0.325543,0.337193,0.000067,No
25,25,625,9,15,24,25,25,50,7,0.391255,0.410452,0.000067,No
21,21,441,9,11,20,21,21,42,7,0.378211,0.395991,0.000067,No
4,4,16,2,4,6,4,4,8,8,0.323371,0.334863,0.000067,No
11,8,88,9,8,17,11,11,22,8,0.352447,0.367902,0.000067,No
19,19,361,10,9,19,19,19,38,8,0.355139,0.370955,0.000067,No
30,30,900,7,19,26,30,30,60,8,0.314502,0.321448,0.000066,No
8,8,64,8,2,10,8,8,16,7,0.332236,0.343545,0.000066,No
23,23,529,15,16,31,23,23,46,7,0.383395,0.402684,0.000066,No
11,9,99,8,7,15,11,11,22,8,0.348844,0.363239,0.000066,No
72,71,5112,15,28,43,72,72,144,7,0.386811,0.406189,0.000066,No
11,11,121,11,7,18,11,11,22,8,0.32201,0.330487,0.000066,No
30,30,900,19,16,35,30,30,60,8,0.344234,0.356875,0.000066,No
15,15,225,9,8,17,15,15,30,8,0.35474,0.370165,0.000066,No
9,9,81,4,5,9,9,9,18,7,0.328634,0.338641,0.000066,No
5,4,20,5,5,10,5,5,10,8,0.332204,0.343275,0.000066,No
110,105,11550,15,59,74,110,110,220,8,0.36045,0.377877,0.000066,No
4,4,16,4,4,8,4,4,8,8,0.343596,0.356516,0.000066,No
36,33,1188,11,15,26,36,36,72,7,0.371492,0.389144,0.000066,No
12,12,144,11,8,19,12,12,24,8,0.349258,0.363239,0.000066,No
14,11,154,10,12,22,14,14,28,8,0.321598,0.330396,0.000066,No
16,15,240,5,13,18,16,16,32,7,0.348303,0.361853,0.000066,No
18,18,324,12,8,20,18,18,36,7,0.35508,0.370567,0.000066,No
6,6,36,3,6,9,6,6,12,7,0.331797,0.34321,0.000066,No
4,4,16,4,4,8,4,4,8,8,0.345405,0.358337,0.000066,No
11,11,121,7,9,16,11,11,22,8,0.363793,0.380662,0.000066,No
26,26,676,8,14,22,26,26,52,8,0.37288,0.390706,0.000066,No
17,17,289,9,14,23,17,17,34,8,0.361007,0.377151,0.000066,No
7,7,49,5,6,11,7,7,14,7,0.357535,0.373244,0.000066,No
4,4,16,3,3,6,4,4,8,8,0.344304,0.357153,0.000066,No
8,8,64,6,5,11,8,8,16,7,0.334241,0.345836,0.000066,No
6,6,36,6,5,11,6,6,12,8,0.347551,0.361308,0.000066,No
22,22,484,14,18,32,22,22,44,8,0.318964,0.327,0.000066,No
8,8,64,8,7,15,8,8,16,8,0.338484,0.350711,0.000066,No
19,19,361,7,14,21,19,19,38,8,0.351474,0.366006,0.000066,No
18,18,324,5,9,14,18,18,36,7,0.348887,0.362482,0.000066,No
14,14,196,11,9,20,14,14,28,8,0.373501,0.391359,0.000066,No
12,11,132,10,9,19,12,12,24,8,0.345832,0.359616,0.000065,No
4,4,16,4,4,8,4,4,8,8,0.312916,0.320981,0.000065,No
5,5,25,1,2,3,5,5,10,8,0.272211,0.278789,0.000065,No
12,11,132,10,9,19,12,12,24,8,0.337681,0.349616,0.000065,No
46,43,1978,23,10,33,46,46,92,8,0.361007,0.37668,0.000065,No
9,9,81,7,7,14,9,9,18,8,0.352658,0.367104,0.000065,No
20,18,360,7,16,23,20,20,40,7,0.364049,0.380027,0.000065,No
26,23,598,13,12,25,26,26,52,8,0.313831,0.320509,0.000065,No
16,15,240,3,10,13,16,16,32,8,0.35764,0.373195,0.000065,No
23,23,529,12,13,25,23,23,46,7,0.382724,0.401252,0.000065,No
6,6,36,5,4,9,6,6,12,8,0.341042,0.353465,0.000065,No
23,23,529,17,7,24,23,23,46,8,0.351445,0.365605,0.000065,No
12,12,144,10,9,19,12,12,24,8,0.335424,0.346994,0.000065,No
8,8,64,5,6,11,8,8,16,8,0.333229,0.34524,0.000065,No
11,11,121,9,8,17,11,11,22,7,0.359592,0.375004,0.000065,No
3,3,9,2,2,4,3,3,6,9,0.246258,0.251249,0.000065,No
12,12,144,7,11,18,12,12,24,8,0.352337,0.366868,0.000065,No
22,20,440,5,16,21,22,22,44,7,0.350075,0.364596,0.000065,No
10,9,90,5,6,11,10,10,20,8,0.348395,0.362712,0.000065,No
3,3,9,3,3,6,3,3,6,8,0.339961,0.352273,0.000065,No
16,16,256,10,9,19,16,16,32,8,0.34948,0.36371,0.000065,No
13,9,117,5,8,13,13,13,26,7,0.368364,0.3854,0.000065,No
26,26,676,17,10,27,26,26,52,8,0.346802,0.360175,0.000065,No
6,6,36,2,5,7,6,6,12,8,0.333555,0.344428,0.000065,No
4,4,16,4,4,8,4,4,8,8,0.280194,0.288964,0.000065,No
9,9,81,5,9,14,9,9,18,8,0.366355,0.3851,0.000065,No
7,7,49,7,6,13,7,7,14,8,0.343839,0.356899,0.000065,No
18,18,324,13,8,21,18,18,36,7,0.368762,0.385609,0.000065,No
23,23,529,19,7,26,23,23,46,7,0.34516,0.358684,0.000065,No
9,9,81,9,8,17,9,9,18,8,0.351517,0.365918,0.000065,No
44,43,1892,26,26,52,44,44,88,7,0.371541,0.389007,0.000064,yes
6,6,36,3,5,8,6,6,12,8,0.344937,0.358207,0.000064,No
7,7,49,5,5,10,7,7,14,7,0.332262,0.34267,0.000064,No
3,3,9,2,3,5,3,3,6,8,0.32501,0.335819,0.000064,No
16,16,256,14,10,24,16,16,32,8,0.349022,0.363474,0.000064,No
7,6,42,4,6,10,7,7,14,8,0.342865,0.355057,0.000064,No
19,19,361,6,12,18,19,19,38,8,0.343099,0.355496,0.000064,No
40,37,1480,13,14,27,40,40,80,7,0.375738,0.393791,0.000064,No
30,30,900,26,23,49,30,30,60,7,0.37735,0.396239,0.000064,No
19,19,361,2,15,17,19,19,38,8,0.361934,0.377346,0.000064,No
11,10,110,7,8,15,11,11,22,7,0.33825,0.350815,0.000064,No
8,8,64,5,6,11,8,8,16,8,0.332567,0.344707,0.000064,No
16,16,256,13,10,23,16,16,32,8,0.352672,0.367458,0.000064,No
18,18,324,13,8,21,18,18,36,8,0.350061,0.364742,0.000064,No
3,3,9,3,3,6,3,3,6,8,0.342637,0.356566,0.000064,No
39,37,1443,23,4,27,39,39,78,8,0.319299,0.32709,0.000064,No
7,7,49,5,5,10,7,7,14,7,0.364984,0.381951,0.000064,No
13,13,169,11,9,20,13,13,26,8,0.364423,0.382081,0.000064,No
10,9,90,5,8,13,10,10,20,8,0.363336,0.380409,0.000064,No
5,5,25,4,4,8,5,5,10,8,0.326608,0.337303,0.000064,No
47,46,2162,7,24,31,47,47,94,8,0.372522,0.390661,0.000064,No
16,10,160,6,7,13,16,16,32,8,0.317097,0.325299,0.000064,No
3,3,9,2,2,4,3,3,6,8,0.339975,0.352256,0.000064,No
5,5,25,5,5,10,5,5,10,8,0.353037,0.369025,0.000064,No
12,9,108,7,10,17,12,12,24,8,0.349852,0.364743,0.000064,No
4,4,16,3,3,6,4,4,8,8,0.342837,0.355539,0.000064,No
9,9,81,5,8,13,9,9,18,8,0.343714,0.357471,0.000064,No
9,9,81,7,8,15,9,9,18,8,0.340382,0.354437,0.000064,No
18,15,270,4,9,13,18,18,36,8,0.355991,0.371689,0.000064,No
14,14,196,9,10,19,14,14,28,7,0.347593,0.361034,0.000064,No
11,10,110,5,11,16,11,11,22,7,0.333914,0.345536,0.000064,No
33,33,1089,7,20,27,33,33,66,7,0.375357,0.392911,0.000064,No
4,4,16,3,4,7,4,4,8,8,0.334306,0.345745,0.000064,No
2,2,4,2,2,4,2,2,4,9,0.241112,0.244492,0.000064,No
3,3,9,3,3,6,3,3,6,8,0.283039,0.290358,0.000064,No
6,5,30,6,5,11,6,6,12,8,0.345615,0.358628,0.000064,No
4,4,16,3,2,5,4,4,8,8,0.336674,0.348875,0.000064,No
10,10,100,7,8,15,10,10,20,8,0.323524,0.332707,0.000064,No
6,4,24,4,4,8,6,6,12,7,0.342699,0.356219,0.000063,No
7,7,49,5,7,12,7,7,14,8,0.349387,0.363897,0.000063,No
43,40,1720,13,24,37,43,43,86,8,0.370846,0.388914,0.000063,No
16,16,256,8,6,14,16,16,32,8,0.333966,0.346518,0.000063,No
6,6,36,4,4,8,6,6,12,8,0.296351,0.30383,0.000063,No
11,11,121,8,8,16,11,11,22,8,0.351177,0.365478,0.000063,No
12,12,144,6,3,9,12,12,24,8,0.316227,0.326583,0.000063,No
22,22,484,12,8,20,22,22,44,8,0.365845,0.382096,0.000063,No
4,4,16,4,4,8,4,4,8,8,0.351481,0.366144,0.000063,No
12,12,144,8,9,17,12,12,24,8,0.349652,0.363614,0.000063,No
6,5,30,4,5,9,6,6,12,7,0.342232,0.355313,0.000063,No
7,7,49,6,6,12,7,7,14,8,0.363058,0.379772,0.000063,No
14,14,196,12,8,20,14,14,28,8,0.354585,0.369914,0.000063,No
24,23,552,12,21,33,24,24,48,7,0.374501,0.392867,0.000063,No
25,25,625,8,19,27,25,25,50,8,0.36623,0.383757,0.000063,No
14,13,182,7,13,20,14,14,28,8,0.351127,0.365491,0.000063,No
8,8,64,3,6,9,8,8,16,8,0.327693,0.338648,0.000063,No
6,6,36,6,5,11,6,6,12,8,0.359463,0.376336,0.000063,No
6,6,36,3,5,8,6,6,12,8,0.340552,0.353108,0.000063,No
2,1,2,2,2,4,2,2,4,8,0.310745,0.317554,0.000063,No
3,3,9,3,3,6,3,3,6,8,0.344304,0.357153,0.000063,No
5,3,15,5,5,10,5,5,10,8,0.306217,0.315182,0.000063,No
60,58,3480,28,15,43,60,60,120,7,0.365343,0.381703,0.000063,No
7,7,49,3,5,8,7,7,14,8,0.331617,0.343739,0.000063,No
6,6,36,4,5,9,6,6,12,8,0.310214,0.318857,0.000063,No
7,7,49,7,7,14,7,7,14,7,0.357049,0.372835,0.000063,No
9,8,72,7,6,13,9,9,18,7,0.333145,0.345127,0.000063,No
6,5,30,3,6,9,6,6,12,8,0.316099,0.323873,0.000063,No
9,8,72,9,9,18,9,9,18,8,0.336276,0.348019,0.000063,No
8,8,64,5,2,7,8,8,16,8,0.330961,0.343854,0.000063,No
13,13,169,4,9,13,13,13,26,7,0.346872,0.360764,0.000063,No
20,19,380,10,14,24,20,20,40,8,0.332859,0.344738,0.000063,No
7,6,42,5,3,8,7,7,14,7,0.355494,0.370175,0.000063,No
61,61,3721,17,29,46,61,61,122,7,0.398864,0.418193,0.000063,No
8,8,64,4,6,10,8,8,16,7,0.350932,0.365214,0.000063,No
7,7,49,6,6,12,7,7,14,8,0.313445,0.321805,0.000063,No
12,12,144,7,5,12,12,12,24,8,0.365743,0.382875,0.000063,No
20,20,400,11,13,24,20,20,40,7,0.370725,0.388538,0.000063,No
2,2,4,2,2,4,2,2,4,8,0.343673,0.356375,0.000063,No
8,8,64,7,7,14,8,8,16,8,0.34836,0.361571,0.000063,No
129,127,16383,30,29,59,129,129,258,7,0.372165,0.389423,0.000063,No
2,2,4,2,2,4,2,2,4,8,0.311335,0.322362,0.000063,No
6,6,36,4,4,8,6,6,12,8,0.338585,0.351152,0.000063,No
16,16,256,4,14,18,16,16,32,8,0.364392,0.381407,0.000063,No
7,7,49,4,4,8,7,7,14,8,0.332204,0.343762,0.000063,No
3,3,9,3,3,6,3,3,6,8,0.345209,0.359841,0.000063,No
9,9,81,2,6,8,9,9,18,7,0.329338,0.340129,0.000062,yes
13,10,130,9,4,13,13,13,26,8,0.339157,0.352292,0.000062,No
7,7,49,5,5,10,7,7,14,8,0.346309,0.359735,0.000062,No
15,15,225,11,8,19,15,15,30,7,0.378077,0.395689,0.000062,No
52,50,2600,15,3,18,52,52,104,7,0.329344,0.339917,0.000062,No
7,7,49,3,7,10,7,7,14,8,0.312006,0.319316,0.000062,No
7,7,49,2,5,7,7,7,14,8,0.342686,0.355366,0.000062,No
10,10,100,6,5,11,10,10,20,8,0.367507,0.384482,0.000062,No
6,6,36,6,5,11,6,6,12,8,0.326552,0.337981,0.000062,No
4,4,16,4,4,8,4,4,8,8,0.330198,0.342956,0.000062,No
17,15,255,8,5,13,17,17,34,7,0.332703,0.343971,0.000062,No
112,104,11648,34,41,75,112,112,224,7,0.376983,0.396098,0.000062,No
25,22,550,18,2,20,25,25,50,7,0.329745,0.340907,0.000062,No
36,35,1260,10,10,20,36,36,72,7,0.364189,0.380736,0.000062,No
5,5,25,2,4,6,5,5,10,8,0.333627,0.345387,0.000062,No
18,18,324,10,11,21,18,18,36,7,0.374386,0.39183,0.000062,No
6,5,30,6,5,11,6,6,12,8,0.342417,0.35517,0.000062,No
14,14,196,5,6,11,14,14,28,7,0.343624,0.35653,0.000062,No
21,21,441,7,14,21,21,21,42,7,0.361688,0.377368,0.000062,No
9,8,72,5,8,13,9,9,18,8,0.35073,0.367042,0.000062,No
9,8,72,7,5,12,9,9,18,8,0.364119,0.380133,0.000062,No
2,1,2,2,2,4,2,2,4,8,0.339955,0.352238,0.000062,No
27,27,729,7,15,22,27,27,54,7,0.378438,0.396382,0.000062,No
48,47,2256,5,23,28,48,48,96,7,0.373288,0.391112,0.000062,No
4,3,12,4,3,7,4,4,8,8,0.296521,0.304944,0.000062,No
25,25,625,16,17,33,25,25,50,7,0.374871,0.392692,0.000062,No
7,7,49,4,5,9,7,7,14,7,0.341725,0.355211,0.000062,No
16,16,256,6,8,14,16,16,32,7,0.348744,0.36272,0.000062,No
20,18,360,7,15,22,20,20,40,7,0.354932,0.370097,0.000062,No
5,5,25,4,5,9,5,5,10,8,0.31682,0.324978,0.000062,No
6,6,36,2,4,6,6,6,12,8,0.298696,0.305593,0.000062,No
83,78,6474,2,31,33,83,83,166,7,0.383266,0.402161,0.000062,No
4,4,16,3,3,6,4,4,8,8,0.28715,0.294262,0.000062,No
7,7,49,3,6,9,7,7,14,7,0.345755,0.359214,0.000062,No
6,6,36,6,6,12,6,6,12,8,0.346802,0.361853,0.000062,No
11,11,121,8,8,16,11,11,22,8,0.367412,0.384832,0.000062,No
14,14,196,12,7,19,14,14,28,8,0.359494,0.374813,0.000062,No
8,8,64,5,6,11,8,8,16,7,0.353887,0.368392,0.000062,No
8,8,64,6,7,13,8,8,16,8,0.363274,0.380541,0.000062,No
3,3,9,3,3,6,3,3,6,7,0.342273,0.354951,0.000062,No
3,3,9,2,2,4,3,3,6,8,0.282397,0.291572,0.000062,No
10,10,100,9,5,14,10,10,20,8,0.341951,0.354633,0.000062,No
9,9,81,5,9,14,9,9,18,7,0.35488,0.36997,0.000062,No
9,9,81,7,8,15,9,9,18,8,0.337047,0.347781,0.000062,No
2,2,4,2,2,4,2,2,4,9,0.23519,0.238106,0.000062,No
6,5,30,5,5,10,6,6,12,7,0.35322,0.367767,0.000062,No
11,10,110,5,10,15,11,11,22,7,0.360999,0.377235,0.000062,No
9,9,81,7,8,15,9,9,18,7,0.355154,0.36996,0.000062,No
5,5,25,4,4,8,5,5,10,7,0.342644,0.355488,0.000062,No
12,12,144,8,10,18,12,12,24,8,0.361229,0.377226,0.000062,No
12,11,132,8,8,16,12,12,24,7,0.347728,0.361217,0.000062,No
21,17,357,8,17,25,21,21,42,7,0.368484,0.385658,0.000062,No
16,13,208,6,8,14,16,16,32,8,0.3151,0.322933,0.000062,No
3,3,9,2,3,5,3,3,6,8,0.314694,0.32268,0.000062,No
11,11,121,5,6,11,11,11,22,8,0.331185,0.343491,0.000061,yes
11,11,121,3,7,10,11,11,22,8,0.342273,0.355023,0.000061,No
15,15,225,9,8,17,15,15,30,8,0.326583,0.335794,0.000061,No
6,6,36,6,5,11,6,6,12,8,0.355672,0.370639,0.000061,No
12,12,144,10,8,18,12,12,24,8,0.344986,0.358797,0.000061,No
3,3,9,2,2,4,3,3,6,8,0.339955,0.352238,0.000061,No
3,3,9,2,2,4,3,3,6,8,0.331604,0.343132,0.000061,No
10,10,100,7,8,15,10,10,20,8,0.311738,0.318825,0.000061,No
3,3,9,3,3,6,3,3,6,8,0.307597,0.314826,0.000061,No
3,3,9,2,3,5,3,3,6,8,0.34239,0.354953,0.000061,No
5,4,20,4,4,8,5,5,10,7,0.342823,0.354935,0.000061,No
8,8,64,5,7,12,8,8,16,8,0.359282,0.375543,0.000061,No
4,4,16,4,4,8,4,4,8,8,0.312269,0.323279,0.000061,No
6,5,30,3,5,8,6,6,12,8,0.342088,0.354779,0.000061,No
18,18,324,8,11,19,18,18,36,8,0.368699,0.386392,0.000061,No
9,9,81,8,6,14,9,9,18,7,0.35435,0.368796,0.000061,No
24,23,552,14,16,30,24,24,48,7,0.370307,0.387389,0.000061,No
10,10,100,5,7,12,10,10,20,8,0.348132,0.36199,0.000061,No
7,7,49,4,5,9,7,7,14,7,0.332062,0.343666,0.000061,No
9,9,81,9,6,15,9,9,18,7,0.339623,0.350446,0.000061,No
6,6,36,2,4,6,6,6,12,8,0.344644,0.357489,0.000061,No
14,14,196,9,11,20,14,14,28,8,0.329491,0.339629,0.000061,No
6,6,36,3,6,9,6,6,12,7,0.371605,0.389788,0.000061,No
13,13,169,6,10,16,13,13,26,7,0.346253,0.359446,0.000061,No
10,10,100,6,8,14,10,10,20,8,0.35055,0.365439,0.000061,No
23,23,529,13,17,30,23,23,46,8,0.318387,0.327818,0.000061,No
3,3,9,2,3,5,3,3,6,9,0.282196,0.292936,0.000061,No
27,26,702,7,15,22,27,27,54,8,0.371048,0.388712,0.000061,No
18,18,324,8,10,18,18,18,36,7,0.364345,0.381427,0.000061,No
2,2,4,2,2,4,2,2,4,9,0.261402,0.2673,0.000061,No
7,7,49,5,6,11,7,7,14,8,0.30303,0.311281,0.000061,No
6,6,36,6,6,12,6,6,12,8,0.330563,0.341077,0.000061,No
24,24,576,10,19,29,24,24,48,8,0.362426,0.379863,0.000061,No
5,5,25,5,4,9,5,5,10,8,0.343389,0.356168,0.000061,No
61,57,3477,23,26,49,61,61,122,7,0.378396,0.396756,0.000061,No
5,5,25,5,5,10,5,5,10,7,0.345839,0.358937,0.000061,No
2,2,4,2,2,4,2,2,4,8,0.30398,0.311074,0.000061,No
12,12,144,9,8,17,12,12,24,8,0.347593,0.361879,0.000061,No
4,4,16,3,4,7,4,4,8,8,0.332185,0.34374,0.000061,No
7,5,35,7,7,14,7,7,14,8,0.3124,0.319951,0.000061,No
9,9,81,4,7,11,9,9,18,8,0.352935,0.367236,0.000061,No
1,1,1,1,1,2,1,1,2,8,0.260934,0.266323,0.000061,No
8,8,64,5,7,12,8,8,16,8,0.365367,0.38244,0.000061,No
2,2,4,1,2,3,2,2,4,8,0.317463,0.327498,0.000061,No
6,6,36,3,5,8,6,6,12,8,0.33212,0.342799,0.000061,No
4,3,12,2,3,5,4,4,8,8,0.340436,0.352813,0.000061,No
5,5,25,3,4,7,5,5,10,7,0.332101,0.343864,0.000061,No
4,3,12,4,3,7,4,4,8,8,0.319352,0.326693,0.000061,No
6,6,36,6,6,12,6,6,12,7,0.356459,0.371971,0.000061,No
3,3,9,3,2,5,3,3,6,8,0.345167,0.358809,0.000061,No
23,21,483,9,10,19,23,23,46,8,0.363089,0.378929,0.000061,No
28,27,756,12,22,34,28,28,56,7,0.385169,0.403825,0.000061,No
4,4,16,3,3,6,4,4,8,8,0.318917,0.328992,0.000061,No
1,1,1,1,1,2,1,1,2,9,0.20695,0.209598,0.000061,No
3,3,9,3,2,5,3,3,6,8,0.318756,0.328742,0.000061,No
3,3,9,3,3,6,3,3,6,8,0.323481,0.334547,0.000061,No
5,5,25,4,5,9,5,5,10,7,0.331778,0.343222,0.000061,No
6,6,36,5,6,11,6,6,12,7,0.348331,0.362384,0.000061,No
2,1,2,2,2,4,2,2,4,9,0.269434,0.276064,0.000061,No
57,56,3192,29,20,49,57,57,114,8,0.361366,0.378434,0.000061,No
7,7,49,5,5,10,7,7,14,8,0.310231,0.319255,0.000061,No
7,7,49,4,6,10,7,7,14,7,0.331675,0.343028,0.000061,No
5,5,25,5,4,9,5,5,10,7,0.354107,0.36874,0.000061,No
12,11,132,6,10,16,12,12,24,8,0.359312,0.375015,0.000061,No
4,4,16,3,3,6,4,4,8,8,0.292731,0.301098,0.000061,No
3,3,9,3,3,6,3,3,6,7,0.339171,0.350371,0.000061,No
2,2,4,2,2,4,2,2,4,8,0.34461,0.357406,0.000061,No
2,2,4,2,2,4,2,2,4,8,0.283603,0.293053,0.000061,No
8,6,48,3,6,9,8,8,16,8,0.354306,0.368978,0.000061,No
5,5,25,4,5,9,5,5,10,8,0.350571,0.365417,0.000061,No
4,3,12,3,4,7,4,4,8,8,0.340953,0.35333,0.000061,No
3,3,9,3,3,6,3,3,6,8,0.324429,0.333671,0.000061,No
9,9,81,9,9,18,9,9,18,8,0.350233,0.364786,0.000061,No
8,8,64,6,4,10,8,8,16,8,0.333294,0.344779,0.000061,No
4,4,16,2,2,4,4,4,8,8,0.320679,0.331019,0.000061,No
18,18,324,13,16,29,18,18,36,7,0.367159,0.383751,0.000061,No
78,66,5148,5,33,38,78,78,156,8,0.319161,0.326933,0.00006,yes
10,10,100,7,9,16,10,10,20,8,0.336734,0.347964,0.00006,yes
2,2,4,2,2,4,2,2,4,8,0.301626,0.31456,0.00006,No
1,1,1,1,1,2,1,1,2,9,0.249029,0.253711,0.00006,No
9,9,81,2,5,7,9,9,18,8,0.345209,0.358375,0.00006,No
4,4,16,3,3,6,4,4,8,8,0.35241,0.367775,0.00006,No
6,6,36,6,5,11,6,6,12,8,0.317469,0.326284,0.00006,No
5,5,25,4,5,9,5,5,10,8,0.321011,0.330894,0.00006,No
21,20,420,3,13,16,21,21,42,7,0.363561,0.379677,0.00006,No
33,32,1056,12,19,31,33,33,66,7,0.370508,0.387889,0.00006,No
15,13,195,7,8,15,15,15,30,8,0.344603,0.357807,0.00006,No
5,4,20,3,5,8,5,5,10,7,0.33736,0.347696,0.00006,No
13,13,169,5,8,13,13,13,26,8,0.32591,0.336229,0.00006,No
2,2,4,2,2,4,2,2,4,9,0.303818,0.312077,0.00006,No
15,15,225,3,8,11,15,15,30,7,0.331198,0.342411,0.00006,No
2,2,4,2,2,4,2,2,4,8,0.338364,0.350881,0.00006,No
6,6,36,2,6,8,6,6,12,7,0.351127,0.365627,0.00006,No
6,6,36,3,6,9,6,6,12,8,0.315298,0.326459,0.00006,No
7,7,49,3,7,10,7,7,14,8,0.354063,0.36887,0.00006,No
8,8,64,6,7,13,8,8,16,8,0.336323,0.349687,0.00006,No
2,2,4,2,2,4,2,2,4,9,0.269818,0.276737,0.00006,No
11,11,121,7,8,15,11,11,22,8,0.34858,0.36236,0.00006,No
12,12,144,8,8,16,12,12,24,8,0.339576,0.35074,0.00006,No
17,17,289,14,4,18,17,17,34,8,0.319939,0.328961,0.00006,No
9,9,81,8,7,15,9,9,18,8,0.315537,0.324425,0.00006,No
3,3,9,3,3,6,3,3,6,8,0.332043,0.343643,0.00006,No
19,19,361,10,7,17,19,19,38,8,0.367405,0.384409,0.00006,No
26,26,676,11,16,27,26,26,52,7,0.375374,0.392974,0.00006,No
8,8,64,1,7,8,8,8,16,8,0.318488,0.325592,0.00006,No
4,4,16,3,2,5,4,4,8,7,0.331282,0.342332,0.00006,No
2,2,4,2,2,4,2,2,4,7,0.327838,0.338556,0.00006,No
8,8,64,6,3,9,8,8,16,8,0.33825,0.351527,0.00006,No
17,17,289,8,7,15,17,17,34,8,0.354814,0.369501,0.00006,No
12,12,144,11,3,14,12,12,24,8,0.345328,0.359709,0.00006,No
12,12,144,10,7,17,12,12,24,8,0.310231,0.3173,0.00006,No
4,4,16,2,4,6,4,4,8,8,0.352454,0.367843,0.00006,No
3,2,6,3,3,6,3,3,6,8,0.309163,0.31805,0.00006,No
2,2,4,2,2,4,2,2,4,8,0.275935,0.285074,0.00006,No
46,44,2024,16,14,30,46,46,92,7,0.370387,0.38795,0.00006,No
2,2,4,2,2,4,2,2,4,8,0.29231,0.300623,0.00006,No
2,2,4,2,2,4,2,2,4,8,0.265432,0.271399,0.00006,No
4,3,12,3,4,7,4,4,8,8,0.306519,0.319197,0.00006,No
13,12,156,6,10,16,13,13,26,8,0.351098,0.364748,0.00006,No
4,4,16,3,4,7,4,4,8,8,0.344199,0.357517,0.00006,No
6,6,36,4,4,8,6,6,12,8,0.330032,0.342103,0.00006,No
2,2,4,2,2,4,2,2,4,9,0.26755,0.273844,0.00006,No
9,9,81,5,5,10,9,9,18,8,0.347678,0.361172,0.00006,No
2,2,4,2,2,4,2,2,4,10,0.203742,0.206871,0.00006,No
5,5,25,5,5,10,5,5,10,8,0.324379,0.338592,0.00006,No
6,5,30,4,4,8,6,6,12,7,0.353162,0.367654,0.00006,No
3,3,9,3,3,6,3,3,6,8,0.315555,0.324933,0.00006,No
7,7,49,5,7,12,7,7,14,7,0.359047,0.374343,0.00006,No
3,3,9,2,3,5,3,3,6,8,0.340104,0.352414,0.00006,No
6,4,24,3,5,8,6,6,12,7,0.342555,0.355371,0.00006,No
12,12,144,7,10,17,12,12,24,8,0.361934,0.379429,0.00006,No
7,6,42,2,4,6,7,7,14,8,0.344324,0.357201,0.00006,No
3,3,9,2,2,4,3,3,6,7,0.327845,0.338566,0.00006,No
4,4,16,2,4,6,4,4,8,7,0.34397,0.356744,0.00006,No
3,3,9,2,3,5,3,3,6,8,0.275971,0.285255,0.00006,No
9,9,81,6,5,11,9,9,18,8,0.340341,0.353345,0.00006,No
4,4,16,3,3,6,4,4,8,8,0.314178,0.321656,0.00006,No
4,4,16,3,3,6,4,4,8,8,0.311153,0.318484,0.00006,No
15,15,225,12,11,23,15,15,30,8,0.319753,0.327138,0.00006,No
4,4,16,2,4,6,4,4,8,8,0.316439,0.326493,0.00006,No
28,27,756,8,6,14,28,28,56,7,0.343058,0.355576,0.00006,No
20,18,360,11,8,19,20,20,40,8,0.342472,0.355605,0.00006,No
9,9,81,6,5,11,9,9,18,8,0.332664,0.342262,0.00006,No
4,4,16,4,2,6,4,4,8,8,0.3347,0.34661,0.00006,No
9,9,81,8,7,15,9,9,18,7,0.340402,0.351584,0.00006,No
5,5,25,5,4,9,5,5,10,8,0.353403,0.367933,0.00006,No
4,4,16,3,3,6,4,4,8,8,0.308369,0.314812,0.00006,No
15,15,225,12,9,21,15,15,30,7,0.34782,0.361904,0.00006,No
12,12,144,3,8,11,12,12,24,8,0.358979,0.374153,0.00006,No
3,3,9,2,3,5,3,3,6,8,0.307464,0.314191,0.00006,No
5,5,25,4,4,8,5,5,10,8,0.321804,0.331232,0.00006,No
7,7,49,7,6,13,7,7,14,8,0.324842,0.335035,0.00006,No
4,4,16,3,3,6,4,4,8,8,0.342637,0.356566,0.00006,No
70,66,4620,16,26,42,70,70,140,7,0.384943,0.403465,0.00006,No
7,7,49,5,2,7,7,7,14,7,0.347983,0.361927,0.00006,No
3,3,9,3,3,6,3,3,6,7,0.332224,0.342927,0.00006,No
2,2,4,2,2,4,2,2,4,8,0.339955,0.352238,0.00006,No
11,11,121,7,8,15,11,11,22,8,0.342143,0.355774,0.00006,No
10,8,80,7,4,11,10,10,20,8,0.320354,0.32904,0.00006,No
4,4,16,3,3,6,4,4,8,8,0.343134,0.356023,0.00006,No
12,10,120,4,6,10,12,12,24,8,0.313491,0.321601,0.00006,No
2,1,2,2,2,4,2,2,4,8,0.278762,0.2883,0.00006,No
2,2,4,2,2,4,2,2,4,8,0.294088,0.301683,0.00006,No
4,4,16,3,3,6,4,4,8,8,0.293169,0.303753,0.00006,No
3,3,9,2,3,5,3,3,6,8,0.310056,0.318762,0.00006,No
3,3,9,3,3,6,3,3,6,9,0.27775,0.284941,0.00006,No
8,8,64,5,7,12,8,8,16,8,0.350111,0.364226,0.00006,No
3,3,9,3,2,5,3,3,6,8,0.331649,0.343176,0.00006,No
2,2,4,2,2,4,2,2,4,8,0.3016,0.31453,0.00006,No
8,8,64,3,4,7,8,8,16,8,0.316973,0.326966,0.00006,No
4,3,12,2,4,6,4,4,8,8,0.350255,0.36449,0.00006,No
14,14,196,11,8,19,14,14,28,7,0.373828,0.391728,0.00006,No
9,9,81,7,6,13,9,9,18,8,0.358843,0.374882,0.00006,No
1,1,1,1,1,2,1,1,2,8,0.331584,0.343081,0.00006,No
8,7,56,8,7,15,8,8,16,7,0.349079,0.362358,0.00006,No
4,4,16,4,4,8,4,4,8,7,0.345587,0.358508,0.00006,No
5,5,25,3,4,7,5,5,10,8,0.352884,0.367422,0.00006,No
10,10,100,9,5,14,10,10,20,8,0.333041,0.344522,0.00006,No
5,5,25,4,4,8,5,5,10,7,0.328166,0.338908,0.00006,No
9,9,81,7,6,13,9,9,18,8,0.329503,0.339068,0.00006,No
3,3,9,2,3,5,3,3,6,8,0.278484,0.285717,0.000059,yes
2,2,4,2,1,3,2,2,4,7,0.327819,0.338512,0.000059,yes
1,1,1,1,1,2,1,1,2,9,0.25371,0.258582,0.000059,No
1,1,1,1,1,2,1,1,2,9,0.213787,0.217734,0.000059,No
1,1,1,1,1,2,1,1,2,9,0.223119,0.226562,0.000059,No
1,1,1,1,1,2,1,1,2,9,0.268721,0.277328,0.000059,No
1,1,1,1,1,2,1,1,2,8,0.27296,0.279655,0.000059,No
1,1,1,1,1,2,1,1,2,11,0.17614,0.178291,0.000059,No
2,2,4,2,2,4,2,2,4,8,0.331597,0.343127,0.000059,No
1,1,1,1,1,2,1,1,2,9,0.231724,0.237333,0.000059,No
1,1,1,1,1,2,1,1,2,8,0.271894,0.278716,0.000059,No
1,1,1,1,1,2,1,1,2,8,0.339941,0.352199,0.000059,No
1,1,1,1,1,2,1,1,2,8,0.297472,0.304366,0.000059,No
1,1,1,1,1,2,1,1,2,8,0.298539,0.305394,0.000059,No
2,2,4,1,1,2,2,2,4,8,0.258495,0.265653,0.000059,No
3,3,9,3,3,6,3,3,6,8,0.343023,0.356956,0.000059,No
1,1,1,1,1,2,1,1,2,8,0.303391,0.311476,0.000059,No
1,1,1,1,1,2,1,1,2,8,0.323426,0.334429,0.000059,No
2,2,4,2,2,4,2,2,4,8,0.315386,0.32508,0.000059,No
21,20,420,14,14,28,21,21,42,7,0.374698,0.392105,0.000059,No
7,7,49,5,5,10,7,7,14,8,0.323193,0.332101,0.000059,No
2,2,4,2,2,4,2,2,4,8,0.309342,0.317986,0.000059,No
2,2,4,2,1,3,2,2,4,8,0.309325,0.317943,0.000059,No
2,2,4,2,2,4,2,2,4,8,0.271712,0.278398,0.000059,No
1,1,1,1,1,2,1,1,2,8,0.271899,0.280395,0.000059,No
1,1,1,1,1,2,1,1,2,8,0.246907,0.251306,0.000059,No
2,2,4,2,2,4,2,2,4,8,0.331591,0.343122,0.000059,No
2,2,4,2,2,4,2,2,4,8,0.30783,0.314455,0.000059,No
1,1,1,1,1,2,1,1,2,8,0.323432,0.334432,0.000059,No
7,7,49,3,3,6,7,7,14,8,0.329173,0.339622,0.000059,No
1,1,1,1,1,2,1,1,2,10,0.19414,0.195792,0.000059,No
1,1,1,1,1,2,1,1,2,8,0.339941,0.352199,0.000059,No
12,12,144,7,7,14,12,12,24,7,0.340022,0.351322,0.000059,No
2,2,4,2,2,4,2,2,4,8,0.280489,0.287471,0.000059,No
3,3,9,3,3,6,3,3,6,7,0.332256,0.343589,0.000059,No
6,6,36,4,5,9,6,6,12,8,0.344331,0.357525,0.000059,No
2,2,4,2,1,3,2,2,4,8,0.339941,0.352199,0.000059,No
2,2,4,2,2,4,2,2,4,8,0.29206,0.299499,0.000059,No
7,7,49,7,6,13,7,7,14,8,0.353777,0.368591,0.000059,No
1,1,1,1,1,2,1,1,2,8,0.280762,0.287772,0.000059,No
1,1,1,1,1,2,1,1,2,9,0.213782,0.21773,0.000059,No
2,2,4,2,2,4,2,2,4,8,0.272737,0.280577,0.000059,No
1,1,1,1,1,2,1,1,2,9,0.256559,0.262194,0.000059,No
1,1,1,1,1,2,1,1,2,9,0.213782,0.21773,0.000059,No
1,1,1,1,1,2,1,1,2,8,0.271903,0.280398,0.000059,No
4,4,16,2,3,5,4,4,8,8,0.296634,0.303915,0.000059,No
2,2,4,1,2,3,2,2,4,9,0.269916,0.276333,0.000059,No
5,5,25,3,2,5,5,5,10,8,0.310423,0.31886,0.000059,No
1,1,1,1,1,2,1,1,2,9,0.249022,0.253706,0.000059,No
1,1,1,1,1,2,1,1,2,9,0.27606,0.283081,0.000059,No
1,1,1,1,1,2,1,1,2,9,0.25371,0.258582,0.000059,No
1,1,1,1,1,2,1,1,2,9,0.217635,0.220945,0.000059,No
1,1,1,1,1,2,1,1,2,9,0.203805,0.206141,0.000059,No
4,4,16,3,3,6,4,4,8,7,0.342307,0.355332,0.000059,No
2,2,4,2,2,4,2,2,4,7,0.327845,0.338566,0.000059,No
3,3,9,3,2,5,3,3,6,8,0.316615,0.324603,0.000059,No
1,1,1,1,1,2,1,1,2,8,0.292601,0.299544,0.000059,No
1,1,1,1,1,2,1,1,2,8,0.310039,0.318687,0.000059,No
3,3,9,1,2,3,3,3,6,8,0.258711,0.263986,0.000059,No
2,2,4,2,2,4,2,2,4,8,0.304463,0.311299,0.000059,No
1,1,1,1,1,2,1,1,2,8,0.339941,0.352199,0.000059,No
3,3,9,1,1,2,3,3,6,9,0.25371,0.258582,0.000059,No
3,3,9,2,3,5,3,3,6,8,0.310315,0.322192,0.000059,No
7,7,49,3,4,7,7,7,14,7,0.332969,0.3431,0.000059,No
4,4,16,2,4,6,4,4,8,8,0.337654,0.349921,0.000059,No
1,1,1,1,1,2,1,1,2,7,0.29631,0.304858,0.000059,No
1,1,1,1,1,2,1,1,2,8,0.246907,0.251306,0.000059,No
1,1,1,1,1,2,1,1,2,10,0.197825,0.19988,0.000059,No
2,2,4,2,2,4,2,2,4,8,0.334051,0.345896,0.000059,No
1,1,1,1,1,2,1,1,2,9,0.233216,0.236255,0.000059,No
3,3,9,3,3,6,3,3,6,8,0.314757,0.323972,0.000059,No
1,1,1,1,1,2,1,1,2,8,0.304637,0.31125,0.000059,No
2,2,4,2,2,4,2,2,4,8,0.349637,0.363925,0.000059,No
1,1,1,1,1,2,1,1,2,10,0.211823,0.215844,0.000059,No
1,1,1,1,1,2,1,1,2,10,0.189872,0.191685,0.000059,No
1,1,1,1,1,2,1,1,2,10,0.213344,0.216745,0.000059,No
4,4,16,4,3,7,4,4,8,8,0.332904,0.34481,0.000059,No
2,2,4,1,1,2,2,2,4,8,0.304631,0.311247,0.000059,No
1,1,1,1,1,2,1,1,2,9,0.244389,0.248972,0.000059,No
3,3,9,3,3,6,3,3,6,7,0.32679,0.338337,0.000059,No
1,1,1,1,1,2,1,1,2,9,0.237517,0.24041,0.000059,No
1,1,1,1,1,2,1,1,2,9,0.215423,0.219627,0.000059,No
2,2,4,2,2,4,2,2,4,8,0.289886,0.297769,0.000059,No
1,1,1,1,1,2,1,1,2,8,0.2771,0.285608,0.000059,No
1,1,1,1,1,2,1,1,2,9,0.26155,0.267601,0.000059,No
2,2,4,1,1,2,2,2,4,9,0.225815,0.229189,0.000059,No
1,1,1,1,1,2,1,1,2,8,0.331584,0.343081,0.000059,No
2,2,4,1,1,2,2,2,4,8,0.331578,0.343078,0.000059,No
1,1,1,1,1,2,1,1,2,9,0.22839,0.232208,0.000059,No
1,1,1,1,1,2,1,1,2,10,0.204762,0.207322,0.000059,No
1,1,1,1,1,2,1,1,2,9,0.259746,0.266042,0.000059,No
1,1,1,1,1,2,1,1,2,8,0.301594,0.314494,0.000059,No
2,2,4,1,1,2,2,2,4,8,0.295965,0.304324,0.000059,No
5,5,25,2,5,7,5,5,10,8,0.315141,0.323234,0.000059,No
1,1,1,1,1,2,1,1,2,8,0.274554,0.283667,0.000059,No
2,2,4,1,1,2,2,2,4,8,0.323426,0.334429,0.000059,No
5,4,20,5,4,9,5,5,10,8,0.346077,0.35938,0.000059,No
4,4,16,4,4,8,4,4,8,8,0.341656,0.354132,0.000059,No
1,1,1,1,1,2,1,1,2,10,0.18618,0.188664,0.000059,No
2,2,4,2,2,4,2,2,4,8,0.277105,0.285644,0.000059,No
3,3,9,2,2,4,3,3,6,9,0.266664,0.273547,0.000059,No
1,1,1,1,1,2,1,1,2,8,0.339941,0.352199,0.000059,No
2,2,4,2,2,4,2,2,4,8,0.2891,0.296259,0.000059,No
1,1,1,1,1,2,1,1,2,10,0.201203,0.203712,0.000059,No
1,1,1,1,1,2,1,1,2,9,0.268645,0.276939,0.000059,No
3,3,9,3,2,5,3,3,6,8,0.330961,0.343854,0.000059,No
1,1,1,1,1,2,1,1,2,9,0.253717,0.258587,0.000059,No
1,1,1,1,1,2,1,1,2,7,0.296305,0.304855,0.000059,No
8,8,64,4,6,10,8,8,16,8,0.321858,0.331158,0.000059,No
1,1,1,1,1,2,1,1,2,9,0.278652,0.285713,0.000059,No
5,5,25,4,4,8,5,5,10,7,0.350355,0.364649,0.000059,No
2,2,4,1,1,2,2,2,4,9,0.253717,0.258587,0.000059,No
4,4,16,3,3,6,4,4,8,8,0.343555,0.356154,0.000059,No
2,2,4,1,1,2,2,2,4,9,0.210654,0.213637,0.000059,No
6,6,36,4,4,8,6,6,12,8,0.340002,0.352351,0.000059,No
1,1,1,1,1,2,1,1,2,8,0.301589,0.314491,0.000059,No
1,1,1,1,1,2,1,1,2,8,0.296444,0.303518,0.000059,No
2,2,4,1,2,3,2,2,4,8,0.295622,0.3033,0.000059,No
2,2,4,1,1,2,2,2,4,9,0.237078,0.240122,0.000059,No
1,1,1,1,1,2,1,1,2,8,0.339941,0.352199,0.000059,No
1,1,1,1,1,2,1,1,2,8,0.277393,0.284286,0.000059,No
2,2,4,2,2,4,2,2,4,7,0.335807,0.34642,0.000059,No
1,1,1,1,1,2,1,1,2,9,0.249029,0.253711,0.000059,No
4,4,16,1,2,3,4,4,8,8,0.295678,0.302647,0.000059,No
1,1,1,1,1,2,1,1,2,8,0.263363,0.269098,0.000059,No
1,1,1,1,1,2,1,1,2,9,0.25371,0.258582,0.000059,No
1,1,1,1,1,2,1,1,2,8,0.293143,0.300758,0.000059,No
1,1,1,1,1,2,1,1,2,8,0.251037,0.255424,0.000059,No
1,1,1,1,1,2,1,1,2,8,0.315771,0.323495,0.000059,No
7,7,49,7,6,13,7,7,14,7,0.346985,0.359798,0.000059,No
3,2,6,3,3,6,3,3,6,8,0.340395,0.352622,0.000059,No
3,3,9,3,2,5,3,3,6,8,0.34361,0.356903,0.000059,No
1,1,1,1,1,2,1,1,2,9,0.236671,0.240471,0.000059,No
5,5,25,3,2,5,5,5,10,8,0.325065,0.335867,0.000059,No
1,1,1,1,1,2,1,1,2,7,0.29631,0.304858,0.000059,No
1,1,1,1,1,2,1,1,2,8,0.331578,0.343078,0.000059,No
2,2,4,1,2,3,2,2,4,8,0.282402,0.289405,0.000059,No
2,2,4,2,1,3,2,2,4,9,0.245377,0.249848,0.000059,No
2,2,4,2,2,4,2,2,4,8,0.312309,0.321227,0.000059,No
2,1,2,1,2,3,2,2,4,8,0.274975,0.28412,0.000059,No
3,3,9,1,2,3,3,3,6,7,0.327838,0.338556,0.000059,No
4,3,12,4,4,8,4,4,8,8,0.313722,0.320554,0.000059,No
1,1,1,1,1,2,1,1,2,9,0.199698,0.201968,0.000059,No
1,1,1,1,1,2,1,1,2,9,0.230413,0.233874,0.000059,No
1,1,1,1,1,2,1,1,2,9,0.25371,0.258582,0.000059,No
1,1,1,1,1,2,1,1,2,9,0.223713,0.228588,0.000059,No
1,1,1,1,1,2,1,1,2,8,0.323426,0.334429,0.000059,No
3,3,9,2,2,4,3,3,6,9,0.260767,0.266754,0.000059,No
8,8,64,4,4,8,8,8,16,8,0.325481,0.34044,0.000059,No
3,3,9,3,3,6,3,3,6,8,0.312429,0.321308,0.000059,No
1,1,1,1,1,2,1,1,2,9,0.25371,0.258582,0.000059,No
2,2,4,1,1,2,2,2,4,9,0.25433,0.259231,0.000059,No
1,1,1,1,1,2,1,1,2,9,0.244309,0.248587,0.000059,No
1,1,1,1,1,2,1,1,2,8,0.238164,0.241148,0.000059,No
3,3,9,2,2,4,3,3,6,8,0.323439,0.334468,0.000059,No
1,1,1,1,1,2,1,1,2,8,0.301589,0.314491,0.000059,No
17,17,289,6,5,11,17,17,34,8,0.362095,0.37888,0.000059,No
2,2,4,2,2,4,2,2,4,8,0.301941,0.308767,0.000059,No
1,1,1,1,1,2,1,1,2,8,0.301594,0.314494,0.000059,No
2,2,4,1,1,2,2,2,4,8,0.30338,0.311471,0.000059,No
1,1,1,1,1,2,1,1,2,8,0.228586,0.232456,0.000059,No
2,2,4,2,2,4,2,2,4,7,0.32821,0.338853,0.000059,No
3,3,9,3,2,5,3,3,6,8,0.340708,0.352931,0.000059,No
1,1,1,1,1,2,1,1,2,9,0.231718,0.237328,0.000059,No
1,1,1,1,1,2,1,1,2,8,0.313508,0.320221,0.000059,No
5,4,20,4,5,9,5,5,10,8,0.301541,0.308411,0.000059,No
3,1,3,3,2,5,3,3,6,8,0.281684,0.288968,0.000059,No
2,2,4,2,2,4,2,2,4,8,0.307708,0.315606,0.000059,No
5,5,25,3,4,7,5,5,10,8,0.333986,0.347485,0.000059,No
3,3,9,2,3,5,3,3,6,8,0.321482,0.329903,0.000059,No
1,1,1,1,1,2,1,1,2,9,0.228194,0.231403,0.000059,No
2,2,4,2,2,4,2,2,4,8,0.3016,0.31453,0.000059,No
1,1,1,1,1,2,1,1,2,9,0.232786,0.236433,0.000059,No
2,2,4,2,2,4,2,2,4,7,0.331224,0.342603,0.000059,No
1,1,1,1,1,2,1,1,2,10,0.211818,0.21584,0.000059,No
1,1,1,1,1,2,1,1,2,8,0.289945,0.297465,0.000059,No
1,1,1,1,1,2,1,1,2,8,0.304132,0.310718,0.000059,No
1,1,1,1,1,2,1,1,2,9,0.235804,0.239063,0.000059,No
4,4,16,4,4,8,4,4,8,8,0.312155,0.320513,0.000059,No
3,3,9,3,3,6,3,3,6,8,0.338256,0.351537,0.000059,No
3,3,9,2,3,5,3,3,6,8,0.340022,0.352313,0.000059,No
1,1,1,1,1,2,1,1,2,9,0.232945,0.237079,0.000059,No
1,1,1,1,1,2,1,1,2,9,0.271181,0.278268,0.000059,No
5,5,25,3,5,8,5,5,10,8,0.326702,0.335502,0.000059,No
5,5,25,2,3,5,5,5,10,8,0.304936,0.311905,0.000059,No
1,1,1,1,1,2,1,1,2,9,0.238687,0.241674,0.000059,No
4,4,16,3,2,5,4,4,8,8,0.278771,0.288315,0.000059,No
2,2,4,2,2,4,2,2,4,8,0.308492,0.31485,0.000059,No
3,3,9,3,2,5,3,3,6,8,0.277001,0.283694,0.000059,No
3,3,9,3,3,6,3,3,6,8,0.332372,0.344891,0.000059,No
4,4,16,4,4,8,4,4,8,8,0.324201,0.332936,0.000059,No
3,3,9,3,3,6,3,3,6,8,0.316679,0.32385,0.000059,No
14,14,196,7,11,18,14,14,28,8,0.374238,0.392642,0.000059,No
2,2,4,2,2,4,2,2,4,8,0.290236,0.29738,0.000059,No
3,3,9,3,3,6,3,3,6,8,0.324435,0.335023,0.000059,No
4,4,16,4,3,7,4,4,8,8,0.33827,0.351551,0.000059,No
2,2,4,1,1,2,2,2,4,9,0.255974,0.261484,0.000059,No
3,3,9,3,3,6,3,3,6,7,0.33116,0.341796,0.000059,No
2,2,4,2,2,4,2,2,4,7,0.327882,0.338595,0.000059,No
7,6,42,2,4,6,7,7,14,8,0.343403,0.356596,0.000059,No
2,2,4,1,2,3,2,2,4,8,0.298122,0.306406,0.000059,No
1,1,1,1,1,2,1,1,2,8,0.294611,0.302087,0.000059,No
3,2,6,3,2,5,3,3,6,8,0.292826,0.302705,0.000059,No
1,1,1,1,1,2,1,1,2,8,0.262637,0.2685,0.000059,No
1,1,1,1,1,2,1,1,2,10,0.216349,0.219694,0.000059,No
1,1,1,1,1,2,1,1,2,9,0.232694,0.236431,0.000059,No
3,3,9,3,2,5,3,3,6,8,0.281062,0.288514,0.000059,No
1,1,1,1,1,2,1,1,2,8,0.331578,0.343078,0.000059,No
1,1,1,1,1,2,1,1,2,8,0.331584,0.343081,0.000059,No
1,1,1,1,1,2,1,1,2,10,0.188775,0.190795,0.000059,No
2,2,4,2,2,4,2,2,4,8,0.273986,0.280623,0.000059,No
7,7,49,7,5,12,7,7,14,8,0.338069,0.349754,0.000059,No
2,2,4,1,1,2,2,2,4,9,0.229669,0.233429,0.000059,No
5,5,25,4,4,8,5,5,10,8,0.319664,0.329374,0.000059,No
1,1,1,1,1,2,1,1,2,9,0.22483,0.228162,0.000059,No
5,5,25,5,4,9,5,5,10,8,0.327492,0.336103,0.000059,No
8,8,64,7,5,12,8,8,16,8,0.329962,0.34047,0.000059,No
1,1,1,1,1,2,1,1,2,8,0.287179,0.294464,0.000059,No
2,2,4,2,2,4,2,2,4,8,0.310186,0.318855,0.000059,No
10,10,100,6,5,11,10,10,20,8,0.335147,0.347552,0.000059,No
5,5,25,4,4,8,5,5,10,8,0.341595,0.354087,0.000059,No
2,2,4,2,2,4,2,2,4,8,0.310214,0.318892,0.000059,No
1,1,1,1,1,2,1,1,2,10,0.211818,0.21584,0.000059,No
4,4,16,4,4,8,4,4,8,8,0.317197,0.325554,0.000059,No
1,1,1,1,1,2,1,1,2,10,0.200555,0.203058,0.000059,No
3,2,6,3,3,6,3,3,6,8,0.31027,0.316646,0.000059,No
1,1,1,1,1,2,1,1,2,9,0.238693,0.241679,0.000059,No
1,1,1,1,1,2,1,1,2,9,0.236261,0.240057,0.000059,No
6,6,36,4,5,9,6,6,12,8,0.315298,0.322578,0.000059,No
4,4,16,4,4,8,4,4,8,8,0.313019,0.322027,0.000059,No
1,1,1,1,1,2,1,1,2,9,0.234698,0.23857,0.000059,No
2,2,4,2,2,4,2,2,4,8,0.287005,0.297276,0.000059,No
1,1,1,1,1,2,1,1,2,8,0.313502,0.320218,0.000059,No
2,2,4,1,2,3,2,2,4,9,0.261286,0.267191,0.000059,No
2,2,4,1,1,2,2,2,4,8,0.303661,0.312967,0.000059,No
3,3,9,2,2,4,3,3,6,8,0.339955,0.352238,0.000059,No
1,1,1,1,1,2,1,1,2,8,0.290019,0.297096,0.000059,No
1,1,1,1,1,2,1,1,2,9,0.219898,0.223337,0.000059,No
1,1,1,1,1,2,1,1,2,8,0.339941,0.352199,0.000059,No
2,2,4,2,2,4,2,2,4,8,0.317463,0.327498,0.000059,No
1,1,1,1,1,2,1,1,2,10,0.183562,0.18552,0.000059,No
1,1,1,1,1,2,1,1,2,8,0.281865,0.289107,0.000059,No
1,1,1,1,1,2,1,1,2,9,0.203056,0.205728,0.000059,No
1,1,1,1,1,2,1,1,2,7,0.327826,0.338517,0.000059,No
5,5,25,5,5,10,5,5,10,8,0.317015,0.328924,0.000059,No
1,1,1,1,1,2,1,1,2,9,0.203054,0.205726,0.000059,No
7,7,49,3,2,5,7,7,14,8,0.268857,0.276128,0.000059,No
3,3,9,2,3,5,3,3,6,8,0.318744,0.326475,0.000059,No
1,1,1,1,1,2,1,1,2,8,0.271899,0.280395,0.000059,No
2,2,4,1,2,3,2,2,4,7,0.327882,0.338595,0.000059,No
2,2,4,2,1,3,2,2,4,8,0.278743,0.288253,0.000059,No
1,1,1,1,1,2,1,1,2,8,0.339941,0.352199,0.000059,No
1,1,1,1,1,2,1,1,2,8,0.271899,0.280395,0.000059,No
3,3,9,2,3,5,3,3,6,8,0.333034,0.344623,0.000059,No
1,1,1,1,1,2,1,1,2,8,0.339934,0.352194,0.000059,No
4,4,16,4,1,5,4,4,8,9,0.264526,0.271027,0.000059,No
1,1,1,1,1,2,1,1,2,9,0.226375,0.229634,0.000059,No
2,2,4,2,2,4,2,2,4,9,0.268658,0.276983,0.000059,No
1,1,1,1,1,2,1,1,2,9,0.253717,0.258587,0.000059,No
11,11,121,6,5,11,11,11,22,8,0.33744,0.349854,0.000059,No
1,1,1,1,1,2,1,1,2,9,0.232774,0.236425,0.000059,No
1,1,1,1,1,2,1,1,2,10,0.194204,0.196446,0.000059,No
3,2,6,3,3,6,3,3,6,7,0.34804,0.361995,0.000059,No
1,1,1,1,1,2,1,1,2,10,0.185451,0.187726,0.000059,No
1,1,1,1,1,2,1,1,2,8,0.309331,0.317947,0.000059,No
3,3,9,3,3,6,3,3,6,8,0.311562,0.319948,0.000059,No
2,2,4,2,2,4,2,2,4,8,0.342328,0.354909,0.000059,No
2,2,4,1,1,2,2,2,4,8,0.228592,0.232461,0.000059,No
2,2,4,1,1,2,2,2,4,8,0.339934,0.352194,0.000059,No
1,1,1,1,1,2,1,1,2,9,0.249022,0.253706,0.000059,No
1,1,1,1,1,2,1,1,2,9,0.231718,0.237328,0.000059,No
2,2,4,2,2,4,2,2,4,8,0.317759,0.324828,0.000059,No
4,4,16,1,3,4,4,4,8,8,0.309921,0.31733,0.000059,No
1,1,1,1,1,2,1,1,2,9,0.249029,0.253711,0.000059,No
1,1,1,1,1,2,1,1,2,8,0.295971,0.304327,0.000059,No
3,3,9,2,2,4,3,3,6,8,0.290276,0.299545,0.000059,No
1,1,1,1,1,2,1,1,2,8,0.288168,0.299068,0.000059,No
3,3,9,1,1,2,3,3,6,8,0.339941,0.352199,0.000059,No
1,1,1,1,1,2,1,1,2,8,0.339941,0.352199,0.000059,No
1,1,1,1,1,2,1,1,2,9,0.240003,0.243369,0.000059,No
2,2,4,2,2,4,2,2,4,8,0.340266,0.352595,0.000059,No
2,2,4,1,1,2,2,2,4,8,0.339948,0.352202,0.000059,No
1,1,1,1,1,2,1,1,2,8,0.271903,0.280398,0.000059,No
2,2,4,2,2,4,2,2,4,8,0.323439,0.334468,0.000059,No
3,3,9,2,2,4,3,3,6,8,0.309713,0.318303,0.000059,No
1,1,1,1,1,2,1,1,2,9,0.25371,0.258582,0.000059,No
1,1,1,1,1,2,1,1,2,8,0.290488,0.297498,0.000059,No
3,3,9,2,2,4,3,3,6,8,0.31352,0.320267,0.000059,No
1,1,1,1,1,2,1,1,2,8,0.2469,0.251301,0.000059,No
4,4,16,1,2,3,4,4,8,9,0.269319,0.275777,0.000059,No
2,2,4,2,2,4,2,2,4,8,0.309331,0.317972,0.000059,No
1,1,1,1,1,2,1,1,2,9,0.217996,0.222364,0.000059,No
2,2,4,1,2,3,2,2,4,8,0.277118,0.285661,0.000059,No
2,2,4,2,2,4,2,2,4,8,0.292375,0.299951,0.000059,No
4,3,12,2,4,6,4,4,8,8,0.352454,0.367843,0.000059,No
1,1,1,1,1,2,1,1,2,9,0.237415,0.24215,0.000059,No
2,2,4,1,1,2,2,2,4,9,0.20541,0.208799,0.000059,No
5,5,25,3,3,6,5,5,10,8,0.317162,0.326406,0.000059,No
1,1,1,1,1,2,1,1,2,9,0.303807,0.312038,0.000059,No
1,1,1,1,1,2,1,1,2,9,0.255752,0.260986,0.000059,No
4,4,16,1,4,5,4,4,8,8,0.359645,0.376626,0.000059,No
1,1,1,1,1,2,1,1,2,9,0.249029,0.253711,0.000059,No
1,1,1,1,1,2,1,1,2,9,0.208469,0.21127,0.000059,No
1,1,1,1,1,2,1,1,2,10,0.211818,0.21584,0.000059,No
6,6,36,4,3,7,6,6,12,8,0.331946,0.343478,0.000059,No
4,2,8,2,2,4,4,4,8,8,0.29205,0.299618,0.000059,No
2,2,4,1,1,2,2,2,4,9,0.233509,0.236547,0.000059,No
1,1,1,1,1,2,1,1,2,8,0.339941,0.352199,0.000059,No
1,1,1,1,1,2,1,1,2,9,0.249022,0.253706,0.000059,No
1,1,1,1,1,2,1,1,2,9,0.215279,0.2187,0.000059,No
1,1,1,1,1,2,1,1,2,9,0.231724,0.237333,0.000059,No
3,3,9,3,3,6,3,3,6,8,0.354534,0.369022,0.000059,No
1,1,1,1,1,2,1,1,2,8,0.228586,0.232456,0.000059,No
1,1,1,1,1,2,1,1,2,10,0.202432,0.204841,0.000059,No
2,2,4,2,2,4,2,2,4,8,0.340009,0.352302,0.000059,No
3,3,9,2,3,5,3,3,6,8,0.319646,0.329554,0.000059,No
1,1,1,1,1,2,1,1,2,8,0.339941,0.352199,0.000059,No
1,1,1,1,1,2,1,1,2,8,0.310728,0.31751,0.000059,No
2,2,4,1,1,2,2,2,4,10,0.203815,0.20656,0.000059,No
7,7,49,5,6,11,7,7,14,7,0.353909,0.368572,0.000059,No
2,2,4,1,2,3,2,2,4,9,0.239326,0.2424,0.000059,No
3,3,9,2,1,3,3,3,6,8,0.310028,0.318679,0.000059,No
1,1,1,1,1,2,1,1,2,7,0.29631,0.304858,0.000059,No
1,1,1,1,1,2,1,1,2,9,0.244309,0.248587,0.000059,No
1,1,1,1,1,2,1,1,2,9,0.232774,0.236425,0.000059,No
4,4,16,2,3,5,4,4,8,8,0.343168,0.356033,0.000059,No
4,4,16,4,3,7,4,4,8,8,0.300765,0.307495,0.000059,No
2,2,4,2,2,4,2,2,4,7,0.320264,0.329397,0.000059,No
2,2,4,1,1,2,2,2,4,9,0.228384,0.232203,0.000059,No
2,2,4,2,2,4,2,2,4,8,0.300882,0.308146,0.000059,No
1,1,1,1,1,2,1,1,2,10,0.213785,0.21767,0.000059,No
5,5,25,4,3,7,5,5,10,8,0.341315,0.35386,0.000059,No
2,2,4,2,2,4,2,2,4,7,0.352621,0.366966,0.000059,No
1,1,1,1,1,2,1,1,2,9,0.258178,0.263279,0.000059,No
1,1,1,1,1,2,1,1,2,9,0.217546,0.221067,0.000059,No
1,1,1,1,1,2,1,1,2,10,0.211768,0.215663,0.000059,No
1,1,1,1,1,2,1,1,2,9,0.213782,0.21773,0.000059,No
2,2,4,2,1,3,2,2,4,10,0.193114,0.194754,0.000059,No
1,1,1,1,1,2,1,1,2,9,0.268726,0.277331,0.000059,No
2,2,4,1,1,2,2,2,4,8,0.29166,0.29884,0.000059,No
2,2,4,2,2,4,2,2,4,8,0.278866,0.286171,0.000059,No
2,2,4,1,1,2,2,2,4,9,0.253717,0.258587,0.000059,No
1,1,1,1,1,2,1,1,2,8,0.228586,0.232456,0.000059,No
2,2,4,1,1,2,2,2,4,8,0.303385,0.311474,0.000059,No
1,1,1,1,1,2,1,1,2,8,0.271899,0.280395,0.000059,No
1,1,1,1,1,2,1,1,2,9,0.253702,0.258574,0.000059,No
6,5,30,3,6,9,6,6,12,8,0.350111,0.364391,0.000059,No
2,2,4,2,2,4,2,2,4,8,0.341499,0.353942,0.000059,No
1,1,1,1,1,2,1,1,2,7,0.327819,0.338512,0.000059,No
1,1,1,1,1,2,1,1,2,9,0.210686,0.213621,0.000059,No
3,3,9,2,2,4,3,3,6,8,0.28147,0.290952,0.000059,No
1,1,1,1,1,2,1,1,2,9,0.236677,0.240476,0.000059,No
1,1,1,1,1,2,1,1,2,8,0.246907,0.251306,0.000059,No
2,2,4,2,2,4,2,2,4,8,0.318161,0.325355,0.000059,No
2,2,4,1,1,2,2,2,4,9,0.244396,0.24898,0.000059,No
1,1,1,1,1,2,1,1,2,9,0.233516,0.236552,0.000059,No
4,4,16,1,3,4,4,4,8,8,0.349659,0.363969,0.000059,No
4,4,16,2,2,4,4,4,8,8,0.258034,0.263378,0.000059,No
3,3,9,2,2,4,3,3,6,8,0.339975,0.352256,0.000059,No
1,1,1,1,1,2,1,1,2,10,0.233025,0.236739,0.000059,No
1,1,1,1,1,2,1,1,2,7,0.296305,0.304855,0.000059,No
1,1,1,1,1,2,1,1,2,8,0.310039,0.318687,0.000059,No
1,1,1,1,1,2,1,1,2,9,0.229283,0.232503,0.000059,No
3,3,9,3,3,6,3,3,6,8,0.280144,0.287055,0.000059,No
4,4,16,3,3,6,4,4,8,7,0.304387,0.312859,0.000059,No
1,1,1,1,1,2,1,1,2,10,0.202454,0.204911,0.000059,No
1,1,1,1,1,2,1,1,2,9,0.223707,0.22858,0.000059,No
1,1,1,1,1,2,1,1,2,7,0.327832,0.33852,0.000059,No
2,2,4,2,2,4,2,2,4,8,0.333594,0.345114,0.000059,No
1,1,1,1,1,2,1,1,2,10,0.191939,0.193508,0.000059,No
2,2,4,1,1,2,2,2,4,9,0.249022,0.253706,0.000059,No
1,1,1,1,1,2,1,1,2,10,0.19635,0.198517,0.000059,No
1,1,1,1,1,2,1,1,2,8,0.228592,0.232461,0.000059,No
1,1,1,1,1,2,1,1,2,8,0.255959,0.260647,0.000059,No
1,1,1,1,1,2,1,1,2,8,0.309336,0.31795,0.000059,No
2,2,4,2,2,4,2,2,4,7,0.328343,0.338995,0.000059,No
2,2,4,2,2,4,2,2,4,7,0.299288,0.308183,0.000059,No
1,1,1,1,1,2,1,1,2,9,0.232952,0.237082,0.000059,No
2,2,4,2,2,4,2,2,4,8,0.27192,0.280452,0.000059,No
1,1,1,1,1,2,1,1,2,7,0.327832,0.33852,0.000059,No
1,1,1,1,1,2,1,1,2,9,0.258131,0.26399,0.000059,No
1,1,1,1,1,2,1,1,2,9,0.257469,0.262626,0.000059,No
1,1,1,1,1,2,1,1,2,8,0.310033,0.318684,0.000059,No
2,2,4,2,2,4,2,2,4,8,0.305575,0.318214,0.000059,No
1,1,1,1,1,2,1,1,2,8,0.303385,0.311474,0.000059,No
1,1,1,1,1,2,1,1,2,9,0.236267,0.240062,0.000059,No
4,4,16,4,4,8,4,4,8,8,0.349465,0.36386,0.000059,No
1,1,1,1,1,2,1,1,2,8,0.295971,0.304327,0.000059,No
2,2,4,2,2,4,2,2,4,8,0.2835,0.292943,0.000059,No
2,2,4,1,1,2,2,2,4,8,0.310728,0.31751,0.000059,No
1,1,1,1,1,2,1,1,2,8,0.331578,0.343078,0.000059,No
1,1,1,1,1,2,1,1,2,9,0.224821,0.228361,0.000059,No
1,1,1,1,1,2,1,1,2,8,0.339941,0.352199,0.000059,No
2,2,4,2,2,4,2,2,4,8,0.266893,0.273071,0.000059,No
1,1,1,1,1,2,1,1,2,8,0.30338,0.311471,0.000059,No
1,1,1,1,1,2,1,1,2,8,0.331578,0.343078,0.000059,No
1,1,1,1,1,2,1,1,2,8,0.309983,0.317112,0.000059,No
1,1,1,1,1,2,1,1,2,9,0.224785,0.228308,0.000059,No
1,1,1,1,1,2,1,1,2,9,0.236641,0.239834,0.000059,No
1,1,1,1,1,2,1,1,2,8,0.331584,0.343081,0.000059,No
3,2,6,1,3,4,3,3,6,8,0.316621,0.325696,0.000059,No
3,3,9,3,3,6,3,3,6,7,0.304251,0.312229,0.000059,No
1,1,1,1,1,2,1,1,2,8,0.339941,0.352199,0.000059,No
1,1,1,1,1,2,1,1,2,8,0.317901,0.325044,0.000059,No
6,6,36,4,5,9,6,6,12,8,0.333509,0.345774,0.000059,No
1,1,1,1,1,2,1,1,2,8,0.308548,0.315803,0.000059,No
1,1,1,1,1,2,1,1,2,10,0.168789,0.170333,0.000059,No
1,1,1,1,1,2,1,1,2,9,0.229916,0.233106,0.000059,No
1,1,1,1,1,2,1,1,2,8,0.310728,0.31751,0.000059,No
2,2,4,2,1,3,2,2,4,8,0.339934,0.352194,0.000059,No
1,1,1,1,1,2,1,1,2,9,0.244396,0.24898,0.000059,No
2,2,4,1,1,2,2,2,4,8,0.309336,0.31795,0.000059,No
1,1,1,1,1,2,1,1,2,8,0.278743,0.288253,0.000059,No
1,1,1,1,1,2,1,1,2,9,0.25371,0.258582,0.000059,No
1,1,1,1,1,2,1,1,2,9,0.240993,0.245266,0.000059,No
6,6,36,5,3,8,6,6,12,8,0.318839,0.32774,0.000059,No
4,4,16,3,3,6,4,4,8,8,0.257442,0.262695,0.000059,No
1,1,1,1,1,2,1,1,2,8,0.274325,0.28142,0.000059,No
1,1,1,1,1,2,1,1,2,8,0.323439,0.334434,0.000059,No
1,1,1,1,1,2,1,1,2,9,0.202231,0.204778,0.000059,No
2,2,4,2,2,4,2,2,4,8,0.317056,0.323986,0.000059,No
1,1,1,1,1,2,1,1,2,9,0.223648,0.226995,0.000059,No
1,1,1,1,1,2,1,1,2,9,0.231718,0.237328,0.000059,No
1,1,1,1,1,2,1,1,2,9,0.249029,0.253711,0.000059,No
1,1,1,1,1,2,1,1,2,8,0.278748,0.288256,0.000059,No
1,1,1,1,1,2,1,1,2,8,0.299377,0.306905,0.000059,No
20,19,380,12,3,15,20,20,40,7,0.349888,0.363976,0.000059,No
2,1,2,2,2,4,2,2,4,8,0.309342,0.317986,0.000059,No
2,2,4,1,1,2,2,2,4,9,0.236267,0.240062,0.000059,No
1,1,1,1,1,2,1,1,2,9,0.216987,0.220961,0.000059,No
3,2,6,3,1,4,3,3,6,9,0.24049,0.244384,0.000059,No
8,6,48,4,4,8,8,8,16,7,0.354666,0.369233,0.000059,No
3,3,9,2,3,5,3,3,6,8,0.30727,0.316019,0.000059,No
3,3,9,3,3,6,3,3,6,8,0.316427,0.326454,0.000059,No
1,1,1,1,1,2,1,1,2,8,0.308548,0.315803,0.000059,No
3,3,9,1,2,3,3,3,6,8,0.331804,0.3433,0.000059,No
1,1,1,1,1,2,1,1,2,8,0.339948,0.352202,0.000059,No
3,3,9,3,2,5,3,3,6,8,0.340885,0.353199,0.000059,No
1,1,1,1,1,2,1,1,2,8,0.246893,0.251294,0.000059,No
2,2,4,1,1,2,2,2,4,7,0.29631,0.304858,0.000059,No
1,1,1,1,1,2,1,1,2,9,0.252161,0.2569,0.000059,No
2,2,4,2,2,4,2,2,4,8,0.341226,0.353858,0.000059,No
1,1,1,1,1,2,1,1,2,10,0.233025,0.236739,0.000059,No
2,2,4,1,1,2,2,2,4,9,0.253717,0.258587,0.000059,No
7,7,49,2,7,9,7,7,14,8,0.33123,0.340751,0.000059,No
1,1,1,1,1,2,1,1,2,9,0.244396,0.24898,0.000059,No
2,2,4,1,1,2,2,2,4,9,0.236267,0.240062,0.000059,No
3,3,9,2,2,4,3,3,6,8,0.286258,0.295997,0.000059,No
1,1,1,1,1,2,1,1,2,8,0.301589,0.314491,0.000059,No
2,2,4,2,2,4,2,2,4,9,0.307281,0.315429,0.000059,No
1,1,1,1,1,2,1,1,2,9,0.215423,0.219627,0.000059,No
3,3,9,2,2,4,3,3,6,8,0.312945,0.32137,0.000059,No
2,2,4,2,2,4,2,2,4,8,0.330961,0.343854,0.000059,No
2,2,4,2,2,4,2,2,4,8,0.339955,0.352238,0.000059,No
1,1,1,1,1,2,1,1,2,8,0.339948,0.352202,0.000059,No
2,2,4,2,2,4,2,2,4,8,0.327838,0.339203,0.000059,No
2,2,4,1,2,3,2,2,4,8,0.304539,0.311366,0.000059,No
1,1,1,1,1,2,1,1,2,8,0.278743,0.288253,0.000059,No
5,5,25,4,4,8,5,5,10,8,0.327172,0.337449,0.000059,No
3,3,9,2,2,4,3,3,6,8,0.320775,0.331734,0.000059,No
1,1,1,1,1,2,1,1,2,8,0.31386,0.320867,0.000059,No
10,10,100,7,7,14,10,10,20,8,0.330954,0.343257,0.000059,No
8,8,64,6,5,11,8,8,16,8,0.33965,0.352792,0.000059,No
3,3,9,1,2,3,3,3,6,7,0.327838,0.338556,0.000059,No
1,1,1,1,1,2,1,1,2,10,0.168792,0.170336,0.000059,No
4,4,16,3,3,6,4,4,8,8,0.266868,0.272797,0.000059,No
1,1,1,1,1,2,1,1,2,10,0.194492,0.196727,0.000059,No
2,2,4,2,2,4,2,2,4,8,0.306211,0.318624,0.000059,No
1,1,1,1,1,2,1,1,2,8,0.2469,0.251301,0.000059,No
1,1,1,1,1,2,1,1,2,9,0.246593,0.250626,0.000059,No
3,3,9,2,2,4,3,3,6,8,0.31009,0.318767,0.000059,No
4,4,16,3,3,6,4,4,8,8,0.331771,0.342696,0.000059,No
1,1,1,1,1,2,1,1,2,9,0.25371,0.258582,0.000059,No
6,6,36,4,4,8,6,6,12,8,0.308008,0.316863,0.000059,No
1,1,1,1,1,2,1,1,2,8,0.339941,0.352199,0.000059,No
2,2,4,2,2,4,2,2,4,8,0.309342,0.317986,0.000059,No
5,5,25,3,4,7,5,5,10,8,0.333119,0.344368,0.000059,No
2,2,4,2,2,4,2,2,4,8,0.323022,0.333349,0.000059,No
1,1,1,1,1,2,1,1,2,9,0.236677,0.240476,0.000059,No
2,1,2,2,1,3,2,2,4,8,0.339941,0.352199,0.000059,No
1,1,1,1,1,2,1,1,2,9,0.226703,0.230243,0.000059,No
1,1,1,1,1,2,1,1,2,8,0.2469,0.251301,0.000059,No
1,1,1,1,1,2,1,1,2,7,0.296305,0.304855,0.000059,No
9,9,81,8,6,14,9,9,18,7,0.335259,0.348432,0.000059,No
4,4,16,4,3,7,4,4,8,8,0.338612,0.351894,0.000059,No
1,1,1,1,1,2,1,1,2,8,0.303666,0.31297,0.000059,No
1,1,1,1,1,2,1,1,2,9,0.268726,0.277331,0.000059,No
7,7,49,6,7,13,7,7,14,7,0.346619,0.360264,0.000059,No
2,2,4,2,2,4,2,2,4,8,0.28565,0.292705,0.000059,No
38,38,1444,16,20,36,38,38,76,7,0.386881,0.405663,0.000059,No
1,1,1,1,1,2,1,1,2,9,0.244396,0.24898,0.000059,No
1,1,1,1,1,2,1,1,2,9,0.244396,0.24898,0.000059,No
1,1,1,1,1,2,1,1,2,9,0.24441,0.248988,0.000059,No
2,2,4,2,1,3,2,2,4,8,0.339934,0.352194,0.000059,No
1,1,1,1,1,2,1,1,2,8,0.339941,0.352199,0.000059,No
1,1,1,1,1,2,1,1,2,8,0.286206,0.293399,0.000059,No
5,5,25,5,3,8,5,5,10,8,0.288611,0.299349,0.000059,No
6,6,36,4,6,10,6,6,12,8,0.356407,0.371087,0.000059,No
1,1,1,1,1,2,1,1,2,8,0.323426,0.334429,0.000059,No
3,3,9,3,3,6,3,3,6,8,0.300405,0.307246,0.000059,No
1,1,1,1,1,2,1,1,2,9,0.25371,0.258582,0.000059,No
2,2,4,2,2,4,2,2,4,8,0.292621,0.303436,0.000059,No
3,3,9,3,2,5,3,3,6,7,0.297022,0.305548,0.000059,No
4,4,16,3,4,7,4,4,8,8,0.325773,0.336549,0.000059,No
2,2,4,2,2,4,2,2,4,8,0.303434,0.311547,0.000059,No
3,2,6,3,3,6,3,3,6,7,0.332437,0.344021,0.000059,No
3,3,9,1,2,3,3,3,6,8,0.286383,0.293417,0.000059,No
2,2,4,2,2,4,2,2,4,8,0.313941,0.323264,0.000059,No
1,1,1,1,1,2,1,1,2,9,0.25371,0.258582,0.000059,No
1,1,1,1,1,2,1,1,2,8,0.25348,0.258551,0.000059,No
3,3,9,2,3,5,3,3,6,8,0.339988,0.352307,0.000059,No
1,1,1,1,1,2,1,1,2,9,0.235804,0.239063,0.000059,No
2,2,4,2,1,3,2,2,4,9,0.25371,0.258582,0.000059,No
1,1,1,1,1,2,1,1,2,9,0.231724,0.237333,0.000059,No
1,1,1,1,1,2,1,1,2,8,0.260703,0.266236,0.000059,No
2,2,4,1,1,2,2,2,4,8,0.317451,0.327459,0.000059,No
4,4,16,3,4,7,4,4,8,8,0.324429,0.333539,0.000059,No
3,3,9,2,2,4,3,3,6,7,0.328198,0.338834,0.000059,No
1,1,1,1,1,2,1,1,2,9,0.208014,0.210894,0.000059,No
1,1,1,1,1,2,1,1,2,9,0.22839,0.232208,0.000059,No
1,1,1,1,1,2,1,1,2,9,0.253702,0.258574,0.000059,No
1,1,1,1,1,2,1,1,2,9,0.216987,0.220961,0.000059,No
1,1,1,1,1,2,1,1,2,7,0.327826,0.338517,0.000059,No
1,1,1,1,1,2,1,1,2,9,0.200673,0.202897,0.000059,No
1,1,1,1,1,2,1,1,2,7,0.327826,0.338517,0.000059,No
1,1,1,1,1,2,1,1,2,8,0.278157,0.285073,0.000059,No
3,3,9,3,3,6,3,3,6,8,0.318049,0.327562,0.000059,No
1,1,1,1,1,2,1,1,2,9,0.223707,0.22858,0.000059,No
2,2,4,2,2,4,2,2,4,8,0.312429,0.319272,0.000059,No
1,1,1,1,1,2,1,1,2,9,0.25371,0.258582,0.000059,No
1,1,1,1,1,2,1,1,2,8,0.288061,0.295135,0.000059,No
6,6,36,5,4,9,6,6,12,8,0.302525,0.309134,0.000059,No
2,2,4,2,2,4,2,2,4,8,0.304061,0.311365,0.000059,No
2,2,4,2,2,4,2,2,4,8,0.303391,0.31151,0.000059,No
4,4,16,4,4,8,4,4,8,8,0.288295,0.295608,0.000059,No
2,2,4,1,1,2,2,2,4,10,0.174009,0.175703,0.000059,No
1,1,1,1,1,2,1,1,2,9,0.206799,0.209529,0.000059,No
1,1,1,1,1,2,1,1,2,9,0.213782,0.217058,0.000059,No
1,1,1,1,1,2,1,1,2,9,0.253831,0.258719,0.000059,No
1,1,1,1,1,2,1,1,2,8,0.2771,0.285608,0.000059,No
1,1,1,1,1,2,1,1,2,9,0.250849,0.255932,0.000059,No
1,1,1,1,1,2,1,1,2,7,0.296305,0.304855,0.000059,No
2,1,2,2,2,4,2,2,4,8,0.313514,0.320257,0.000059,No
1,1,1,1,1,2,1,1,2,8,0.2469,0.251301,0.000059,No
1,1,1,1,1,2,1,1,2,9,0.213787,0.217734,0.000059,No
4,4,16,2,4,6,4,4,8,8,0.313768,0.321302,0.000059,No
1,1,1,1,1,2,1,1,2,8,0.301594,0.314494,0.000059,No
1,1,1,1,1,2,1,1,2,9,0.225985,0.229323,0.000059,No
5,5,25,3,4,7,5,5,10,8,0.333933,0.34455,0.000059,No
2,2,4,1,1,2,2,2,4,9,0.228381,0.232339,0.000059,No
1,1,1,1,1,2,1,1,2,9,0.241439,0.245721,0.000059,No
1,1,1,1,1,2,1,1,2,8,0.331584,0.343081,0.000059,No
6,6,36,4,2,6,6,6,12,8,0.328172,0.338681,0.000059,No
2,2,4,1,1,2,2,2,4,8,0.295955,0.304713,0.000059,No
2,2,4,1,1,2,2,2,4,9,0.232939,0.237074,0.000059,No
1,1,1,1,1,2,1,1,2,9,0.249029,0.253711,0.000059,No
2,2,4,2,2,4,2,2,4,8,0.329408,0.34028,0.000059,No
1,1,1,1,1,2,1,1,2,9,0.227661,0.231871,0.000059,No
5,5,25,5,4,9,5,5,10,8,0.335318,0.347522,0.000059,No
4,4,16,3,4,7,4,4,8,8,0.32425,0.334883,0.000059,No
2,2,4,2,2,4,2,2,4,8,0.317416,0.324554,0.000059,No
1,1,1,1,1,2,1,1,2,8,0.339934,0.352194,0.000059,No
2,2,4,2,2,4,2,2,4,8,0.271039,0.277775,0.000059,No
4,3,12,1,4,5,4,4,8,8,0.29482,0.301838,0.000059,No
2,2,4,2,2,4,2,2,4,7,0.34799,0.361931,0.000059,No
1,1,1,1,1,2,1,1,2,9,0.215423,0.219627,0.000059,No
2,2,4,1,2,3,2,2,4,8,0.310056,0.318731,0.000059,No
1,1,1,1,1,2,1,1,2,8,0.323426,0.334429,0.000059,No
1,1,1,1,1,2,1,1,2,7,0.327832,0.33852,0.000059,No
1,1,1,1,1,2,1,1,2,8,0.303672,0.312972,0.000059,No
1,1,1,1,1,2,1,1,2,8,0.295642,0.302492,0.000059,No
2,2,4,2,2,4,2,2,4,9,0.274043,0.280888,0.000059,No
1,1,1,1,1,2,1,1,2,9,0.25371,0.258582,0.000059,No
2,2,4,1,1,2,2,2,4,8,0.339948,0.352202,0.000059,No
1,1,1,1,1,2,1,1,2,9,0.25371,0.258582,0.000059,No
2,2,4,2,2,4,2,2,4,8,0.288183,0.299117,0.000059,No
1,1,1,1,1,2,1,1,2,10,0.211768,0.215663,0.000059,No
7,7,49,7,6,13,7,7,14,8,0.307835,0.314685,0.000059,No
2,2,4,2,2,4,2,2,4,8,0.29596,0.304749,0.000059,No
45,44,1980,14,28,42,45,45,90,7,0.397859,0.417387,0.000059,No
4,4,16,2,1,3,4,4,8,9,0.228216,0.231462,0.000059,No
1,1,1,1,1,2,1,1,2,9,0.234359,0.237697,0.000059,No
1,1,1,1,1,2,1,1,2,10,0.201388,0.203779,0.000059,No
8,8,64,8,6,14,8,8,16,8,0.348887,0.362723,0.000059,No
1,1,1,1,1,2,1,1,2,9,0.25371,0.258582,0.000059,No
3,3,9,3,3,6,3,3,6,8,0.314126,0.320868,0.000059,No
1,1,1,1,1,2,1,1,2,8,0.228586,0.232456,0.000059,No
1,1,1,1,1,2,1,1,2,9,0.249022,0.253706,0.000059,No
1,1,1,1,1,2,1,1,2,9,0.23278,0.23643,0.000059,No
7,7,49,7,4,11,7,7,14,8,0.325177,0.336455,0.000059,No
2,2,4,2,2,4,2,2,4,8,0.309994,0.317151,0.000059,No
2,2,4,2,2,4,2,2,4,8,0.287614,0.295231,0.000059,No
1,1,1,1,1,2,1,1,2,9,0.25371,0.258582,0.000059,No
1,1,1,1,1,2,1,1,2,8,0.2469,0.251301,0.000059,No
2,2,4,2,2,4,2,2,4,8,0.298262,0.305016,0.000059,No
1,1,1,1,1,2,1,1,2,10,0.211813,0.215836,0.000059,No
2,2,4,2,2,4,2,2,4,8,0.326415,0.338228,0.000059,No
1,1,1,1,1,2,1,1,2,8,0.339941,0.352199,0.000059,No
3,3,9,2,2,4,3,3,6,8,0.315083,0.329711,0.000059,No
2,2,4,2,2,4,2,2,4,8,0.339955,0.352238,0.000059,No
1,1,1,1,1,2,1,1,2,8,0.30338,0.311471,0.000059,No
2,2,4,1,1,2,2,2,4,9,0.253702,0.258574,0.000059,No
1,1,1,1,1,2,1,1,2,9,0.214437,0.217665,0.000059,No
1,1,1,1,1,2,1,1,2,9,0.25371,0.258582,0.000059,No
2,2,4,2,1,3,2,2,4,7,0.327826,0.338517,0.000059,No
2,2,4,2,2,4,2,2,4,8,0.351996,0.366276,0.000059,No
1,1,1,1,1,2,1,1,2,8,0.288163,0.299063,0.000059,No
7,7,49,6,3,9,7,7,14,8,0.343797,0.356773,0.000059,No
1,1,1,1,1,2,1,1,2,8,0.288163,0.299063,0.000059,No
2,2,4,2,1,3,2,2,4,8,0.331571,0.343073,0.000059,No
6,6,36,5,5,10,6,6,12,8,0.347155,0.361472,0.000059,No
5,5,25,4,5,9,5,5,10,8,0.333516,0.344687,0.000059,No
1,1,1,1,1,2,1,1,2,7,0.327826,0.338517,0.000059,No
3,3,9,2,2,4,3,3,6,7,0.335714,0.347567,0.000059,No
4,4,16,3,3,6,4,4,8,8,0.322205,0.33302,0.000059,No
3,3,9,2,1,3,3,3,6,8,0.331571,0.343073,0.000059,No
10,10,100,6,5,11,10,10,20,8,0.341882,0.355995,0.000059,No
1,1,1,1,1,2,1,1,2,10,0.207337,0.21032,0.000059,No
3,3,9,2,3,5,3,3,6,8,0.314294,0.322988,0.000059,No
2,2,4,2,2,4,2,2,4,8,0.313947,0.323269,0.000059,No
1,1,1,1,1,2,1,1,2,8,0.331584,0.343081,0.000059,No
1,1,1,1,1,2,1,1,2,10,0.19635,0.198517,0.000059,No
4,4,16,2,2,4,4,4,8,8,0.265345,0.271458,0.000059,No
2,2,4,2,2,4,2,2,4,8,0.317487,0.327523,0.000059,No
1,1,1,1,1,2,1,1,2,9,0.217991,0.222359,0.000059,No
2,2,4,2,2,4,2,2,4,8,0.340341,0.352525,0.000059,No
3,3,9,3,3,6,3,3,6,7,0.353945,0.368456,0.000059,No
3,3,9,2,2,4,3,3,6,8,0.323439,0.334468,0.000059,No
4,4,16,1,4,5,4,4,8,8,0.333353,0.344795,0.000059,No
1,1,1,1,1,2,1,1,2,9,0.237078,0.240122,0.000059,No
5,5,25,2,3,5,5,5,10,8,0.331629,0.343181,0.000059,No
4,4,16,2,2,4,4,4,8,8,0.309342,0.317986,0.000059,No
5,5,25,4,5,9,5,5,10,8,0.33758,0.349333,0.000059,No
1,1,1,1,1,2,1,1,2,7,0.312595,0.319281,0.000059,No
1,1,1,1,1,2,1,1,2,9,0.213782,0.21773,0.000059,No
2,2,4,1,2,3,2,2,4,8,0.325152,0.335939,0.000059,No
1,1,1,1,1,2,1,1,2,8,0.278012,0.285474,0.000059,No
3,3,9,2,3,5,3,3,6,8,0.340538,0.353377,0.000059,No
3,3,9,3,3,6,3,3,6,7,0.335154,0.345884,0.000059,No
1,1,1,1,1,2,1,1,2,9,0.268645,0.276939,0.000059,No
2,2,4,2,2,4,2,2,4,8,0.278762,0.2883,0.000059,No
2,2,4,2,2,4,2,2,4,8,0.279332,0.288868,0.000059,No
1,1,1,1,1,2,1,1,2,8,0.301594,0.314494,0.000059,No
2,2,4,2,2,4,2,2,4,8,0.28418,0.293618,0.000059,No
1,1,1,1,1,2,1,1,2,9,0.227576,0.231051,0.000059,No
1,1,1,1,1,2,1,1,2,9,0.251867,0.256832,0.000059,No
4,4,16,3,3,6,4,4,8,8,0.332872,0.344781,0.000059,No
2,2,4,2,2,4,2,2,4,8,0.29878,0.305651,0.000059,No
1,1,1,1,1,2,1,1,2,9,0.253714,0.258592,0.000059,No
2,2,4,2,2,4,2,2,4,9,0.246433,0.251056,0.000059,No
1,1,1,1,1,2,1,1,2,7,0.327826,0.338517,0.000059,No
15,14,210,10,10,20,15,15,30,7,0.360207,0.37623,0.000059,No
1,1,1,1,1,2,1,1,2,9,0.25371,0.258582,0.000059,No
2,2,4,1,1,2,2,2,4,9,0.240969,0.245237,0.000059,No
1,1,1,1,1,2,1,1,2,8,0.228592,0.232461,0.000059,No
2,2,4,2,2,4,2,2,4,8,0.299572,0.307364,0.000059,No
2,2,4,1,2,3,2,2,4,8,0.317451,0.327484,0.000059,No
3,3,9,2,3,5,3,3,6,8,0.352316,0.366716,0.000059,No
2,2,4,1,2,3,2,2,4,8,0.341055,0.353428,0.000059,No
2,2,4,2,2,4,2,2,4,9,0.257508,0.263177,0.000059,No
2,2,4,1,1,2,2,2,4,8,0.309336,0.31795,0.000059,No
6,5,30,5,6,11,6,6,12,8,0.340905,0.354066,0.000059,No
6,6,36,3,3,6,6,6,12,8,0.344812,0.357836,0.000059,No
3,3,9,3,3,6,3,3,6,8,0.294601,0.30189,0.000059,No
1,1,1,1,1,2,1,1,2,10,0.206199,0.209246,0.000059,No
1,1,1,1,1,2,1,1,2,8,0.306657,0.315385,0.000059,No
2,2,4,1,1,2,2,2,4,8,0.339941,0.352199,0.000059,No
11,10,110,2,6,8,11,11,22,8,0.33827,0.351014,0.000059,No
3,3,9,3,3,6,3,3,6,8,0.343534,0.356314,0.000059,No
2,2,4,1,1,2,2,2,4,9,0.232774,0.236425,0.000059,No
1,1,1,1,1,2,1,1,2,10,0.217938,0.221319,0.000059,No
1,1,1,1,1,2,1,1,2,7,0.327832,0.33852,0.000059,No
1,1,1,1,1,2,1,1,2,10,0.203674,0.206291,0.000059,No
2,2,4,2,2,4,2,2,4,8,0.273489,0.280379,0.000059,No
1,1,1,1,1,2,1,1,2,8,0.266901,0.272944,0.000059,No
2,2,4,2,2,4,2,2,4,8,0.323439,0.334468,0.000059,No
1,1,1,1,1,2,1,1,2,10,0.204186,0.206993,0.000059,No
9,9,81,3,8,11,9,9,18,8,0.355635,0.370729,0.000059,No
1,1,1,1,1,2,1,1,2,8,0.339941,0.352199,0.000059,No
7,7,49,3,7,10,7,7,14,8,0.331391,0.343278,0.000059,No
2,2,4,2,2,4,2,2,4,9,0.232958,0.237126,0.000059,No
1,1,1,1,1,2,1,1,2,9,0.231718,0.234919,0.000059,No
1,1,1,1,1,2,1,1,2,9,0.253797,0.258651,0.000059,No
3,3,9,2,2,4,3,3,6,8,0.339955,0.352238,0.000059,No
1,1,1,1,1,2,1,1,2,10,0.19635,0.198517,0.000059,No
3,3,9,3,2,5,3,3,6,8,0.296207,0.303889,0.000059,No
1,1,1,1,1,2,1,1,2,8,0.249514,0.25397,0.000059,No
3,3,9,3,3,6,3,3,6,8,0.320294,0.334133,0.000059,No
2,2,4,2,2,4,2,2,4,8,0.313514,0.320262,0.000059,No
2,2,4,1,1,2,2,2,4,9,0.23278,0.23643,0.000059,No
2,2,4,2,1,3,2,2,4,7,0.327819,0.338512,0.000059,No
1,1,1,1,1,2,1,1,2,10,0.205212,0.207742,0.000059,No
1,1,1,1,1,2,1,1,2,10,0.20518,0.208091,0.000059,No
1,1,1,1,1,2,1,1,2,8,0.29195,0.299049,0.000059,No
3,3,9,2,2,4,3,3,6,8,0.31031,0.318946,0.000059,No
2,2,4,2,2,4,2,2,4,8,0.274629,0.283781,0.000059,No
1,1,1,1,1,2,1,1,2,8,0.339941,0.352199,0.000059,No
1,1,1,1,1,2,1,1,2,9,0.244309,0.248587,0.000059,No
1,1,1,1,1,2,1,1,2,8,0.274554,0.283667,0.000059,No
3,3,9,3,2,5,3,3,6,8,0.274559,0.283703,0.000059,No
2,2,4,2,2,4,2,2,4,8,0.323451,0.334476,0.000059,No
1,1,1,1,1,2,1,1,2,9,0.244396,0.24898,0.000059,No
1,1,1,1,1,2,1,1,2,9,0.244403,0.248985,0.000059,No
1,1,1,1,1,2,1,1,2,8,0.274554,0.283667,0.000059,No
2,2,4,2,2,4,2,2,4,9,0.238367,0.241932,0.000059,No
4,4,16,4,4,8,4,4,8,8,0.324657,0.335514,0.000059,No
1,1,1,1,1,2,1,1,2,9,0.228671,0.231974,0.000059,No
1,1,1,1,1,2,1,1,2,8,0.228592,0.232461,0.000059,No
1,1,1,1,1,2,1,1,2,9,0.231724,0.237333,0.000059,No
3,3,9,3,1,4,3,3,6,8,0.32342,0.334424,0.000059,No
4,4,16,2,2,4,4,4,8,8,0.338236,0.351488,0.000059,No
2,2,4,1,1,2,2,2,4,9,0.249022,0.253706,0.000059,No
2,2,4,2,2,4,2,2,4,8,0.339955,0.352238,0.000059,No
1,1,1,1,1,2,1,1,2,8,0.271224,0.279029,0.000059,No
1,1,1,1,1,2,1,1,2,9,0.213368,0.217039,0.000059,No
1,1,1,1,1,2,1,1,2,9,0.217991,0.222359,0.000059,No
2,2,4,1,1,2,2,2,4,8,0.331578,0.343078,0.000059,No
2,2,4,2,2,4,2,2,4,8,0.339961,0.352248,0.000059,No
1,1,1,1,1,2,1,1,2,9,0.303807,0.312038,0.000059,No
1,1,1,1,1,2,1,1,2,10,0.202379,0.204832,0.000059,No
10,10,100,5,7,12,10,10,20,7,0.346576,0.359578,0.000059,No
1,1,1,1,1,2,1,1,2,9,0.240894,0.243994,0.000059,No
1,1,1,1,1,2,1,1,2,9,0.219226,0.222572,0.000059,No
1,1,1,1,1,2,1,1,2,8,0.323426,0.334429,0.000059,No
2,2,4,2,2,4,2,2,4,8,0.35201,0.366291,0.000059,No
1,1,1,1,1,2,1,1,2,9,0.238897,0.241999,0.000059,No
4,4,16,3,3,6,4,4,8,8,0.329694,0.343194,0.000059,No
1,1,1,1,1,2,1,1,2,7,0.29631,0.304858,0.000059,No
1,1,1,1,1,2,1,1,2,9,0.237078,0.240122,0.000059,No
4,4,16,1,3,4,4,4,8,8,0.281164,0.288292,0.000059,No
3,3,9,3,3,6,3,3,6,8,0.350175,0.364643,0.000059,No
1,1,1,1,1,2,1,1,2,8,0.311312,0.322315,0.000059,No
1,1,1,1,1,2,1,1,2,8,0.228592,0.232461,0.000059,No
1,1,1,1,1,2,1,1,2,9,0.217167,0.220466,0.000059,No
2,2,4,2,1,3,2,2,4,9,0.268721,0.277328,0.000059,No
9,9,81,5,7,12,9,9,18,8,0.353476,0.368189,0.000059,No
1,1,1,1,1,2,1,1,2,9,0.268726,0.277331,0.000059,No
5,5,25,2,3,5,5,5,10,8,0.349946,0.364557,0.000059,No
1,1,1,1,1,2,1,1,2,9,0.228757,0.233381,0.000059,No
4,4,16,2,2,4,4,4,8,8,0.271916,0.280442,0.000059,No
3,3,9,3,3,6,3,3,6,8,0.282444,0.290881,0.000059,No
2,2,4,2,2,4,2,2,4,8,0.288168,0.299093,0.000059,No
2,2,4,2,2,4,2,2,4,8,0.318452,0.325684,0.000059,No
1,1,1,1,1,2,1,1,2,9,0.26873,0.277333,0.000059,No
1,1,1,1,1,2,1,1,2,9,0.225109,0.228419,0.000059,No
5,5,25,4,4,8,5,5,10,7,0.329835,0.340592,0.000059,No
1,1,1,1,1,2,1,1,2,8,0.32342,0.334424,0.000059,No
1,1,1,1,1,2,1,1,2,9,0.222528,0.225939,0.000059,No
4,4,16,3,1,4,4,4,8,8,0.331571,0.343073,0.000059,No
1,1,1,1,1,2,1,1,2,8,0.301589,0.308538,0.000059,No
2,2,4,2,1,3,2,2,4,7,0.296305,0.304855,0.000059,No
3,3,9,3,3,6,3,3,6,7,0.323041,0.33316,0.000059,No
4,4,16,4,4,8,4,4,8,8,0.318762,0.328143,0.000059,No
3,3,9,2,2,4,3,3,6,8,0.323285,0.33364,0.000059,No
3,3,9,3,2,5,3,3,6,8,0.308576,0.320688,0.000059,No
2,2,4,1,1,2,2,2,4,8,0.339948,0.352202,0.000059,No
17,17,289,6,12,18,17,17,34,7,0.38197,0.400688,0.000058,No
32,28,896,7,14,21,32,32,64,8,0.366316,0.384705,0.000058,No
37,36,1332,11,22,33,37,37,74,7,0.390538,0.409706,0.000058,No
130,128,16640,43,24,67,130,130,260,8,0.373541,0.391397,0.000058,No
24,20,480,5,15,20,24,24,48,8,0.366536,0.38461,0.000058,No
1,1,1,1,1,2,1,1,2,9,0.255737,0.261999,0.000058,No
48,42,2016,14,20,34,48,48,96,7,0.380573,0.39949,0.000058,No
12,11,132,4,9,13,12,12,24,8,0.353249,0.368266,0.000057,No
12,10,120,9,9,18,12,12,24,8,0.344505,0.358047,0.000057,No
33,31,1023,4,23,27,33,33,66,7,0.389611,0.409034,0.000057,No
15,15,225,9,11,20,15,15,30,7,0.37355,0.391442,0.000057,No
28,27,756,12,12,24,28,28,56,8,0.368714,0.385525,0.000057,No
12,12,144,10,9,19,12,12,24,8,0.333594,0.344355,0.000057,No
38,38,1444,16,20,36,38,38,76,7,0.376958,0.395524,0.000056,No
100,97,9700,20,16,36,100,100,200,7,0.386539,0.405284,0.000056,No
51,46,2346,9,19,28,51,51,102,7,0.386093,0.405028,0.000056,No
43,41,1763,17,26,43,43,43,86,7,0.384822,0.403526,0.000056,No
8,8,64,4,8,12,8,8,16,7,0.358143,0.373858,0.000056,No
1,1,1,1,1,2,1,1,2,8,0.309983,0.317112,0.000056,No
20,20,400,9,11,20,20,20,40,8,0.366332,0.383453,0.000056,No
12,12,144,8,8,16,12,12,24,8,0.351575,0.365232,0.000055,No
11,10,110,6,9,15,11,11,22,8,0.369809,0.388163,0.000055,No
6,6,36,6,6,12,6,6,12,8,0.347353,0.360962,0.000055,No
7,7,49,6,7,13,7,7,14,8,0.334162,0.346645,0.000055,No
13,13,169,3,4,7,13,13,26,7,0.33201,0.343439,0.000055,No
2,2,4,2,2,4,2,2,4,9,0.258346,0.264612,0.000055,No
18,18,324,6,13,19,18,18,36,7,0.364244,0.38084,0.000054,No
3,3,9,3,3,6,3,3,6,8,0.34026,0.352619,0.000054,No
15,15,225,10,12,22,15,15,30,7,0.374739,0.392907,0.000054,No
38,38,1444,23,19,42,38,38,76,7,0.370114,0.386715,0.000054,No
16,16,256,9,9,18,16,16,32,8,0.361734,0.377763,0.000054,No
20,19,380,10,16,26,20,20,40,7,0.355302,0.370563,0.000054,No
73,70,5110,26,24,50,73,73,146,8,0.388874,0.407814,0.000053,No
42,38,1596,19,20,39,42,42,84,8,0.370018,0.387625,0.000053,No
17,17,289,4,16,20,17,17,34,7,0.368086,0.38531,0.000053,No
9,6,54,8,9,17,9,9,18,8,0.326765,0.335766,0.000053,No
11,11,121,5,8,13,11,11,22,8,0.35559,0.370837,0.000053,No
41,38,1558,21,16,37,41,41,82,8,0.3847,0.403275,0.000053,No
29,26,754,17,22,39,29,29,58,8,0.382913,0.403035,0.000053,No
6,6,36,3,5,8,6,6,12,8,0.353718,0.368409,0.000053,No
34,34,1156,11,19,30,34,34,68,8,0.379515,0.397943,0.000052,No
39,39,1521,10,20,30,39,39,78,7,0.377033,0.395517,0.000052,No
5,5,25,3,5,8,5,5,10,7,0.343016,0.355496,0.000052,No
35,35,1225,16,19,35,35,35,70,7,0.38037,0.399159,0.000052,No
30,29,870,15,22,37,30,30,60,8,0.374427,0.392492,0.000052,No
55,54,2970,19,27,46,55,55,110,8,0.376783,0.394552,0.000052,No
49,49,2401,34,34,68,49,49,98,7,0.3871,0.406399,0.000052,No
4,4,16,3,4,7,4,4,8,7,0.339894,0.352609,0.000052,No
6,6,36,3,4,7,6,6,12,8,0.308861,0.315738,0.000052,No
63,63,3969,22,31,53,63,63,126,7,0.385517,0.40513,0.000051,No
23,23,529,13,14,27,23,23,46,7,0.362796,0.378982,0.000051,No
43,41,1763,16,16,32,43,43,86,7,0.386557,0.405516,0.000051,No
18,17,306,12,15,27,18,18,36,8,0.387496,0.406726,0.000051,No
39,37,1443,5,27,32,39,39,78,8,0.377977,0.396767,0.00005,No
52,48,2496,3,31,34,52,52,104,7,0.394721,0.414174,0.00005,No
12,9,108,6,9,15,12,12,24,7,0.366395,0.383477,0.00005,No
4,4,16,3,3,6,4,4,8,8,0.317593,0.325297,0.00005,No
81,81,6561,43,8,51,81,81,162,7,0.347714,0.360956,0.00005,No
32,32,1024,14,15,29,32,32,64,8,0.362788,0.379304,0.00005,No
11,11,121,5,8,13,11,11,22,8,0.357647,0.37392,0.00005,No
47,47,2209,14,24,38,47,47,94,7,0.380905,0.399536,0.000049,No
16,15,240,8,12,20,16,16,32,8,0.363646,0.381411,0.000049,No
31,30,930,4,21,25,31,31,62,8,0.363251,0.380546,0.000049,No
47,46,2162,13,34,47,47,47,94,7,0.392262,0.412073,0.000049,No
3,3,9,1,3,4,3,3,6,7,0.315269,0.322589,0.000049,No
23,21,483,13,14,27,23,23,46,7,0.381945,0.399993,0.000049,No
32,30,960,16,14,30,32,32,64,7,0.370275,0.387712,0.000048,yes
29,28,812,22,17,39,29,29,58,7,0.375432,0.393544,0.000048,yes
47,47,2209,16,19,35,47,47,94,7,0.361022,0.377505,0.000048,No
46,46,2116,23,24,47,46,46,92,7,0.38859,0.407338,0.000048,No
63,54,3402,17,29,46,63,63,126,7,0.394611,0.414291,0.000048,No
1,1,1,1,1,2,1,1,2,8,0.301589,0.314491,0.000048,No
85,76,6460,11,37,48,85,85,170,7,0.391911,0.411383,0.000048,No
7,7,49,7,5,12,7,7,14,8,0.327486,0.339018,0.000048,No
8,8,64,4,4,8,8,8,16,7,0.339995,0.351398,0.000048,No
1,1,1,1,1,2,1,1,2,9,0.2425,0.245948,0.000048,No
13,12,156,4,10,14,13,13,26,8,0.356229,0.371822,0.000047,No
18,18,324,13,7,20,18,18,36,7,0.349946,0.363917,0.000047,No
31,31,961,10,14,24,31,31,62,7,0.35743,0.373056,0.000047,No
44,41,1804,18,28,46,44,44,88,7,0.35861,0.3748,0.000046,yes
15,13,195,6,11,17,15,15,30,7,0.353213,0.368486,0.000046,No
10,10,100,5,6,11,10,10,20,8,0.328078,0.33921,0.000046,No
10,9,90,8,6,14,10,10,20,8,0.323022,0.330914,0.000046,No
28,27,756,18,9,27,28,28,56,8,0.313336,0.3199,0.000046,No
8,8,64,7,7,14,8,8,16,8,0.327964,0.339251,0.000046,No
26,24,624,12,15,27,26,26,52,7,0.365304,0.38146,0.000046,No
13,13,169,8,9,17,13,13,26,8,0.359721,0.376022,0.000046,No
3,2,6,1,3,4,3,3,6,8,0.302557,0.311597,0.000046,No
20,19,380,16,17,33,20,20,40,7,0.373591,0.390764,0.000045,No
10,10,100,4,6,10,10,10,20,8,0.337047,0.349857,0.000045,No
12,12,144,6,12,18,12,12,24,7,0.353498,0.368547,0.000045,No
27,27,729,8,17,25,27,27,54,8,0.347119,0.360856,0.000045,No
53,52,2756,18,27,45,53,53,106,7,0.380531,0.398755,0.000045,No
42,42,1764,15,15,30,42,42,84,7,0.375465,0.392957,0.000045,No
10,10,100,8,9,17,10,10,20,8,0.365743,0.382283,0.000045,No
16,16,256,11,13,24,16,16,32,7,0.365484,0.381741,0.000045,No
1,1,1,1,1,2,1,1,2,8,0.295965,0.304324,0.000045,No
17,17,289,10,9,19,17,17,34,7,0.34341,0.35603,0.000045,No
87,80,6960,25,26,51,87,87,174,7,0.348054,0.362454,0.000044,No
19,19,361,13,11,24,19,19,38,7,0.359827,0.37528,0.000044,No
42,37,1554,7,21,28,42,42,84,7,0.388511,0.407367,0.000044,No
35,35,1225,23,19,42,35,35,70,7,0.391434,0.410456,0.000044,No
44,44,1936,23,19,42,44,44,88,8,0.364719,0.380776,0.000044,No
22,22,484,14,16,30,22,22,44,7,0.363344,0.379632,0.000044,No
24,24,576,15,16,31,24,24,48,7,0.35966,0.375486,0.000044,No
20,18,360,4,20,24,20,20,40,7,0.360938,0.37661,0.000044,No
38,35,1330,21,26,47,38,38,76,8,0.353615,0.369868,0.000044,No
16,16,256,12,9,21,16,16,32,8,0.354438,0.369261,0.000044,No
45,45,2025,4,18,22,45,45,90,7,0.38451,0.403228,0.000044,No
27,20,540,6,17,23,27,27,54,8,0.374978,0.39252,0.000043,No
34,31,1054,12,24,36,34,34,68,8,0.381211,0.400191,0.000043,No
1,1,1,1,1,2,1,1,2,8,0.339941,0.352199,0.000043,No
62,59,3658,19,15,34,62,62,124,7,0.379035,0.397241,0.000043,No
33,33,1089,7,17,24,33,33,66,7,0.369385,0.386689,0.000043,No
39,37,1443,18,29,47,39,39,78,7,0.381509,0.400044,0.000043,No
50,49,2450,6,23,29,50,50,100,7,0.372685,0.390323,0.000043,No
21,19,399,12,14,26,21,21,42,8,0.373288,0.392176,0.000043,No
3,3,9,2,2,4,3,3,6,8,0.299283,0.306334,0.000043,No
107,105,11235,14,53,67,107,107,214,7,0.412419,0.431971,0.000043,No
39,29,1131,8,18,26,39,39,78,7,0.377442,0.395554,0.000043,No
70,67,4690,24,14,38,70,70,140,8,0.354291,0.369516,0.000043,No
19,18,342,9,11,20,19,19,38,8,0.362904,0.379333,0.000043,No
1,1,1,1,1,2,1,1,2,8,0.317451,0.327459,0.000042,No
1,1,1,1,1,2,1,1,2,10,0.19772,0.200087,0.000042,No
19,19,361,13,11,24,19,19,38,7,0.358391,0.373826,0.000042,No
10,9,90,8,7,15,10,10,20,7,0.359115,0.374338,0.000042,No
25,23,575,16,19,35,25,25,50,7,0.364182,0.38102,0.000042,No
34,33,1122,15,15,30,34,34,68,7,0.367785,0.384715,0.000042,No
55,54,2970,9,18,27,55,55,110,7,0.379237,0.3976,0.000042,No
82,72,5904,23,24,47,82,82,164,7,0.382347,0.401113,0.000042,No
5,5,25,4,3,7,5,5,10,8,0.339955,0.352263,0.000042,No
24,23,552,13,11,24,24,24,48,8,0.368007,0.384541,0.000042,No
38,38,1444,18,29,47,38,38,76,8,0.34683,0.362033,0.000042,No
37,31,1147,11,20,31,37,37,74,7,0.380871,0.399211,0.000041,No
22,19,418,9,16,25,22,22,44,7,0.385474,0.403928,0.000041,No
32,32,1024,9,10,19,32,32,64,8,0.347367,0.361751,0.000041,No
55,55,3025,27,21,48,55,55,110,7,0.377625,0.395492,0.000041,No
29,29,841,9,20,29,29,29,58,8,0.377258,0.395897,0.000041,No
1,1,1,1,1,2,1,1,2,7,0.296305,0.304855,0.000041,No
42,42,1764,27,23,50,42,42,84,8,0.323181,0.331436,0.000041,No
10,9,90,6,7,13,10,10,20,8,0.345881,0.359718,0.000041,No
37,36,1332,16,30,46,37,37,74,7,0.365234,0.382064,0.000041,No
39,37,1443,9,25,34,39,39,78,7,0.394995,0.414513,0.000041,No
10,9,90,5,6,11,10,10,20,8,0.351278,0.365875,0.000041,No
37,36,1332,16,23,39,37,37,74,7,0.369145,0.386565,0.00004,No
5,5,25,4,4,8,5,5,10,8,0.322564,0.330098,0.00004,No
12,11,132,5,7,12,12,12,24,7,0.341574,0.35442,0.00004,No
20,19,380,6,14,20,20,20,40,7,0.361038,0.377211,0.00004,No
23,20,460,11,11,22,23,23,46,7,0.374904,0.393153,0.00004,No
8,6,48,4,6,10,8,8,16,8,0.334772,0.345519,0.00004,No
22,22,484,11,15,26,22,22,44,7,0.372051,0.389759,0.00004,No
2,2,4,2,2,4,2,2,4,8,0.310045,0.318723,0.00004,No
29,29,841,17,11,28,29,29,58,8,0.362356,0.378537,0.00004,No
39,37,1443,25,24,49,39,39,78,7,0.361053,0.376854,0.00004,No
20,20,400,7,6,13,20,20,40,8,0.341233,0.35423,0.00004,No
7,7,49,6,4,10,7,7,14,8,0.353118,0.368209,0.00004,No
24,23,552,7,17,24,24,24,48,7,0.380293,0.398782,0.00004,No
19,17,323,8,16,24,19,19,38,8,0.345664,0.360909,0.000039,No
28,22,616,6,13,19,28,28,56,7,0.367872,0.384435,0.000039,No
66,64,4224,17,42,59,66,66,132,7,0.398855,0.418821,0.000039,No
4,4,16,3,4,7,4,4,8,8,0.29216,0.301397,0.000039,No
17,16,272,10,14,24,17,17,34,7,0.366245,0.384479,0.000039,No
35,33,1155,11,23,34,35,35,70,7,0.374279,0.392239,0.000039,No
14,14,196,8,10,18,14,14,28,8,0.353183,0.368171,0.000039,No
26,26,676,5,19,24,26,26,52,7,0.371597,0.389095,0.000039,No
1,1,1,1,1,2,1,1,2,9,0.239598,0.245738,0.000039,No
10,10,100,8,2,10,10,10,20,8,0.333587,0.345109,0.000039,No
26,23,598,6,10,16,26,26,52,8,0.34388,0.357743,0.000039,No
20,20,400,14,16,30,20,20,40,8,0.355583,0.370329,0.000039,No
20,18,360,6,14,20,20,20,40,7,0.381049,0.400065,0.000039,No
58,56,3248,12,24,36,58,58,116,7,0.387065,0.405829,0.000039,No
12,12,144,6,10,16,12,12,24,7,0.362372,0.378615,0.000038,No
19,19,361,13,14,27,19,19,38,8,0.3715,0.389477,0.000038,No
29,27,783,8,11,19,29,29,58,8,0.349824,0.364149,0.000038,No
42,41,1722,17,20,37,42,42,84,7,0.387399,0.406141,0.000038,No
3,3,9,2,3,5,3,3,6,8,0.318524,0.331741,0.000038,No
5,5,25,5,5,10,5,5,10,7,0.34113,0.353724,0.000038,No
1,1,1,1,1,2,1,1,2,9,0.255783,0.260778,0.000038,No
23,23,529,9,18,27,23,23,46,8,0.365062,0.382707,0.000038,No
8,8,64,7,6,13,8,8,16,8,0.349852,0.364572,0.000037,No
14,11,154,11,13,24,14,14,28,8,0.324016,0.332802,0.000037,No
2,2,4,1,2,3,2,2,4,9,0.262016,0.267917,0.000037,No
1,1,1,1,1,2,1,1,2,9,0.227519,0.230868,0.000037,No
32,31,992,12,19,31,32,32,64,7,0.38251,0.401319,0.000037,No
30,29,870,15,13,28,30,30,60,8,0.356236,0.371694,0.000037,No
21,17,357,7,18,25,21,21,42,8,0.367381,0.38444,0.000037,No
8,7,56,6,6,12,8,8,16,8,0.292837,0.300276,0.000037,No
22,22,484,9,12,21,22,22,44,7,0.361275,0.377056,0.000037,No
44,42,1848,15,17,32,44,44,88,7,0.372734,0.390895,0.000037,No
8,8,64,7,6,13,8,8,16,8,0.36268,0.37927,0.000036,No
32,30,960,7,11,18,32,32,64,7,0.359055,0.375716,0.000036,No
10,10,100,6,8,14,10,10,20,8,0.331018,0.341369,0.000036,No
24,24,576,9,11,20,24,24,48,7,0.371978,0.389244,0.000036,No
102,99,10098,27,22,49,102,102,204,7,0.378925,0.397747,0.000036,No
48,47,2256,18,27,45,48,48,96,7,0.385648,0.404426,0.000036,No
25,20,500,6,17,23,25,25,50,8,0.37146,0.389925,0.000036,No
32,32,1024,9,11,20,32,32,64,7,0.362564,0.378699,0.000036,No
15,15,225,9,10,19,15,15,30,8,0.363793,0.379881,0.000036,No
15,15,225,9,8,17,15,15,30,8,0.346562,0.360045,0.000036,No
21,18,378,12,11,23,21,21,42,8,0.371064,0.388956,0.000036,No
58,58,3364,17,29,46,58,58,116,7,0.402714,0.422226,0.000036,No
54,52,2808,27,6,33,54,54,108,8,0.356348,0.370821,0.000036,No
24,23,552,5,20,25,24,24,48,8,0.384718,0.403586,0.000036,No
51,48,2448,22,14,36,51,51,102,7,0.389264,0.408078,0.000036,No
16,14,224,9,13,22,16,16,32,7,0.372132,0.389375,0.000036,No
12,12,144,8,5,13,12,12,24,8,0.335009,0.346959,0.000036,No
31,31,961,20,13,33,31,31,62,8,0.364353,0.380603,0.000036,No
5,5,25,5,5,10,5,5,10,8,0.330691,0.340306,0.000036,No
16,15,240,7,10,17,16,16,32,8,0.356512,0.371341,0.000036,No
21,21,441,12,13,25,21,21,42,8,0.378337,0.396606,0.000035,No
19,19,361,6,11,17,19,19,38,7,0.362541,0.378015,0.000035,No
44,43,1892,10,9,19,44,44,88,8,0.361366,0.378927,0.000035,No
13,11,143,7,10,17,13,13,26,7,0.345433,0.358718,0.000035,No
11,11,121,6,9,15,11,11,22,8,0.349094,0.363575,0.000035,No
30,29,870,13,19,32,30,30,60,7,0.382476,0.400986,0.000035,No
50,44,2200,23,21,44,50,50,100,7,0.382784,0.402008,0.000035,No
25,24,600,11,18,29,25,25,50,7,0.382458,0.401252,0.000035,No
18,17,306,6,12,18,18,18,36,8,0.365469,0.38234,0.000035,No
11,11,121,6,6,12,11,11,22,8,0.362865,0.379386,0.000034,No
30,30,900,7,18,25,30,30,60,7,0.371524,0.389221,0.000034,No
7,7,49,6,6,12,7,7,14,8,0.346077,0.359361,0.000034,No
23,20,460,14,5,19,23,23,46,7,0.358617,0.374259,0.000034,No
26,26,676,12,11,23,26,26,52,7,0.370106,0.387756,0.000034,No
34,28,952,10,20,30,34,34,68,7,0.393901,0.413537,0.000034,No
39,39,1521,25,17,42,39,39,78,7,0.382501,0.400976,0.000034,No
27,26,702,12,18,30,27,27,54,8,0.379153,0.397562,0.000034,No
6,6,36,4,5,9,6,6,12,8,0.300802,0.309591,0.000034,No
33,31,1023,15,20,35,33,33,66,7,0.35249,0.36667,0.000034,No
2,2,4,2,1,3,2,2,4,8,0.339934,0.352194,0.000034,No
68,67,4556,25,16,41,68,68,136,7,0.38209,0.400005,0.000034,No
50,49,2450,5,22,27,50,50,100,7,0.393383,0.412527,0.000034,No
56,55,3080,31,28,59,56,56,112,7,0.361137,0.377475,0.000034,No
33,33,1089,12,15,27,33,33,66,8,0.339137,0.350557,0.000034,No
14,14,196,8,13,21,14,14,28,7,0.369737,0.386726,0.000034,No
29,28,812,9,25,34,29,29,58,7,0.392028,0.41124,0.000034,No
40,40,1600,28,18,46,40,40,80,7,0.379777,0.39836,0.000033,No
5,5,25,4,4,8,5,5,10,8,0.33347,0.345468,0.000033,No
21,20,420,6,13,19,21,21,42,7,0.376003,0.394344,0.000033,No
41,40,1640,29,18,47,41,41,82,7,0.368126,0.384579,0.000033,No
122,111,13542,32,31,63,122,122,244,7,0.399649,0.41942,0.000033,No
41,41,1681,8,8,16,41,41,82,7,0.356825,0.372061,0.000033,No
21,20,420,10,16,26,21,21,42,7,0.379077,0.397701,0.000033,No
14,14,196,5,11,16,14,14,28,8,0.381671,0.400598,0.000033,No
30,30,900,12,17,29,30,30,60,7,0.355983,0.371323,0.000033,No
20,17,340,14,15,29,20,20,40,8,0.373321,0.391825,0.000033,No
24,23,552,17,17,34,24,24,48,8,0.383387,0.402476,0.000033,No
24,23,552,11,14,25,24,24,48,7,0.369841,0.386363,0.000032,No
46,45,2070,19,22,41,46,46,92,7,0.384406,0.403191,0.000032,No
6,5,30,4,5,9,6,6,12,8,0.35396,0.369548,0.000032,No
15,15,225,10,11,21,15,15,30,7,0.370621,0.388102,0.000032,No
43,43,1849,18,13,31,43,43,86,8,0.35785,0.373164,0.000032,No
34,33,1122,16,23,39,34,34,68,7,0.389255,0.408346,0.000032,No
10,10,100,7,5,12,10,10,20,8,0.358466,0.374396,0.000032,No
26,25,650,14,9,23,26,26,52,8,0.339177,0.352569,0.000032,No
13,13,169,10,9,19,13,13,26,7,0.363569,0.380127,0.000032,No
27,20,540,6,11,17,27,27,54,8,0.347296,0.360608,0.000032,No
53,53,2809,12,26,38,53,53,106,7,0.393683,0.413513,0.000032,No
25,24,600,17,16,33,25,25,50,7,0.383008,0.401305,0.000032,No
48,45,2160,19,15,34,48,48,96,7,0.364322,0.380204,0.000032,No
7,7,49,4,7,11,7,7,14,7,0.331456,0.342554,0.000032,No
12,12,144,6,7,13,12,12,24,7,0.357385,0.37252,0.000032,No
20,19,380,10,13,23,20,20,40,7,0.375655,0.393696,0.000032,No
8,7,56,7,6,13,8,8,16,8,0.331946,0.344616,0.000032,No
15,15,225,12,13,25,15,15,30,7,0.314624,0.323494,0.000032,No
2,2,4,2,2,4,2,2,4,8,0.27459,0.283745,0.000032,No
32,32,1024,12,5,17,32,32,64,8,0.337034,0.348708,0.000032,No
43,42,1806,16,13,29,43,43,86,8,0.346365,0.360279,0.000032,No
2,2,4,2,1,3,2,2,4,9,0.239666,0.243409,0.000032,No
24,23,552,14,18,32,24,24,48,7,0.371921,0.389728,0.000032,No
28,28,784,16,18,34,28,28,56,8,0.369601,0.386652,0.000031,yes
16,16,256,14,11,25,16,16,32,7,0.361895,0.378071,0.000031,yes
17,15,255,8,13,21,17,17,34,8,0.335042,0.346077,0.000031,yes
20,19,380,9,17,26,20,20,40,7,0.371395,0.388851,0.000031,No
24,23,552,12,12,24,24,24,48,7,0.365179,0.381703,0.000031,No
30,29,870,6,16,22,30,30,60,7,0.36346,0.38011,0.000031,No
59,59,3481,20,29,49,59,59,118,7,0.370878,0.387978,0.000031,No
12,11,132,11,5,16,12,12,24,8,0.333099,0.34544,0.000031,No
17,14,238,15,11,26,17,17,34,8,0.35743,0.373149,0.000031,No
34,32,1088,18,19,37,34,34,68,7,0.358429,0.373689,0.000031,No
17,16,272,8,13,21,17,17,34,7,0.372774,0.390494,0.000031,No
4,4,16,4,4,8,4,4,8,7,0.349946,0.364369,0.000031,No
16,16,256,10,12,22,16,16,32,7,0.371136,0.388556,0.000031,No
25,25,625,15,17,32,25,25,50,8,0.36525,0.382442,0.000031,No
5,4,20,4,5,9,5,5,10,8,0.329389,0.342381,0.000031,No
21,20,420,6,14,20,21,21,42,7,0.368722,0.386378,0.000031,No
22,22,484,10,13,23,22,22,44,8,0.367642,0.384756,0.000031,No
25,22,550,10,14,24,25,25,50,8,0.370749,0.38871,0.000031,No
6,4,24,4,4,8,6,6,12,8,0.344832,0.358005,0.000031,No
29,29,841,10,19,29,29,29,58,7,0.374739,0.392464,0.00003,No
18,18,324,7,13,20,18,18,36,7,0.362172,0.379188,0.00003,No
5,4,20,4,4,8,5,5,10,7,0.33432,0.345107,0.00003,No
24,23,552,15,13,28,24,24,48,7,0.3753,0.393101,0.00003,No
14,14,196,6,10,16,14,14,28,8,0.370315,0.38772,0.00003,No
36,36,1296,12,14,26,36,36,72,7,0.374246,0.3924,0.00003,No
23,20,460,12,18,30,23,23,46,7,0.373689,0.391427,0.00003,No
31,31,961,18,18,36,31,31,62,7,0.387945,0.406601,0.00003,No
16,16,256,8,12,20,16,16,32,7,0.381228,0.399274,0.00003,No
3,3,9,3,3,6,3,3,6,8,0.332755,0.344525,0.00003,No
22,22,484,6,13,19,22,22,44,7,0.363267,0.379555,0.00003,No
11,11,121,6,9,15,11,11,22,8,0.357528,0.373861,0.00003,No
11,11,121,2,4,6,11,11,22,8,0.335945,0.34802,0.00003,No
9,9,81,8,8,16,9,9,18,8,0.362303,0.379454,0.000029,No
1,1,1,1,1,2,1,1,2,9,0.224981,0.229184,0.000029,No
8,8,64,7,7,14,8,8,16,8,0.352483,0.366617,0.000029,No
36,36,1296,13,16,29,36,36,72,7,0.373509,0.391212,0.000029,No
2,2,4,2,1,3,2,2,4,8,0.303661,0.312967,0.000029,No
20,20,400,8,14,22,20,20,40,8,0.375159,0.393776,0.000029,No
10,10,100,3,4,7,10,10,20,8,0.357176,0.37388,0.000029,No
21,18,378,11,13,24,21,21,42,7,0.371767,0.389272,0.000029,No
10,9,90,3,7,10,10,10,20,7,0.361627,0.377845,0.000029,No
12,12,144,4,11,15,12,12,24,7,0.341465,0.354105,0.000029,No
9,9,81,6,7,13,9,9,18,8,0.362303,0.379858,0.000029,No
14,14,196,8,11,19,14,14,28,8,0.347402,0.36184,0.000029,No
24,22,528,15,15,30,24,24,48,7,0.368134,0.385727,0.000029,No
40,39,1560,25,19,44,40,40,80,7,0.37262,0.389718,0.000029,No
14,14,196,10,12,22,14,14,28,8,0.341246,0.355415,0.000029,No
26,25,650,8,19,27,26,26,52,7,0.38059,0.399613,0.000029,No
1,1,1,1,1,2,1,1,2,8,0.303666,0.31297,0.000029,No
9,9,81,6,5,11,9,9,18,8,0.366245,0.38351,0.000029,No
1,1,1,1,1,2,1,1,2,8,0.331578,0.343078,0.000029,No
1,1,1,1,1,2,1,1,2,8,0.331578,0.343078,0.000029,No
8,8,64,6,7,13,8,8,16,8,0.350219,0.364382,0.000029,No
9,9,81,9,8,17,9,9,18,8,0.315345,0.322188,0.000029,No
6,6,36,4,4,8,6,6,12,7,0.327964,0.339429,0.000029,No
7,7,49,4,5,9,7,7,14,7,0.334963,0.347121,0.000029,No
1,1,1,1,1,2,1,1,2,8,0.339941,0.352199,0.000029,No
1,1,1,1,1,2,1,1,2,8,0.339941,0.352199,0.000029,No
1,1,1,1,1,2,1,1,2,8,0.30748,0.313776,0.000029,No
3,3,9,3,1,4,3,3,6,8,0.307475,0.313771,0.000029,No
4,4,16,3,3,6,4,4,8,8,0.293395,0.302388,0.000028,No
16,16,256,3,10,13,16,16,32,8,0.345825,0.359811,0.000028,No
12,12,144,7,10,17,12,12,24,7,0.352994,0.367836,0.000028,No
32,30,960,14,18,32,32,32,64,8,0.346387,0.360807,0.000028,No
48,37,1776,26,25,51,48,48,96,7,0.384917,0.403775,0.000028,No
14,14,196,7,9,16,14,14,28,8,0.342424,0.356511,0.000028,No
11,11,121,6,7,13,11,11,22,8,0.344986,0.358706,0.000028,No
20,20,400,8,14,22,20,20,40,8,0.374534,0.39329,0.000028,No
12,12,144,3,8,11,12,12,24,8,0.338706,0.350388,0.000028,No
5,5,25,5,4,9,5,5,10,8,0.352512,0.367897,0.000028,No
17,17,289,9,6,15,17,17,34,7,0.361244,0.376949,0.000028,No
53,53,2809,27,10,37,53,53,106,7,0.355694,0.370927,0.000028,No
37,37,1369,16,19,35,37,37,74,7,0.358489,0.373688,0.000028,No
28,28,784,12,12,24,28,28,56,7,0.349644,0.363312,0.000028,No
11,11,121,3,11,14,11,11,22,8,0.357895,0.374649,0.000027,No
7,7,49,4,5,9,7,7,14,7,0.359342,0.375235,0.000027,No
3,3,9,3,2,5,3,3,6,8,0.343203,0.35581,0.000027,No
55,55,3025,7,18,25,55,55,110,8,0.335859,0.347802,0.000027,No
2,2,4,2,2,4,2,2,4,8,0.317528,0.327553,0.000027,No
28,28,784,16,10,26,28,28,56,7,0.348161,0.361975,0.000027,No
13,13,169,8,9,17,13,13,26,7,0.375069,0.393379,0.000027,No
14,14,196,9,7,16,14,14,28,8,0.354969,0.371009,0.000027,No
14,14,196,8,7,15,14,14,28,8,0.333738,0.344775,0.000027,No
98,92,9016,23,24,47,98,98,196,7,0.383223,0.401898,0.000027,No
24,24,576,11,18,29,24,24,48,7,0.375003,0.393273,0.000027,No
19,19,361,14,13,27,19,19,38,7,0.358753,0.373715,0.000027,No
24,23,552,12,18,30,24,24,48,7,0.378925,0.396986,0.000027,No
27,27,729,8,20,28,27,27,54,7,0.34777,0.360976,0.000027,No
7,7,49,5,4,9,7,7,14,8,0.33833,0.351637,0.000027,No
21,20,420,10,13,23,21,21,42,8,0.349738,0.364379,0.000027,No
33,33,1089,12,18,30,33,33,66,7,0.371848,0.390587,0.000027,No
12,12,144,9,12,21,12,12,24,8,0.361688,0.377876,0.000027,No
4,4,16,3,3,6,4,4,8,7,0.297908,0.306417,0.000027,No
13,13,169,7,11,18,13,13,26,7,0.355931,0.371225,0.000027,No
32,32,1024,15,18,33,32,32,64,7,0.369137,0.387016,0.000027,No
9,9,81,5,3,8,9,9,18,7,0.328672,0.339376,0.000026,No
13,13,169,9,8,17,13,13,26,7,0.361957,0.377749,0.000026,No
16,15,240,10,12,22,16,16,32,8,0.356058,0.371856,0.000026,No
18,17,306,9,11,20,18,18,36,7,0.352731,0.367062,0.000026,No
28,28,784,14,18,32,28,28,56,7,0.377859,0.396235,0.000026,No
30,25,750,8,20,28,30,30,60,7,0.383567,0.402514,0.000026,No
66,66,4356,27,16,43,66,66,132,7,0.3476,0.360899,0.000026,No
10,10,100,6,9,15,10,10,20,8,0.352738,0.367698,0.000026,No
17,17,289,10,11,21,17,17,34,8,0.373109,0.391145,0.000026,No
8,8,64,6,6,12,8,8,16,8,0.338518,0.351648,0.000026,No
4,4,16,4,3,7,4,4,8,8,0.2696,0.27591,0.000026,No
18,18,324,9,11,20,18,18,36,8,0.354386,0.370648,0.000026,No
34,34,1156,15,18,33,34,34,68,7,0.37249,0.390132,0.000026,No
14,14,196,6,8,14,14,14,28,8,0.348808,0.36287,0.000026,No
6,6,36,4,6,10,6,6,12,7,0.35785,0.373063,0.000026,No
49,49,2401,13,28,41,49,49,98,7,0.396768,0.416294,0.000026,No
8,7,56,6,5,11,8,8,16,8,0.356981,0.373137,0.000026,No
24,16,384,3,14,17,24,24,48,7,0.381595,0.400046,0.000026,No
58,55,3190,22,19,41,58,58,116,7,0.368452,0.385072,0.000026,No
12,12,144,7,10,17,12,12,24,7,0.367618,0.38455,0.000026,No
13,12,156,6,9,15,13,13,26,8,0.356877,0.372143,0.000026,No
2,2,4,1,1,2,2,2,4,9,0.246376,0.250666,0.000025,No
18,18,324,11,15,26,18,18,36,7,0.346422,0.35937,0.000025,No
2,2,4,2,2,4,2,2,4,8,0.352003,0.366286,0.000025,No
2,2,4,2,2,4,2,2,4,8,0.324065,0.335163,0.000025,No
15,15,225,8,10,18,15,15,30,7,0.364875,0.38201,0.000025,No
10,10,100,6,9,15,10,10,20,8,0.371322,0.388727,0.000025,No
8,8,64,6,6,12,8,8,16,7,0.337213,0.348069,0.000025,No
41,41,1681,15,13,28,41,41,82,7,0.382321,0.400819,0.000025,No
2,2,4,2,2,4,2,2,4,9,0.235258,0.239056,0.000025,No
42,39,1638,15,31,46,42,42,84,7,0.335575,0.347783,0.000025,No
7,6,42,3,6,9,7,7,14,8,0.318345,0.325761,0.000025,No
26,23,598,10,14,24,26,26,52,7,0.368507,0.385724,0.000025,No
145,142,20590,11,16,27,145,145,290,7,0.367618,0.385081,0.000025,No
97,96,9312,23,23,46,97,97,194,7,0.380896,0.399186,0.000025,No
5,5,25,4,4,8,5,5,10,7,0.3289,0.339529,0.000025,No
46,43,1978,22,23,45,46,46,92,7,0.378648,0.396755,0.000024,No
37,37,1369,15,15,30,37,37,74,7,0.359501,0.375249,0.000024,No
12,11,132,5,8,13,12,12,24,7,0.363066,0.37915,0.000024,No
34,33,1122,9,16,25,34,34,68,7,0.381185,0.399308,0.000024,No
9,9,81,6,7,13,9,9,18,7,0.361734,0.377877,0.000024,No
24,24,576,5,14,19,24,24,48,7,0.364524,0.381028,0.000024,No
23,21,483,8,14,22,23,23,46,7,0.355687,0.370066,0.000024,No
19,19,361,3,9,12,19,19,38,8,0.357123,0.371913,0.000024,No
25,25,625,12,15,27,25,25,50,7,0.373787,0.391904,0.000024,No
20,14,280,4,11,15,20,20,40,8,0.371719,0.38958,0.000024,No
17,16,272,12,12,24,17,17,34,8,0.325053,0.335512,0.000024,No
7,7,49,5,6,11,7,7,14,8,0.345363,0.358988,0.000024,No
26,26,676,10,10,20,26,26,52,7,0.351228,0.36493,0.000024,No
15,15,225,7,14,21,15,15,30,8,0.35913,0.375816,0.000024,No
29,28,812,7,17,24,29,29,58,7,0.375523,0.393677,0.000024,No
10,10,100,6,8,14,10,10,20,8,0.349408,0.363559,0.000024,No
1,1,1,1,1,2,1,1,2,8,0.331578,0.343078,0.000024,No
13,12,156,9,11,20,13,13,26,8,0.359812,0.376843,0.000024,No
18,18,324,10,13,23,18,18,36,7,0.366986,0.383045,0.000024,No
20,16,320,4,14,18,20,20,40,7,0.37108,0.388607,0.000024,No
12,11,132,7,8,15,12,12,24,8,0.334752,0.347269,0.000024,No
19,15,285,7,13,20,19,19,38,7,0.377684,0.395715,0.000024,No
15,15,225,12,12,24,15,15,30,8,0.341725,0.354784,0.000024,No
2,2,4,2,2,4,2,2,4,8,0.299919,0.307417,0.000024,No
82,81,6642,22,34,56,82,82,164,7,0.377533,0.395816,0.000024,No
30,30,900,13,14,27,30,30,60,8,0.373885,0.392437,0.000024,No
6,6,36,5,5,10,6,6,12,7,0.330409,0.341533,0.000024,No
12,12,144,8,10,18,12,12,24,8,0.375069,0.393571,0.000024,No
41,41,1681,17,16,33,41,41,82,8,0.367357,0.385154,0.000024,No
20,20,400,10,17,27,20,20,40,7,0.369585,0.386609,0.000024,No
13,13,169,7,8,15,13,13,26,8,0.366167,0.382516,0.000024,No
26,26,676,11,20,31,26,26,52,7,0.373787,0.391474,0.000024,No
23,20,460,13,16,29,23,23,46,7,0.378631,0.397037,0.000023,yes
13,12,156,6,8,14,13,13,26,7,0.373918,0.39177,0.000023,No
18,18,324,9,14,23,18,18,36,8,0.362241,0.378934,0.000023,No
9,9,81,3,5,8,9,9,18,8,0.305602,0.312332,0.000023,No
38,36,1368,17,12,29,38,38,76,7,0.377667,0.395908,0.000023,No
14,13,182,7,12,19,14,14,28,8,0.358617,0.37504,0.000023,No
43,43,1849,18,12,30,43,43,86,8,0.34831,0.361217,0.000023,No
42,37,1554,10,13,23,42,42,84,7,0.34486,0.358527,0.000023,No
10,8,80,6,6,12,10,10,20,8,0.33201,0.342324,0.000023,No
8,8,64,4,7,11,8,8,16,7,0.369585,0.386848,0.000023,No
17,17,289,9,11,20,17,17,34,8,0.368898,0.385775,0.000023,No
3,3,9,2,2,4,3,3,6,8,0.346274,0.360268,0.000023,No
9,9,81,5,7,12,9,9,18,7,0.367713,0.384722,0.000023,No
13,13,169,6,9,15,13,13,26,7,0.357011,0.372433,0.000023,No
44,44,1936,37,21,58,44,44,88,8,0.33706,0.349144,0.000023,No
28,26,728,9,14,23,28,28,56,8,0.36221,0.378314,0.000023,No
28,26,728,11,18,29,28,28,56,8,0.381945,0.400696,0.000023,No
32,31,992,11,18,29,32,32,64,7,0.383171,0.401828,0.000023,No
2,2,4,2,2,4,2,2,4,7,0.296815,0.305365,0.000023,No
16,15,240,7,8,15,16,16,32,7,0.345937,0.358395,0.000023,No
10,10,100,5,8,13,10,10,20,8,0.325078,0.335428,0.000023,No
7,6,42,3,7,10,7,7,14,8,0.325047,0.335877,0.000023,No
2,2,4,2,2,4,2,2,4,8,0.316609,0.326436,0.000023,No
47,43,2021,12,10,22,47,47,94,7,0.369201,0.386898,0.000023,No
27,27,729,19,13,32,27,27,54,7,0.367167,0.38364,0.000023,No
35,35,1225,19,18,37,35,35,70,7,0.364073,0.380481,0.000023,No
9,9,81,8,6,14,9,9,18,7,0.342934,0.35456,0.000023,No
28,26,728,14,15,29,28,28,56,7,0.37104,0.387939,0.000023,No
12,12,144,9,8,17,12,12,24,8,0.354644,0.369591,0.000023,No
12,9,108,8,9,17,12,12,24,7,0.345825,0.358534,0.000023,No
16,14,224,7,11,18,16,16,32,7,0.36539,0.382226,0.000023,No
19,19,361,15,13,28,19,19,38,7,0.378959,0.396803,0.000022,No
22,21,462,9,9,18,22,22,44,7,0.345748,0.35927,0.000022,No
9,8,72,3,9,12,9,9,18,8,0.356043,0.371544,0.000022,No
8,8,64,5,4,9,8,8,16,8,0.344791,0.357539,0.000022,No
25,25,625,9,16,25,25,25,50,8,0.350362,0.364064,0.000022,No
16,16,256,10,9,19,16,16,32,7,0.340328,0.352613,0.000022,No
36,35,1260,16,20,36,36,36,72,7,0.357243,0.373006,0.000022,No
29,29,841,13,21,34,29,29,58,7,0.391075,0.410413,0.000022,No
10,10,100,6,10,16,10,10,20,7,0.366875,0.383482,0.000022,No
5,5,25,3,3,6,5,5,10,8,0.327738,0.339593,0.000022,No
21,21,441,11,11,22,21,21,42,8,0.349137,0.3627,0.000022,No
1,1,1,1,1,2,1,1,2,8,0.339934,0.352194,0.000022,No
14,14,196,11,12,23,14,14,28,8,0.353396,0.36854,0.000022,No
61,60,3660,13,34,47,61,61,122,7,0.391263,0.41104,0.000022,No
15,13,195,9,11,20,15,15,30,7,0.369825,0.38668,0.000022,No
27,27,729,12,12,24,27,27,54,7,0.36656,0.383621,0.000022,No
22,22,484,14,10,24,22,22,44,7,0.361642,0.377107,0.000022,No
67,65,4355,5,32,37,67,67,134,7,0.397767,0.417575,0.000022,No
16,16,256,12,9,21,16,16,32,7,0.368189,0.38485,0.000022,No
6,6,36,6,5,11,6,6,12,7,0.31796,0.327002,0.000022,No
22,22,484,12,12,24,22,22,44,8,0.357034,0.37165,0.000022,No
20,20,400,9,13,22,20,20,40,8,0.3596,0.375673,0.000021,No
15,15,225,12,11,23,15,15,30,8,0.36634,0.382963,0.000021,No
13,13,169,7,5,12,13,13,26,7,0.359433,0.375337,0.000021,No
24,24,576,22,9,31,24,24,48,8,0.359312,0.374499,0.000021,No
23,23,529,13,14,27,23,23,46,7,0.350068,0.36393,0.000021,No
17,16,272,8,11,19,17,17,34,7,0.374896,0.392548,0.000021,No
47,47,2209,20,16,36,47,47,94,8,0.354947,0.369886,0.000021,No
13,13,169,11,11,22,13,13,26,8,0.365586,0.382376,0.000021,No
12,11,132,9,10,19,12,12,24,7,0.370749,0.387718,0.000021,No
5,5,25,4,4,8,5,5,10,8,0.326415,0.337241,0.000021,No
11,11,121,9,9,18,11,11,22,7,0.37001,0.386863,0.000021,No
28,28,784,16,15,31,28,28,56,7,0.366277,0.382617,0.000021,No
40,39,1560,18,12,30,40,40,80,7,0.353549,0.367706,0.000021,No
9,6,54,5,9,14,9,9,18,7,0.365297,0.381878,0.000021,No
12,8,96,6,9,15,12,12,24,8,0.361788,0.3779,0.000021,No
27,27,729,7,6,13,27,27,54,8,0.366836,0.383776,0.000021,No
12,12,144,8,8,16,12,12,24,7,0.349874,0.364033,0.000021,No
14,14,196,5,10,15,14,14,28,7,0.359668,0.374897,0.000021,No
18,17,306,10,11,21,18,18,36,7,0.372213,0.389311,0.000021,No
9,7,63,5,9,14,9,9,18,8,0.346612,0.359866,0.000021,No
7,7,49,4,6,10,7,7,14,7,0.344665,0.357659,0.000021,No
35,33,1155,10,16,26,35,35,70,8,0.374377,0.393132,0.000021,No
16,13,208,6,11,17,16,16,32,8,0.352461,0.367146,0.000021,No
23,23,529,14,14,28,23,23,46,7,0.341643,0.354102,0.000021,No
60,59,3540,15,20,35,60,60,120,7,0.387954,0.406991,0.000021,No
3,3,9,2,2,4,3,3,6,7,0.296712,0.30526,0.000021,No
16,16,256,15,13,28,16,16,32,8,0.35749,0.373408,0.000021,No
11,11,121,9,8,17,11,11,22,8,0.340423,0.352954,0.000021,No
39,39,1521,9,12,21,39,39,78,7,0.381988,0.400804,0.000021,No
11,11,121,10,10,20,11,11,22,8,0.362533,0.37944,0.000021,No
17,17,289,8,12,20,17,17,34,8,0.366844,0.384836,0.000021,No
15,15,225,7,13,20,15,15,30,7,0.37832,0.396576,0.000021,No
10,9,90,7,9,16,10,10,20,7,0.351756,0.365735,0.000021,No
13,13,169,3,11,14,13,13,26,8,0.359319,0.375188,0.000021,No
11,11,121,4,7,11,11,11,22,8,0.372213,0.389689,0.000021,No
14,14,196,3,10,13,14,14,28,8,0.346253,0.360108,0.000021,No
30,29,870,15,15,30,30,30,60,8,0.352192,0.367342,0.000021,No
16,15,240,10,11,21,16,16,32,7,0.355472,0.370183,0.000021,No
12,11,132,6,10,16,12,12,24,8,0.36885,0.387058,0.00002,No
31,31,961,11,24,35,31,31,62,7,0.375895,0.393604,0.00002,No
14,14,196,11,10,21,14,14,28,8,0.364415,0.380885,0.00002,No
4,4,16,3,4,7,4,4,8,7,0.34011,0.353235,0.00002,No
19,19,361,8,15,23,19,19,38,7,0.356743,0.371611,0.00002,No
6,6,36,5,5,10,6,6,12,8,0.321864,0.328946,0.00002,No
12,11,132,8,8,16,12,12,24,8,0.333561,0.346142,0.00002,No
9,9,81,3,8,11,9,9,18,8,0.353454,0.368836,0.00002,No
14,12,168,6,10,16,14,14,28,7,0.357692,0.373065,0.00002,No
20,20,400,15,12,27,20,20,40,8,0.315946,0.324445,0.00002,No
1,1,1,1,1,2,1,1,2,8,0.32342,0.334424,0.00002,No
24,24,576,10,15,25,24,24,48,7,0.3772,0.395562,0.00002,No
7,7,49,6,6,12,7,7,14,8,0.325344,0.333358,0.00002,No
18,18,324,8,10,18,18,18,36,7,0.371856,0.389773,0.00002,No
10,10,100,5,8,13,10,10,20,8,0.337367,0.349222,0.00002,No
23,22,506,8,12,20,23,23,46,7,0.353059,0.368236,0.00002,No
2,2,4,1,1,2,2,2,4,8,0.304631,0.311247,0.00002,No
14,14,196,11,10,21,14,14,28,8,0.352352,0.366932,0.00002,No
15,12,180,7,9,16,15,15,30,7,0.356922,0.37186,0.00002,No
16,16,256,11,12,23,16,16,32,8,0.371322,0.389141,0.00002,No
42,41,1722,12,20,32,42,42,84,8,0.366261,0.382903,0.00002,No
30,30,900,19,22,41,30,30,60,7,0.365516,0.382722,0.00002,No
21,20,420,7,16,23,21,21,42,7,0.372132,0.389566,0.00002,No
3,2,6,2,3,5,3,3,6,8,0.346661,0.360977,0.00002,No
12,12,144,5,11,16,12,12,24,8,0.358617,0.375038,0.00002,No
8,8,64,5,4,9,8,8,16,7,0.36391,0.380628,0.00002,No
7,7,49,7,6,13,7,7,14,8,0.359418,0.374559,0.00002,No
19,17,323,8,13,21,19,19,38,7,0.373378,0.390909,0.00002,No
3,3,9,2,2,4,3,3,6,8,0.317309,0.324432,0.00002,No
16,16,256,6,6,12,16,16,32,7,0.363933,0.380466,0.00002,No
25,25,625,10,19,29,25,25,50,8,0.360245,0.37613,0.00002,No
13,13,169,5,8,13,13,13,26,8,0.325835,0.334304,0.00002,No
15,12,180,9,8,17,15,15,30,7,0.330993,0.341436,0.000019,yes
15,15,225,10,10,20,15,15,30,8,0.335681,0.346556,0.000019,No
28,26,728,11,19,30,28,28,56,7,0.389353,0.40806,0.000019,No
11,11,121,5,7,12,11,11,22,8,0.340158,0.352686,0.000019,No
29,28,812,13,23,36,29,29,58,7,0.369185,0.388168,0.000019,No
9,9,81,7,4,11,9,9,18,8,0.345902,0.359575,0.000019,No
6,6,36,6,5,11,6,6,12,7,0.370002,0.38731,0.000019,No
32,31,992,6,20,26,32,32,64,8,0.367017,0.384743,0.000019,No
11,11,121,7,10,17,11,11,22,8,0.355072,0.371015,0.000019,No
50,46,2300,8,5,13,50,50,100,8,0.344589,0.358603,0.000019,No
22,21,462,3,13,16,22,22,44,8,0.362888,0.37941,0.000019,No
7,7,49,4,6,10,7,7,14,7,0.35767,0.37382,0.000019,No
70,69,4830,20,16,36,70,70,140,7,0.366749,0.383204,0.000019,No
6,6,36,3,5,8,6,6,12,8,0.3178,0.32734,0.000019,No
8,8,64,5,6,11,8,8,16,8,0.344742,0.357566,0.000019,No
13,13,169,7,10,17,13,13,26,7,0.334038,0.345364,0.000019,No
16,15,240,5,10,15,16,16,32,7,0.358406,0.373356,0.000019,No
15,15,225,4,12,16,15,15,30,8,0.343583,0.357534,0.000019,No
27,25,675,11,10,21,27,27,54,8,0.350326,0.365026,0.000019,No
19,19,361,10,10,20,19,19,38,7,0.364688,0.380967,0.000019,No
32,32,1024,16,13,29,32,32,64,8,0.379161,0.39723,0.000019,No
6,6,36,3,6,9,6,6,12,8,0.351517,0.365875,0.000019,No
19,18,342,11,14,25,19,19,38,7,0.364189,0.380711,0.000019,No
24,24,576,15,11,26,24,24,48,8,0.36712,0.383823,0.000019,No
103,103,10609,26,16,42,103,103,206,8,0.354306,0.370386,0.000019,No
21,21,441,11,13,24,21,21,42,8,0.330518,0.341945,0.000019,No
12,9,108,5,8,13,12,12,24,7,0.361083,0.376733,0.000019,No
31,31,961,6,22,28,31,31,62,7,0.374476,0.392811,0.000019,No
12,12,144,10,9,19,12,12,24,8,0.363089,0.379487,0.000018,No
22,22,484,8,8,16,22,22,44,7,0.35314,0.367188,0.000018,No
3,3,9,3,3,6,3,3,6,7,0.33073,0.342071,0.000018,No
30,30,900,18,16,34,30,30,60,7,0.350939,0.364994,0.000018,No
15,13,195,4,7,11,15,15,30,7,0.332204,0.342481,0.000018,No
4,4,16,3,2,5,4,4,8,8,0.286114,0.293353,0.000018,No
12,11,132,7,10,17,12,12,24,8,0.357393,0.372718,0.000018,No
5,5,25,2,4,6,5,5,10,7,0.355516,0.370219,0.000018,No
14,14,196,10,10,20,14,14,28,7,0.361696,0.377163,0.000018,No
13,13,169,7,9,16,13,13,26,8,0.36475,0.382129,0.000018,No
12,11,132,7,6,13,12,12,24,8,0.352039,0.367079,0.000018,No
25,25,625,19,7,26,25,25,50,8,0.355435,0.370312,0.000018,No
12,11,132,6,11,17,12,12,24,7,0.373967,0.39152,0.000018,No
21,21,441,10,11,21,21,21,42,8,0.347692,0.361757,0.000018,No
14,14,196,10,12,22,14,14,28,8,0.361267,0.377348,0.000018,No
16,16,256,15,10,25,16,16,32,8,0.364368,0.381469,0.000018,No
15,15,225,7,10,17,15,15,30,8,0.318221,0.326471,0.000018,No
17,17,289,10,11,21,17,17,34,7,0.362433,0.378629,0.000018,No
39,39,1521,15,21,36,39,39,78,8,0.380302,0.399164,0.000018,No
17,17,289,10,11,21,17,17,34,7,0.367231,0.383835,0.000018,No
14,14,196,10,9,19,14,14,28,8,0.340524,0.353999,0.000018,No
7,7,49,3,7,10,7,7,14,8,0.34361,0.357925,0.000018,No
2,2,4,1,2,3,2,2,4,8,0.303747,0.310647,0.000018,No
16,16,256,4,13,17,16,16,32,7,0.357019,0.37364,0.000018,No
30,26,780,15,20,35,30,30,60,7,0.362164,0.379318,0.000018,No
21,21,441,16,12,28,21,21,42,8,0.378094,0.396164,0.000018,No
5,5,25,5,5,10,5,5,10,8,0.33702,0.348363,0.000018,No
11,11,121,4,10,14,11,11,22,7,0.34943,0.364125,0.000018,No
2,2,4,2,2,4,2,2,4,8,0.310124,0.318656,0.000018,No
13,12,156,8,11,19,13,13,26,7,0.369601,0.387334,0.000018,No
15,15,225,7,10,17,15,15,30,7,0.374723,0.391882,0.000018,No
20,20,400,15,12,27,20,20,40,7,0.351438,0.36611,0.000018,No
11,11,121,5,7,12,11,11,22,8,0.354357,0.368869,0.000018,No
9,9,81,7,6,13,9,9,18,8,0.327003,0.336446,0.000018,No
7,7,49,5,5,10,7,7,14,8,0.332004,0.342871,0.000018,No
8,8,64,6,7,13,8,8,16,8,0.36129,0.377801,0.000018,No
21,21,441,7,16,23,21,21,42,7,0.353403,0.367221,0.000018,No
3,2,6,2,3,5,3,3,6,7,0.335807,0.346445,0.000018,No
16,16,256,11,10,21,16,16,32,7,0.357557,0.372518,0.000018,No
4,4,16,4,4,8,4,4,8,8,0.311272,0.319854,0.000018,No
15,15,225,9,10,19,15,15,30,7,0.353923,0.368468,0.000018,No
16,10,160,3,9,12,16,16,32,7,0.362634,0.378391,0.000018,No
24,23,552,6,16,22,24,24,48,7,0.372888,0.391311,0.000018,No
4,4,16,3,3,6,4,4,8,8,0.291456,0.298563,0.000018,No
8,8,64,7,7,14,8,8,16,7,0.345706,0.358893,0.000018,No
3,3,9,3,3,6,3,3,6,8,0.35579,0.371867,0.000018,No
23,23,529,4,13,17,23,23,46,7,0.37725,0.395326,0.000018,No
9,9,81,9,9,18,9,9,18,7,0.347933,0.361195,0.000018,No
23,23,529,8,16,24,23,23,46,7,0.388254,0.407108,0.000018,No
15,15,225,5,11,16,15,15,30,7,0.360549,0.376214,0.000018,No
4,4,16,4,4,8,4,4,8,8,0.34047,0.352725,0.000018,No
31,28,868,4,14,18,31,31,62,7,0.374805,0.392713,0.000017,No
21,21,441,8,11,19,21,21,42,8,0.346077,0.360009,0.000017,No
17,17,289,10,12,22,17,17,34,7,0.368054,0.384331,0.000017,No
15,14,210,4,12,16,15,15,30,8,0.368102,0.385951,0.000017,No
6,6,36,3,3,6,6,6,12,8,0.303084,0.310043,0.000017,No
8,8,64,6,8,14,8,8,16,8,0.339043,0.350513,0.000017,No
20,19,380,17,7,24,20,20,40,8,0.328015,0.338789,0.000017,No
11,11,121,3,4,7,11,11,22,7,0.35385,0.368524,0.000017,No
31,31,961,10,13,23,31,31,62,7,0.374115,0.391406,0.000017,No
11,11,121,8,8,16,11,11,22,8,0.331546,0.341355,0.000017,No
7,7,49,5,7,12,7,7,14,8,0.343334,0.357462,0.000017,No
6,6,36,3,4,7,6,6,12,8,0.336104,0.349588,0.000017,No
19,18,342,12,13,25,19,19,38,8,0.366513,0.382796,0.000017,No
12,11,132,7,7,14,12,12,24,7,0.342562,0.354408,0.000017,No
22,22,484,13,6,19,22,22,44,8,0.326646,0.336772,0.000017,No
24,24,576,5,17,22,24,24,48,8,0.360382,0.376629,0.000017,No
7,6,42,4,5,9,7,7,14,7,0.322692,0.331131,0.000017,No
16,16,256,7,8,15,16,16,32,7,0.335364,0.346293,0.000017,No
46,41,1886,7,13,20,46,46,92,7,0.383343,0.401834,0.000017,No
7,7,49,4,3,7,7,7,14,8,0.348937,0.362207,0.000017,No
10,9,90,5,9,14,10,10,20,8,0.354114,0.369872,0.000017,No
5,5,25,2,1,3,5,5,10,8,0.243434,0.247374,0.000017,No
1,1,1,1,1,2,1,1,2,9,0.254577,0.259499,0.000017,No
12,12,144,5,11,16,12,12,24,7,0.355546,0.370826,0.000017,No
11,11,121,8,9,17,11,11,22,7,0.360116,0.375251,0.000017,No
1,1,1,1,1,2,1,1,2,8,0.277096,0.285605,0.000017,No
1,1,1,1,1,2,1,1,2,9,0.231926,0.23508,0.000017,No
13,13,169,11,8,19,13,13,26,8,0.327769,0.338922,0.000017,No
1,1,1,1,1,2,1,1,2,8,0.288173,0.299071,0.000017,No
1,1,1,1,1,2,1,1,2,8,0.339941,0.352199,0.000017,No
23,22,506,14,11,25,23,23,46,8,0.369561,0.387231,0.000017,No
32,32,1024,18,9,27,32,32,64,8,0.346281,0.36034,0.000017,No
12,12,144,6,8,14,12,12,24,7,0.355842,0.37078,0.000017,No
34,34,1156,12,18,30,34,34,68,7,0.382827,0.401366,0.000017,No
4,3,12,3,3,6,4,4,8,7,0.3596,0.375874,0.000017,No
12,12,144,5,11,16,12,12,24,7,0.378153,0.396994,0.000017,No
25,25,625,7,16,23,25,25,50,7,0.376426,0.395303,0.000016,No
9,8,72,6,4,10,9,9,18,7,0.352643,0.367034,0.000016,No
14,14,196,5,9,14,14,14,28,8,0.3513,0.366597,0.000016,No
15,15,225,7,12,19,15,15,30,8,0.354328,0.36909,0.000016,No
12,12,144,8,8,16,12,12,24,7,0.332088,0.342237,0.000016,No
9,9,81,4,2,6,9,9,18,7,0.327838,0.338556,0.000016,No
4,4,16,3,3,6,4,4,8,8,0.321628,0.32976,0.000016,No
17,15,255,5,8,13,17,17,34,7,0.378547,0.396812,0.000016,No
39,32,1248,3,23,26,39,39,78,7,0.388546,0.407428,0.000016,No
2,2,4,2,2,4,2,2,4,8,0.278762,0.2883,0.000016,No
3,3,9,2,1,3,3,3,6,9,0.252434,0.257334,0.000016,No
13,13,169,9,8,17,13,13,26,8,0.332651,0.345056,0.000016,No
8,8,64,6,6,12,8,8,16,8,0.341192,0.355226,0.000016,No
27,27,729,11,17,28,27,27,54,7,0.373158,0.39135,0.000016,No
9,9,81,7,7,14,9,9,18,8,0.337975,0.351338,0.000016,No
46,45,2070,13,23,36,46,46,92,7,0.373746,0.391535,0.000016,No
8,7,56,8,8,16,8,8,16,8,0.345349,0.358244,0.000016,No
6,6,36,5,5,10,6,6,12,8,0.336522,0.348495,0.000016,No
31,27,837,5,12,17,31,31,62,8,0.372092,0.389489,0.000016,No
18,18,324,8,10,18,18,18,36,7,0.360786,0.376444,0.000016,No
6,6,36,5,5,10,6,6,12,8,0.343403,0.356351,0.000016,No
7,7,49,7,6,13,7,7,14,8,0.35559,0.370814,0.000016,No
12,11,132,8,6,14,12,12,24,7,0.367144,0.384222,0.000016,No
28,27,756,15,12,27,28,28,56,8,0.344881,0.358293,0.000016,No
6,5,30,6,6,12,6,6,12,7,0.33967,0.35105,0.000016,No
12,12,144,4,8,12,12,12,24,8,0.350961,0.364599,0.000016,No
25,24,600,7,16,23,25,25,50,7,0.382939,0.402211,0.000016,No
27,27,729,9,7,16,27,27,54,8,0.354962,0.369971,0.000016,No
39,38,1482,16,14,30,39,39,78,8,0.368269,0.385633,0.000016,No
17,17,289,8,12,20,17,17,34,7,0.360131,0.376175,0.000016,No
19,19,361,15,13,28,19,19,38,8,0.350701,0.365101,0.000016,No
38,36,1368,15,19,34,38,38,76,8,0.364353,0.380278,0.000016,No
4,4,16,3,3,6,4,4,8,8,0.313065,0.321169,0.000016,No
6,5,30,5,5,10,6,6,12,7,0.357213,0.372651,0.000016,No
7,7,49,5,7,12,7,7,14,8,0.326302,0.334535,0.000016,No
21,21,441,2,13,15,21,21,42,7,0.375746,0.393804,0.000016,No
16,14,224,8,13,21,16,16,32,7,0.365516,0.38209,0.000016,No
14,14,196,5,10,15,14,14,28,8,0.376783,0.394883,0.000016,No
18,18,324,7,12,19,18,18,36,7,0.377208,0.395551,0.000016,No
1,1,1,1,1,2,1,1,2,8,0.301594,0.314494,0.000016,No
27,26,702,7,15,22,27,27,54,8,0.316956,0.324184,0.000015,yes
32,32,1024,3,19,22,32,32,64,7,0.380573,0.398486,0.000015,No
7,7,49,7,6,13,7,7,14,8,0.353015,0.368493,0.000015,No
9,9,81,5,4,9,9,9,18,8,0.349759,0.364082,0.000015,No
1,1,1,1,1,2,1,1,2,9,0.236776,0.240582,0.000015,No
18,16,288,13,12,25,18,18,36,7,0.360085,0.375514,0.000015,No
3,3,9,1,3,4,3,3,6,8,0.319084,0.329778,0.000015,No
5,5,25,5,4,9,5,5,10,8,0.344088,0.358427,0.000015,No
3,3,9,3,2,5,3,3,6,7,0.339306,0.352082,0.000015,No
18,18,324,10,10,20,18,18,36,7,0.380922,0.399036,0.000015,No
14,8,112,7,7,14,14,14,28,8,0.355768,0.37092,0.000015,No
21,20,420,11,13,24,21,21,42,8,0.365523,0.383159,0.000015,No
20,20,400,15,12,27,20,20,40,8,0.350039,0.364483,0.000015,No
23,23,529,16,8,24,23,23,46,7,0.378723,0.396987,0.000015,No
51,50,2550,13,10,23,51,51,102,7,0.365476,0.381821,0.000015,No
14,14,196,7,11,18,14,14,28,8,0.353755,0.368889,0.000015,No
10,10,100,8,5,13,10,10,20,7,0.359721,0.375056,0.000015,No
2,2,4,2,2,4,2,2,4,8,0.339968,0.352253,0.000015,No
17,17,289,10,12,22,17,17,34,7,0.366096,0.382507,0.000015,No
7,6,42,6,7,13,7,7,14,8,0.365117,0.382422,0.000015,No
4,4,16,3,4,7,4,4,8,8,0.317759,0.327043,0.000015,No
1,1,1,1,1,2,1,1,2,9,0.246099,0.250972,0.000015,No
8,8,64,6,5,11,8,8,16,7,0.362372,0.378256,0.000015,No
22,21,462,14,8,22,22,22,44,7,0.360017,0.375331,0.000015,No
15,15,225,8,9,17,15,15,30,7,0.370267,0.387873,0.000015,No
4,4,16,4,4,8,4,4,8,8,0.314126,0.320935,0.000015,No
20,20,400,10,12,22,20,20,40,8,0.370693,0.388389,0.000015,No
3,3,9,3,3,6,3,3,6,8,0.34314,0.356033,0.000015,No
13,13,169,5,10,15,13,13,26,8,0.355575,0.371453,0.000015,No
15,15,225,4,13,17,15,15,30,7,0.362611,0.378417,0.000015,No
25,25,625,15,8,23,25,25,50,8,0.364563,0.382155,0.000015,No
30,29,870,15,16,31,30,30,60,8,0.357273,0.372126,0.000015,No
2,2,4,2,2,4,2,2,4,8,0.331597,0.343127,0.000015,No
9,9,81,6,7,13,9,9,18,8,0.354364,0.369835,0.000015,No
13,12,156,8,7,15,13,13,26,8,0.342067,0.355064,0.000015,No
12,12,144,7,9,16,12,12,24,8,0.360702,0.37709,0.000015,No
11,10,110,7,7,14,11,11,22,7,0.355828,0.37062,0.000015,No
9,7,63,4,8,12,9,9,18,8,0.338531,0.352148,0.000015,No
3,3,9,1,3,4,3,3,6,8,0.339968,0.352277,0.000015,No
2,2,4,2,2,4,2,2,4,8,0.323457,0.334488,0.000015,No
53,53,2809,17,28,45,53,53,106,7,0.398482,0.418288,0.000015,No
8,7,56,5,7,12,8,8,16,8,0.342129,0.355394,0.000015,No
25,25,625,18,13,31,25,25,50,7,0.363669,0.380311,0.000015,No
26,26,676,18,6,24,26,26,52,7,0.367927,0.384835,0.000015,No
19,17,323,9,13,22,19,19,38,8,0.322668,0.330905,0.000014,yes
20,18,360,11,11,22,20,20,40,7,0.36601,0.382856,0.000014,No
19,19,361,14,14,28,19,19,38,8,0.383654,0.402159,0.000014,No
6,6,36,3,6,9,6,6,12,8,0.35047,0.365062,0.000014,No
10,10,100,2,5,7,10,10,20,8,0.341602,0.354134,0.000014,No
11,11,121,4,10,14,11,11,22,7,0.368118,0.385506,0.000014,No
13,13,169,10,11,21,13,13,26,8,0.315246,0.322419,0.000014,No
44,43,1892,15,15,30,44,44,88,7,0.372636,0.390964,0.000014,No
15,15,225,9,9,18,15,15,30,7,0.35605,0.371095,0.000014,No
5,5,25,2,4,6,5,5,10,7,0.371508,0.389131,0.000014,No
1,1,1,1,1,2,1,1,2,9,0.25283,0.257827,0.000014,No
7,7,49,4,4,8,7,7,14,8,0.298565,0.307482,0.000014,No
7,7,49,4,6,10,7,7,14,8,0.331018,0.344283,0.000014,No
8,8,64,6,8,14,8,8,16,7,0.357722,0.372734,0.000014,No
8,8,64,5,7,12,8,8,16,7,0.323242,0.332024,0.000014,No
4,4,16,4,3,7,4,4,8,7,0.339785,0.352473,0.000014,No
9,9,81,5,4,9,9,9,18,7,0.361351,0.377306,0.000014,No
8,7,56,5,8,13,8,8,16,8,0.343341,0.35743,0.000014,No
12,12,144,8,9,17,12,12,24,7,0.374008,0.392193,0.000014,No
22,22,484,12,7,19,22,22,44,8,0.354034,0.369433,0.000014,No
24,24,576,10,10,20,24,24,48,8,0.32916,0.337823,0.000014,No
15,15,225,12,10,22,15,15,30,8,0.357692,0.373602,0.000014,No
9,9,81,5,9,14,9,9,18,8,0.327203,0.336768,0.000014,No
7,5,35,5,4,9,7,7,14,7,0.349609,0.363724,0.000014,No
1,1,1,1,1,2,1,1,2,8,0.313502,0.320218,0.000014,No
36,36,1296,23,5,28,36,36,72,7,0.333555,0.3443,0.000014,No
13,13,169,11,5,16,13,13,26,8,0.332774,0.346218,0.000014,No
8,8,64,7,6,13,8,8,16,8,0.35024,0.364104,0.000014,No
5,5,25,4,5,9,5,5,10,8,0.34445,0.358749,0.000014,No
3,3,9,1,2,3,3,3,6,8,0.340837,0.353211,0.000014,No
31,31,961,9,16,25,31,31,62,8,0.3601,0.377493,0.000014,No
37,37,1369,9,25,34,37,37,74,8,0.400916,0.420882,0.000014,No
13,13,169,10,8,18,13,13,26,7,0.352287,0.366165,0.000014,No
7,7,49,6,5,11,7,7,14,7,0.36391,0.380647,0.000014,No
74,73,5402,18,19,37,74,74,148,8,0.366552,0.383285,0.000014,No
7,7,49,5,3,8,7,7,14,7,0.331836,0.343404,0.000014,No
26,25,650,7,10,17,26,26,52,7,0.344144,0.356096,0.000014,No
18,18,324,11,14,25,18,18,36,7,0.346274,0.35921,0.000014,No
17,16,272,6,9,15,17,17,34,8,0.331417,0.342015,0.000014,No
9,9,81,4,6,10,9,9,18,7,0.364508,0.381316,0.000014,No
7,7,49,6,6,12,7,7,14,8,0.330678,0.339462,0.000014,No
13,13,169,10,10,20,13,13,26,8,0.371484,0.389629,0.000014,No
6,6,36,5,6,11,6,6,12,8,0.345762,0.359779,0.000014,No
8,5,40,4,6,10,8,8,16,8,0.348459,0.363089,0.000014,No
13,12,156,4,10,14,13,13,26,8,0.355887,0.371198,0.000014,No
4,4,16,3,3,6,4,4,8,8,0.295095,0.307696,0.000014,No
13,13,169,6,10,16,13,13,26,7,0.370967,0.388924,0.000014,No
7,7,49,6,1,7,7,7,14,8,0.331571,0.343073,0.000014,No
1,1,1,1,1,2,1,1,2,10,0.204784,0.207594,0.000014,No
18,17,306,3,12,15,18,18,36,8,0.358459,0.374979,0.000014,No
15,15,225,12,8,20,15,15,30,8,0.327166,0.337519,0.000014,No
33,31,1023,11,9,20,33,33,66,8,0.373239,0.390371,0.000014,No
11,11,121,1,2,3,11,11,22,8,0.317333,0.324466,0.000014,No
1,1,1,1,1,2,1,1,2,8,0.331578,0.343078,0.000014,No
13,10,130,9,9,18,13,13,26,7,0.362873,0.378628,0.000014,No
41,35,1435,15,14,29,41,41,82,7,0.384709,0.403279,0.000014,No
1,1,1,1,1,2,1,1,2,9,0.226615,0.230008,0.000014,No
4,4,16,4,4,8,4,4,8,8,0.316826,0.32363,0.000014,No
15,15,225,8,7,15,15,15,30,7,0.355346,0.370076,0.000014,No
9,9,81,7,8,15,9,9,18,7,0.353637,0.368006,0.000014,No
8,7,56,6,8,14,8,8,16,8,0.373174,0.39092,0.000014,No
12,12,144,7,9,16,12,12,24,8,0.338942,0.351136,0.000013,No
11,11,121,7,9,16,11,11,22,8,0.34612,0.359891,0.000013,No
36,34,1224,16,14,30,36,36,72,7,0.375514,0.393086,0.000013,No
19,19,361,13,17,30,19,19,38,8,0.353418,0.368566,0.000013,No
9,9,81,3,6,9,9,9,18,8,0.308676,0.315986,0.000013,No
9,8,72,8,8,16,9,9,18,8,0.345615,0.359036,0.000013,No
10,10,100,7,10,17,10,10,20,8,0.358075,0.373919,0.000013,No
17,17,289,4,9,13,17,17,34,7,0.344408,0.356354,0.000013,No
33,33,1089,10,23,33,33,33,66,7,0.364477,0.380891,0.000013,No
79,79,6241,21,18,39,79,79,158,8,0.352069,0.367263,0.000013,No
36,36,1296,11,17,28,36,36,72,7,0.37432,0.392312,0.000013,No
14,14,196,11,11,22,14,14,28,8,0.377517,0.395698,0.000013,No
6,6,36,4,6,10,6,6,12,8,0.356989,0.371888,0.000013,No
10,10,100,7,5,12,10,10,20,7,0.336641,0.348868,0.000013,No
5,5,25,5,4,9,5,5,10,8,0.347282,0.360859,0.000013,No
7,6,42,6,5,11,7,7,14,7,0.332353,0.343996,0.000013,No
4,4,16,3,3,6,4,4,8,8,0.346541,0.359697,0.000013,No
2,2,4,1,1,2,2,2,4,8,0.339941,0.352199,0.000013,No
39,39,1521,19,18,37,39,39,78,7,0.383068,0.4021,0.000013,No
14,14,196,5,11,16,14,14,28,7,0.349924,0.365106,0.000013,No
1,1,1,1,1,2,1,1,2,9,0.272424,0.279226,0.000013,No
5,5,25,4,4,8,5,5,10,7,0.355368,0.370279,0.000013,No
8,7,56,4,6,10,8,8,16,8,0.372075,0.389719,0.000013,No
14,14,196,11,4,15,14,14,28,8,0.33032,0.341416,0.000013,No
7,7,49,5,6,11,7,7,14,8,0.350463,0.364441,0.000013,No
14,14,196,6,11,17,14,14,28,7,0.362364,0.378226,0.000013,No
7,7,49,4,4,8,7,7,14,8,0.337727,0.351111,0.000013,No
15,13,195,6,10,16,15,15,30,7,0.349616,0.363201,0.000013,No
8,8,64,6,6,12,8,8,16,7,0.333757,0.345242,0.000013,No
17,15,255,8,8,16,17,17,34,8,0.366237,0.383605,0.000013,No
11,11,121,7,8,15,11,11,22,8,0.351083,0.36544,0.000013,No
12,11,132,4,8,12,12,12,24,7,0.356981,0.372537,0.000013,No
4,4,16,2,3,5,4,4,8,8,0.320564,0.331589,0.000013,No
12,12,144,7,10,17,12,12,24,8,0.358173,0.374048,0.000013,No
9,9,81,6,7,13,9,9,18,7,0.360032,0.376086,0.000013,No
9,9,81,8,8,16,9,9,18,8,0.356073,0.372505,0.000013,No
6,6,36,4,6,10,6,6,12,8,0.35611,0.371079,0.000013,No
20,20,400,8,13,21,20,20,40,8,0.342438,0.355983,0.000013,No
25,25,625,15,16,31,25,25,50,7,0.342129,0.354018,0.000013,No
21,19,399,8,12,20,21,21,42,7,0.380888,0.399184,0.000013,No
7,7,49,7,7,14,7,7,14,8,0.351221,0.365453,0.000013,No
25,25,625,6,7,13,25,25,50,8,0.351293,0.366029,0.000013,No
14,12,168,9,10,19,14,14,28,8,0.356467,0.371525,0.000013,No
12,12,144,10,9,19,12,12,24,7,0.334333,0.345102,0.000013,No
4,4,16,4,4,8,4,4,8,7,0.355361,0.370195,0.000013,No
13,13,169,9,11,20,13,13,26,8,0.344068,0.357078,0.000013,No
11,11,121,8,8,16,11,11,22,7,0.356608,0.371978,0.000013,No
30,29,870,12,9,21,30,30,60,8,0.337814,0.349058,0.000013,No
5,5,25,5,4,9,5,5,10,8,0.320047,0.329905,0.000013,No
12,12,144,8,9,17,12,12,24,7,0.334437,0.346149,0.000013,No
5,5,25,5,3,8,5,5,10,7,0.348111,0.362093,0.000013,No
1,1,1,1,1,2,1,1,2,8,0.228586,0.232456,0.000013,No
7,7,49,4,5,9,7,7,14,7,0.355102,0.369967,0.000013,No
5,5,25,5,5,10,5,5,10,7,0.349673,0.363376,0.000013,No
6,6,36,6,6,12,6,6,12,7,0.334045,0.345485,0.000013,No
52,51,2652,11,27,38,52,52,104,7,0.384778,0.403544,0.000013,No
15,13,195,12,13,25,15,15,30,7,0.356877,0.371244,0.000013,No
38,37,1406,7,13,20,38,38,76,7,0.365696,0.382432,0.000013,No
30,30,900,9,5,14,30,30,60,7,0.347452,0.360542,0.000013,No
13,13,169,4,13,17,13,13,26,8,0.377667,0.395873,0.000013,No
55,51,2805,15,30,45,55,55,110,7,0.389682,0.409175,0.000013,No
5,4,20,2,4,6,5,5,10,8,0.320029,0.328058,0.000013,No
5,5,25,4,5,9,5,5,10,8,0.328135,0.338956,0.000013,No
13,13,169,6,9,15,13,13,26,8,0.355183,0.369884,0.000012,No
10,10,100,6,8,14,10,10,20,8,0.356206,0.370932,0.000012,No
12,12,144,4,10,14,12,12,24,7,0.366355,0.382792,0.000012,No
43,43,1849,18,20,38,43,43,86,8,0.372116,0.389657,0.000012,No
4,4,16,3,3,6,4,4,8,8,0.316503,0.324672,0.000012,No
9,9,81,7,6,13,9,9,18,8,0.347834,0.361556,0.000012,No
12,12,144,9,9,18,12,12,24,8,0.333731,0.344188,0.000012,No
14,14,196,6,10,16,14,14,28,8,0.339016,0.350285,0.000012,No
14,14,196,8,5,13,14,14,28,8,0.347678,0.360939,0.000012,No
17,16,272,6,9,15,17,17,34,8,0.338397,0.350775,0.000012,No
3,3,9,2,3,5,3,3,6,8,0.32902,0.34091,0.000012,No
5,4,20,3,5,8,5,5,10,8,0.327486,0.337969,0.000012,No
9,9,81,6,9,15,9,9,18,7,0.337895,0.349176,0.000012,No
14,14,196,9,9,18,14,14,28,7,0.34167,0.35494,0.000012,No
2,2,4,2,2,4,2,2,4,9,0.254862,0.26019,0.000012,No
5,5,25,4,4,8,5,5,10,8,0.311932,0.318597,0.000012,No
19,19,361,10,9,19,19,19,38,7,0.364446,0.380603,0.000012,No
44,44,1936,14,23,37,44,44,88,7,0.386574,0.405698,0.000012,No
10,10,100,9,10,19,10,10,20,8,0.35019,0.365266,0.000012,No
29,25,725,7,6,13,29,29,58,7,0.351474,0.365203,0.000012,No
14,14,196,7,8,15,14,14,28,8,0.349394,0.363376,0.000012,No
12,12,144,5,10,15,12,12,24,7,0.375622,0.393564,0.000012,No
16,16,256,11,5,16,16,16,32,7,0.356549,0.371768,0.000012,No
5,5,25,3,4,7,5,5,10,8,0.336449,0.348519,0.000012,No
27,26,702,17,14,31,27,27,54,7,0.368031,0.384889,0.000012,No
32,32,1024,18,10,28,32,32,64,8,0.359274,0.3752,0.000012,No
14,14,196,6,9,15,14,14,28,7,0.351517,0.365248,0.000012,No
15,15,225,8,13,21,15,15,30,7,0.37146,0.38943,0.000012,No
19,19,361,9,9,18,19,19,38,7,0.363251,0.379844,0.000012,No
10,9,90,9,10,19,10,10,20,8,0.356735,0.372501,0.000012,No
12,12,144,7,7,14,12,12,24,7,0.36815,0.385296,0.000012,No
13,12,156,9,11,20,13,13,26,8,0.365939,0.383495,0.000012,No
3,3,9,3,3,6,3,3,6,8,0.277691,0.286176,0.000012,No
13,13,169,5,6,11,13,13,26,7,0.352614,0.367173,0.000012,No
7,7,49,2,5,7,7,7,14,8,0.347063,0.361834,0.000012,No
5,4,20,4,5,9,5,5,10,8,0.334503,0.345556,0.000012,No
15,15,225,7,10,17,15,15,30,8,0.359964,0.376725,0.000012,No
23,21,483,12,12,24,23,23,46,8,0.348994,0.363048,0.000012,No
10,10,100,7,5,12,10,10,20,7,0.355724,0.370517,0.000012,No
9,6,54,5,6,11,9,9,18,8,0.351047,0.365149,0.000012,No
24,24,576,12,10,22,24,24,48,8,0.35352,0.368196,0.000012,No
18,18,324,4,10,14,18,18,36,7,0.366481,0.38307,0.000012,No
29,29,841,12,15,27,29,29,58,7,0.361596,0.378028,0.000012,No
11,11,121,7,8,15,11,11,22,7,0.34558,0.35947,0.000012,No
3,3,9,3,3,6,3,3,6,8,0.271661,0.278645,0.000012,No
19,19,361,10,13,23,19,19,38,7,0.369321,0.386232,0.000012,No
7,7,49,7,7,14,7,7,14,8,0.348004,0.361504,0.000012,No
6,6,36,3,4,7,6,6,12,8,0.340124,0.352473,0.000012,No
9,9,81,6,7,13,9,9,18,7,0.364353,0.381204,0.000012,No
12,12,144,3,7,10,12,12,24,7,0.358075,0.373663,0.000012,No
12,12,144,10,9,19,12,12,24,8,0.37201,0.389195,0.000012,No
7,7,49,6,6,12,7,7,14,8,0.343278,0.357348,0.000012,No
62,61,3782,38,6,44,62,62,124,7,0.336881,0.348015,0.000012,No
35,34,1190,14,21,35,35,35,70,8,0.344429,0.358116,0.000012,No
33,29,957,20,18,38,33,33,66,7,0.382965,0.40162,0.000012,No
8,8,64,4,6,10,8,8,16,7,0.3591,0.374614,0.000012,No
7,6,42,3,7,10,7,7,14,7,0.34461,0.358253,0.000012,No
2,2,4,1,2,3,2,2,4,9,0.269813,0.276393,0.000012,No
37,37,1369,22,7,29,37,37,74,7,0.345321,0.357638,0.000012,No
5,4,20,4,5,9,5,5,10,8,0.337267,0.349927,0.000012,No
4,4,16,4,4,8,4,4,8,7,0.354925,0.369904,0.000012,No
8,8,64,6,6,12,8,8,16,7,0.363987,0.380194,0.000012,No
2,1,2,2,2,4,2,2,4,8,0.345692,0.358823,0.000012,No
11,11,121,6,8,14,11,11,22,7,0.358534,0.374291,0.000012,No
17,16,272,10,12,22,17,17,34,8,0.362811,0.379556,0.000012,No
8,8,64,6,7,13,8,8,16,8,0.355753,0.371026,0.000012,No
18,17,306,7,13,20,18,18,36,8,0.355909,0.371331,0.000012,No
37,35,1295,24,17,41,37,37,74,7,0.359213,0.374547,0.000012,No
13,13,169,6,9,15,13,13,26,7,0.374057,0.392115,0.000012,No
15,15,225,9,9,18,15,15,30,7,0.356154,0.370913,0.000012,No
29,29,841,16,10,26,29,29,58,8,0.357146,0.372921,0.000012,No
18,18,324,4,16,20,18,18,36,8,0.369497,0.387571,0.000011,No
11,10,110,6,8,14,11,11,22,8,0.351648,0.366173,0.000011,No
9,9,81,6,5,11,9,9,18,7,0.344951,0.357151,0.000011,No
5,5,25,4,4,8,5,5,10,7,0.355679,0.370807,0.000011,No
17,17,289,7,9,16,17,17,34,7,0.331965,0.34304,0.000011,No
5,5,25,3,5,8,5,5,10,8,0.337975,0.35152,0.000011,No
28,28,784,12,9,21,28,28,56,7,0.379591,0.39784,0.000011,No
16,16,256,13,5,18,16,16,32,8,0.315427,0.32238,0.000011,No
15,15,225,8,9,17,15,15,30,8,0.35806,0.373546,0.000011,No
11,11,121,7,9,16,11,11,22,7,0.366355,0.38324,0.000011,No
1,1,1,1,1,2,1,1,2,8,0.301594,0.314494,0.000011,No
8,7,56,6,7,13,8,8,16,7,0.348033,0.361339,0.000011,No
15,15,225,11,8,19,15,15,30,8,0.352775,0.367694,0.000011,No
5,5,25,3,4,7,5,5,10,7,0.36103,0.376586,0.000011,No
25,25,625,15,11,26,25,25,50,7,0.369081,0.38584,0.000011,No
6,6,36,6,5,11,6,6,12,8,0.336688,0.349629,0.000011,No
7,7,49,5,4,9,7,7,14,8,0.347388,0.360482,0.000011,No
17,17,289,10,12,22,17,17,34,8,0.361267,0.377933,0.000011,No
8,6,48,6,6,12,8,8,16,8,0.347331,0.361725,0.000011,No
20,20,400,11,13,24,20,20,40,8,0.353615,0.368037,0.000011,No
16,16,256,4,8,12,16,16,32,8,0.356967,0.373576,0.000011,No
3,2,6,2,3,5,3,3,6,8,0.302064,0.311031,0.000011,No
3,3,9,2,3,5,3,3,6,8,0.342369,0.355821,0.000011,No
16,16,256,11,8,19,16,16,32,8,0.350499,0.364906,0.000011,No
10,10,100,8,6,14,10,10,20,7,0.344777,0.3582,0.000011,No
5,5,25,5,5,10,5,5,10,7,0.361888,0.377654,0.000011,No
21,19,399,14,17,31,21,21,42,7,0.381441,0.399565,0.000011,No
20,20,400,8,13,21,20,20,40,7,0.357064,0.371902,0.000011,No
13,13,169,11,10,21,13,13,26,7,0.359933,0.374966,0.000011,No
3,3,9,2,2,4,3,3,6,8,0.324935,0.333327,0.000011,No
11,11,121,5,5,10,11,11,22,8,0.345419,0.358959,0.000011,No
39,37,1443,16,11,27,39,39,78,7,0.361359,0.377307,0.000011,No
33,32,1056,9,24,33,33,33,66,7,0.36807,0.385057,0.000011,No
3,3,9,3,3,6,3,3,6,8,0.276051,0.283049,0.000011,No
5,5,25,4,5,9,5,5,10,7,0.339528,0.352065,0.000011,No
3,3,9,3,3,6,3,3,6,8,0.317186,0.329154,0.000011,No
9,9,81,4,7,11,9,9,18,8,0.344088,0.357258,0.000011,No
10,10,100,9,7,16,10,10,20,8,0.321816,0.331477,0.000011,No
14,14,196,9,9,18,14,14,28,8,0.342672,0.355067,0.000011,No
8,8,64,5,7,12,8,8,16,8,0.352323,0.367736,0.000011,No
12,12,144,10,10,20,12,12,24,7,0.354261,0.369325,0.000011,No
3,3,9,3,3,6,3,3,6,7,0.328337,0.339119,0.000011,No
7,7,49,1,4,5,7,7,14,8,0.324688,0.336951,0.000011,No
12,12,144,9,8,17,12,12,24,7,0.343389,0.356136,0.000011,No
4,4,16,3,3,6,4,4,8,8,0.356608,0.372877,0.000011,No
5,5,25,5,5,10,5,5,10,7,0.354092,0.3688,0.000011,No
20,20,400,7,12,19,20,20,40,8,0.377308,0.395714,0.000011,No
29,29,841,18,17,35,29,29,58,7,0.362049,0.377603,0.000011,No
14,14,196,7,12,19,14,14,28,8,0.354829,0.369138,0.000011,No
17,14,238,4,10,14,17,17,34,8,0.360527,0.377263,0.000011,No
8,8,64,7,8,15,8,8,16,8,0.332586,0.343194,0.000011,No
3,3,9,2,2,4,3,3,6,8,0.317068,0.323909,0.000011,No
5,4,20,4,5,9,5,5,10,8,0.322107,0.332872,0.000011,No
17,16,272,10,11,21,17,17,34,8,0.32449,0.33313,0.000011,No
13,13,169,8,9,17,13,13,26,8,0.362672,0.378952,0.000011,No
6,6,36,5,6,11,6,6,12,7,0.336177,0.34759,0.000011,No
14,14,196,9,10,19,14,14,28,7,0.363182,0.379372,0.000011,No
11,11,121,5,8,13,11,11,22,8,0.351141,0.365804,0.000011,No
14,14,196,8,5,13,14,14,28,7,0.340572,0.352408,0.000011,No
2,2,4,2,2,4,2,2,4,8,0.300802,0.307538,0.000011,No
26,25,650,9,12,21,26,26,52,8,0.367025,0.383863,0.000011,No
8,7,56,6,8,14,8,8,16,7,0.364135,0.380838,0.000011,No
2,2,4,1,1,2,2,2,4,9,0.246376,0.250666,0.000011,No
29,29,841,25,10,35,29,29,58,7,0.349215,0.363328,0.000011,No
4,4,16,1,2,3,4,4,8,9,0.271656,0.280261,0.000011,No
2,2,4,1,1,2,2,2,4,9,0.246376,0.250666,0.000011,No
14,14,196,12,10,22,14,14,28,8,0.349265,0.363794,0.000011,No
23,23,529,18,1,19,23,23,46,7,0.327819,0.338512,0.000011,No
1,1,1,1,1,2,1,1,2,7,0.327832,0.33852,0.000011,No
6,6,36,5,6,11,6,6,12,8,0.337721,0.350631,0.000011,No
6,6,36,5,4,9,6,6,12,8,0.354998,0.370345,0.000011,No
6,6,36,5,4,9,6,6,12,8,0.350658,0.364939,0.000011,No
3,3,9,2,2,4,3,3,6,8,0.266593,0.27262,0.000011,No
3,2,6,3,3,6,3,3,6,8,0.346309,0.359572,0.000011,No
41,41,1681,17,14,31,41,41,82,8,0.360915,0.376676,0.000011,No
10,10,100,8,6,14,10,10,20,8,0.342047,0.354392,0.000011,No
15,15,225,10,11,21,15,15,30,7,0.35474,0.369106,0.000011,No
23,17,391,11,12,23,23,23,46,7,0.380913,0.399765,0.000011,No
17,17,289,9,12,21,17,17,34,8,0.332963,0.344556,0.00001,yes
19,18,342,7,8,15,19,19,38,8,0.304925,0.311695,0.00001,No
1,1,1,1,1,2,1,1,2,8,0.323426,0.334429,0.00001,No
13,13,169,3,8,11,13,13,26,8,0.334536,0.34528,0.00001,No
3,3,9,2,2,4,3,3,6,7,0.328583,0.33918,0.00001,No
16,16,256,11,15,26,16,16,32,7,0.362433,0.378538,0.00001,No
9,9,81,3,7,10,9,9,18,8,0.339414,0.352464,0.00001,No
7,7,49,6,5,11,7,7,14,8,0.345573,0.35831,0.00001,No
20,20,400,13,7,20,20,20,40,7,0.353037,0.367464,0.00001,No
36,35,1260,16,10,26,36,36,72,8,0.355331,0.370226,0.00001,No
8,8,64,5,6,11,8,8,16,8,0.33134,0.343572,0.00001,No
21,21,441,5,6,11,21,21,42,7,0.354607,0.37018,0.00001,No
10,10,100,6,5,11,10,10,20,8,0.322528,0.332945,0.00001,No
15,14,210,3,8,11,15,15,30,7,0.363336,0.379877,0.00001,No
11,11,121,7,6,13,11,11,22,8,0.354681,0.369472,0.00001,No
31,30,930,14,19,33,31,31,62,7,0.369305,0.386435,0.00001,No
6,6,36,5,4,9,6,6,12,8,0.332372,0.345548,0.00001,No
11,11,121,4,8,12,11,11,22,8,0.358346,0.373222,0.00001,No
17,16,272,9,10,19,17,17,34,7,0.360572,0.375566,0.00001,No
11,11,121,4,9,13,11,11,22,8,0.362303,0.378496,0.00001,No
9,8,72,7,7,14,9,9,18,7,0.353967,0.368756,0.00001,No
16,15,240,9,12,21,16,16,32,8,0.339177,0.351777,0.00001,No
14,13,182,4,13,17,14,14,28,8,0.365516,0.382867,0.00001,No
7,7,49,4,4,8,7,7,14,8,0.297643,0.304542,0.00001,No
18,18,324,9,14,23,18,18,36,7,0.371492,0.389416,0.00001,No
4,4,16,3,3,6,4,4,8,7,0.339245,0.352466,0.00001,No
26,26,676,16,17,33,26,26,52,8,0.349029,0.363927,0.00001,No
7,7,49,6,5,11,7,7,14,7,0.356095,0.371311,0.00001,No
30,30,900,23,15,38,30,30,60,8,0.345601,0.358473,0.00001,No
3,3,9,3,3,6,3,3,6,7,0.32679,0.338337,0.00001,No
5,5,25,2,3,5,5,5,10,8,0.342129,0.354692,0.00001,No
21,21,441,15,11,26,21,21,42,7,0.359766,0.375581,0.00001,No
34,33,1122,15,16,31,34,34,68,7,0.388148,0.406811,0.00001,No
10,9,90,7,8,15,10,10,20,7,0.341062,0.353093,0.00001,No
15,15,225,2,10,12,15,15,30,7,0.353169,0.368423,0.00001,No
18,18,324,14,6,20,18,18,36,8,0.310011,0.316691,0.00001,No
11,11,121,4,6,10,11,11,22,7,0.344338,0.358092,0.00001,No
17,17,289,7,11,18,17,17,34,8,0.36241,0.378431,0.00001,No
5,5,25,5,5,10,5,5,10,8,0.319586,0.327662,0.00001,No
5,5,25,4,4,8,5,5,10,7,0.35014,0.364205,0.00001,No
3,3,9,2,3,5,3,3,6,8,0.31754,0.324666,0.00001,No
4,4,16,3,3,6,4,4,8,8,0.352025,0.366335,0.00001,No
1,1,1,1,1,2,1,1,2,7,0.327826,0.338517,0.00001,No
18,18,324,8,9,17,18,18,36,8,0.347133,0.360616,0.00001,No
2,1,2,1,2,3,2,2,4,8,0.281354,0.29093,0.00001,No
15,14,210,7,9,16,15,15,30,7,0.368126,0.385477,0.00001,No
2,2,4,2,2,4,2,2,4,8,0.295709,0.303378,0.00001,No
9,9,81,8,7,15,9,9,18,7,0.366395,0.38324,0.00001,No
14,14,196,9,10,19,14,14,28,8,0.360192,0.376099,0.00001,No
18,18,324,11,12,23,18,18,36,7,0.35806,0.373282,0.00001,No
1,1,1,1,1,2,1,1,2,8,0.323426,0.334429,0.00001,No
7,7,49,6,6,12,7,7,14,8,0.354622,0.369508,0.00001,No
33,32,1056,21,11,32,33,33,66,8,0.345461,0.358669,0.00001,No
11,11,121,7,9,16,11,11,22,8,0.357408,0.37288,0.00001,No
9,9,81,7,5,12,9,9,18,7,0.359441,0.375362,0.00001,No
4,4,16,3,4,7,4,4,8,7,0.342507,0.355264,0.00001,No
9,9,81,7,5,12,9,9,18,8,0.341219,0.355679,0.00001,No
9,8,72,7,9,16,9,9,18,8,0.347997,0.361174,0.00001,No
2,2,4,2,2,4,2,2,4,8,0.313641,0.323585,0.00001,No
20,20,400,8,13,21,20,20,40,7,0.366552,0.383411,0.00001,No
15,15,225,6,11,17,15,15,30,7,0.355583,0.370744,0.00001,No
20,20,400,16,13,29,20,20,40,7,0.369489,0.38753,0.00001,No
15,15,225,10,12,22,15,15,30,8,0.324102,0.333065,0.00001,No
14,14,196,11,8,19,14,14,28,8,0.356303,0.370818,0.00001,No
8,7,56,5,8,13,8,8,16,8,0.354364,0.369334,0.00001,No
12,12,144,4,11,15,12,12,24,8,0.358813,0.375059,0.00001,No
6,6,36,5,6,11,6,6,12,7,0.339616,0.350746,0.00001,No
6,6,36,4,4,8,6,6,12,7,0.355739,0.370281,0.00001,No
18,18,324,8,10,18,18,18,36,7,0.338901,0.352271,0.00001,No
5,5,25,4,4,8,5,5,10,7,0.33409,0.344426,0.00001,No
26,26,676,12,17,29,26,26,52,8,0.367642,0.384506,0.00001,No
18,18,324,13,10,23,18,18,36,7,0.36248,0.379272,0.00001,No
13,12,156,7,9,16,13,13,26,8,0.336754,0.347771,0.00001,No
8,7,56,5,7,12,8,8,16,8,0.35764,0.373488,0.00001,No
2,2,4,2,2,4,2,2,4,7,0.335714,0.347567,0.00001,No
7,6,42,5,6,11,7,7,14,7,0.363414,0.379703,0.00001,No
10,10,100,7,8,15,10,10,20,8,0.364812,0.381679,0.00001,No
9,8,72,3,8,11,9,9,18,7,0.332288,0.344444,0.00001,No
2,2,4,1,2,3,2,2,4,8,0.293118,0.300547,0.00001,No
17,16,272,5,5,10,17,17,34,8,0.346894,0.360146,0.00001,No
6,6,36,5,6,11,6,6,12,7,0.362603,0.378555,0.00001,No
7,7,49,7,7,14,7,7,14,7,0.336761,0.348025,0.00001,No
7,7,49,4,7,11,7,7,14,8,0.344526,0.357794,0.00001,No
16,16,256,10,7,17,16,16,32,8,0.342019,0.35572,0.00001,No
7,6,42,6,6,12,7,7,14,8,0.360893,0.377451,0.00001,No
21,21,441,13,13,26,21,21,42,8,0.364065,0.380504,0.00001,No
13,13,169,8,9,17,13,13,26,7,0.355242,0.370381,0.00001,No
5,5,25,4,5,9,5,5,10,7,0.33547,0.346593,0.00001,No
30,30,900,11,21,32,30,30,60,7,0.373951,0.39195,0.000009,yes
11,10,110,5,5,10,11,11,22,7,0.361895,0.378143,0.000009,No
8,8,64,4,6,10,8,8,16,8,0.352753,0.367017,0.000009,No
7,7,49,4,7,11,7,7,14,8,0.336257,0.347819,0.000009,No
12,12,144,4,7,11,12,12,24,8,0.351648,0.367128,0.000009,No
7,7,49,7,4,11,7,7,14,8,0.355191,0.370917,0.000009,No
1,1,1,1,1,2,1,1,2,8,0.241354,0.244478,0.000009,No
4,4,16,4,2,6,4,4,8,8,0.344408,0.357419,0.000009,No
8,8,64,2,2,4,8,8,16,9,0.265135,0.271682,0.000009,No
1,1,1,1,1,2,1,1,2,8,0.28042,0.287817,0.000009,No
15,15,225,12,12,24,15,15,30,8,0.341834,0.353482,0.000009,No
8,8,64,5,6,11,8,8,16,8,0.327341,0.3373,0.000009,No
6,6,36,6,4,10,6,6,12,7,0.343742,0.357201,0.000009,No
8,6,48,6,6,12,8,8,16,7,0.365367,0.382422,0.000009,No
25,23,575,13,17,30,25,25,50,8,0.372059,0.389504,0.000009,No
10,9,90,7,5,12,10,10,20,8,0.321422,0.329486,0.000009,No
9,9,81,6,7,13,9,9,18,8,0.340844,0.353775,0.000009,No
4,4,16,4,4,8,4,4,8,8,0.357251,0.372551,0.000009,No
16,12,192,5,9,14,16,16,32,7,0.366403,0.383244,0.000009,No
8,8,64,3,5,8,8,8,16,8,0.298174,0.306776,0.000009,No
26,26,676,4,17,21,26,26,52,7,0.374715,0.392547,0.000009,No
12,12,144,5,9,14,12,12,24,7,0.340681,0.353107,0.000009,No
10,10,100,4,8,12,10,10,20,8,0.333751,0.344589,0.000009,No
7,7,49,6,5,11,7,7,14,7,0.341958,0.355276,0.000009,No
22,22,484,10,15,25,22,22,44,7,0.378077,0.396227,0.000009,No
32,31,992,16,11,27,32,32,64,8,0.37108,0.387933,0.000009,No
19,19,361,1,18,19,19,19,38,8,0.356087,0.371688,0.000009,No
7,7,49,6,3,9,7,7,14,8,0.352025,0.36633,0.000009,No
9,9,81,5,7,12,9,9,18,7,0.35029,0.36382,0.000009,No
9,8,72,4,8,12,9,9,18,8,0.365312,0.381831,0.000009,No
14,13,182,10,7,17,14,14,28,8,0.347211,0.360694,0.000009,No
8,8,64,3,7,10,8,8,16,8,0.339826,0.351121,0.000009,No
6,6,36,4,4,8,6,6,12,8,0.340817,0.353128,0.000009,No
9,9,81,7,9,16,9,9,18,7,0.349824,0.362809,0.000009,No
3,3,9,2,3,5,3,3,6,8,0.281145,0.290788,0.000009,No
2,2,4,2,2,4,2,2,4,8,0.315987,0.326293,0.000009,No
8,8,64,6,8,14,8,8,16,8,0.359736,0.375185,0.000009,No
7,7,49,5,7,12,7,7,14,8,0.304642,0.311486,0.000009,No
12,12,144,4,10,14,12,12,24,8,0.350658,0.364448,0.000009,No
5,5,25,4,3,7,5,5,10,8,0.340192,0.352507,0.000009,No
14,13,182,11,9,20,14,14,28,8,0.355294,0.369876,0.000009,No
13,13,169,6,7,13,13,13,26,7,0.330531,0.341635,0.000009,No
16,16,256,8,10,18,16,16,32,7,0.351004,0.365205,0.000009,No
28,27,756,12,11,23,28,28,56,8,0.371694,0.388607,0.000009,No
2,2,4,2,2,4,2,2,4,8,0.29648,0.308028,0.000009,No
4,4,16,4,4,8,4,4,8,8,0.33234,0.344539,0.000009,No
3,3,9,3,2,5,3,3,6,8,0.32504,0.33643,0.000009,No
27,26,702,9,19,28,27,27,54,7,0.374238,0.391938,0.000009,No
8,8,64,5,4,9,8,8,16,8,0.371856,0.389426,0.000009,No
9,9,81,7,9,16,9,9,18,8,0.343707,0.357616,0.000009,No
24,23,552,13,11,24,24,24,48,7,0.366065,0.38272,0.000009,No
4,2,8,3,4,7,4,4,8,8,0.350247,0.364602,0.000009,No
19,19,361,6,9,15,19,19,38,7,0.340077,0.352389,0.000009,No
8,8,64,6,7,13,8,8,16,8,0.359501,0.375239,0.000009,No
11,11,121,5,4,9,11,11,22,7,0.337881,0.349546,0.000009,No
15,15,225,10,11,21,15,15,30,7,0.352994,0.367346,0.000009,No
5,5,25,5,5,10,5,5,10,8,0.3062,0.313736,0.000009,No
3,3,9,3,3,6,3,3,6,8,0.363166,0.379887,0.000009,No
54,54,2916,13,5,18,54,54,108,7,0.344853,0.358371,0.000009,No
10,10,100,4,7,11,10,10,20,7,0.364081,0.380301,0.000009,No
8,8,64,6,4,10,8,8,16,8,0.356273,0.371418,0.000009,No
14,14,196,4,10,14,14,14,28,7,0.364516,0.380797,0.000009,No
12,12,144,9,10,19,12,12,24,8,0.356817,0.372801,0.000009,No
7,7,49,5,7,12,7,7,14,8,0.364283,0.381404,0.000009,No
4,4,16,4,4,8,4,4,8,8,0.340885,0.353267,0.000009,No
10,9,90,8,7,15,10,10,20,7,0.345531,0.359385,0.000009,No
13,13,169,9,6,15,13,13,26,7,0.338008,0.348927,0.000009,No
8,8,64,6,7,13,8,8,16,8,0.339312,0.350906,0.000009,No
8,7,56,5,7,12,8,8,16,8,0.33105,0.341467,0.000009,No
7,6,42,5,7,12,7,7,14,7,0.341615,0.355124,0.000009,No
10,6,60,6,5,11,10,10,20,8,0.322857,0.332526,0.000009,No
2,2,4,2,2,4,2,2,4,8,0.319257,0.327865,0.000009,No
24,24,576,23,14,37,24,24,48,7,0.379676,0.398023,0.000009,No
9,9,81,5,7,12,9,9,18,7,0.340871,0.351909,0.000009,No
4,4,16,3,3,6,4,4,8,8,0.299246,0.309575,0.000009,No
3,3,9,3,3,6,3,3,6,8,0.321174,0.332592,0.000009,No
10,10,100,9,5,14,10,10,20,8,0.350276,0.364842,0.000009,No
14,14,196,8,10,18,14,14,28,8,0.3591,0.374993,0.000009,No
9,8,72,5,6,11,9,9,18,7,0.360664,0.376522,0.000009,No
12,11,132,7,9,16,12,12,24,8,0.346929,0.360389,0.000009,No
13,13,169,9,9,18,13,13,26,8,0.371258,0.388905,0.000009,No
22,22,484,13,12,25,22,22,44,8,0.35764,0.373877,0.000009,No
7,7,49,6,6,12,7,7,14,8,0.344582,0.358178,0.000009,No
1,1,1,1,1,2,1,1,2,9,0.223499,0.226859,0.000009,No
7,7,49,3,6,9,7,7,14,7,0.345923,0.359047,0.000009,No
10,10,100,8,7,15,10,10,20,8,0.325854,0.335631,0.000009,No
17,17,289,12,11,23,17,17,34,8,0.347501,0.361654,0.000009,No
11,10,110,7,9,16,11,11,22,7,0.346274,0.359433,0.000009,No
9,9,81,2,9,11,9,9,18,8,0.372067,0.389684,0.000009,No
7,6,42,6,3,9,7,7,14,8,0.309825,0.323514,0.000009,No
2,2,4,2,2,4,2,2,4,8,0.321464,0.329859,0.000009,No
7,7,49,5,3,8,7,7,14,7,0.35276,0.367112,0.000009,No
10,9,90,9,8,17,10,10,20,8,0.33734,0.349061,0.000009,No
7,7,49,5,5,10,7,7,14,8,0.339245,0.352037,0.000009,No
9,9,81,6,5,11,9,9,18,7,0.351467,0.366251,0.000009,No
3,3,9,3,3,6,3,3,6,7,0.322241,0.330009,0.000009,No
4,4,16,4,3,7,4,4,8,8,0.321138,0.329495,0.000009,No
10,9,90,4,7,11,10,10,20,7,0.332885,0.342853,0.000009,No
4,4,16,4,4,8,4,4,8,8,0.335595,0.347527,0.000009,No
5,2,10,4,5,9,5,5,10,8,0.350672,0.365025,0.000009,No
6,6,36,3,4,7,6,6,12,8,0.344791,0.358509,0.000009,No
38,36,1368,8,14,22,38,38,76,7,0.378681,0.397314,0.000009,No
5,5,25,3,5,8,5,5,10,8,0.357715,0.374119,0.000009,No
20,20,400,3,13,16,20,20,40,7,0.378396,0.396922,0.000009,No
15,13,195,10,13,23,15,15,30,8,0.352738,0.368055,0.000009,No
1,1,1,1,1,2,1,1,2,9,0.235313,0.238835,0.000009,No
6,6,36,5,6,11,6,6,12,8,0.32937,0.340627,0.000009,No
1,1,1,1,1,2,1,1,2,10,0.197459,0.19972,0.000009,No
10,10,100,10,9,19,10,10,20,7,0.335305,0.345928,0.000009,No
8,8,64,4,7,11,8,8,16,8,0.328116,0.338321,0.000009,No
7,7,49,3,6,9,7,7,14,7,0.363259,0.379665,0.000009,No
16,16,256,7,9,16,16,16,32,7,0.351756,0.365814,0.000009,No
6,6,36,3,5,8,6,6,12,8,0.333054,0.346269,0.000009,No
1,1,1,1,1,2,1,1,2,8,0.287731,0.294949,0.000009,No
15,15,225,7,9,16,15,15,30,8,0.357423,0.3729,0.000009,No
7,7,49,3,5,8,7,7,14,8,0.322692,0.331671,0.000008,No
3,3,9,2,3,5,3,3,6,8,0.340402,0.352747,0.000008,No
15,15,225,3,10,13,15,15,30,8,0.367033,0.38442,0.000008,No
5,5,25,5,5,10,5,5,10,8,0.353308,0.368852,0.000008,No
11,9,99,3,9,12,11,11,22,8,0.351684,0.366082,0.000008,No
6,6,36,4,4,8,6,6,12,8,0.306442,0.31557,0.000008,No
3,2,6,2,3,5,3,3,6,8,0.310457,0.317808,0.000008,No
15,15,225,9,10,19,15,15,30,7,0.36248,0.378828,0.000008,No
10,10,100,4,5,9,10,10,20,8,0.357978,0.37427,0.000008,No
5,5,25,1,3,4,5,5,10,8,0.31552,0.325969,0.000008,No
1,1,1,1,1,2,1,1,2,9,0.241545,0.244678,0.000008,No
4,4,16,2,4,6,4,4,8,8,0.350528,0.365022,0.000008,No
5,5,25,2,5,7,5,5,10,8,0.341397,0.354124,0.000008,No
19,18,342,7,10,17,19,19,38,7,0.352257,0.366549,0.000008,No
1,1,1,1,1,2,1,1,2,9,0.223496,0.226857,0.000008,No
17,17,289,8,12,20,17,17,34,7,0.367492,0.384431,0.000008,No
14,14,196,10,9,19,14,14,28,8,0.306861,0.313704,0.000008,No
27,27,729,6,14,20,27,27,54,8,0.381808,0.400162,0.000008,No
5,5,25,3,4,7,5,5,10,8,0.354092,0.370382,0.000008,No
15,15,225,11,10,21,15,15,30,8,0.377625,0.39613,0.000008,No
13,13,169,9,9,18,13,13,26,7,0.371775,0.388859,0.000008,No
13,12,156,10,8,18,13,13,26,7,0.359198,0.37579,0.000008,No
1,1,1,1,1,2,1,1,2,8,0.339941,0.352199,0.000008,No
8,8,64,5,6,11,8,8,16,7,0.376218,0.393974,0.000008,No
3,3,9,3,3,6,3,3,6,8,0.337567,0.352523,0.000008,No
9,9,81,5,9,14,9,9,18,8,0.348858,0.363162,0.000008,No
9,9,81,8,9,17,9,9,18,7,0.342493,0.355656,0.000008,No
9,9,81,9,8,17,9,9,18,7,0.352163,0.366761,0.000008,No
28,27,756,8,5,13,28,28,56,8,0.322071,0.331881,0.000008,No
12,12,144,3,10,13,12,12,24,8,0.371298,0.389112,0.000008,No
14,14,196,10,7,17,14,14,28,8,0.337948,0.349465,0.000008,No
4,4,16,4,4,8,4,4,8,8,0.332178,0.343699,0.000008,No
2,1,2,1,2,3,2,2,4,9,0.25622,0.261385,0.000008,No
10,9,90,6,7,13,10,10,20,7,0.344686,0.35692,0.000008,No
10,10,100,4,7,11,10,10,20,8,0.348552,0.365283,0.000008,No
6,5,30,5,5,10,6,6,12,7,0.350722,0.365449,0.000008,No
14,14,196,11,9,20,14,14,28,8,0.353096,0.369337,0.000008,No
10,10,100,9,8,17,10,10,20,8,0.350039,0.364919,0.000008,No
1,1,1,1,1,2,1,1,2,8,0.339941,0.352199,0.000008,No
20,20,400,13,9,22,20,20,40,8,0.368007,0.3845,0.000008,No
16,16,256,11,8,19,16,16,32,7,0.344986,0.358945,0.000008,No
16,15,240,8,13,21,16,16,32,8,0.374008,0.392139,0.000008,No
17,16,272,10,11,21,17,17,34,7,0.350039,0.364386,0.000008,No
8,6,48,5,5,10,8,8,16,8,0.340844,0.353443,0.000008,No
15,15,225,5,13,18,15,15,30,8,0.370427,0.387871,0.000008,No
5,5,25,4,4,8,5,5,10,8,0.333555,0.345501,0.000008,No
24,24,576,7,7,14,24,24,48,7,0.369745,0.386927,0.000008,No
26,26,676,17,9,26,26,26,52,7,0.357565,0.372916,0.000008,No
20,20,400,6,14,20,20,20,40,7,0.378984,0.397061,0.000008,No
29,28,812,12,8,20,29,29,58,8,0.366403,0.38328,0.000008,No
3,3,9,3,3,6,3,3,6,8,0.353257,0.367803,0.000008,No
4,4,16,2,4,6,4,4,8,8,0.345531,0.359302,0.000008,No
6,6,36,5,6,11,6,6,12,8,0.33364,0.344468,0.000008,No
10,9,90,9,7,16,10,10,20,8,0.365265,0.38226,0.000008,No
34,33,1122,12,17,29,34,34,68,8,0.351488,0.366197,0.000008,No
3,3,9,3,3,6,3,3,6,8,0.354902,0.370633,0.000008,No
15,15,225,13,7,20,15,15,30,8,0.35579,0.371328,0.000008,No
16,16,256,10,10,20,16,16,32,7,0.352738,0.367615,0.000008,No
20,20,400,10,11,21,20,20,40,8,0.34111,0.353195,0.000008,No
3,3,9,2,2,4,3,3,6,8,0.339948,0.352234,0.000008,No
12,12,144,9,11,20,12,12,24,8,0.37549,0.392943,0.000008,No
10,9,90,4,5,9,10,10,20,7,0.344728,0.357983,0.000008,No
17,17,289,11,14,25,17,17,34,8,0.334398,0.346679,0.000008,No
13,13,169,11,11,22,13,13,26,7,0.336522,0.347417,0.000008,No
6,6,36,3,6,9,6,6,12,8,0.3235,0.33132,0.000008,No
10,10,100,6,6,12,10,10,20,8,0.354357,0.369225,0.000008,No
9,9,81,9,9,18,9,9,18,7,0.356713,0.371768,0.000008,No
29,29,841,14,17,31,29,29,58,8,0.371096,0.388546,0.000008,No
11,10,110,8,9,17,11,11,22,8,0.355302,0.370106,0.000008,No
1,1,1,1,1,2,1,1,2,8,0.331578,0.343078,0.000008,No
3,3,9,3,3,6,3,3,6,7,0.328116,0.338849,0.000008,No
8,8,64,7,7,14,8,8,16,8,0.330211,0.340792,0.000008,No
5,5,25,4,3,7,5,5,10,8,0.309533,0.321547,0.000008,No
26,26,676,9,12,21,26,26,52,8,0.375672,0.393691,0.000008,No
2,2,4,2,2,4,2,2,4,8,0.343203,0.35581,0.000008,No
2,2,4,1,1,2,2,2,4,8,0.26631,0.272349,0.000008,No
6,6,36,3,5,8,6,6,12,8,0.320932,0.333386,0.000008,No
13,13,169,7,9,16,13,13,26,7,0.359698,0.375323,0.000008,No
6,6,36,4,5,9,6,6,12,7,0.333359,0.345037,0.000008,No
5,5,25,4,5,9,5,5,10,7,0.304702,0.314164,0.000008,No
6,5,30,5,6,11,6,6,12,7,0.336422,0.347323,0.000008,No
29,28,812,15,16,31,29,29,58,7,0.371541,0.388757,0.000008,No
16,15,240,4,16,20,16,16,32,7,0.374682,0.392491,0.000008,No
13,13,169,9,9,18,13,13,26,8,0.355316,0.370258,0.000008,No
12,12,144,8,8,16,12,12,24,8,0.34565,0.358992,0.000008,No
19,19,361,8,12,20,19,19,38,7,0.348473,0.361694,0.000008,No
9,8,72,4,8,12,9,9,18,8,0.351909,0.366547,0.000008,No
1,1,1,1,1,2,1,1,2,9,0.253729,0.258605,0.000008,No
8,7,56,3,6,9,8,8,16,8,0.317274,0.32462,0.000008,No
5,5,25,3,5,8,5,5,10,7,0.343645,0.356115,0.000008,No
12,12,144,8,10,18,12,12,24,8,0.350499,0.36552,0.000008,No
1,1,1,1,1,2,1,1,2,9,0.260373,0.26589,0.000008,No
11,11,121,8,8,16,11,11,22,8,0.353125,0.368693,0.000008,No
7,7,49,6,5,11,7,7,14,8,0.350326,0.363987,0.000008,No
1,1,1,1,1,2,1,1,2,9,0.259237,0.264913,0.000008,No
4,4,16,2,3,5,4,4,8,8,0.336708,0.349903,0.000008,No
3,2,6,2,3,5,3,3,6,8,0.343258,0.356476,0.000008,No
3,3,9,3,3,6,3,3,6,8,0.302659,0.315504,0.000008,No
23,19,437,16,7,23,23,23,46,7,0.353733,0.368299,0.000008,No
9,9,81,5,7,12,9,9,18,8,0.343251,0.357936,0.000008,No
6,6,36,2,4,6,6,6,12,8,0.323549,0.332358,0.000008,No
6,6,36,5,6,11,6,6,12,8,0.31767,0.328609,0.000008,No
3,3,9,3,3,6,3,3,6,8,0.311875,0.323958,0.000008,No
42,41,1722,13,8,21,42,42,84,7,0.341001,0.352409,0.000008,No
4,4,16,3,4,7,4,4,8,8,0.327178,0.338591,0.000008,No
8,8,64,5,5,10,8,8,16,7,0.342328,0.35388,0.000008,No
8,8,64,8,4,12,8,8,16,8,0.323457,0.334542,0.000008,No
9,9,81,9,3,12,9,9,18,8,0.3418,0.355377,0.000008,No
8,8,64,4,5,9,8,8,16,7,0.335879,0.346782,0.000008,No
2,2,4,1,1,2,2,2,4,9,0.242883,0.247486,0.000008,No
8,8,64,5,4,9,8,8,16,7,0.337387,0.350157,0.000008,No
11,11,121,5,8,13,11,11,22,7,0.349437,0.36268,0.000008,No
11,10,110,7,9,16,11,11,22,7,0.372262,0.389902,0.000008,No
24,24,576,11,9,20,24,24,48,8,0.337467,0.351267,0.000008,No
8,8,64,5,5,10,8,8,16,8,0.351778,0.366646,0.000008,No
8,7,56,4,5,9,8,8,16,7,0.35731,0.372432,0.000008,No
5,4,20,3,5,8,5,5,10,8,0.326884,0.335826,0.000008,No
6,6,36,4,5,9,6,6,12,8,0.353454,0.36798,0.000008,No
3,3,9,3,3,6,3,3,6,8,0.317516,0.324644,0.000008,No
6,6,36,5,4,9,6,6,12,8,0.302654,0.312221,0.000008,No
8,7,56,5,6,11,8,8,16,7,0.361351,0.37737,0.000008,No
9,9,81,6,6,12,9,9,18,8,0.313284,0.321478,0.000008,No
41,41,1681,12,15,27,41,41,82,8,0.365445,0.38209,0.000008,No
12,12,144,10,10,20,12,12,24,7,0.364703,0.381861,0.000008,No
9,9,81,9,6,15,9,9,18,8,0.34206,0.357436,0.000008,No
25,25,625,12,7,19,25,25,50,8,0.367412,0.383874,0.000008,No
35,34,1190,21,8,29,35,35,70,8,0.365375,0.382525,0.000008,No
30,30,900,13,14,27,30,30,60,8,0.374863,0.39288,0.000008,No
12,12,144,9,9,18,12,12,24,8,0.355753,0.370806,0.000008,No
1,1,1,1,1,2,1,1,2,9,0.236258,0.240054,0.000007,No
20,20,400,12,13,25,20,20,40,8,0.360885,0.376675,0.000007,No
6,6,36,5,6,11,6,6,12,8,0.3317,0.343713,0.000007,No
5,5,25,4,4,8,5,5,10,8,0.341506,0.355124,0.000007,No
12,12,144,9,7,16,12,12,24,8,0.34707,0.361176,0.000007,No
3,3,9,3,3,6,3,3,6,8,0.322217,0.333618,0.000007,No
5,5,25,5,4,9,5,5,10,7,0.332411,0.343843,0.000007,No
13,13,169,9,7,16,13,13,26,8,0.321331,0.331396,0.000007,No
8,8,64,6,5,11,8,8,16,8,0.341212,0.35292,0.000007,No
5,5,25,5,4,9,5,5,10,7,0.342266,0.354971,0.000007,No
12,11,132,7,10,17,12,12,24,8,0.359093,0.374476,0.000007,No
3,3,9,3,3,6,3,3,6,7,0.335919,0.346536,0.000007,No
2,2,4,2,2,4,2,2,4,8,0.285927,0.293968,0.000007,No
14,14,196,10,10,20,14,14,28,7,0.349831,0.363362,0.000007,No
19,19,361,3,6,9,19,19,38,8,0.311317,0.318393,0.000007,No
13,11,143,5,6,11,13,13,26,7,0.356922,0.371949,0.000007,No
10,10,100,8,8,16,10,10,20,8,0.353059,0.36731,0.000007,No
1,1,1,1,1,2,1,1,2,8,0.339941,0.352199,0.000007,No
10,10,100,8,8,16,10,10,20,7,0.348459,0.362577,0.000007,No
5,5,25,1,3,4,5,5,10,8,0.300188,0.310921,0.000007,No
21,21,441,2,15,17,21,21,42,8,0.365,0.38244,0.000007,No
13,13,169,6,10,16,13,13,26,7,0.364843,0.381068,0.000007,No
13,13,169,7,7,14,13,13,26,8,0.345419,0.358937,0.000007,No
5,5,25,4,5,9,5,5,10,8,0.343444,0.357392,0.000007,No
1,1,1,1,1,2,1,1,2,8,0.331578,0.343078,0.000007,No
16,16,256,10,11,21,16,16,32,8,0.368778,0.385892,0.000007,No
4,4,16,4,4,8,4,4,8,7,0.342947,0.355685,0.000007,No
5,4,20,5,5,10,5,5,10,8,0.35776,0.373536,0.000007,No
19,17,323,7,10,17,19,19,38,7,0.335496,0.347579,0.000007,No
4,4,16,4,4,8,4,4,8,8,0.307552,0.316406,0.000007,No
13,13,169,8,9,17,13,13,26,8,0.345461,0.358898,0.000007,No
2,2,4,2,2,4,2,2,4,8,0.321707,0.329745,0.000007,No
3,2,6,3,2,5,3,3,6,8,0.344408,0.357419,0.000007,No
8,8,64,3,7,10,8,8,16,8,0.333914,0.344727,0.000007,No
16,16,256,10,10,20,16,16,32,8,0.362303,0.378732,0.000007,No
6,6,36,3,3,6,6,6,12,8,0.340783,0.353274,0.000007,No
2,2,4,2,1,3,2,2,4,7,0.327819,0.338512,0.000007,No
3,3,9,2,3,5,3,3,6,8,0.301153,0.30897,0.000007,No
10,10,100,6,7,13,10,10,20,7,0.352964,0.367206,0.000007,No
11,11,121,7,7,14,11,11,22,7,0.329988,0.339899,0.000007,No
3,3,9,3,3,6,3,3,6,8,0.288587,0.297286,0.000007,No
13,13,169,9,11,20,13,13,26,7,0.352541,0.365844,0.000007,No
24,24,576,14,11,25,24,24,48,8,0.367904,0.384806,0.000007,No
11,10,110,4,6,10,11,11,22,7,0.356758,0.37245,0.000007,No
7,7,49,1,3,4,7,7,14,7,0.342665,0.355479,0.000007,No
16,16,256,4,11,15,16,16,32,8,0.350571,0.365271,0.000007,No
6,6,36,5,5,10,6,6,12,7,0.347338,0.360614,0.000007,No
9,8,72,6,6,12,9,9,18,8,0.348552,0.362004,0.000007,No
5,5,25,4,4,8,5,5,10,7,0.32845,0.33915,0.000007,No
4,3,12,4,4,8,4,4,8,8,0.337834,0.352143,0.000007,No
8,8,64,5,6,11,8,8,16,8,0.368309,0.386163,0.000007,No
5,5,25,4,4,8,5,5,10,8,0.343313,0.355996,0.000007,No
9,9,81,7,3,10,9,9,18,7,0.334018,0.345857,0.000007,No
15,15,225,10,13,23,15,15,30,7,0.36165,0.3778,0.000007,No
10,10,100,5,8,13,10,10,20,7,0.363135,0.379465,0.000007,No
10,10,100,9,8,17,10,10,20,8,0.330787,0.340382,0.000007,No
2,2,4,2,2,4,2,2,4,8,0.318851,0.326183,0.000007,No
3,3,9,3,3,6,3,3,6,8,0.30324,0.310709,0.000007,No
23,23,529,11,14,25,23,23,46,7,0.353601,0.368207,0.000007,No
6,6,36,4,4,8,6,6,12,8,0.323942,0.334926,0.000007,No
10,10,100,8,1,9,10,10,20,8,0.32342,0.334424,0.000007,No
2,2,4,2,2,4,2,2,4,8,0.34493,0.357689,0.000007,No
12,11,132,6,8,14,12,12,24,8,0.353945,0.368279,0.000007,No
6,6,36,5,4,9,6,6,12,8,0.333392,0.3461,0.000007,No
47,44,2068,11,19,30,47,47,94,7,0.376617,0.394607,0.000007,No
8,8,64,6,6,12,8,8,16,7,0.35284,0.367389,0.000007,No
1,1,1,1,1,2,1,1,2,9,0.259825,0.265925,0.000007,No
6,6,36,4,6,10,6,6,12,8,0.352658,0.367257,0.000007,No
1,1,1,1,1,2,1,1,2,9,0.250978,0.255411,0.000007,No
29,29,841,19,18,37,29,29,58,7,0.377508,0.396077,0.000007,No
10,10,100,3,6,9,10,10,20,8,0.346302,0.359624,0.000007,No
12,12,144,7,6,13,12,12,24,8,0.34664,0.36115,0.000007,No
2,2,4,1,2,3,2,2,4,8,0.288207,0.299142,0.000007,No
23,23,529,9,15,24,23,23,46,7,0.379904,0.397879,0.000007,No
7,7,49,6,5,11,7,7,14,7,0.355065,0.369731,0.000007,No
3,3,9,2,3,5,3,3,6,8,0.30813,0.316705,0.000007,No
5,5,25,5,4,9,5,5,10,8,0.330871,0.344286,0.000007,No
17,17,289,7,14,21,17,17,34,7,0.3718,0.38955,0.000007,No
2,2,4,2,2,4,2,2,4,8,0.29451,0.301664,0.000007,No
7,6,42,5,4,9,7,7,14,8,0.34413,0.357625,0.000007,No
6,6,36,4,5,9,6,6,12,7,0.331095,0.342235,0.000007,No
2,2,4,2,2,4,2,2,4,8,0.342102,0.354638,0.000007,No
11,11,121,9,11,20,11,11,22,7,0.37568,0.393726,0.000007,No
5,5,25,3,3,6,5,5,10,8,0.344443,0.357483,0.000007,No
17,17,289,6,10,16,17,17,34,7,0.361466,0.377129,0.000007,No
18,18,324,6,8,14,18,18,36,7,0.3591,0.374196,0.000007,No
20,18,360,14,18,32,20,20,40,8,0.363043,0.379903,0.000007,No
3,3,9,1,2,3,3,3,6,8,0.33161,0.343137,0.000007,No
4,3,12,3,2,5,4,4,8,8,0.304012,0.316652,0.000007,No
2,2,4,2,2,4,2,2,4,8,0.308147,0.319169,0.000007,No
15,15,225,12,5,17,15,15,30,8,0.356877,0.372497,0.000007,No
8,8,64,4,5,9,8,8,16,8,0.355146,0.370401,0.000007,No
6,5,30,4,5,9,6,6,12,8,0.355013,0.371355,0.000007,No
34,31,1054,9,3,12,34,34,68,7,0.333158,0.344084,0.000007,No
8,8,64,5,7,12,8,8,16,8,0.318768,0.326259,0.000007,No
8,8,64,5,6,11,8,8,16,7,0.34831,0.361883,0.000007,No
7,6,42,5,6,11,7,7,14,8,0.339812,0.352974,0.000007,No
1,1,1,1,1,2,1,1,2,9,0.227658,0.231869,0.000007,No
17,17,289,11,11,22,17,17,34,7,0.363646,0.379713,0.000007,No
20,20,400,15,9,24,20,20,40,7,0.35125,0.364841,0.000007,No
7,6,42,5,5,10,7,7,14,7,0.337027,0.349205,0.000007,No
12,12,144,10,7,17,12,12,24,7,0.358015,0.373058,0.000007,No
8,8,64,8,8,16,8,8,16,7,0.348687,0.362149,0.000007,No
3,3,9,1,3,4,3,3,6,8,0.317363,0.32452,0.000007,No
23,23,529,13,4,17,23,23,46,7,0.318619,0.326089,0.000007,No
14,14,196,6,9,15,14,14,28,7,0.347324,0.360093,0.000007,No
7,7,49,3,5,8,7,7,14,7,0.332956,0.344217,0.000007,No
28,27,756,19,13,32,28,28,56,7,0.368898,0.385811,0.000007,No
7,6,42,6,6,12,7,7,14,8,0.341144,0.353566,0.000007,No
12,12,144,10,9,19,12,12,24,8,0.343444,0.355523,0.000007,No
8,7,56,7,6,13,8,8,16,8,0.352745,0.367559,0.000007,No
2,2,4,2,2,4,2,2,4,8,0.352003,0.366286,0.000007,No
14,13,182,7,9,16,14,14,28,8,0.366497,0.382833,0.000007,No
3,3,9,3,3,6,3,3,6,8,0.329835,0.340548,0.000007,No
5,5,25,5,4,9,5,5,10,7,0.339894,0.353278,0.000007,No
16,16,256,7,11,18,16,16,32,7,0.362888,0.378367,0.000007,No
6,6,36,6,6,12,6,6,12,7,0.35042,0.363817,0.000007,No
10,10,100,3,7,10,10,10,20,8,0.297488,0.304504,0.000007,No
8,8,64,5,5,10,8,8,16,7,0.357827,0.372969,0.000007,No
3,3,9,3,3,6,3,3,6,8,0.341773,0.354408,0.000007,No
9,9,81,6,8,14,9,9,18,7,0.343507,0.356606,0.000007,No
11,11,121,3,2,5,11,11,22,8,0.323451,0.334493,0.000007,No
27,27,729,10,13,23,27,27,54,7,0.382407,0.401298,0.000007,No
5,4,20,4,4,8,5,5,10,8,0.340097,0.352478,0.000007,No
16,15,240,7,6,13,16,16,32,7,0.35758,0.37279,0.000007,No
2,2,4,2,2,4,2,2,4,8,0.352396,0.367736,0.000007,No
16,16,256,6,11,17,16,16,32,8,0.360002,0.376415,0.000007,No
5,5,25,4,5,9,5,5,10,8,0.344095,0.356855,0.000007,No
5,5,25,5,4,9,5,5,10,8,0.353608,0.368427,0.000007,No
2,2,4,2,2,4,2,2,4,8,0.352003,0.366286,0.000007,No
7,7,49,3,5,8,7,7,14,8,0.35363,0.369357,0.000007,No
5,4,20,4,4,8,5,5,10,7,0.33269,0.34397,0.000007,No
11,11,121,7,8,15,11,11,22,8,0.360633,0.377265,0.000007,No
1,1,1,1,1,2,1,1,2,9,0.239777,0.243932,0.000007,No
11,11,121,6,5,11,11,11,22,8,0.358391,0.374412,0.000007,No
1,1,1,1,1,2,1,1,2,9,0.240952,0.244058,0.000007,No
5,5,25,5,5,10,5,5,10,7,0.330659,0.340957,0.000007,No
7,7,49,5,6,11,7,7,14,7,0.334182,0.346128,0.000007,No
11,11,121,8,8,16,11,11,22,8,0.362742,0.380615,0.000007,No
10,10,100,4,5,9,10,10,20,8,0.338901,0.351308,0.000007,No
9,9,81,8,7,15,9,9,18,8,0.363902,0.379976,0.000007,No
16,14,224,6,7,13,16,16,32,8,0.348352,0.362999,0.000007,No
10,10,100,4,8,12,10,10,20,8,0.311096,0.318786,0.000006,yes
1,1,1,1,1,2,1,1,2,9,0.195906,0.198152,0.000006,No
3,3,9,3,3,6,3,3,6,7,0.353945,0.368456,0.000006,No
12,12,144,10,7,17,12,12,24,8,0.351401,0.36559,0.000006,No
12,12,144,6,9,15,12,12,24,7,0.34664,0.36028,0.000006,No
6,6,36,6,4,10,6,6,12,8,0.340355,0.352783,0.000006,No
18,18,324,13,8,21,18,18,36,7,0.366363,0.382532,0.000006,No
3,3,9,3,3,6,3,3,6,7,0.331147,0.34236,0.000006,No
10,10,100,4,10,14,10,10,20,8,0.357985,0.372957,0.000006,No
3,3,9,2,3,5,3,3,6,8,0.353718,0.368459,0.000006,No
21,20,420,11,13,24,21,21,42,8,0.374764,0.392924,0.000006,No
3,3,9,2,3,5,3,3,6,8,0.317824,0.325941,0.000006,No
10,9,90,5,5,10,10,10,20,8,0.324799,0.336251,0.000006,No
9,9,81,9,9,18,9,9,18,7,0.355072,0.369823,0.000006,No
5,5,25,2,4,6,5,5,10,7,0.346056,0.359001,0.000006,No
1,1,1,1,1,2,1,1,2,9,0.242352,0.246318,0.000006,No
1,1,1,1,1,2,1,1,2,8,0.23036,0.234341,0.000006,No
14,14,196,9,11,20,14,14,28,8,0.319448,0.329382,0.000006,No
3,3,9,1,2,3,3,3,6,8,0.341219,0.353987,0.000006,No
11,10,110,5,8,13,11,11,22,8,0.351865,0.36666,0.000006,No
16,16,256,12,8,20,16,16,32,8,0.316773,0.32385,0.000006,No
5,3,15,4,5,9,5,5,10,8,0.354984,0.371038,0.000006,No
12,12,144,11,10,21,12,12,24,7,0.335048,0.345538,0.000006,No
21,21,441,8,14,22,21,21,42,8,0.328881,0.338304,0.000006,No
11,11,121,7,7,14,11,11,22,8,0.33728,0.349536,0.000006,No
18,17,306,11,10,21,18,18,36,8,0.337761,0.350655,0.000006,No
9,9,81,7,5,12,9,9,18,8,0.354357,0.369098,0.000006,No
9,9,81,5,4,9,9,9,18,7,0.353505,0.368148,0.000006,No
2,2,4,2,2,4,2,2,4,8,0.344283,0.357109,0.000006,No
8,8,64,3,4,7,8,8,16,8,0.312824,0.320632,0.000006,No
10,10,100,6,7,13,10,10,20,7,0.356944,0.37224,0.000006,No
12,12,144,8,9,17,12,12,24,7,0.349387,0.362722,0.000006,No
5,5,25,5,5,10,5,5,10,7,0.33728,0.347965,0.000006,No
4,4,16,4,4,8,4,4,8,8,0.330345,0.341272,0.000006,No
7,7,49,5,5,10,7,7,14,8,0.354173,0.36864,0.000006,No
1,1,1,1,1,2,1,1,2,9,0.233174,0.236492,0.000006,No
5,4,20,4,5,9,5,5,10,8,0.334326,0.345549,0.000006,No
3,3,9,2,2,4,3,3,6,7,0.328128,0.338803,0.000006,No
4,3,12,2,3,5,4,4,8,8,0.355561,0.371657,0.000006,No
2,2,4,2,2,4,2,2,4,8,0.265899,0.2719,0.000006,No
10,10,100,5,7,12,10,10,20,8,0.357363,0.373279,0.000006,No
2,2,4,2,2,4,2,2,4,8,0.301765,0.314683,0.000006,No
7,7,49,6,7,13,7,7,14,8,0.333197,0.345793,0.000006,No
4,3,12,3,4,7,4,4,8,8,0.336296,0.3482,0.000006,No
10,9,90,5,6,11,10,10,20,8,0.324182,0.333641,0.000006,No
11,11,121,8,8,16,11,11,22,7,0.357842,0.373149,0.000006,No
5,5,25,4,5,9,5,5,10,8,0.318144,0.329883,0.000006,No
6,6,36,3,4,7,6,6,12,8,0.304958,0.311793,0.000006,No
33,30,990,19,13,32,33,33,66,8,0.352957,0.368048,0.000006,No
17,17,289,5,10,15,17,17,34,8,0.363987,0.380885,0.000006,No
7,7,49,5,4,9,7,7,14,8,0.320854,0.330499,0.000006,No
3,3,9,3,2,5,3,3,6,8,0.299125,0.310483,0.000006,No
9,7,63,6,7,13,9,9,18,8,0.358572,0.375197,0.000006,No
20,18,360,6,15,21,20,20,40,8,0.37685,0.395525,0.000006,No
5,5,25,4,4,8,5,5,10,7,0.336203,0.3474,0.000006,No
14,14,196,11,5,16,14,14,28,7,0.357011,0.371947,0.000006,No
2,2,4,2,2,4,2,2,4,8,0.315089,0.329716,0.000006,No
2,2,4,2,2,4,2,2,4,8,0.336608,0.349772,0.000006,No
4,4,16,4,3,7,4,4,8,8,0.282594,0.289869,0.000006,No
21,20,420,4,13,17,21,21,42,7,0.3766,0.394596,0.000006,No
2,2,4,2,2,4,2,2,4,8,0.313883,0.32347,0.000006,No
5,5,25,5,5,10,5,5,10,8,0.325941,0.335725,0.000006,No
3,3,9,3,3,6,3,3,6,8,0.288734,0.295925,0.000006,No
10,10,100,3,4,7,10,10,20,8,0.354998,0.370345,0.000006,No
4,4,16,3,3,6,4,4,8,8,0.349867,0.364967,0.000006,No
3,3,9,2,3,5,3,3,6,8,0.323279,0.334648,0.000006,No
11,11,121,6,10,16,11,11,22,8,0.337293,0.350363,0.000006,No
7,7,49,2,6,8,7,7,14,8,0.352236,0.366667,0.000006,No
1,1,1,1,1,2,1,1,2,9,0.25371,0.258582,0.000006,No
9,8,72,6,6,12,9,9,18,8,0.356497,0.371652,0.000006,No
26,23,598,12,15,27,26,26,52,8,0.369353,0.386205,0.000006,No
5,5,25,5,4,9,5,5,10,8,0.349122,0.362442,0.000006,No
4,4,16,4,4,8,4,4,8,8,0.27925,0.287106,0.000006,No
10,10,100,3,7,10,10,10,20,8,0.349501,0.364032,0.000006,No
1,1,1,1,1,2,1,1,2,9,0.254425,0.259427,0.000006,No
2,2,4,2,2,4,2,2,4,8,0.326408,0.338223,0.000006,No
3,2,6,3,3,6,3,3,6,8,0.328666,0.340326,0.000006,No
4,4,16,2,2,4,4,4,8,8,0.340395,0.352588,0.000006,No
7,7,49,5,6,11,7,7,14,8,0.354703,0.369562,0.000006,No
7,7,49,3,4,7,7,7,14,8,0.347445,0.361882,0.000006,No
12,11,132,5,10,15,12,12,24,7,0.370339,0.387138,0.000006,No
9,9,81,4,7,11,9,9,18,8,0.334556,0.345825,0.000006,No
7,7,49,6,6,12,7,7,14,7,0.343375,0.357062,0.000006,No
6,5,30,4,3,7,6,6,12,8,0.353271,0.368818,0.000006,No
3,3,9,2,3,5,3,3,6,8,0.326284,0.336403,0.000006,No
14,14,196,11,6,17,14,14,28,8,0.34996,0.36388,0.000006,No
19,18,342,12,10,22,19,19,38,7,0.365437,0.381412,0.000006,No
4,3,12,4,4,8,4,4,8,7,0.348644,0.362718,0.000006,No
7,6,42,7,5,12,7,7,14,8,0.354122,0.368782,0.000006,No
3,3,9,3,3,6,3,3,6,8,0.293048,0.300304,0.000006,No
5,5,25,4,4,8,5,5,10,7,0.360694,0.37652,0.000006,No
8,8,64,2,7,9,8,8,16,8,0.347537,0.361153,0.000006,No
16,16,256,8,10,18,16,16,32,7,0.371702,0.388655,0.000006,No
3,3,9,3,2,5,3,3,6,8,0.297893,0.304676,0.000006,No
4,4,16,2,4,6,4,4,8,8,0.347395,0.362018,0.000006,No
7,7,49,7,7,14,7,7,14,8,0.303715,0.310821,0.000006,No
5,4,20,5,3,8,5,5,10,7,0.335813,0.346454,0.000006,No
5,5,25,3,5,8,5,5,10,8,0.295167,0.304306,0.000006,No
15,14,210,9,7,16,15,15,30,8,0.346576,0.360295,0.000006,No
39,36,1404,7,16,23,39,39,78,7,0.387566,0.406441,0.000006,No
5,5,25,4,4,8,5,5,10,7,0.353418,0.367796,0.000006,No
6,6,36,4,6,10,6,6,12,8,0.32361,0.333156,0.000006,No
17,17,289,6,10,16,17,17,34,7,0.371921,0.389714,0.000006,No
18,18,324,12,11,23,18,18,36,7,0.370564,0.387478,0.000006,No
22,17,374,5,5,10,22,22,44,7,0.357955,0.373347,0.000006,No
6,6,36,6,5,11,6,6,12,7,0.310801,0.318671,0.000006,No
9,9,81,3,6,9,9,9,18,7,0.349623,0.363738,0.000006,No
8,8,64,5,4,9,8,8,16,8,0.336031,0.347898,0.000006,No
11,11,121,6,8,14,11,11,22,7,0.363615,0.380246,0.000006,No
8,7,56,4,8,12,8,8,16,8,0.368954,0.386274,0.000006,No
3,3,9,3,3,6,3,3,6,8,0.344422,0.357458,0.000006,No
25,25,625,9,16,25,25,25,50,8,0.352877,0.367073,0.000006,No
3,3,9,2,2,4,3,3,6,8,0.339948,0.352234,0.000006,No
13,13,169,6,10,16,13,13,26,8,0.331791,0.342932,0.000006,No
11,11,121,7,10,17,11,11,22,7,0.35117,0.364905,0.000006,No
12,10,120,8,7,15,12,12,24,8,0.358889,0.374785,0.000006,No
7,7,49,5,5,10,7,7,14,8,0.335655,0.348244,0.000006,No
5,5,25,3,5,8,5,5,10,8,0.352811,0.368266,0.000006,No
10,10,100,8,7,15,10,10,20,7,0.330531,0.342122,0.000006,No
9,9,81,2,6,8,9,9,18,8,0.348659,0.362022,0.000006,No
3,3,9,3,3,6,3,3,6,8,0.33825,0.351527,0.000006,No
15,15,225,5,11,16,15,15,30,7,0.359274,0.374933,0.000006,No
11,11,121,6,10,16,11,11,22,7,0.333542,0.343777,0.000006,No
1,1,1,1,1,2,1,1,2,8,0.339941,0.352199,0.000006,No
1,1,1,1,1,2,1,1,2,8,0.339941,0.352199,0.000006,No
31,29,899,10,10,20,31,31,62,8,0.337487,0.348555,0.000006,No
10,10,100,6,8,14,10,10,20,7,0.358692,0.374114,0.000006,No
18,18,324,12,12,24,18,18,36,7,0.364594,0.380761,0.000006,No
20,20,400,12,13,25,20,20,40,8,0.350377,0.364262,0.000006,No
9,8,72,8,7,15,9,9,18,7,0.323727,0.331566,0.000006,No
15,15,225,5,10,15,15,15,30,8,0.341349,0.35437,0.000006,No
8,8,64,4,7,11,8,8,16,8,0.333568,0.345766,0.000006,No
6,5,30,4,6,10,6,6,12,8,0.353527,0.367934,0.000006,No
15,15,225,12,9,21,15,15,30,8,0.351633,0.366253,0.000006,No
11,11,121,5,7,12,11,11,22,7,0.336257,0.34669,0.000006,No
9,9,81,8,8,16,9,9,18,8,0.35582,0.371726,0.000006,No
3,3,9,3,3,6,3,3,6,8,0.344749,0.357611,0.000006,No
6,5,30,3,6,9,6,6,12,8,0.331533,0.343515,0.000006,No
14,14,196,4,9,13,14,14,28,7,0.34794,0.361797,0.000006,No
13,13,169,5,5,10,13,13,26,7,0.356452,0.371133,0.000006,No
4,4,16,3,4,7,4,4,8,8,0.344526,0.357681,0.000006,No
18,16,288,12,12,24,18,18,36,8,0.343527,0.357187,0.000006,No
4,4,16,3,3,6,4,4,8,7,0.32393,0.332146,0.000006,No
19,19,361,4,12,16,19,19,38,7,0.354011,0.368878,0.000006,No
4,4,16,3,2,5,4,4,8,7,0.352614,0.366956,0.000006,No
9,9,81,6,4,10,9,9,18,8,0.34283,0.355915,0.000006,No
2,2,4,2,2,4,2,2,4,8,0.331584,0.343112,0.000006,No
2,2,4,2,2,4,2,2,4,7,0.302761,0.312306,0.000006,No
17,17,289,11,10,21,17,17,34,8,0.357468,0.372616,0.000006,No
4,4,16,3,4,7,4,4,8,8,0.331083,0.342161,0.000006,No
3,3,9,3,3,6,3,3,6,8,0.280162,0.287166,0.000006,No
3,3,9,3,1,4,3,3,6,8,0.32342,0.334424,0.000006,No
5,5,25,4,5,9,5,5,10,7,0.333346,0.344891,0.000006,No
3,3,9,2,2,4,3,3,6,8,0.309713,0.318304,0.000006,No
43,43,1849,24,5,29,43,43,86,7,0.343562,0.356684,0.000006,No
5,5,25,4,4,8,5,5,10,8,0.342975,0.355844,0.000006,No
7,7,49,3,4,7,7,7,14,8,0.342369,0.354965,0.000006,No
17,16,272,3,4,7,17,17,34,8,0.324836,0.335565,0.000006,No
4,4,16,3,4,7,4,4,8,8,0.316532,0.324731,0.000006,No
15,15,225,4,11,15,15,15,30,8,0.35257,0.367203,0.000006,No
8,8,64,5,6,11,8,8,16,8,0.347289,0.360621,0.000006,No
3,3,9,3,3,6,3,3,6,8,0.312326,0.321769,0.000006,No
17,17,289,4,6,10,17,17,34,7,0.331746,0.340876,0.000006,No
2,2,4,1,2,3,2,2,4,8,0.339948,0.352234,0.000006,No
3,3,9,2,3,5,3,3,6,7,0.342686,0.355255,0.000006,No
8,7,56,3,8,11,8,8,16,8,0.328533,0.338616,0.000006,No
8,8,64,4,7,11,8,8,16,8,0.353403,0.368955,0.000006,No
12,12,144,7,8,15,12,12,24,7,0.347721,0.361573,0.000006,No
1,1,1,1,1,2,1,1,2,10,0.215105,0.218397,0.000006,No
2,2,4,2,2,4,2,2,4,7,0.328229,0.338877,0.000006,No
25,25,625,9,13,22,25,25,50,7,0.375135,0.394217,0.000006,No
46,45,2070,14,21,35,46,46,92,7,0.394803,0.414003,0.000006,No
9,9,81,5,7,12,9,9,18,8,0.354129,0.369223,0.000006,No
3,3,9,3,3,6,3,3,6,7,0.341697,0.354296,0.000006,No
8,8,64,4,8,12,8,8,16,7,0.345895,0.359417,0.000006,No
10,10,100,8,5,13,10,10,20,8,0.355805,0.371339,0.000006,No
2,2,4,2,2,4,2,2,4,7,0.32254,0.333404,0.000006,No
5,5,25,2,4,6,5,5,10,8,0.342699,0.355616,0.000006,No
3,3,9,3,3,6,3,3,6,8,0.342823,0.35535,0.000006,No
5,5,25,4,4,8,5,5,10,8,0.348787,0.362081,0.000006,No
5,4,20,2,4,6,5,5,10,8,0.347699,0.361622,0.000006,No
9,9,81,5,5,10,9,9,18,8,0.344227,0.357184,0.000006,No
7,7,49,7,5,12,7,7,14,8,0.343513,0.356967,0.000006,No
7,7,49,5,6,11,7,7,14,8,0.311642,0.321266,0.000006,No
11,11,121,9,6,15,11,11,22,8,0.359388,0.375462,0.000006,No
1,1,1,1,1,2,1,1,2,8,0.339941,0.352199,0.000006,No
5,5,25,4,5,9,5,5,10,8,0.359138,0.375653,0.000005,No
11,11,121,11,5,16,11,11,22,8,0.357243,0.37241,0.000005,No
8,8,64,5,5,10,8,8,16,7,0.341663,0.355174,0.000005,No
38,37,1406,16,20,36,38,38,76,7,0.361076,0.377133,0.000005,No
3,3,9,2,1,3,3,3,6,9,0.257426,0.262845,0.000005,No
7,7,49,3,4,7,7,7,14,8,0.345007,0.357928,0.000005,No
19,19,361,12,11,23,19,19,38,7,0.341732,0.354391,0.000005,No
8,8,64,6,6,12,8,8,16,8,0.351843,0.365966,0.000005,No
7,7,49,3,4,7,7,7,14,8,0.297151,0.308515,0.000005,No
7,7,49,5,4,9,7,7,14,7,0.335325,0.347358,0.000005,No
13,13,169,5,4,9,13,13,26,7,0.334424,0.344897,0.000005,No
12,12,144,6,10,16,12,12,24,8,0.349458,0.362974,0.000005,No
7,7,49,2,4,6,7,7,14,8,0.316304,0.323245,0.000005,No
8,8,64,7,5,12,8,8,16,7,0.351401,0.365333,0.000005,No
7,7,49,2,3,5,7,7,14,7,0.350888,0.365125,0.000005,No
2,2,4,2,2,4,2,2,4,8,0.343209,0.355815,0.000005,No
5,5,25,5,5,10,5,5,10,7,0.338673,0.349806,0.000005,No
5,5,25,3,4,7,5,5,10,7,0.350276,0.364386,0.000005,No
3,3,9,2,3,5,3,3,6,8,0.308119,0.316058,0.000005,No
6,6,36,4,4,8,6,6,12,8,0.336555,0.348439,0.000005,No
2,2,4,2,2,4,2,2,4,8,0.287333,0.294865,0.000005,No
14,13,182,5,5,10,14,14,28,7,0.339461,0.350948,0.000005,No
7,6,42,4,4,8,7,7,14,8,0.352032,0.366359,0.000005,No
2,2,4,2,1,3,2,2,4,9,0.235722,0.241688,0.000005,No
7,7,49,5,5,10,7,7,14,8,0.32417,0.335267,0.000005,No
5,3,15,5,5,10,5,5,10,7,0.345216,0.357741,0.000005,No
2,2,4,2,2,4,2,2,4,7,0.333561,0.345446,0.000005,No
2,2,4,2,2,4,2,2,4,8,0.317386,0.324505,0.000005,No
4,4,16,2,2,4,4,4,8,7,0.352621,0.366966,0.000005,No
14,14,196,10,8,18,14,14,28,7,0.352134,0.366276,0.000005,No
39,38,1482,12,12,24,39,39,78,7,0.354563,0.369044,0.000005,No
10,8,80,6,8,14,10,10,20,8,0.352425,0.366995,0.000005,No
10,8,80,5,3,8,10,10,20,8,0.328387,0.339772,0.000005,No
13,13,169,8,7,15,13,13,26,7,0.368778,0.38531,0.000005,No
5,5,25,5,4,9,5,5,10,8,0.315619,0.32598,0.000005,No
2,1,2,2,2,4,2,2,4,8,0.34664,0.360933,0.000005,No
7,7,49,6,5,11,7,7,14,8,0.345286,0.358844,0.000005,No
4,4,16,3,4,7,4,4,8,8,0.33872,0.35195,0.000005,No
12,12,144,9,7,16,12,12,24,8,0.366907,0.383333,0.000005,No
6,6,36,5,5,10,6,6,12,7,0.334346,0.346258,0.000005,No
4,4,16,4,4,8,4,4,8,8,0.343106,0.355872,0.000005,No
4,4,16,4,4,8,4,4,8,8,0.310242,0.319007,0.000005,No
16,16,256,5,9,14,16,16,32,7,0.364112,0.380246,0.000005,No
1,1,1,1,1,2,1,1,2,8,0.311306,0.32231,0.000005,No
23,23,529,2,13,15,23,23,46,7,0.369057,0.385771,0.000005,No
12,12,144,3,6,9,12,12,24,7,0.348253,0.361684,0.000005,No
34,34,1156,15,16,31,34,34,68,7,0.358406,0.373966,0.000005,No
17,17,289,10,9,19,17,17,34,8,0.348033,0.36187,0.000005,No
7,7,49,3,3,6,7,7,14,7,0.329726,0.340593,0.000005,No
9,9,81,8,8,16,9,9,18,8,0.357094,0.372721,0.000005,No
11,11,121,6,8,14,11,11,22,8,0.346661,0.359727,0.000005,No
1,1,1,1,1,2,1,1,2,8,0.317445,0.327454,0.000005,No
5,5,25,3,4,7,5,5,10,8,0.331984,0.34355,0.000005,No
4,4,16,2,4,6,4,4,8,8,0.333666,0.344458,0.000005,No
9,9,81,4,6,10,9,9,18,8,0.340484,0.353243,0.000005,No
11,11,121,5,7,12,11,11,22,7,0.340871,0.353061,0.000005,No
13,13,169,4,9,13,13,13,26,7,0.335952,0.346069,0.000005,No
8,8,64,5,4,9,8,8,16,7,0.352716,0.36717,0.000005,No
3,3,9,2,3,5,3,3,6,7,0.329039,0.339989,0.000005,No
1,1,1,1,1,2,1,1,2,8,0.311306,0.32231,0.000005,No
3,3,9,3,3,6,3,3,6,7,0.329764,0.340951,0.000005,No
3,3,9,3,3,6,3,3,6,8,0.345188,0.358167,0.000005,No
1,1,1,1,1,2,1,1,2,9,0.246907,0.251574,0.000005,No
23,23,529,12,16,28,23,23,46,8,0.366253,0.383493,0.000005,No
11,11,121,9,7,16,11,11,22,8,0.344387,0.358412,0.000005,No
3,3,9,3,3,6,3,3,6,8,0.320161,0.328973,0.000005,No
8,8,64,5,7,12,8,8,16,7,0.35188,0.366041,0.000005,No
2,2,4,2,2,4,2,2,4,8,0.315083,0.329711,0.000005,No
12,11,132,7,6,13,12,12,24,8,0.30474,0.316679,0.000005,No
14,14,196,6,7,13,14,14,28,8,0.35322,0.367491,0.000005,No
21,20,420,11,10,21,21,21,42,8,0.357161,0.372164,0.000005,No
11,10,110,7,10,17,11,11,22,7,0.363731,0.381275,0.000005,No
11,11,121,9,8,17,11,11,22,7,0.32993,0.338771,0.000005,No
5,5,25,4,4,8,5,5,10,8,0.347657,0.36117,0.000005,No
7,7,49,5,6,11,7,7,14,8,0.343361,0.357545,0.000005,No
5,5,25,3,5,8,5,5,10,8,0.340382,0.353568,0.000005,No
7,7,49,6,3,9,7,7,14,8,0.329592,0.341236,0.000005,No
20,20,400,12,16,28,20,20,40,8,0.365406,0.381783,0.000005,No
7,7,49,7,5,12,7,7,14,8,0.307441,0.313991,0.000005,No
8,8,64,4,7,11,8,8,16,7,0.375044,0.393045,0.000005,No
11,10,110,5,7,12,11,11,22,8,0.335767,0.348655,0.000005,No
10,10,100,5,8,13,10,10,20,8,0.369593,0.386832,0.000005,No
2,2,4,2,2,4,2,2,4,8,0.337808,0.352065,0.000005,No
18,18,324,5,11,16,18,18,36,8,0.357333,0.373897,0.000005,No
5,5,25,2,4,6,5,5,10,8,0.334733,0.346698,0.000005,No
9,9,81,7,8,15,9,9,18,8,0.345944,0.360653,0.000005,No
8,8,64,6,6,12,8,8,16,8,0.332043,0.343215,0.000005,No
8,6,48,4,6,10,8,8,16,8,0.34804,0.36163,0.000005,No
10,9,90,6,8,14,10,10,20,8,0.358248,0.374098,0.000005,No
6,6,36,2,5,7,6,6,12,8,0.320848,0.328913,0.000005,No
3,3,9,3,3,6,3,3,6,8,0.326702,0.336203,0.000005,No
9,9,81,6,8,14,9,9,18,8,0.359926,0.377027,0.000005,No
1,1,1,1,1,2,1,1,2,9,0.238944,0.24297,0.000005,No
3,3,9,3,3,6,3,3,6,8,0.313146,0.324028,0.000005,No
26,26,676,23,4,27,26,26,52,7,0.319215,0.3282,0.000005,No
5,5,25,3,4,7,5,5,10,8,0.355524,0.370385,0.000005,No
6,6,36,5,6,11,6,6,12,7,0.363491,0.379555,0.000005,No
2,2,4,2,2,4,2,2,4,8,0.297529,0.304978,0.000005,No
1,1,1,1,1,2,1,1,2,8,0.311306,0.32231,0.000005,No
10,8,80,8,8,16,10,10,20,8,0.340837,0.353354,0.000005,No
16,16,256,4,8,12,16,16,32,7,0.348189,0.362083,0.000005,No
2,2,4,2,2,4,2,2,4,7,0.328463,0.339063,0.000005,No
19,19,361,15,7,22,19,19,38,7,0.353733,0.368874,0.000005,No
61,60,3660,5,21,26,61,61,122,7,0.388626,0.408376,0.000005,No
1,1,1,1,1,2,1,1,2,8,0.311306,0.32231,0.000005,No
18,18,324,6,11,17,18,18,36,8,0.355479,0.370896,0.000005,No
5,5,25,4,3,7,5,5,10,8,0.344798,0.35825,0.000005,No
7,7,49,5,5,10,7,7,14,7,0.356058,0.371021,0.000005,No
18,18,324,7,15,22,18,18,36,8,0.34707,0.360247,0.000005,No
19,19,361,4,15,19,19,19,38,7,0.381117,0.399865,0.000005,No
1,1,1,1,1,2,1,1,2,8,0.339941,0.352199,0.000005,No
2,2,4,1,2,3,2,2,4,8,0.342253,0.354901,0.000005,No
7,6,42,5,5,10,7,7,14,7,0.350061,0.364928,0.000005,No
9,9,81,9,6,15,9,9,18,7,0.33915,0.352027,0.000005,No
9,9,81,8,5,13,9,9,18,8,0.337207,0.349679,0.000005,No
10,10,100,3,7,10,10,10,20,8,0.336409,0.347491,0.000005,No
4,4,16,3,4,7,4,4,8,7,0.322284,0.330075,0.000005,No
16,15,240,12,13,25,16,16,32,7,0.367199,0.384245,0.000005,No
8,8,64,5,5,10,8,8,16,8,0.327266,0.336456,0.000005,No
3,2,6,2,3,5,3,3,6,7,0.324268,0.334185,0.000005,No
11,11,121,6,7,13,11,11,22,8,0.321059,0.329878,0.000005,No
1,1,1,1,1,2,1,1,2,8,0.309331,0.317947,0.000005,No
7,7,49,4,5,9,7,7,14,8,0.327763,0.338976,0.000005,No
11,11,121,7,6,13,11,11,22,8,0.351098,0.365393,0.000005,No
6,6,36,3,4,7,6,6,12,7,0.304164,0.314427,0.000005,No
1,1,1,1,1,2,1,1,2,8,0.311306,0.32231,0.000005,No
4,4,16,4,4,8,4,4,8,8,0.322949,0.332705,0.000005,No
9,9,81,6,7,13,9,9,18,8,0.351278,0.366542,0.000005,No
1,1,1,1,1,2,1,1,2,8,0.339934,0.352194,0.000005,No
6,5,30,5,6,11,6,6,12,7,0.343292,0.356032,0.000005,No
17,17,289,11,4,15,17,17,34,8,0.355257,0.370195,0.000005,No
4,4,16,4,4,8,4,4,8,8,0.342472,0.355464,0.000005,No
7,7,49,6,4,10,7,7,14,8,0.339454,0.353501,0.000005,No
2,2,4,2,2,4,2,2,4,8,0.34664,0.360933,0.000005,No
4,4,16,4,4,8,4,4,8,8,0.336402,0.350447,0.000005,No
5,5,25,4,3,7,5,5,10,8,0.286446,0.29359,0.000005,No
4,3,12,4,4,8,4,4,8,8,0.295683,0.302782,0.000005,No
9,9,81,6,6,12,9,9,18,8,0.335476,0.348017,0.000005,No
7,7,49,3,6,9,7,7,14,8,0.339002,0.351877,0.000005,No
8,8,64,3,6,9,8,8,16,8,0.333933,0.344501,0.000005,No
5,5,25,4,5,9,5,5,10,8,0.347105,0.360409,0.000005,No
12,12,144,5,6,11,12,12,24,8,0.348822,0.362902,0.000005,No
13,13,169,4,8,12,13,13,26,7,0.349001,0.363137,0.000005,No
16,16,256,4,7,11,16,16,32,8,0.328583,0.340065,0.000005,No
3,3,9,3,3,6,3,3,6,8,0.321852,0.332752,0.000005,No
2,2,4,1,1,2,2,2,4,8,0.311306,0.32231,0.000005,No
12,11,132,7,7,14,12,12,24,8,0.351793,0.366814,0.000005,No
7,7,49,4,7,11,7,7,14,8,0.341438,0.354025,0.000005,No
5,5,25,3,5,8,5,5,10,7,0.335641,0.347967,0.000005,No
16,13,208,9,8,17,16,16,32,8,0.370387,0.388193,0.000005,No
6,6,36,4,5,9,6,6,12,8,0.329745,0.339577,0.000005,No
6,5,30,3,5,8,6,6,12,8,0.344165,0.35684,0.000005,No
5,5,25,5,4,9,5,5,10,7,0.306784,0.316222,0.000005,No
2,2,4,2,2,4,2,2,4,8,0.307231,0.314862,0.000005,No
8,8,64,6,6,12,8,8,16,7,0.338895,0.35052,0.000005,No
6,6,36,6,5,11,6,6,12,8,0.335042,0.347292,0.000005,No
8,8,64,5,7,12,8,8,16,7,0.341923,0.35436,0.000005,No
3,3,9,3,3,6,3,3,6,8,0.335628,0.348846,0.000005,No
2,2,4,2,2,4,2,2,4,8,0.323463,0.334488,0.000005,No
9,9,81,3,6,9,9,9,18,7,0.347345,0.360729,0.000005,No
8,8,64,7,4,11,8,8,16,8,0.332872,0.344515,0.000005,No
4,4,16,4,4,8,4,4,8,7,0.352935,0.367395,0.000005,No
14,14,196,9,10,19,14,14,28,8,0.371994,0.39047,0.000005,No
10,9,90,4,7,11,10,10,20,8,0.320318,0.327968,0.000005,No
3,3,9,2,3,5,3,3,6,8,0.294048,0.304423,0.000005,No
5,5,25,5,5,10,5,5,10,8,0.356288,0.371176,0.000005,No
12,12,144,7,7,14,12,12,24,7,0.361719,0.378067,0.000005,No
9,9,81,3,8,11,9,9,18,8,0.354151,0.368357,0.000005,No
17,17,289,15,9,24,17,17,34,8,0.349122,0.36336,0.000005,No
3,2,6,3,2,5,3,3,6,7,0.339306,0.352082,0.000005,No
16,13,208,10,10,20,16,16,32,7,0.345713,0.357721,0.000005,No
14,14,196,8,11,19,14,14,28,7,0.354283,0.368942,0.000005,No
4,4,16,4,3,7,4,4,8,8,0.274215,0.281202,0.000005,No
7,7,49,6,4,10,7,7,14,8,0.346689,0.360312,0.000005,No
7,7,49,5,4,9,7,7,14,7,0.362711,0.378571,0.000005,No
8,8,64,4,6,10,8,8,16,8,0.328053,0.338999,0.000005,No
5,5,25,5,4,9,5,5,10,8,0.357348,0.372663,0.000005,No
3,2,6,1,2,3,3,3,6,8,0.327763,0.34053,0.000005,No
6,6,36,4,5,9,6,6,12,8,0.325388,0.336184,0.000005,No
4,4,16,3,3,6,4,4,8,8,0.330973,0.343893,0.000005,No
3,3,9,2,1,3,3,3,6,8,0.323426,0.334429,0.000005,No
6,6,36,4,4,8,6,6,12,8,0.325823,0.336786,0.000005,No
6,6,36,4,6,10,6,6,12,7,0.328343,0.336628,0.000005,No
4,4,16,3,3,6,4,4,8,8,0.339515,0.352808,0.000005,No
7,6,42,5,7,12,7,7,14,8,0.328868,0.340261,0.000005,No
6,6,36,5,4,9,6,6,12,8,0.345342,0.359386,0.000005,No
22,22,484,16,8,24,22,22,44,7,0.357528,0.372691,0.000005,No
14,14,196,8,10,18,14,14,28,7,0.358972,0.374901,0.000005,No
7,7,49,5,7,12,7,7,14,8,0.330441,0.339556,0.000005,No
5,5,25,4,5,9,5,5,10,8,0.312303,0.323219,0.000005,No
14,14,196,3,10,13,14,14,28,8,0.330205,0.340925,0.000004,yes
10,10,100,5,8,13,10,10,20,8,0.314166,0.32066,0.000004,No
7,7,49,3,2,5,7,7,14,8,0.342253,0.354901,0.000004,No
2,2,4,2,2,4,2,2,4,8,0.329408,0.34028,0.000004,No
2,2,4,2,2,4,2,2,4,7,0.33161,0.341859,0.000004,No
3,3,9,3,3,6,3,3,6,8,0.351843,0.36641,0.000004,No
4,4,16,4,4,8,4,4,8,8,0.343265,0.356346,0.000004,No
2,2,4,1,1,2,2,2,4,8,0.309983,0.317112,0.000004,No
6,5,30,4,6,10,6,6,12,7,0.35352,0.368123,0.000004,No
11,11,121,7,3,10,11,11,22,8,0.328305,0.340116,0.000004,No
20,20,400,10,8,18,20,20,40,7,0.347162,0.361302,0.000004,No
15,10,150,4,8,12,15,15,30,8,0.349315,0.36385,0.000004,No
6,6,36,3,5,8,6,6,12,8,0.326596,0.336765,0.000004,No
3,3,9,3,2,5,3,3,6,7,0.327958,0.338691,0.000004,No
7,6,42,3,7,10,7,7,14,8,0.348666,0.363131,0.000004,No
4,4,16,2,4,6,4,4,8,8,0.343085,0.356149,0.000004,No
2,2,4,2,2,4,2,2,4,8,0.287077,0.294315,0.000004,No
1,1,1,1,1,2,1,1,2,9,0.259833,0.265037,0.000004,No
12,12,144,11,8,19,12,12,24,8,0.344909,0.359044,0.000004,No
8,8,64,6,8,14,8,8,16,8,0.356459,0.371745,0.000004,No
21,20,420,13,10,23,21,21,42,8,0.365617,0.382002,0.000004,No
4,4,16,3,3,6,4,4,8,8,0.336781,0.34887,0.000004,No
4,4,16,4,4,8,4,4,8,8,0.317321,0.326699,0.000004,No
7,7,49,4,6,10,7,7,14,7,0.325655,0.333688,0.000004,No
4,4,16,4,4,8,4,4,8,8,0.324318,0.33313,0.000004,No
8,8,64,4,5,9,8,8,16,7,0.317711,0.32704,0.000004,No
7,7,49,5,6,11,7,7,14,8,0.32845,0.340008,0.000004,No
21,21,441,15,10,25,21,21,42,8,0.366363,0.382779,0.000004,No
1,1,1,1,1,2,1,1,2,7,0.327819,0.338512,0.000004,No
3,3,9,3,3,6,3,3,6,8,0.309449,0.318121,0.000004,No
7,7,49,2,4,6,7,7,14,8,0.321289,0.330329,0.000004,No
7,7,49,2,3,5,7,7,14,8,0.309797,0.31843,0.000004,No
2,2,4,2,2,4,2,2,4,7,0.328204,0.338849,0.000004,No
8,8,64,3,6,9,8,8,16,8,0.34782,0.361341,0.000004,No
6,6,36,5,5,10,6,6,12,8,0.344262,0.356976,0.000004,No
8,8,64,6,7,13,8,8,16,7,0.327876,0.336054,0.000004,No
16,15,240,8,7,15,16,16,32,8,0.345258,0.359696,0.000004,No
17,17,289,5,13,18,17,17,34,7,0.35474,0.369835,0.000004,No
6,6,36,2,6,8,6,6,12,8,0.324256,0.333787,0.000004,No
4,4,16,3,3,6,4,4,8,8,0.33746,0.348362,0.000004,No
11,10,110,4,9,13,11,11,22,8,0.349465,0.364072,0.000004,No
2,2,4,2,2,4,2,2,4,7,0.331597,0.34297,0.000004,No
8,8,64,6,7,13,8,8,16,8,0.330563,0.339703,0.000004,No
5,5,25,3,3,6,5,5,10,8,0.320582,0.331429,0.000004,No
5,5,25,4,4,8,5,5,10,8,0.326072,0.336944,0.000004,No
12,12,144,6,4,10,12,12,24,7,0.343493,0.356332,0.000004,No
8,8,64,2,5,7,8,8,16,8,0.333509,0.3451,0.000004,No
8,7,56,5,3,8,8,8,16,8,0.345084,0.358062,0.000004,No
11,11,121,8,8,16,11,11,22,7,0.342095,0.354528,0.000004,No
15,14,210,11,9,20,15,15,30,7,0.340192,0.352447,0.000004,No
6,6,36,3,5,8,6,6,12,8,0.355013,0.371014,0.000004,No
1,1,1,1,1,2,1,1,2,8,0.339934,0.352194,0.000004,No
4,4,16,3,4,7,4,4,8,8,0.326078,0.336689,0.000004,No
3,3,9,2,3,5,3,3,6,8,0.319628,0.327048,0.000004,No
6,6,36,5,6,11,6,6,12,8,0.352185,0.367383,0.000004,No
2,2,4,1,1,2,2,2,4,8,0.2953,0.302309,0.000004,No
2,2,4,2,2,4,2,2,4,7,0.335714,0.347567,0.000004,No
20,20,400,9,12,21,20,20,40,7,0.35963,0.374822,0.000004,No
1,1,1,1,1,2,1,1,2,9,0.26054,0.266098,0.000004,No
7,7,49,5,4,9,7,7,14,7,0.340701,0.353492,0.000004,No
2,2,4,2,2,4,2,2,4,9,0.267903,0.274822,0.000004,No
9,7,63,4,4,8,9,9,18,7,0.357595,0.372716,0.000004,No
6,6,36,4,2,6,6,6,12,7,0.352621,0.366966,0.000004,No
5,5,25,3,3,6,5,5,10,8,0.316093,0.32913,0.000004,No
4,4,16,4,3,7,4,4,8,7,0.348019,0.361983,0.000004,No
5,5,25,3,4,7,5,5,10,8,0.293274,0.30045,0.000004,No
3,3,9,3,3,6,3,3,6,8,0.334339,0.344944,0.000004,No
6,6,36,4,4,8,6,6,12,7,0.330685,0.341852,0.000004,No
6,6,36,5,5,10,6,6,12,8,0.333301,0.345554,0.000004,No
3,3,9,3,3,6,3,3,6,8,0.308341,0.320417,0.000004,No
6,6,36,3,6,9,6,6,12,8,0.324663,0.335039,0.000004,No
24,24,576,9,13,22,24,24,48,7,0.368866,0.386507,0.000004,No
2,2,4,2,2,4,2,2,4,7,0.331153,0.341767,0.000004,No
13,13,169,6,6,12,13,13,26,8,0.345447,0.359145,0.000004,No
13,13,169,6,4,10,13,13,26,7,0.348837,0.362945,0.000004,No
6,6,36,6,6,12,6,6,12,7,0.335292,0.345846,0.000004,No
5,5,25,2,5,7,5,5,10,8,0.319436,0.331143,0.000004,No
27,26,702,6,16,22,27,27,54,8,0.311932,0.319196,0.000004,No
20,20,400,4,11,15,20,20,40,8,0.378127,0.396551,0.000004,No
3,3,9,3,3,6,3,3,6,7,0.333594,0.344679,0.000004,No
10,9,90,9,4,13,10,10,20,8,0.349222,0.364163,0.000004,No
24,24,576,6,17,23,24,24,48,7,0.370629,0.387769,0.000004,No
24,24,576,11,7,18,24,24,48,7,0.34007,0.351292,0.000004,No
6,4,24,3,5,8,6,6,12,7,0.345601,0.35921,0.000004,No
8,7,56,8,8,16,8,8,16,8,0.335318,0.346261,0.000004,No
3,3,9,2,2,4,3,3,6,7,0.32787,0.33859,0.000004,No
4,4,16,3,3,6,4,4,8,8,0.322314,0.333567,0.000004,No
4,4,16,4,4,8,4,4,8,8,0.331083,0.34304,0.000004,No
9,9,81,4,6,10,9,9,18,7,0.329879,0.340479,0.000004,No
4,2,8,4,4,8,4,4,8,7,0.337227,0.348793,0.000004,No
2,2,4,2,2,4,2,2,4,8,0.343127,0.355994,0.000004,No
10,10,100,6,7,13,10,10,20,8,0.319879,0.328959,0.000004,No
4,4,16,2,4,6,4,4,8,8,0.31682,0.324313,0.000004,No
1,1,1,1,1,2,1,1,2,9,0.236687,0.240495,0.000004,No
5,5,25,3,3,6,5,5,10,8,0.310457,0.318993,0.000004,No
1,1,1,1,1,2,1,1,2,8,0.313502,0.320218,0.000004,No
2,2,4,2,2,4,2,2,4,7,0.31809,0.330229,0.000004,No
34,33,1122,8,9,17,34,34,68,8,0.367017,0.384308,0.000004,No
12,12,144,8,11,19,12,12,24,8,0.339643,0.354139,0.000004,No
2,2,4,2,2,4,2,2,4,8,0.318774,0.325918,0.000004,No
2,2,4,2,2,4,2,2,4,8,0.336469,0.349263,0.000004,No
12,12,144,6,8,14,12,12,24,7,0.346886,0.360044,0.000004,No
12,12,144,5,8,13,12,12,24,7,0.362087,0.37855,0.000004,No
7,7,49,6,5,11,7,7,14,8,0.346696,0.359994,0.000004,No
7,7,49,5,6,11,7,7,14,8,0.316274,0.323329,0.000004,No
20,19,380,5,6,11,20,20,40,7,0.351829,0.366202,0.000004,No
4,4,16,3,4,7,4,4,8,8,0.345727,0.358658,0.000004,No
12,10,120,7,6,13,12,12,24,8,0.356221,0.37104,0.000004,No
2,2,4,2,1,3,2,2,4,8,0.339934,0.352194,0.000004,No
4,4,16,2,4,6,4,4,8,8,0.320643,0.329098,0.000004,No
8,7,56,6,7,13,8,8,16,8,0.364057,0.380102,0.000004,No
1,1,1,1,1,2,1,1,2,8,0.25817,0.263604,0.000004,No
10,10,100,3,7,10,10,10,20,8,0.363824,0.381037,0.000004,No
22,20,440,17,13,30,22,22,44,7,0.361619,0.377848,0.000004,No
6,5,30,5,5,10,6,6,12,8,0.351141,0.364925,0.000004,No
7,6,42,4,5,9,7,7,14,8,0.304593,0.312545,0.000004,No
16,16,256,11,10,21,16,16,32,8,0.359797,0.375509,0.000004,No
4,4,16,2,4,6,4,4,8,8,0.319921,0.327188,0.000004,No
3,3,9,3,3,6,3,3,6,8,0.337694,0.351204,0.000004,No
5,5,25,3,3,6,5,5,10,7,0.355487,0.370166,0.000004,No
11,11,121,9,6,15,11,11,22,8,0.323463,0.333145,0.000004,No
5,5,25,5,4,9,5,5,10,7,0.3317,0.343298,0.000004,No
13,13,169,8,4,12,13,13,26,8,0.346823,0.361201,0.000004,No
3,3,9,2,3,5,3,3,6,8,0.320673,0.333105,0.000004,No
8,8,64,3,5,8,8,8,16,7,0.347948,0.362337,0.000004,No
7,7,49,5,4,9,7,7,14,8,0.349229,0.362564,0.000004,No
9,9,81,5,7,12,9,9,18,8,0.339927,0.353771,0.000004,No
1,1,1,1,1,2,1,1,2,8,0.314589,0.321465,0.000004,No
4,4,16,3,4,7,4,4,8,8,0.316321,0.33028,0.000004,No
4,4,16,2,4,6,4,4,8,8,0.347551,0.361195,0.000004,No
3,3,9,3,3,6,3,3,6,8,0.308308,0.316211,0.000004,No
7,7,49,4,4,8,7,7,14,8,0.355672,0.371733,0.000004,No
18,18,324,5,9,14,18,18,36,7,0.349473,0.364396,0.000004,No
1,1,1,1,1,2,1,1,2,8,0.339934,0.352194,0.000004,No
1,1,1,1,1,2,1,1,2,8,0.339934,0.352194,0.000004,No
7,7,49,5,4,9,7,7,14,8,0.362919,0.378854,0.000004,No
7,6,42,5,5,10,7,7,14,7,0.33835,0.350211,0.000004,No
2,2,4,1,1,2,2,2,4,9,0.220222,0.224437,0.000004,No
21,21,441,15,8,23,21,21,42,7,0.353835,0.367987,0.000004,No
9,9,81,6,4,10,9,9,18,8,0.356862,0.372592,0.000004,No
17,17,289,7,7,14,17,17,34,7,0.356705,0.372311,0.000004,No
7,7,49,6,6,12,7,7,14,8,0.331733,0.345351,0.000004,No
17,16,272,7,6,13,17,17,34,7,0.349623,0.363603,0.000004,No
1,1,1,1,1,2,1,1,2,8,0.339934,0.352194,0.000004,No
6,5,30,5,4,9,6,6,12,7,0.334084,0.346111,0.000004,No
6,5,30,4,6,10,6,6,12,7,0.346204,0.360365,0.000004,No
6,6,36,5,6,11,6,6,12,8,0.332742,0.344352,0.000004,No
4,3,12,4,4,8,4,4,8,8,0.318423,0.3273,0.000004,No
3,3,9,2,3,5,3,3,6,8,0.276096,0.283007,0.000004,No
2,2,4,1,1,2,2,2,4,8,0.339934,0.352194,0.000004,No
6,6,36,5,4,9,6,6,12,7,0.339164,0.350781,0.000004,No
6,6,36,4,5,9,6,6,12,8,0.337527,0.350074,0.000004,No
1,1,1,1,1,2,1,1,2,8,0.339941,0.352199,0.000004,No
3,2,6,3,3,6,3,3,6,8,0.313773,0.321821,0.000004,No
9,9,81,4,5,9,9,9,18,8,0.359577,0.375666,0.000004,No
3,3,9,3,2,5,3,3,6,8,0.297099,0.3084,0.000004,No
15,15,225,12,11,23,15,15,30,8,0.338505,0.350186,0.000004,No
3,3,9,3,3,6,3,3,6,8,0.289571,0.296803,0.000004,No
3,3,9,3,3,6,3,3,6,8,0.327687,0.339549,0.000004,No
11,11,121,3,8,11,11,11,22,7,0.339968,0.351169,0.000004,No
1,1,1,1,1,2,1,1,2,8,0.339934,0.352194,0.000004,No
7,6,42,4,7,11,7,7,14,7,0.352163,0.367735,0.000004,No
6,6,36,3,5,8,6,6,12,8,0.345965,0.35909,0.000004,No
1,1,1,1,1,2,1,1,2,7,0.327826,0.338517,0.000004,No
1,1,1,1,1,2,1,1,2,9,0.258679,0.264996,0.000004,No
6,6,36,6,5,11,6,6,12,8,0.308866,0.318141,0.000004,No
4,4,16,3,3,6,4,4,8,8,0.352418,0.367785,0.000004,No
4,4,16,3,4,7,4,4,8,8,0.310773,0.31737,0.000004,No
4,3,12,2,4,6,4,4,8,7,0.330384,0.340866,0.000004,No
11,11,121,2,10,12,11,11,22,7,0.353857,0.369353,0.000004,No
3,3,9,2,3,5,3,3,6,8,0.293744,0.303434,0.000004,No
2,2,4,2,2,4,2,2,4,8,0.342816,0.355495,0.000004,No
3,3,9,3,3,6,3,3,6,8,0.320161,0.329843,0.000004,No
12,12,144,6,8,14,12,12,24,7,0.351344,0.365034,0.000004,No
2,1,2,2,2,4,2,2,4,8,0.33161,0.343132,0.000004,No
2,2,4,2,2,4,2,2,4,8,0.324379,0.335427,0.000004,No
5,5,25,4,4,8,5,5,10,8,0.348716,0.362524,0.000004,No
11,11,121,8,8,16,11,11,22,7,0.359637,0.374839,0.000004,No
3,3,9,3,3,6,3,3,6,8,0.325245,0.336036,0.000004,No
5,5,25,2,3,5,5,5,10,8,0.340674,0.353772,0.000004,No
11,11,121,8,9,17,11,11,22,7,0.365594,0.382075,0.000004,No
10,10,100,7,7,14,10,10,20,8,0.324244,0.334057,0.000004,No
7,7,49,5,4,9,7,7,14,7,0.345615,0.359604,0.000004,No
3,3,9,2,2,4,3,3,6,8,0.281234,0.290654,0.000004,No
17,17,289,10,8,18,17,17,34,8,0.338814,0.351189,0.000004,No
5,5,25,5,5,10,5,5,10,7,0.337094,0.347868,0.000004,No
5,5,25,4,5,9,5,5,10,8,0.348246,0.3632,0.000004,No
2,2,4,2,2,4,2,2,4,7,0.331481,0.34251,0.000004,No
6,6,36,2,5,7,6,6,12,8,0.351018,0.366415,0.000004,No
4,4,16,2,3,5,4,4,8,8,0.323924,0.334081,0.000004,No
5,5,25,2,3,5,5,5,10,8,0.345629,0.359136,0.000004,No
4,4,16,1,4,5,4,4,8,8,0.329052,0.340177,0.000004,No
2,2,4,2,2,4,2,2,4,8,0.278757,0.288297,0.000004,No
6,6,36,4,4,8,6,6,12,8,0.338854,0.352381,0.000004,No
1,1,1,1,1,2,1,1,2,8,0.339934,0.352194,0.000004,No
6,6,36,5,5,10,6,6,12,8,0.313502,0.320971,0.000004,No
9,9,81,5,7,12,9,9,18,8,0.335476,0.348829,0.000004,No
2,2,4,2,2,4,2,2,4,7,0.332236,0.343545,0.000004,No
12,12,144,10,8,18,12,12,24,8,0.359198,0.375371,0.000004,No
11,11,121,3,4,7,11,11,22,8,0.31799,0.327342,0.000004,No
21,21,441,6,7,13,21,21,42,8,0.348019,0.361401,0.000004,No
15,15,225,10,11,21,15,15,30,7,0.368826,0.385539,0.000004,No
10,10,100,6,6,12,10,10,20,8,0.345811,0.3588,0.000004,No
7,7,49,5,5,10,7,7,14,8,0.325997,0.337024,0.000004,No
3,3,9,3,3,6,3,3,6,7,0.335562,0.34754,0.000004,No
3,3,9,3,3,6,3,3,6,7,0.335404,0.3477,0.000004,No
6,6,36,3,6,9,6,6,12,8,0.360519,0.377727,0.000004,No
13,13,169,1,7,8,13,13,26,8,0.3403,0.352476,0.000004,No
8,8,64,8,8,16,8,8,16,7,0.337647,0.348608,0.000004,No
1,1,1,1,1,2,1,1,2,8,0.2469,0.251301,0.000004,No
4,4,16,4,4,8,4,4,8,7,0.351257,0.365659,0.000004,No
6,5,30,6,5,11,6,6,12,8,0.354056,0.370548,0.000004,No
5,5,25,5,4,9,5,5,10,8,0.350614,0.363999,0.000004,No
17,16,272,13,8,21,17,17,34,8,0.34883,0.362796,0.000004,No
1,1,1,1,1,2,1,1,2,8,0.253533,0.257815,0.000004,No
1,1,1,1,1,2,1,1,2,10,0.214897,0.21815,0.000004,No
2,2,4,2,2,4,2,2,4,8,0.277867,0.286352,0.000004,No
16,16,256,11,9,20,16,16,32,8,0.320793,0.329648,0.000004,No
11,11,121,7,4,11,11,11,22,8,0.332976,0.344669,0.000004,No
15,15,225,10,11,21,15,15,30,7,0.36312,0.379701,0.000004,No
6,6,36,6,5,11,6,6,12,8,0.331546,0.343956,0.000004,No
2,2,4,2,2,4,2,2,4,9,0.274882,0.281676,0.000004,No
12,12,144,5,6,11,12,12,24,7,0.351865,0.366218,0.000004,No
4,4,16,4,3,7,4,4,8,8,0.329376,0.340636,0.000004,No
1,1,1,1,1,2,1,1,2,8,0.309331,0.317947,0.000004,No
24,24,576,11,14,25,24,24,48,7,0.371921,0.389352,0.000004,No
10,10,100,3,9,12,10,10,20,8,0.34607,0.359644,0.000004,No
5,5,25,4,4,8,5,5,10,8,0.332573,0.343347,0.000004,No
9,9,81,7,6,13,9,9,18,8,0.363398,0.379246,0.000004,No
18,18,324,10,10,20,18,18,36,8,0.352519,0.367719,0.000004,No
8,8,64,5,7,12,8,8,16,8,0.361934,0.377891,0.000004,No
6,6,36,5,4,9,6,6,12,8,0.343652,0.356597,0.000004,No
11,9,99,4,7,11,11,11,22,7,0.34883,0.362516,0.000004,No
2,2,4,2,2,4,2,2,4,8,0.304642,0.314773,0.000004,No
16,16,256,8,12,20,16,16,32,8,0.340314,0.352972,0.000004,No
2,2,4,2,2,4,2,2,4,7,0.328723,0.33929,0.000004,No
2,1,2,2,2,4,2,2,4,8,0.29159,0.298696,0.000004,No
2,2,4,2,2,4,2,2,4,8,0.339955,0.352243,0.000004,No
5,5,25,3,3,6,5,5,10,8,0.319311,0.329031,0.000004,No
3,3,9,3,3,6,3,3,6,8,0.324367,0.332441,0.000004,No
18,17,306,12,8,20,18,18,36,8,0.344436,0.358543,0.000004,No
2,2,4,2,2,4,2,2,4,8,0.310881,0.317697,0.000004,No
3,3,9,2,3,5,3,3,6,8,0.323439,0.334493,0.000004,No
9,9,81,7,5,12,9,9,18,7,0.350759,0.364553,0.000004,No
17,17,289,10,14,24,17,17,34,7,0.359297,0.374814,0.000004,No
1,1,1,1,1,2,1,1,2,8,0.255026,0.260163,0.000004,No
6,6,36,3,3,6,6,6,12,8,0.338706,0.351887,0.000004,No
7,7,49,6,6,12,7,7,14,8,0.344436,0.357637,0.000004,No
14,13,182,5,6,11,14,14,28,7,0.339238,0.350248,0.000004,No
1,1,1,1,1,2,1,1,2,10,0.211082,0.214136,0.000004,No
6,6,36,6,4,10,6,6,12,7,0.330262,0.342641,0.000004,No
2,2,4,2,2,4,2,2,4,9,0.267894,0.274362,0.000004,No
20,20,400,12,3,15,20,20,40,8,0.338444,0.351786,0.000004,No
8,7,56,5,5,10,8,8,16,8,0.331636,0.341693,0.000004,No
10,10,100,5,6,11,10,10,20,8,0.343389,0.357383,0.000004,No
2,2,4,2,2,4,2,2,4,8,0.330961,0.343854,0.000004,No
3,3,9,2,2,4,3,3,6,8,0.339941,0.352224,0.000004,No
5,5,25,3,4,7,5,5,10,7,0.350903,0.365165,0.000004,No
7,7,49,3,5,8,7,7,14,8,0.318001,0.327426,0.000004,No
3,3,9,2,3,5,3,3,6,8,0.309,0.317555,0.000004,No
1,1,1,1,1,2,1,1,2,8,0.339934,0.352194,0.000004,No
5,5,25,3,3,6,5,5,10,8,0.325847,0.33709,0.000004,No
10,10,100,5,7,12,10,10,20,7,0.35809,0.37345,0.000004,No
4,4,16,2,2,4,4,4,8,7,0.328267,0.338917,0.000004,No
4,4,16,4,4,8,4,4,8,8,0.346267,0.359733,0.000004,No
6,6,36,3,5,8,6,6,12,8,0.306497,0.313878,0.000004,No
2,2,4,1,2,3,2,2,4,8,0.327335,0.338387,0.000004,No
3,2,6,3,2,5,3,3,6,8,0.34361,0.356903,0.000004,No
9,9,81,4,6,10,9,9,18,8,0.360359,0.377732,0.000004,No
2,2,4,2,2,4,2,2,4,8,0.34516,0.358804,0.000004,No
8,8,64,3,5,8,8,8,16,8,0.345335,0.359039,0.000004,No
1,1,1,1,1,2,1,1,2,8,0.331578,0.343078,0.000004,No
6,6,36,2,4,6,6,6,12,8,0.344582,0.357865,0.000004,No
8,8,64,6,7,13,8,8,16,7,0.36619,0.382724,0.000004,No
18,18,324,15,13,28,18,18,36,8,0.374591,0.392235,0.000004,No
10,10,100,5,8,13,10,10,20,7,0.358278,0.373973,0.000004,No
7,7,49,5,7,12,7,7,14,7,0.332716,0.343104,0.000004,No
5,5,25,3,5,8,5,5,10,8,0.321053,0.329219,0.000004,No
5,5,25,2,4,6,5,5,10,9,0.286258,0.295094,0.000004,No
1,1,1,1,1,2,1,1,2,10,0.198052,0.199994,0.000004,No
5,5,25,4,3,7,5,5,10,8,0.341561,0.355673,0.000004,No
1,1,1,1,1,2,1,1,2,8,0.339934,0.352194,0.000004,No
3,3,9,2,2,4,3,3,6,8,0.311352,0.322393,0.000004,No
1,1,1,1,1,2,1,1,2,9,0.241313,0.245364,0.000004,No
6,6,36,4,5,9,6,6,12,7,0.34377,0.356854,0.000004,No
1,1,1,1,1,2,1,1,2,8,0.339934,0.352194,0.000004,No
7,7,49,4,6,10,7,7,14,8,0.343673,0.356898,0.000004,No
9,9,81,7,7,14,9,9,18,8,0.363778,0.380452,0.000004,No
2,1,2,2,1,3,2,2,4,8,0.339934,0.352194,0.000004,No
2,2,4,2,2,4,2,2,4,8,0.263115,0.268893,0.000004,No
4,4,16,3,4,7,4,4,8,7,0.344505,0.358215,0.000004,No
5,5,25,4,5,9,5,5,10,8,0.353527,0.369245,0.000004,No
9,9,81,2,6,8,9,9,18,8,0.331012,0.342927,0.000004,No
4,4,16,4,3,7,4,4,8,7,0.336369,0.346892,0.000004,No
1,1,1,1,1,2,1,1,2,8,0.32342,0.334424,0.000004,No
4,4,16,3,3,6,4,4,8,8,0.354041,0.369863,0.000004,No
4,3,12,4,4,8,4,4,8,7,0.349824,0.363081,0.000004,No
15,15,225,5,4,9,15,15,30,8,0.338605,0.350362,0.000004,No
3,3,9,3,3,6,3,3,6,8,0.333999,0.34505,0.000004,No
6,6,36,5,5,10,6,6,12,8,0.357101,0.372805,0.000004,No
2,2,4,2,2,4,2,2,4,7,0.332872,0.343166,0.000004,No
16,14,224,6,5,11,16,16,32,8,0.34128,0.354603,0.000004,No
4,4,16,3,4,7,4,4,8,8,0.333392,0.344504,0.000004,No
12,12,144,10,7,17,12,12,24,8,0.35935,0.375521,0.000004,No
13,13,169,9,12,21,13,13,26,8,0.378312,0.396674,0.000004,No
8,8,64,5,5,10,8,8,16,8,0.337741,0.349323,0.000004,No
5,5,25,4,5,9,5,5,10,8,0.324521,0.333511,0.000004,No
2,2,4,2,2,4,2,2,4,7,0.296315,0.304894,0.000004,No
10,8,80,6,5,11,10,10,20,7,0.344311,0.358656,0.000004,No
1,1,1,1,1,2,1,1,2,9,0.244589,0.24915,0.000004,No
1,1,1,1,1,2,1,1,2,8,0.339934,0.352194,0.000004,No
17,17,289,9,14,23,17,17,34,8,0.372132,0.390031,0.000003,yes
11,11,121,3,6,9,11,11,22,8,0.290513,0.297655,0.000003,yes
3,2,6,3,3,6,3,3,6,8,0.335674,0.348371,0.000003,No
1,1,1,1,1,2,1,1,2,8,0.339934,0.352194,0.000003,No
6,6,36,4,3,7,6,6,12,8,0.32916,0.341347,0.000003,No
1,1,1,1,1,2,1,1,2,9,0.248674,0.253915,0.000003,No
7,7,49,6,7,13,7,7,14,8,0.326558,0.335607,0.000003,No
4,4,16,3,3,6,4,4,8,7,0.342239,0.354917,0.000003,No
4,4,16,3,3,6,4,4,8,8,0.313762,0.32148,0.000003,No
4,4,16,4,4,8,4,4,8,8,0.309673,0.316871,0.000003,No
1,1,1,1,1,2,1,1,2,8,0.339941,0.352199,0.000003,No
16,13,208,8,7,15,16,16,32,8,0.346534,0.360223,0.000003,No
1,1,1,1,1,2,1,1,2,9,0.261751,0.267315,0.000003,No
6,6,36,3,1,4,6,6,12,8,0.310028,0.318679,0.000003,No
5,5,25,4,3,7,5,5,10,8,0.310118,0.318829,0.000003,No
2,2,4,2,2,4,2,2,4,8,0.325338,0.337449,0.000003,No
1,1,1,1,1,2,1,1,2,8,0.288168,0.299068,0.000003,No
10,10,100,8,6,14,10,10,20,8,0.355701,0.37111,0.000003,No
8,8,64,6,5,11,8,8,16,8,0.334241,0.346332,0.000003,No
6,5,30,2,5,7,6,6,12,8,0.332664,0.344521,0.000003,No
9,8,72,6,6,12,9,9,18,8,0.327448,0.338128,0.000003,No
4,3,12,3,4,7,4,4,8,8,0.313947,0.322306,0.000003,No
4,4,16,3,3,6,4,4,8,8,0.334097,0.345979,0.000003,No
5,5,25,3,5,8,5,5,10,7,0.343527,0.357242,0.000003,No
3,3,9,3,3,6,3,3,6,8,0.32098,0.329242,0.000003,No
3,3,9,3,2,5,3,3,6,8,0.324558,0.335403,0.000003,No
1,1,1,1,1,2,1,1,2,9,0.248826,0.252698,0.000003,No
2,2,4,2,2,4,2,2,4,8,0.284317,0.293742,0.000003,No
6,6,36,5,5,10,6,6,12,8,0.348637,0.362634,0.000003,No
7,7,49,5,4,9,7,7,14,8,0.32449,0.335679,0.000003,No
10,10,100,3,10,13,10,10,20,7,0.34858,0.362025,0.000003,No
3,3,9,2,2,4,3,3,6,8,0.339948,0.352234,0.000003,No
12,12,144,10,10,20,12,12,24,8,0.325835,0.337368,0.000003,No
1,1,1,1,1,2,1,1,2,7,0.327819,0.338512,0.000003,No
7,7,49,5,6,11,7,7,14,8,0.318815,0.328906,0.000003,No
8,6,48,5,5,10,8,8,16,8,0.355361,0.370363,0.000003,No
4,4,16,2,3,5,4,4,8,8,0.332651,0.346042,0.000003,No
1,1,1,1,1,2,1,1,2,8,0.317451,0.327459,0.000003,No
2,2,4,2,2,4,2,2,4,8,0.301829,0.314746,0.000003,No
8,7,56,4,6,10,8,8,16,7,0.338921,0.350193,0.000003,No
3,3,9,3,3,6,3,3,6,7,0.339339,0.352141,0.000003,No
7,7,49,4,4,8,7,7,14,7,0.32979,0.340281,0.000003,No
7,7,49,5,4,9,7,7,14,8,0.341124,0.353524,0.000003,No
4,4,16,4,1,5,4,4,8,7,0.327819,0.338512,0.000003,No
21,21,441,13,8,21,21,21,42,7,0.352228,0.366441,0.000003,No
3,3,9,2,2,4,3,3,6,8,0.326415,0.338228,0.000003,No
9,9,81,7,7,14,9,9,18,7,0.337828,0.349355,0.000003,No
2,2,4,2,2,4,2,2,4,8,0.321749,0.332336,0.000003,No
9,9,81,5,5,10,9,9,18,8,0.321767,0.329955,0.000003,No
4,4,16,4,4,8,4,4,8,8,0.326859,0.337731,0.000003,No
13,13,169,3,8,11,13,13,26,7,0.373345,0.390663,0.000003,No
5,5,25,5,5,10,5,5,10,7,0.334772,0.346916,0.000003,No
4,4,16,3,3,6,4,4,8,7,0.331552,0.343047,0.000003,No
13,13,169,5,7,12,13,13,26,8,0.352228,0.367446,0.000003,No
11,11,121,10,6,16,11,11,22,8,0.338404,0.349936,0.000003,No
2,2,4,2,2,4,2,2,4,8,0.302621,0.315543,0.000003,No
8,8,64,7,7,14,8,8,16,7,0.360405,0.376006,0.000003,No
4,4,16,2,2,4,4,4,8,8,0.352396,0.367736,0.000003,No
4,4,16,3,3,6,4,4,8,7,0.3541,0.368909,0.000003,No
12,12,144,3,3,6,12,12,24,8,0.34049,0.35273,0.000003,No
14,14,196,7,11,18,14,14,28,7,0.346204,0.359209,0.000003,No
2,2,4,2,1,3,2,2,4,8,0.301584,0.314486,0.000003,No
21,21,441,3,4,7,21,21,42,7,0.343583,0.357394,0.000003,No
11,11,121,2,7,9,11,11,22,8,0.311562,0.321987,0.000003,No
1,1,1,1,1,2,1,1,2,8,0.317445,0.327454,0.000003,No
3,3,9,3,3,6,3,3,6,8,0.324774,0.335653,0.000003,No
3,3,9,3,3,6,3,3,6,8,0.300717,0.31112,0.000003,No
5,5,25,4,4,8,5,5,10,7,0.351771,0.366323,0.000003,No
3,3,9,3,3,6,3,3,6,8,0.298356,0.307464,0.000003,No
6,6,36,3,5,8,6,6,12,8,0.352629,0.367126,0.000003,No
4,4,16,4,4,8,4,4,8,8,0.317186,0.328557,0.000003,No
13,13,169,6,5,11,13,13,26,7,0.345167,0.359878,0.000003,No
7,7,49,6,6,12,7,7,14,8,0.33201,0.343256,0.000003,No
2,2,4,2,2,4,2,2,4,8,0.313595,0.320369,0.000003,No
14,14,196,10,11,21,14,14,28,8,0.344874,0.3579,0.000003,No
15,15,225,9,8,17,15,15,30,7,0.346668,0.360746,0.000003,No
5,5,25,3,3,6,5,5,10,8,0.291985,0.300548,0.000003,No
12,12,144,6,9,15,12,12,24,8,0.342314,0.355854,0.000003,No
4,4,16,3,4,7,4,4,8,8,0.291441,0.298495,0.000003,No
11,11,121,6,5,11,11,11,22,8,0.351119,0.365303,0.000003,No
7,7,49,5,6,11,7,7,14,8,0.326016,0.335063,0.000003,No
3,3,9,2,2,4,3,3,6,8,0.287619,0.298854,0.000003,No
22,22,484,7,12,19,22,22,44,8,0.372978,0.391668,0.000003,No
5,5,25,4,3,7,5,5,10,8,0.353147,0.368613,0.000003,No
7,7,49,6,6,12,7,7,14,8,0.318435,0.326498,0.000003,No
4,4,16,2,4,6,4,4,8,8,0.286398,0.293521,0.000003,No
8,7,56,8,7,15,8,8,16,8,0.350521,0.36475,0.000003,No
6,6,36,6,5,11,6,6,12,8,0.344603,0.357717,0.000003,No
4,4,16,3,4,7,4,4,8,7,0.330832,0.342567,0.000003,No
5,5,25,2,3,5,5,5,10,8,0.323494,0.334556,0.000003,No
26,26,676,2,8,10,26,26,52,7,0.348751,0.364066,0.000003,No
3,3,9,3,3,6,3,3,6,8,0.30743,0.317204,0.000003,No
7,6,42,4,5,9,7,7,14,7,0.355546,0.370278,0.000003,No
3,3,9,2,3,5,3,3,6,8,0.332139,0.343602,0.000003,No
10,10,100,8,4,12,10,10,20,8,0.3425,0.355337,0.000003,No
9,9,81,6,6,12,9,9,18,8,0.305198,0.312323,0.000003,No
6,6,36,3,1,4,6,6,12,8,0.273437,0.280423,0.000003,No
1,1,1,1,1,2,1,1,2,7,0.327819,0.338512,0.000003,No
2,2,4,1,2,3,2,2,4,8,0.330961,0.343854,0.000003,No
6,6,36,3,5,8,6,6,12,8,0.297405,0.30714,0.000003,No
6,6,36,3,6,9,6,6,12,8,0.369761,0.386963,0.000003,No
1,1,1,1,1,2,1,1,2,7,0.327826,0.338517,0.000003,No
6,6,36,4,4,8,6,6,12,8,0.330134,0.342538,0.000003,No
5,5,25,3,2,5,5,5,10,7,0.328015,0.338776,0.000003,No
3,3,9,2,3,5,3,3,6,7,0.328387,0.339043,0.000003,No
7,7,49,3,5,8,7,7,14,8,0.34794,0.361079,0.000003,No
1,1,1,1,1,2,1,1,2,8,0.317445,0.327454,0.000003,No
7,7,49,2,4,6,7,7,14,8,0.328666,0.340849,0.000003,No
2,2,4,2,2,4,2,2,4,8,0.316251,0.323981,0.000003,No
1,1,1,1,1,2,1,1,2,8,0.301589,0.314491,0.000003,No
6,6,36,4,5,9,6,6,12,8,0.335939,0.347225,0.000003,No
49,44,2156,14,11,25,49,49,98,8,0.331018,0.341756,0.000003,No
12,12,144,10,10,20,12,12,24,7,0.375465,0.393403,0.000003,No
11,10,110,2,9,11,11,11,22,7,0.368762,0.386031,0.000003,No
4,4,16,3,3,6,4,4,8,8,0.330595,0.341162,0.000003,No
15,15,225,7,8,15,15,15,30,8,0.353652,0.36815,0.000003,No
6,6,36,2,3,5,6,6,12,8,0.349738,0.364072,0.000003,No
4,3,12,4,4,8,4,4,8,8,0.352804,0.368278,0.000003,No
8,8,64,6,5,11,8,8,16,7,0.351851,0.366832,0.000003,No
11,10,110,3,6,9,11,11,22,8,0.345363,0.358525,0.000003,No
5,5,25,4,5,9,5,5,10,7,0.333138,0.344046,0.000003,No
3,3,9,3,3,6,3,3,6,8,0.352745,0.368183,0.000003,No
6,6,36,2,4,6,6,6,12,8,0.316034,0.323245,0.000003,No
5,5,25,4,5,9,5,5,10,8,0.323304,0.332301,0.000003,No
8,8,64,7,6,13,8,8,16,7,0.350845,0.364603,0.000003,No
11,11,121,9,5,14,11,11,22,7,0.359721,0.375227,0.000003,No
7,7,49,4,6,10,7,7,14,8,0.319257,0.326748,0.000003,No
8,8,64,6,6,12,8,8,16,8,0.356967,0.371844,0.000003,No
5,5,25,4,3,7,5,5,10,7,0.352716,0.367076,0.000003,No
3,3,9,2,3,5,3,3,6,7,0.330122,0.341322,0.000003,No
1,1,1,1,1,2,1,1,2,8,0.290019,0.297096,0.000003,No
8,8,64,3,6,9,8,8,16,7,0.341588,0.35378,0.000003,No
4,4,16,3,3,6,4,4,8,8,0.333457,0.345758,0.000003,No
1,1,1,1,1,2,1,1,2,8,0.260707,0.266241,0.000003,No
7,7,49,6,6,12,7,7,14,8,0.329382,0.340217,0.000003,No
8,7,56,5,4,9,8,8,16,7,0.351989,0.366492,0.000003,No
16,15,240,8,11,19,16,16,32,7,0.374025,0.391411,0.000003,No
8,8,64,6,4,10,8,8,16,7,0.35042,0.364912,0.000003,No
9,9,81,8,5,13,9,9,18,8,0.332826,0.344133,0.000003,No
5,4,20,5,3,8,5,5,10,7,0.332463,0.342598,0.000003,No
6,6,36,3,4,7,6,6,12,8,0.316421,0.325702,0.000003,No
5,5,25,2,3,5,5,5,10,8,0.291446,0.299303,0.000003,No
3,3,9,3,3,6,3,3,6,8,0.323807,0.334932,0.000003,No
6,6,36,3,4,7,6,6,12,8,0.344846,0.357856,0.000003,No
2,2,4,1,1,2,2,2,4,8,0.271005,0.2775,0.000003,No
4,4,16,4,3,7,4,4,8,8,0.317245,0.325263,0.000003,No
1,1,1,1,1,2,1,1,2,8,0.301589,0.314491,0.000003,No
5,5,25,3,3,6,5,5,10,8,0.327656,0.338691,0.000003,No
4,3,12,4,3,7,4,4,8,8,0.340253,0.352584,0.000003,No
2,2,4,1,2,3,2,2,4,8,0.338015,0.350314,0.000003,No
4,4,16,3,4,7,4,4,8,7,0.30712,0.316917,0.000003,No
1,1,1,1,1,2,1,1,2,8,0.253423,0.258511,0.000003,No
2,2,4,1,2,3,2,2,4,8,0.309859,0.31859,0.000003,No
9,8,72,4,7,11,9,9,18,8,0.346738,0.360341,0.000003,No
3,3,9,2,3,5,3,3,6,8,0.346654,0.35973,0.000003,No
8,8,64,3,7,10,8,8,16,7,0.367721,0.384956,0.000003,No
18,18,324,7,9,16,18,18,36,7,0.355998,0.371001,0.000003,No
3,3,9,3,3,6,3,3,6,8,0.295371,0.304591,0.000003,No
5,5,25,4,4,8,5,5,10,8,0.346372,0.360419,0.000003,No
5,5,25,1,4,5,5,5,10,8,0.335641,0.347608,0.000003,No
2,2,4,2,2,4,2,2,4,7,0.331102,0.341562,0.000003,No
3,3,9,3,3,6,3,3,6,8,0.321216,0.329928,0.000003,No
12,11,132,5,5,10,12,12,24,8,0.364244,0.381219,0.000003,No
6,4,24,3,4,7,6,6,12,8,0.344686,0.358143,0.000003,No
3,3,9,3,3,6,3,3,6,8,0.321695,0.329539,0.000003,No
5,5,25,4,3,7,5,5,10,8,0.327763,0.339637,0.000003,No
1,1,1,1,1,2,1,1,2,8,0.339934,0.352194,0.000003,No
7,7,49,6,5,11,7,7,14,8,0.366844,0.383211,0.000003,No
2,2,4,2,2,4,2,2,4,8,0.283387,0.290418,0.000003,No
1,1,1,1,1,2,1,1,2,7,0.327819,0.338512,0.000003,No
5,5,25,4,4,8,5,5,10,8,0.345042,0.357995,0.000003,No
8,8,64,3,5,8,8,8,16,8,0.3399,0.353284,0.000003,No
5,5,25,4,5,9,5,5,10,8,0.318405,0.325524,0.000003,No
2,2,4,2,2,4,2,2,4,8,0.272842,0.280262,0.000003,No
6,6,36,4,4,8,6,6,12,8,0.3317,0.343286,0.000003,No
2,2,4,1,1,2,2,2,4,8,0.339941,0.352199,0.000003,No
10,10,100,6,10,16,10,10,20,8,0.350427,0.365821,0.000003,No
12,12,144,9,10,19,12,12,24,8,0.352287,0.366756,0.000003,No
3,3,9,3,3,6,3,3,6,8,0.317109,0.329243,0.000003,No
4,4,16,4,4,8,4,4,8,8,0.33064,0.340796,0.000003,No
1,1,1,1,1,2,1,1,2,9,0.228714,0.232549,0.000003,No
2,2,4,2,2,4,2,2,4,8,0.309786,0.316988,0.000003,No
5,5,25,3,4,7,5,5,10,8,0.330243,0.342431,0.000003,No
14,13,182,5,12,17,14,14,28,7,0.355902,0.371882,0.000003,No
1,1,1,1,1,2,1,1,2,9,0.261626,0.267259,0.000003,No
3,3,9,1,3,4,3,3,6,7,0.331733,0.343258,0.000003,No
4,4,16,2,3,5,4,4,8,8,0.310287,0.318766,0.000003,No
7,7,49,4,3,7,7,7,14,8,0.341431,0.354307,0.000003,No
2,2,4,2,2,4,2,2,4,8,0.259687,0.264803,0.000003,No
3,3,9,3,3,6,3,3,6,8,0.287498,0.294714,0.000003,No
3,3,9,3,2,5,3,3,6,8,0.339982,0.352277,0.000003,No
1,1,1,1,1,2,1,1,2,8,0.339941,0.352199,0.000003,No
5,5,25,5,5,10,5,5,10,7,0.353799,0.368631,0.000003,No
4,4,16,3,3,6,4,4,8,8,0.343299,0.35637,0.000003,No
6,6,36,6,6,12,6,6,12,8,0.357595,0.372935,0.000003,No
5,5,25,3,4,7,5,5,10,7,0.333392,0.345037,0.000003,No
3,3,9,2,3,5,3,3,6,8,0.284317,0.292446,0.000003,No
6,6,36,4,2,6,6,6,12,8,0.267286,0.273762,0.000003,No
8,7,56,4,8,12,8,8,16,8,0.352877,0.36778,0.000003,No
8,7,56,6,7,13,8,8,16,8,0.336814,0.348913,0.000003,No
6,6,36,4,3,7,6,6,12,7,0.333197,0.344826,0.000003,No
4,3,12,3,4,7,4,4,8,8,0.343354,0.356302,0.000003,No
11,11,121,6,6,12,11,11,22,7,0.364329,0.380473,0.000003,No
1,1,1,1,1,2,1,1,2,7,0.327819,0.338512,0.000003,No
2,2,4,2,2,4,2,2,4,8,0.303839,0.316481,0.000003,No
11,11,121,7,5,12,11,11,22,7,0.356437,0.371601,0.000003,No
1,1,1,1,1,2,1,1,2,9,0.24867,0.25391,0.000003,No
3,3,9,3,3,6,3,3,6,7,0.319957,0.331926,0.000003,No
2,2,4,2,2,4,2,2,4,8,0.342335,0.354877,0.000003,No
5,5,25,3,4,7,5,5,10,7,0.340389,0.353192,0.000003,No
5,5,25,5,5,10,5,5,10,7,0.336104,0.346671,0.000003,No
4,4,16,3,3,6,4,4,8,8,0.306349,0.318718,0.000003,No
18,18,324,10,8,18,18,18,36,8,0.363592,0.379743,0.000003,No
1,1,1,1,1,2,1,1,2,9,0.257819,0.263331,0.000003,No
1,1,1,1,1,2,1,1,2,9,0.249019,0.253703,0.000003,No
7,7,49,4,6,10,7,7,14,7,0.356795,0.371571,0.000003,No
5,5,25,4,3,7,5,5,10,8,0.288499,0.295602,0.000003,No
3,3,9,3,3,6,3,3,6,7,0.345007,0.357885,0.000003,No
10,10,100,3,6,9,10,10,20,7,0.355146,0.369901,0.000003,No
3,3,9,3,3,6,3,3,6,8,0.334779,0.346294,0.000003,No
2,2,4,2,2,4,2,2,4,8,0.24879,0.25254,0.000003,No
7,6,42,2,6,8,7,7,14,8,0.338229,0.350567,0.000003,No
3,3,9,2,2,4,3,3,6,8,0.339961,0.352253,0.000003,No
12,12,144,7,7,14,12,12,24,8,0.351184,0.365367,0.000003,No
3,3,9,2,3,5,3,3,6,7,0.328875,0.339539,0.000003,No
1,1,1,1,1,2,1,1,2,9,0.253706,0.258579,0.000003,No
2,2,4,2,2,4,2,2,4,8,0.309848,0.317064,0.000003,No
4,4,16,3,4,7,4,4,8,7,0.353425,0.367806,0.000003,No
9,8,72,6,7,13,9,9,18,8,0.359191,0.37525,0.000003,No
6,6,36,6,5,11,6,6,12,7,0.343085,0.354868,0.000003,No
3,3,9,2,3,5,3,3,6,8,0.324521,0.335404,0.000003,No
7,7,49,4,6,10,7,7,14,7,0.35938,0.374929,0.000003,No
4,4,16,4,4,8,4,4,8,8,0.330909,0.343161,0.000003,No
5,4,20,2,3,5,5,5,10,8,0.352112,0.366442,0.000003,No
6,5,30,3,4,7,6,6,12,8,0.344311,0.357247,0.000003,No
10,10,100,8,8,16,10,10,20,8,0.333021,0.344328,0.000003,No
5,5,25,5,5,10,5,5,10,8,0.329446,0.340397,0.000003,No
1,1,1,1,1,2,1,1,2,9,0.253729,0.258607,0.000003,No
17,17,289,11,11,22,17,17,34,7,0.356698,0.371305,0.000003,No
6,6,36,2,4,6,6,6,12,8,0.321373,0.331775,0.000003,No
5,5,25,4,4,8,5,5,10,8,0.328274,0.339866,0.000003,No
6,6,36,6,5,11,6,6,12,7,0.327203,0.335366,0.000003,No
9,9,81,7,8,15,9,9,18,7,0.363197,0.37976,0.000003,No
6,6,36,4,4,8,6,6,12,7,0.335899,0.346565,0.000003,No
4,4,16,3,3,6,4,4,8,8,0.343424,0.35732,0.000003,No
2,1,2,2,2,4,2,2,4,9,0.260567,0.266132,0.000003,No
2,2,4,2,2,4,2,2,4,8,0.346971,0.361663,0.000003,No
5,5,25,5,5,10,5,5,10,8,0.354261,0.369131,0.000003,No
10,10,100,7,7,14,10,10,20,8,0.343472,0.356345,0.000003,No
3,3,9,3,3,6,3,3,6,8,0.31672,0.323493,0.000003,No
7,7,49,6,7,13,7,7,14,8,0.343368,0.356696,0.000003,No
2,2,4,2,2,4,2,2,4,7,0.332236,0.343545,0.000003,No
2,2,4,2,2,4,2,2,4,7,0.296377,0.304973,0.000003,No
1,1,1,1,1,2,1,1,2,8,0.339934,0.352194,0.000003,No
5,5,25,3,4,7,5,5,10,8,0.314369,0.320825,0.000003,No
10,10,100,5,4,9,10,10,20,7,0.356474,0.371643,0.000003,No
5,5,25,3,3,6,5,5,10,7,0.333275,0.34377,0.000003,No
1,1,1,1,1,2,1,1,2,8,0.301589,0.314491,0.000003,No
6,6,36,4,5,9,6,6,12,8,0.349265,0.363592,0.000003,No
2,2,4,2,2,4,2,2,4,8,0.288251,0.299199,0.000003,No
2,2,4,2,2,4,2,2,4,8,0.29088,0.301777,0.000003,No
1,1,1,1,1,2,1,1,2,9,0.242348,0.246314,0.000003,No
3,3,9,3,3,6,3,3,6,8,0.333268,0.344836,0.000003,No
4,3,12,3,3,6,4,4,8,8,0.348979,0.362962,0.000003,No
3,3,9,2,3,5,3,3,6,8,0.31728,0.327022,0.000003,No
4,4,16,4,4,8,4,4,8,8,0.31946,0.326667,0.000003,No
3,3,9,2,3,5,3,3,6,8,0.349946,0.364557,0.000003,No
10,10,100,7,7,14,10,10,20,7,0.365078,0.381144,0.000003,No
4,4,16,3,3,6,4,4,8,9,0.253732,0.258567,0.000003,No
5,5,25,3,3,6,5,5,10,8,0.361359,0.37701,0.000003,No
4,4,16,3,4,7,4,4,8,8,0.355887,0.371217,0.000003,No
4,4,16,3,4,7,4,4,8,8,0.323752,0.332549,0.000003,No
4,4,16,3,3,6,4,4,8,8,0.310903,0.31972,0.000003,No
5,5,25,4,4,8,5,5,10,8,0.316052,0.32385,0.000003,No
1,1,1,1,1,2,1,1,2,8,0.288168,0.299068,0.000003,No
2,2,4,1,1,2,2,2,4,9,0.253725,0.258602,0.000003,No
3,2,6,3,3,6,3,3,6,7,0.332262,0.343598,0.000003,No
1,1,1,1,1,2,1,1,2,8,0.339934,0.352194,0.000003,No
6,5,30,4,2,6,6,6,12,8,0.296825,0.306183,0.000003,No
1,1,1,1,1,2,1,1,2,7,0.327819,0.338512,0.000003,No
3,3,9,2,3,5,3,3,6,8,0.331623,0.343233,0.000003,No
3,3,9,2,3,5,3,3,6,8,0.306233,0.318678,0.000003,No
7,7,49,6,6,12,7,7,14,8,0.342644,0.355649,0.000003,No
4,3,12,3,4,7,4,4,8,8,0.344075,0.357113,0.000003,No
1,1,1,1,1,2,1,1,2,8,0.25661,0.261896,0.000003,No
2,2,4,2,2,4,2,2,4,8,0.320047,0.328286,0.000003,No
6,6,36,5,4,9,6,6,12,8,0.340865,0.353192,0.000003,No
3,3,9,3,3,6,3,3,6,8,0.308581,0.315155,0.000003,No
5,5,25,4,5,9,5,5,10,7,0.345965,0.360162,0.000003,No
5,5,25,1,3,4,5,5,10,8,0.316626,0.325434,0.000003,No
7,7,49,4,5,9,7,7,14,8,0.354725,0.37004,0.000003,No
2,2,4,2,2,4,2,2,4,8,0.312538,0.320246,0.000003,No
15,15,225,3,4,7,15,15,30,7,0.335556,0.347539,0.000003,No
3,3,9,3,3,6,3,3,6,8,0.355501,0.370583,0.000003,No
3,3,9,3,3,6,3,3,6,8,0.32845,0.340109,0.000003,No
19,19,361,7,2,9,19,19,38,8,0.338189,0.350948,0.000003,No
13,12,156,11,10,21,13,13,26,8,0.358572,0.374323,0.000003,No
11,11,121,4,9,13,11,11,22,8,0.366214,0.382938,0.000003,No
9,9,81,4,7,11,9,9,18,8,0.345398,0.359544,0.000003,No
4,4,16,4,3,7,4,4,8,8,0.344443,0.357476,0.000003,No
19,19,361,10,11,21,19,19,38,8,0.369841,0.386666,0.000003,No
5,5,25,4,4,8,5,5,10,8,0.332989,0.343423,0.000003,No
13,13,169,5,5,10,13,13,26,7,0.338666,0.350071,0.000003,No
4,4,16,3,2,5,4,4,8,8,0.331617,0.343145,0.000003,No
7,7,49,6,5,11,7,7,14,8,0.352039,0.36717,0.000003,No
6,6,36,6,6,12,6,6,12,8,0.336542,0.349141,0.000003,No
18,18,324,12,12,24,18,18,36,8,0.339029,0.351303,0.000003,No
2,2,4,2,2,4,2,2,4,7,0.305422,0.31691,0.000003,No
8,8,64,2,7,9,8,8,16,7,0.356192,0.371495,0.000003,No
2,2,4,2,2,4,2,2,4,8,0.299382,0.306941,0.000003,No
1,1,1,1,1,2,1,1,2,8,0.339941,0.352199,0.000003,No
8,8,64,7,5,12,8,8,16,7,0.331295,0.343533,0.000003,No
10,10,100,8,4,12,10,10,20,8,0.325406,0.33627,0.000003,No
15,14,210,11,4,15,15,15,30,8,0.324157,0.335328,0.000003,No
2,2,4,2,2,4,2,2,4,8,0.270536,0.276911,0.000003,No
14,13,182,10,8,18,14,14,28,8,0.351278,0.365344,0.000003,No
5,4,20,2,4,6,5,5,10,8,0.3089,0.315743,0.000003,No
9,9,81,7,8,15,9,9,18,8,0.324626,0.335111,0.000003,No
9,9,81,5,6,11,9,9,18,8,0.289061,0.297838,0.000003,No
3,3,9,3,3,6,3,3,6,8,0.313952,0.323407,0.000003,No
1,1,1,1,1,2,1,1,2,9,0.259056,0.26452,0.000003,No
18,18,324,12,10,22,18,18,36,8,0.35752,0.372766,0.000003,No
6,6,36,3,3,6,6,6,12,8,0.293496,0.305131,0.000003,No
17,15,255,6,14,20,17,17,34,8,0.377885,0.396432,0.000003,No
9,9,81,8,8,16,9,9,18,8,0.353425,0.368002,0.000003,No
1,1,1,1,1,2,1,1,2,8,0.274232,0.281134,0.000003,No
12,12,144,10,7,17,12,12,24,7,0.35579,0.370674,0.000003,No
5,5,25,3,4,7,5,5,10,8,0.343223,0.355879,0.000003,No
3,3,9,2,2,4,3,3,6,8,0.317327,0.324451,0.000003,No
4,4,16,4,4,8,4,4,8,8,0.309701,0.322176,0.000003,No
4,4,16,4,4,8,4,4,8,8,0.340334,0.35426,0.000003,No
2,2,4,2,1,3,2,2,4,7,0.327813,0.338503,0.000003,No
14,14,196,11,4,15,14,14,28,8,0.329898,0.341194,0.000003,No
11,11,121,8,10,18,11,11,22,8,0.335298,0.345846,0.000003,No
22,21,462,13,11,24,22,22,44,8,0.337935,0.350049,0.000003,No
2,2,4,2,2,4,2,2,4,8,0.318702,0.328996,0.000003,No
8,4,32,5,4,9,8,8,16,7,0.328685,0.337556,0.000003,No
5,5,25,3,4,7,5,5,10,8,0.320468,0.330645,0.000003,No
12,11,132,7,4,11,12,12,24,7,0.33282,0.343561,0.000003,No
6,6,36,3,3,6,6,6,12,8,0.34463,0.357936,0.000003,No
4,4,16,2,4,6,4,4,8,8,0.350104,0.364526,0.000003,No
10,9,90,8,3,11,10,10,20,7,0.332437,0.344021,0.000003,No
5,5,25,3,4,7,5,5,10,8,0.350737,0.365347,0.000003,No
8,8,64,8,7,15,8,8,16,8,0.356006,0.371354,0.000003,No
1,1,1,1,1,2,1,1,2,8,0.289365,0.29723,0.000003,No
3,3,9,3,3,6,3,3,6,8,0.336535,0.348612,0.000003,No
11,11,121,6,7,13,11,11,22,8,0.348232,0.361988,0.000003,No
24,23,552,8,13,21,24,24,48,8,0.355524,0.371151,0.000003,No
5,4,20,3,5,8,5,5,10,7,0.341397,0.353815,0.000003,No
3,3,9,2,1,3,3,3,6,8,0.303375,0.311466,0.000003,No
6,6,36,4,6,10,6,6,12,7,0.322479,0.330983,0.000003,No
9,8,72,4,5,9,9,9,18,8,0.32144,0.330495,0.000003,No
3,3,9,3,3,6,3,3,6,7,0.349372,0.363568,0.000003,No
1,1,1,1,1,2,1,1,2,7,0.327826,0.338517,0.000003,No
2,2,4,2,2,4,2,2,4,8,0.304686,0.31133,0.000003,No
4,4,16,3,3,6,4,4,8,8,0.317788,0.327332,0.000003,No
6,5,30,4,6,10,6,6,12,8,0.320071,0.327345,0.000003,No
14,14,196,6,6,12,14,14,28,7,0.358481,0.374148,0.000003,No
5,4,20,4,4,8,5,5,10,7,0.35303,0.367418,0.000003,No
2,2,4,2,2,4,2,2,4,8,0.323788,0.334748,0.000003,No
2,2,4,2,2,4,2,2,4,8,0.343127,0.355994,0.000003,No
2,1,2,2,2,4,2,2,4,8,0.323592,0.334637,0.000003,No
1,1,1,1,1,2,1,1,2,7,0.327819,0.338512,0.000003,No
4,4,16,1,3,4,4,4,8,7,0.330039,0.340816,0.000003,No
4,4,16,2,4,6,4,4,8,8,0.307043,0.314701,0.000003,No
6,6,36,4,1,5,6,6,12,7,0.327813,0.338503,0.000003,No
7,7,49,4,5,9,7,7,14,7,0.33451,0.346216,0.000003,No
3,3,9,1,1,2,3,3,6,9,0.257426,0.262845,0.000003,No
8,8,64,4,6,10,8,8,16,8,0.35818,0.37338,0.000003,No
8,8,64,3,5,8,8,8,16,8,0.359274,0.375817,0.000003,No
4,4,16,3,4,7,4,4,8,8,0.334496,0.345645,0.000003,No
9,8,72,7,7,14,9,9,18,8,0.34312,0.356426,0.000003,No
2,2,4,2,2,4,2,2,4,8,0.339988,0.352277,0.000003,No
3,3,9,3,3,6,3,3,6,8,0.316662,0.326512,0.000003,No
5,4,20,3,5,8,5,5,10,7,0.342397,0.355078,0.000003,No
2,2,4,2,1,3,2,2,4,9,0.257706,0.2633,0.000003,No
4,4,16,4,4,8,4,4,8,8,0.315619,0.325331,0.000003,No
1,1,1,1,1,2,1,1,2,9,0.237994,0.241874,0.000003,No
22,21,462,9,9,18,22,22,44,8,0.34361,0.356351,0.000003,No
13,13,169,3,4,7,13,13,26,8,0.328324,0.339891,0.000003,No
6,6,36,5,4,9,6,6,12,8,0.342143,0.354775,0.000003,No
7,7,49,4,5,9,7,7,14,7,0.342968,0.355933,0.000003,No
4,4,16,4,4,8,4,4,8,8,0.328583,0.339069,0.000003,No
6,6,36,5,6,11,6,6,12,8,0.351011,0.365522,0.000003,No
9,9,81,5,9,14,9,9,18,7,0.343797,0.356167,0.000003,No
1,1,1,1,1,2,1,1,2,8,0.256838,0.261888,0.000003,No
1,1,1,1,1,2,1,1,2,7,0.327826,0.338517,0.000003,No
1,1,1,1,1,2,1,1,2,7,0.327819,0.338512,0.000003,No
10,9,90,5,7,12,10,10,20,8,0.368826,0.385772,0.000003,No
1,1,1,1,1,2,1,1,2,8,0.32342,0.334424,0.000003,No
9,9,81,5,5,10,9,9,18,8,0.347211,0.361453,0.000003,No
10,10,100,4,9,13,10,10,20,8,0.344227,0.356991,0.000003,No
4,4,16,2,2,4,4,4,8,8,0.289086,0.300254,0.000003,No
11,10,110,6,8,14,11,11,22,7,0.361183,0.376849,0.000003,No
5,5,25,5,5,10,5,5,10,8,0.321295,0.331042,0.000003,No
4,3,12,2,4,6,4,4,8,7,0.316638,0.323837,0.000003,No
5,5,25,3,3,6,5,5,10,8,0.333659,0.344647,0.000003,No
3,3,9,3,3,6,3,3,6,8,0.328413,0.339792,0.000003,No
6,6,36,4,5,9,6,6,12,8,0.328805,0.340687,0.000003,No
7,6,42,6,6,12,7,7,14,7,0.330275,0.341732,0.000003,No
5,5,25,4,5,9,5,5,10,8,0.35407,0.368623,0.000003,No
22,21,462,9,7,16,22,22,44,8,0.363778,0.379999,0.000003,No
6,6,36,3,5,8,6,6,12,8,0.333366,0.344804,0.000003,No
9,8,72,6,5,11,9,9,18,8,0.344825,0.357588,0.000003,No
2,2,4,2,2,4,2,2,4,8,0.255266,0.260665,0.000003,No
2,2,4,2,2,4,2,2,4,7,0.316509,0.325783,0.000003,No
5,5,25,5,5,10,5,5,10,8,0.347176,0.361487,0.000003,No
6,6,36,5,3,8,6,6,12,8,0.331668,0.34321,0.000003,No
2,2,4,2,2,4,2,2,4,8,0.323432,0.334464,0.000003,No
5,5,25,4,4,8,5,5,10,8,0.342796,0.355777,0.000003,No
3,3,9,3,3,6,3,3,6,8,0.330083,0.340494,0.000003,No
1,1,1,1,1,2,1,1,2,9,0.258006,0.26355,0.000003,No
8,8,64,5,5,10,8,8,16,8,0.335061,0.34752,0.000003,No
3,3,9,3,3,6,3,3,6,8,0.297047,0.305393,0.000003,No
8,8,64,3,8,11,8,8,16,8,0.347962,0.361504,0.000003,No
13,13,169,7,10,17,13,13,26,8,0.369601,0.387044,0.000003,No
17,13,221,4,14,18,17,17,34,8,0.358466,0.374021,0.000002,yes
7,7,49,6,5,11,7,7,14,7,0.312887,0.321467,0.000002,yes
17,17,289,10,10,20,17,17,34,7,0.329733,0.340342,0.000002,yes
5,5,25,1,3,4,5,5,10,8,0.337094,0.349294,0.000002,No
2,2,4,2,2,4,2,2,4,8,0.352003,0.366286,0.000002,No
2,2,4,1,2,3,2,2,4,8,0.302225,0.30904,0.000002,No
4,4,16,3,3,6,4,4,8,7,0.336542,0.347967,0.000002,No
3,3,9,3,3,6,3,3,6,8,0.346943,0.360398,0.000002,No
9,9,81,6,7,13,9,9,18,7,0.342328,0.354657,0.000002,No
4,4,16,3,3,6,4,4,8,8,0.344491,0.358052,0.000002,No
5,5,25,4,5,9,5,5,10,8,0.329433,0.338231,0.000002,No
5,5,25,3,5,8,5,5,10,7,0.341958,0.35469,0.000002,No
1,1,1,1,1,2,1,1,2,8,0.265159,0.271386,0.000002,No
2,2,4,2,2,4,2,2,4,7,0.331597,0.34297,0.000002,No
9,9,81,4,4,8,9,9,18,7,0.345608,0.35857,0.000002,No
5,5,25,4,3,7,5,5,10,8,0.341083,0.353619,0.000002,No
4,4,16,3,3,6,4,4,8,8,0.317032,0.326872,0.000002,No
9,9,81,4,5,9,9,9,18,7,0.33295,0.344354,0.000002,No
12,10,120,7,5,12,12,12,24,7,0.335952,0.348092,0.000002,No
10,10,100,8,7,15,10,10,20,8,0.344248,0.357058,0.000002,No
2,2,4,2,2,4,2,2,4,8,0.332573,0.344483,0.000002,No
6,6,36,6,3,9,6,6,12,7,0.353887,0.368486,0.000002,No
2,2,4,2,2,4,2,2,4,8,0.315964,0.323734,0.000002,No
2,2,4,2,2,4,2,2,4,7,0.3358,0.346415,0.000002,No
2,2,4,2,2,4,2,2,4,8,0.301941,0.314836,0.000002,No
9,9,81,8,5,13,9,9,18,8,0.356541,0.372238,0.000002,No
3,3,9,3,3,6,3,3,6,8,0.342459,0.355038,0.000002,No
9,9,81,5,4,9,9,9,18,7,0.339238,0.350218,0.000002,No
8,8,64,6,6,12,8,8,16,8,0.36788,0.384982,0.000002,No
11,11,121,7,6,13,11,11,22,8,0.337968,0.350019,0.000002,No
16,16,256,8,11,19,16,16,32,7,0.348047,0.36123,0.000002,No
7,7,49,5,6,11,7,7,14,8,0.342507,0.355302,0.000002,No
16,16,256,2,6,8,16,16,32,7,0.34386,0.355948,0.000002,No
4,4,16,4,4,8,4,4,8,8,0.306585,0.313087,0.000002,No
3,2,6,3,3,6,3,3,6,8,0.339198,0.352634,0.000002,No
5,5,25,3,5,8,5,5,10,7,0.343299,0.355975,0.000002,No
3,3,9,3,3,6,3,3,6,7,0.33726,0.350097,0.000002,No
5,5,25,4,4,8,5,5,10,7,0.331468,0.341965,0.000002,No
5,5,25,4,4,8,5,5,10,8,0.316909,0.326282,0.000002,No
5,5,25,3,4,7,5,5,10,8,0.341055,0.353465,0.000002,No
6,6,36,2,5,7,6,6,12,7,0.339171,0.350638,0.000002,No
3,3,9,2,2,4,3,3,6,8,0.31216,0.322349,0.000002,No
4,3,12,3,3,6,4,4,8,8,0.324663,0.33548,0.000002,No
5,4,20,4,3,7,5,5,10,8,0.324787,0.335424,0.000002,No
8,8,64,7,6,13,8,8,16,8,0.318667,0.325739,0.000002,No
10,9,90,5,8,13,10,10,20,7,0.360534,0.376476,0.000002,No
12,12,144,2,12,14,12,12,24,8,0.320179,0.327607,0.000002,No
17,17,289,4,4,8,17,17,34,8,0.326827,0.33858,0.000002,No
4,4,16,4,4,8,4,4,8,8,0.355805,0.371906,0.000002,No
3,3,9,3,2,5,3,3,6,8,0.340647,0.353161,0.000002,No
4,4,16,2,2,4,4,4,8,8,0.33825,0.351502,0.000002,No
6,6,36,4,4,8,6,6,12,8,0.309056,0.322366,0.000002,No
4,4,16,1,2,3,4,4,8,8,0.333229,0.344873,0.000002,No
16,16,256,9,3,12,16,16,32,7,0.331836,0.343367,0.000002,No
6,6,36,5,3,8,6,6,12,7,0.332437,0.343336,0.000002,No
5,5,25,4,5,9,5,5,10,8,0.325313,0.335535,0.000002,No
4,4,16,3,3,6,4,4,8,8,0.349115,0.36363,0.000002,No
1,1,1,1,1,2,1,1,2,8,0.339934,0.352194,0.000002,No
2,2,4,2,2,4,2,2,4,8,0.338478,0.351491,0.000002,No
2,2,4,2,2,4,2,2,4,8,0.323445,0.334478,0.000002,No
10,10,100,8,7,15,10,10,20,8,0.316087,0.323146,0.000002,No
8,8,64,4,4,8,8,8,16,7,0.33621,0.348724,0.000002,No
3,3,9,3,3,6,3,3,6,8,0.297146,0.30501,0.000002,No
7,7,49,5,5,10,7,7,14,8,0.34565,0.360264,0.000002,No
2,2,4,2,2,4,2,2,4,8,0.296542,0.303795,0.000002,No
6,5,30,1,4,5,6,6,12,8,0.319412,0.327335,0.000002,No
3,2,6,3,3,6,3,3,6,8,0.34292,0.355761,0.000002,No
1,1,1,1,1,2,1,1,2,8,0.310033,0.318684,0.000002,No
3,3,9,3,3,6,3,3,6,8,0.344283,0.357477,0.000002,No
4,3,12,4,4,8,4,4,8,7,0.336137,0.348996,0.000002,No
6,6,36,3,3,6,6,6,12,7,0.353806,0.368172,0.000002,No
8,8,64,3,3,6,8,8,16,8,0.305427,0.314835,0.000002,No
4,4,16,2,3,5,4,4,8,7,0.342012,0.355664,0.000002,No
17,17,289,12,10,22,17,17,34,8,0.346633,0.360787,0.000002,No
2,2,4,2,1,3,2,2,4,9,0.264608,0.270961,0.000002,No
7,7,49,4,2,6,7,7,14,8,0.288027,0.299908,0.000002,No
11,11,121,4,7,11,11,11,22,8,0.341383,0.355187,0.000002,No
2,2,4,2,2,4,2,2,4,8,0.291312,0.302885,0.000002,No
6,6,36,2,5,7,6,6,12,7,0.335351,0.346327,0.000002,No
14,14,196,5,10,15,14,14,28,8,0.360694,0.375983,0.000002,No
1,1,1,1,1,2,1,1,2,8,0.339934,0.352194,0.000002,No
2,2,4,2,2,4,2,2,4,8,0.307824,0.31445,0.000002,No
2,2,4,2,2,4,2,2,4,7,0.33152,0.343063,0.000002,No
10,10,100,6,8,14,10,10,20,8,0.363213,0.380014,0.000002,No
8,8,64,7,4,11,8,8,16,7,0.357378,0.372898,0.000002,No
3,3,9,3,3,6,3,3,6,8,0.352301,0.366662,0.000002,No
2,2,4,2,1,3,2,2,4,8,0.310033,0.318684,0.000002,No
1,1,1,1,1,2,1,1,2,8,0.287605,0.295192,0.000002,No
8,8,64,5,6,11,8,8,16,8,0.353403,0.367699,0.000002,No
1,1,1,1,1,2,1,1,2,9,0.241378,0.244499,0.000002,No
10,10,100,7,7,14,10,10,20,7,0.33718,0.349071,0.000002,No
14,14,196,8,7,15,14,14,28,7,0.339961,0.350985,0.000002,No
9,9,81,7,8,15,9,9,18,7,0.328526,0.338671,0.000002,No
2,2,4,1,1,2,2,2,4,8,0.301589,0.314491,0.000002,No
3,3,9,3,2,5,3,3,6,8,0.316134,0.32387,0.000002,No
2,2,4,2,2,4,2,2,4,8,0.340389,0.352583,0.000002,No
3,2,6,3,3,6,3,3,6,8,0.341137,0.353865,0.000002,No
1,1,1,1,1,2,1,1,2,9,0.259917,0.265435,0.000002,No
10,10,100,3,8,11,10,10,20,8,0.348303,0.362618,0.000002,No
13,13,169,9,7,16,13,13,26,7,0.358038,0.373472,0.000002,No
5,5,25,4,4,8,5,5,10,8,0.310994,0.317651,0.000002,No
3,3,9,1,2,3,3,3,6,8,0.343223,0.356253,0.000002,No
12,12,144,4,8,12,12,12,24,8,0.348502,0.362978,0.000002,No
5,5,25,3,2,5,5,5,10,8,0.30914,0.317548,0.000002,No
4,4,16,1,4,5,4,4,8,7,0.344665,0.357573,0.000002,No
3,3,9,3,3,6,3,3,6,7,0.337881,0.350658,0.000002,No
13,13,169,7,7,14,13,13,26,8,0.347367,0.359856,0.000002,No
25,23,575,4,13,17,25,25,50,7,0.349287,0.362893,0.000002,No
2,2,4,2,2,4,2,2,4,8,0.352003,0.366286,0.000002,No
7,7,49,6,5,11,7,7,14,7,0.353601,0.368186,0.000002,No
2,2,4,2,2,4,2,2,4,7,0.328154,0.338886,0.000002,No
2,2,4,1,2,3,2,2,4,8,0.268278,0.274851,0.000002,No
9,7,63,4,5,9,9,9,18,8,0.320661,0.329095,0.000002,No
2,2,4,2,2,4,2,2,4,7,0.331649,0.341924,0.000002,No
7,7,49,6,7,13,7,7,14,8,0.342816,0.35579,0.000002,No
11,10,110,4,5,9,11,11,22,7,0.328242,0.337332,0.000002,No
6,6,36,5,5,10,6,6,12,7,0.342342,0.354858,0.000002,No
1,1,1,1,1,2,1,1,2,10,0.187452,0.189437,0.000002,No
9,9,81,5,6,11,9,9,18,8,0.363762,0.379862,0.000002,No
6,6,36,6,5,11,6,6,12,7,0.340865,0.353529,0.000002,No
6,6,36,5,4,9,6,6,12,8,0.342865,0.356783,0.000002,No
14,13,182,5,6,11,14,14,28,7,0.359486,0.376078,0.000002,No
1,1,1,1,1,2,1,1,2,8,0.339934,0.352194,0.000002,No
7,6,42,6,6,12,7,7,14,8,0.344888,0.357963,0.000002,No
2,2,4,2,2,4,2,2,4,8,0.319078,0.326587,0.000002,No
2,2,4,2,2,4,2,2,4,8,0.320637,0.333037,0.000002,No
2,2,4,2,2,4,2,2,4,8,0.290074,0.297189,0.000002,No
1,1,1,1,1,2,1,1,2,7,0.327826,0.338517,0.000002,No
1,1,1,1,1,2,1,1,2,9,0.238064,0.24111,0.000002,No
10,10,100,8,8,16,10,10,20,7,0.359055,0.374928,0.000002,No
3,3,9,3,3,6,3,3,6,8,0.329039,0.339125,0.000002,No
3,3,9,3,2,5,3,3,6,8,0.338243,0.351497,0.000002,No
11,11,121,7,10,17,11,11,22,8,0.343756,0.35697,0.000002,No
2,2,4,2,2,4,2,2,4,8,0.319927,0.328164,0.000002,No
8,8,64,5,6,11,8,8,16,8,0.35737,0.372946,0.000002,No
3,3,9,2,2,4,3,3,6,7,0.30303,0.312761,0.000002,No
2,2,4,2,2,4,2,2,4,8,0.352003,0.366286,0.000002,No
5,5,25,4,4,8,5,5,10,8,0.348246,0.3613,0.000002,No
1,1,1,1,1,2,1,1,2,8,0.339941,0.352199,0.000002,No
3,3,9,2,2,4,3,3,6,8,0.325233,0.336514,0.000002,No
1,1,1,1,1,2,1,1,2,8,0.274554,0.283667,0.000002,No
1,1,1,1,1,2,1,1,2,9,0.253706,0.258579,0.000002,No
5,5,25,5,4,9,5,5,10,8,0.355376,0.370265,0.000002,No
2,2,4,2,2,4,2,2,4,7,0.327863,0.338595,0.000002,No
1,1,1,1,1,2,1,1,2,8,0.323432,0.334432,0.000002,No
2,2,4,2,2,4,2,2,4,8,0.322564,0.33178,0.000002,No
11,11,121,3,7,10,11,11,22,8,0.334529,0.345349,0.000002,No
2,2,4,2,2,4,2,2,4,8,0.29228,0.299381,0.000002,No
27,27,729,2,9,11,27,27,54,8,0.334221,0.345776,0.000002,No
2,2,4,2,2,4,2,2,4,7,0.329981,0.340937,0.000002,No
5,5,25,4,5,9,5,5,10,8,0.362333,0.379173,0.000002,No
4,4,16,4,4,8,4,4,8,8,0.317901,0.325451,0.000002,No
8,8,64,4,5,9,8,8,16,8,0.33938,0.352881,0.000002,No
5,5,25,4,5,9,5,5,10,8,0.301979,0.310986,0.000002,No
9,9,81,7,7,14,9,9,18,8,0.355183,0.36988,0.000002,No
5,5,25,4,4,8,5,5,10,8,0.342321,0.354997,0.000002,No
3,3,9,3,2,5,3,3,6,7,0.328375,0.339029,0.000002,No
4,4,16,3,4,7,4,4,8,8,0.344095,0.357149,0.000002,No
2,2,4,1,1,2,2,2,4,8,0.260922,0.266579,0.000002,No
2,2,4,1,1,2,2,2,4,9,0.268641,0.276936,0.000002,No
1,1,1,1,1,2,1,1,2,8,0.296171,0.303818,0.000002,No
3,3,9,1,2,3,3,3,6,8,0.265779,0.271888,0.000002,No
9,9,81,6,7,13,9,9,18,8,0.320468,0.329452,0.000002,No
8,7,56,6,7,13,8,8,16,8,0.324509,0.333252,0.000002,No
7,7,49,3,6,9,7,7,14,8,0.33736,0.349513,0.000002,No
18,18,324,6,11,17,18,18,36,7,0.351242,0.365162,0.000002,No
2,2,4,1,2,3,2,2,4,7,0.347983,0.361927,0.000002,No
3,3,9,3,3,6,3,3,6,8,0.325692,0.336591,0.000002,No
5,5,25,2,2,4,5,5,10,8,0.340803,0.353326,0.000002,No
2,2,4,2,1,3,2,2,4,9,0.254949,0.25998,0.000002,No
5,5,25,3,4,7,5,5,10,7,0.356378,0.371187,0.000002,No
3,3,9,2,2,4,3,3,6,8,0.286633,0.293754,0.000002,No
2,2,4,1,1,2,2,2,4,8,0.233369,0.237138,0.000002,No
1,1,1,1,1,2,1,1,2,7,0.327819,0.338512,0.000002,No
4,2,8,4,4,8,4,4,8,8,0.316128,0.3273,0.000002,No
8,7,56,5,8,13,8,8,16,8,0.31738,0.326062,0.000002,No
1,1,1,1,1,2,1,1,2,9,0.254061,0.259168,0.000002,No
3,3,9,3,3,6,3,3,6,8,0.306272,0.313693,0.000002,No
5,5,25,1,5,6,5,5,10,8,0.330961,0.341906,0.000002,No
5,5,25,5,3,8,5,5,10,8,0.334483,0.346624,0.000002,No
5,5,25,5,5,10,5,5,10,7,0.338854,0.351781,0.000002,No
24,24,576,7,7,14,24,24,48,8,0.344665,0.357412,0.000002,No
4,4,16,3,3,6,4,4,8,8,0.326621,0.338294,0.000002,No
2,2,4,2,2,4,2,2,4,8,0.340797,0.353316,0.000002,No
1,1,1,1,1,2,1,1,2,8,0.263729,0.269493,0.000002,No
3,3,9,3,3,6,3,3,6,8,0.346689,0.360749,0.000002,No
2,2,4,2,2,4,2,2,4,8,0.311431,0.319995,0.000002,No
1,1,1,1,1,2,1,1,2,9,0.251819,0.256846,0.000002,No
7,7,49,4,6,10,7,7,14,8,0.329313,0.339001,0.000002,No
7,7,49,4,5,9,7,7,14,7,0.333522,0.345169,0.000002,No
6,6,36,4,5,9,6,6,12,7,0.351698,0.36607,0.000002,No
1,1,1,1,1,2,1,1,2,8,0.339941,0.352199,0.000002,No
24,24,576,13,1,14,24,24,48,8,0.32342,0.334424,0.000002,No
11,11,121,11,3,14,11,11,22,8,0.286436,0.293502,0.000002,No
8,8,64,4,4,8,8,8,16,8,0.299587,0.307435,0.000002,No
4,4,16,4,4,8,4,4,8,8,0.313382,0.321759,0.000002,No
3,3,9,2,2,4,3,3,6,8,0.30978,0.323438,0.000002,No
6,6,36,3,4,7,6,6,12,7,0.339839,0.352739,0.000002,No
10,9,90,6,3,9,10,10,20,8,0.301094,0.313452,0.000002,No
5,5,25,3,4,7,5,5,10,8,0.348459,0.362173,0.000002,No
7,7,49,4,2,6,7,7,14,8,0.312069,0.3206,0.000002,No
5,5,25,3,3,6,5,5,10,8,0.328292,0.340101,0.000002,No
19,19,361,14,7,21,19,19,38,8,0.341362,0.353641,0.000002,No
6,6,36,5,5,10,6,6,12,7,0.338203,0.350432,0.000002,No
17,17,289,9,6,15,17,17,34,7,0.32871,0.339416,0.000002,No
12,12,144,6,6,12,12,12,24,7,0.333099,0.344363,0.000002,No
5,5,25,4,4,8,5,5,10,8,0.33829,0.3516,0.000002,No
2,2,4,1,1,2,2,2,4,8,0.331578,0.343078,0.000002,No
3,3,9,3,3,6,3,3,6,8,0.340497,0.352927,0.000002,No
7,7,49,5,6,11,7,7,14,8,0.344665,0.358172,0.000002,No
5,5,25,3,5,8,5,5,10,7,0.366261,0.383419,0.000002,No
3,3,9,2,2,4,3,3,6,8,0.34461,0.357406,0.000002,No
2,2,4,2,2,4,2,2,4,8,0.288655,0.298834,0.000002,No
9,9,81,3,7,10,9,9,18,8,0.36061,0.37802,0.000002,No
1,1,1,1,1,2,1,1,2,8,0.303655,0.312962,0.000002,No
5,5,25,2,4,6,5,5,10,8,0.326028,0.334874,0.000002,No
6,6,36,4,6,10,6,6,12,8,0.305476,0.312227,0.000002,No
18,18,324,5,15,20,18,18,36,8,0.376285,0.394617,0.000002,No
1,1,1,1,1,2,1,1,2,8,0.288168,0.299068,0.000002,No
1,1,1,1,1,2,1,1,2,8,0.288163,0.299063,0.000002,No
4,4,16,4,4,8,4,4,8,8,0.332217,0.343827,0.000002,No
5,5,25,3,5,8,5,5,10,7,0.357295,0.372556,0.000002,No
3,3,9,2,3,5,3,3,6,8,0.358934,0.37513,0.000002,No
6,6,36,5,2,7,6,6,12,8,0.328368,0.339723,0.000002,No
4,4,16,4,3,7,4,4,8,8,0.330967,0.344102,0.000002,No
2,2,4,2,2,4,2,2,4,8,0.333646,0.345191,0.000002,No
15,15,225,11,4,15,15,15,30,8,0.344172,0.358357,0.000002,No
10,10,100,4,8,12,10,10,20,8,0.333008,0.342852,0.000002,No
4,4,16,4,4,8,4,4,8,8,0.35749,0.372467,0.000002,No
13,13,169,6,11,17,13,13,26,8,0.361497,0.377876,0.000002,No
5,5,25,3,4,7,5,5,10,8,0.336807,0.347687,0.000002,No
4,4,16,4,4,8,4,4,8,8,0.304533,0.314837,0.000002,No
16,16,256,11,11,22,16,16,32,8,0.342934,0.355769,0.000002,No
1,1,1,1,1,2,1,1,2,9,0.268721,0.277328,0.000002,No
1,1,1,1,1,2,1,1,2,8,0.331578,0.343078,0.000002,No
11,11,121,10,6,16,11,11,22,7,0.336012,0.347517,0.000002,No
1,1,1,1,1,2,1,1,2,8,0.242586,0.246458,0.000002,No
10,10,100,6,7,13,10,10,20,8,0.340592,0.353637,0.000002,No
11,10,110,8,9,17,11,11,22,7,0.346112,0.359946,0.000002,No
13,13,169,7,9,16,13,13,26,7,0.365218,0.381658,0.000002,No
3,3,9,3,2,5,3,3,6,8,0.331591,0.343122,0.000002,No
3,3,9,1,3,4,3,3,6,8,0.347423,0.360769,0.000002,No
6,6,36,2,6,8,6,6,12,8,0.339265,0.351811,0.000002,No
5,5,25,3,4,7,5,5,10,8,0.32821,0.339784,0.000002,No
6,6,36,5,4,9,6,6,12,8,0.332017,0.343513,0.000002,No
9,9,81,7,7,14,9,9,18,8,0.339833,0.353076,0.000002,No
5,5,25,3,5,8,5,5,10,8,0.335886,0.347036,0.000002,No
3,3,9,2,2,4,3,3,6,8,0.343203,0.35581,0.000002,No
3,3,9,3,3,6,3,3,6,7,0.336801,0.3482,0.000002,No
2,2,4,2,2,4,2,2,4,8,0.304273,0.311367,0.000002,No
8,6,48,4,4,8,8,8,16,7,0.336555,0.34752,0.000002,No
14,14,196,6,7,13,14,14,28,7,0.356073,0.372114,0.000002,No
2,2,4,2,2,4,2,2,4,8,0.291825,0.298832,0.000002,No
10,10,100,5,5,10,10,10,20,7,0.33734,0.350016,0.000002,No
1,1,1,1,1,2,1,1,2,8,0.339934,0.352194,0.000002,No
3,2,6,2,3,5,3,3,6,8,0.306844,0.314381,0.000002,No
1,1,1,1,1,2,1,1,2,8,0.265452,0.271364,0.000002,No
18,18,324,12,6,18,18,18,36,7,0.331668,0.34402,0.000002,No
1,1,1,1,1,2,1,1,2,9,0.2575,0.262956,0.000002,No
4,4,16,3,4,7,4,4,8,8,0.333979,0.347481,0.000002,No
4,4,16,3,3,6,4,4,8,7,0.333614,0.345775,0.000002,No
2,2,4,1,2,3,2,2,4,8,0.310813,0.31924,0.000002,No
2,2,4,2,2,4,2,2,4,8,0.340049,0.352361,0.000002,No
5,4,20,4,5,9,5,5,10,8,0.342253,0.356029,0.000002,No
5,5,25,4,5,9,5,5,10,8,0.328786,0.339414,0.000002,No
8,8,64,6,6,12,8,8,16,8,0.35559,0.370117,0.000002,No
3,3,9,3,3,6,3,3,6,8,0.323911,0.333822,0.000002,No
3,3,9,3,3,6,3,3,6,8,0.311613,0.318595,0.000002,No
2,2,4,1,2,3,2,2,4,9,0.263892,0.270206,0.000002,No
2,2,4,2,2,4,2,2,4,8,0.338243,0.351497,0.000002,No
14,14,196,13,5,18,14,14,28,8,0.331552,0.343327,0.000002,No
7,7,49,5,5,10,7,7,14,8,0.330403,0.340383,0.000002,No
3,3,9,2,2,4,3,3,6,8,0.284024,0.291286,0.000002,No
3,3,9,3,3,6,3,3,6,8,0.307913,0.314562,0.000002,No
12,12,144,9,9,18,12,12,24,8,0.35794,0.374563,0.000002,No
2,2,4,2,2,4,2,2,4,8,0.311528,0.322582,0.000002,No
2,2,4,2,2,4,2,2,4,8,0.342617,0.356522,0.000002,No
2,2,4,2,2,4,2,2,4,8,0.305165,0.317639,0.000002,No
5,5,25,4,5,9,5,5,10,8,0.299914,0.307828,0.000002,No
2,2,4,2,2,4,2,2,4,8,0.324416,0.334979,0.000002,No
17,17,289,15,2,17,17,17,34,8,0.332418,0.343894,0.000002,No
4,4,16,3,3,6,4,4,8,7,0.353374,0.367855,0.000002,No
1,1,1,1,1,2,1,1,2,8,0.339934,0.352194,0.000002,No
3,3,9,3,3,6,3,3,6,7,0.328621,0.339242,0.000002,No
2,2,4,2,2,4,2,2,4,8,0.309842,0.317295,0.000002,No
6,6,36,5,5,10,6,6,12,8,0.334864,0.346575,0.000002,No
2,2,4,2,2,4,2,2,4,8,0.3371,0.349587,0.000002,No
18,18,324,5,12,17,18,18,36,7,0.348594,0.362321,0.000002,No
12,11,132,7,9,16,12,12,24,7,0.334306,0.34455,0.000002,No
2,2,4,2,2,4,2,2,4,8,0.316233,0.327559,0.000002,No
3,3,9,2,2,4,3,3,6,7,0.329745,0.340907,0.000002,No
6,6,36,4,5,9,6,6,12,8,0.324385,0.332122,0.000002,No
3,2,6,1,3,4,3,3,6,8,0.324373,0.335515,0.000002,No
2,2,4,2,1,3,2,2,4,8,0.339934,0.352194,0.000002,No
2,2,4,2,2,4,2,2,4,8,0.310062,0.318748,0.000002,No
2,2,4,1,1,2,2,2,4,9,0.249748,0.254564,0.000002,No
2,2,4,2,2,4,2,2,4,8,0.31538,0.325075,0.000002,No
6,6,36,2,4,6,6,6,12,8,0.305018,0.312573,0.000002,No
5,5,25,4,4,8,5,5,10,8,0.318887,0.325937,0.000002,No
4,4,16,3,4,7,4,4,8,8,0.329529,0.341366,0.000002,No
8,8,64,4,8,12,8,8,16,8,0.362264,0.379175,0.000002,No
2,2,4,2,2,4,2,2,4,8,0.342102,0.354638,0.000002,No
2,2,4,2,2,4,2,2,4,8,0.302176,0.315038,0.000002,No
2,2,4,2,2,4,2,2,4,8,0.317705,0.328598,0.000002,No
10,10,100,5,7,12,10,10,20,8,0.349087,0.364208,0.000002,No
9,9,81,3,3,6,9,9,18,7,0.342803,0.35564,0.000002,No
1,1,1,1,1,2,1,1,2,9,0.261186,0.266859,0.000002,No
1,1,1,1,1,2,1,1,2,8,0.339934,0.352194,0.000002,No
3,3,9,3,3,6,3,3,6,8,0.341246,0.353821,0.000002,No
6,6,36,5,6,11,6,6,12,8,0.350075,0.365298,0.000002,No
3,3,9,2,2,4,3,3,6,8,0.31434,0.322566,0.000002,No
8,8,64,2,5,7,8,8,16,7,0.353227,0.367726,0.000002,No
2,2,4,2,2,4,2,2,4,8,0.335404,0.34645,0.000002,No
2,2,4,2,2,4,2,2,4,8,0.296356,0.303516,0.000002,No
10,10,100,4,5,9,10,10,20,8,0.35091,0.364748,0.000002,No
7,7,49,2,3,5,7,7,14,8,0.322656,0.330719,0.000002,No
4,3,12,4,4,8,4,4,8,7,0.334713,0.346567,0.000002,No
3,3,9,2,2,4,3,3,6,8,0.327003,0.337513,0.000002,No
13,13,169,8,5,13,13,13,26,8,0.366923,0.383294,0.000002,No
4,4,16,4,4,8,4,4,8,8,0.319987,0.330599,0.000002,No
6,6,36,2,4,6,6,6,12,8,0.304931,0.31693,0.000002,No
3,3,9,3,3,6,3,3,6,8,0.295504,0.306254,0.000002,No
14,14,196,6,8,14,14,14,28,7,0.353799,0.368478,0.000002,No
2,2,4,1,1,2,2,2,4,8,0.303655,0.312962,0.000002,No
9,9,81,5,4,9,9,9,18,8,0.326259,0.33561,0.000002,No
2,2,4,2,2,4,2,2,4,8,0.289522,0.299832,0.000002,No
9,9,81,6,7,13,9,9,18,8,0.349989,0.364129,0.000002,No
4,3,12,3,4,7,4,4,8,8,0.334274,0.346161,0.000002,No
4,4,16,3,4,7,4,4,8,8,0.334365,0.345925,0.000002,No
10,10,100,5,6,11,10,10,20,7,0.349594,0.362783,0.000002,No
3,3,9,3,2,5,3,3,6,8,0.315479,0.323373,0.000002,No
2,2,4,2,2,4,2,2,4,7,0.305422,0.31691,0.000002,No
1,1,1,1,1,2,1,1,2,8,0.339941,0.352199,0.000002,No
3,3,9,2,2,4,3,3,6,8,0.308347,0.314759,0.000002,No
3,2,6,3,3,6,3,3,6,8,0.352767,0.367608,0.000002,No
2,2,4,2,2,4,2,2,4,8,0.305832,0.313087,0.000002,No
5,5,25,2,4,6,5,5,10,7,0.33449,0.345303,0.000002,No
4,4,16,2,4,6,4,4,8,8,0.314178,0.321206,0.000002,No
4,3,12,2,4,6,4,4,8,7,0.342768,0.355746,0.000002,No
10,7,70,4,5,9,10,10,20,8,0.321658,0.32967,0.000002,No
7,7,49,6,7,13,7,7,14,8,0.314195,0.321993,0.000002,No
1,1,1,1,1,2,1,1,2,8,0.339934,0.352194,0.000002,No
2,2,4,1,2,3,2,2,4,8,0.34028,0.352688,0.000002,No
2,2,4,2,2,4,2,2,4,8,0.326134,0.337909,0.000002,No
7,7,49,5,5,10,7,7,14,8,0.342246,0.355092,0.000002,No
1,1,1,1,1,2,1,1,2,8,0.301589,0.314491,0.000002,No
5,5,25,4,5,9,5,5,10,7,0.362033,0.378118,0.000002,No
3,3,9,2,3,5,3,3,6,8,0.275436,0.282967,0.000002,No
11,11,121,3,7,10,11,11,22,8,0.348331,0.362536,0.000002,No
7,7,49,6,7,13,7,7,14,7,0.345349,0.358656,0.000002,No
3,3,9,3,3,6,3,3,6,8,0.285287,0.29247,0.000002,No
4,4,16,4,4,8,4,4,8,8,0.348168,0.36289,0.000002,No
5,5,25,5,3,8,5,5,10,8,0.34154,0.35436,0.000002,No
4,4,16,4,3,7,4,4,8,8,0.331262,0.34247,0.000002,No
5,5,25,2,3,5,5,5,10,7,0.333203,0.344756,0.000002,No
4,4,16,4,4,8,4,4,8,8,0.327228,0.337571,0.000002,No
12,12,144,2,11,13,12,12,24,8,0.356817,0.372495,0.000002,No
15,15,225,2,12,14,15,15,30,8,0.363669,0.380976,0.000002,No
3,3,9,3,3,6,3,3,6,8,0.344366,0.357216,0.000002,No
8,7,56,8,8,16,8,8,16,7,0.332495,0.342508,0.000002,No
5,5,25,4,5,9,5,5,10,8,0.336031,0.347199,0.000002,No
4,4,16,2,2,4,4,4,8,8,0.271406,0.278121,0.000002,No
6,5,30,4,4,8,6,6,12,7,0.330147,0.3418,0.000002,No
9,9,81,6,5,11,9,9,18,8,0.353813,0.36837,0.000002,No
9,9,81,9,6,15,9,9,18,8,0.341971,0.355111,0.000002,No
7,7,49,6,5,11,7,7,14,8,0.321258,0.329741,0.000002,No
3,3,9,3,2,5,3,3,6,8,0.339948,0.352234,0.000002,No
11,11,121,2,5,7,11,11,22,8,0.32462,0.335348,0.000002,No
3,3,9,3,3,6,3,3,6,7,0.354107,0.368919,0.000002,No
5,5,25,4,4,8,5,5,10,8,0.318221,0.332355,0.000002,No
3,3,9,2,1,3,3,3,6,7,0.327819,0.338512,0.000002,No
1,1,1,1,1,2,1,1,2,9,0.243007,0.246437,0.000002,No
1,1,1,1,1,2,1,1,2,8,0.339934,0.352194,0.000002,No
6,6,36,2,3,5,6,6,12,8,0.331991,0.343572,0.000002,No
4,4,16,3,3,6,4,4,8,7,0.33549,0.346733,0.000002,No
7,7,49,4,4,8,7,7,14,8,0.341944,0.354629,0.000002,No
6,6,36,4,4,8,6,6,12,7,0.350506,0.364775,0.000002,No
2,2,4,2,2,4,2,2,4,8,0.309359,0.318004,0.000002,No
14,14,196,9,9,18,14,14,28,8,0.364773,0.381247,0.000002,No
2,2,4,2,2,4,2,2,4,8,0.302128,0.315,0.000002,No
5,5,25,2,4,6,5,5,10,7,0.347466,0.362261,0.000002,No
4,4,16,2,4,6,4,4,8,8,0.348637,0.362737,0.000002,No
2,2,4,2,2,4,2,2,4,8,0.31005,0.318728,0.000002,No
1,1,1,1,1,2,1,1,2,8,0.323426,0.334429,0.000002,No
6,6,36,2,2,4,6,6,12,8,0.329224,0.33988,0.000002,No
2,2,4,1,1,2,2,2,4,7,0.312589,0.319278,0.000002,No
7,7,49,3,3,6,7,7,14,7,0.35421,0.368805,0.000002,No
7,7,49,7,5,12,7,7,14,8,0.347763,0.361206,0.000002,No
3,3,9,2,3,5,3,3,6,8,0.347338,0.361812,0.000002,No
3,3,9,3,3,6,3,3,6,7,0.320986,0.328616,0.000002,No
6,5,30,3,6,9,6,6,12,8,0.344394,0.357674,0.000002,No
7,7,49,4,5,9,7,7,14,8,0.345769,0.358812,0.000002,No
8,8,64,5,2,7,8,8,16,7,0.328856,0.339465,0.000002,No
9,9,81,6,5,11,9,9,18,7,0.339198,0.350752,0.000002,No
1,1,1,1,1,2,1,1,2,7,0.327819,0.338512,0.000002,No
4,4,16,2,2,4,4,4,8,8,0.334326,0.344905,0.000002,No
2,2,4,2,2,4,2,2,4,8,0.283114,0.290802,0.000002,No
16,16,256,9,13,22,16,16,32,7,0.364812,0.381251,0.000002,No
7,7,49,4,6,10,7,7,14,8,0.357116,0.372545,0.000002,No
5,5,25,5,4,9,5,5,10,8,0.332075,0.344023,0.000002,No
4,4,16,2,3,5,4,4,8,8,0.355361,0.370918,0.000002,No
7,5,35,2,4,6,7,7,14,8,0.317889,0.327974,0.000002,No
5,3,15,4,5,9,5,5,10,8,0.353557,0.369143,0.000002,No
1,1,1,1,1,2,1,1,2,9,0.261494,0.267182,0.000002,No
7,7,49,5,5,10,7,7,14,8,0.333868,0.345149,0.000002,No
1,1,1,1,1,2,1,1,2,9,0.226387,0.2312,0.000002,No
1,1,1,1,1,2,1,1,2,9,0.257889,0.263402,0.000002,No
3,3,9,2,2,4,3,3,6,8,0.286047,0.295633,0.000002,No
2,2,4,2,1,3,2,2,4,8,0.32342,0.334424,0.000002,No
3,3,9,3,2,5,3,3,6,8,0.340348,0.352534,0.000002,No
7,7,49,3,5,8,7,7,14,8,0.345195,0.358188,0.000002,No
9,9,81,5,5,10,9,9,18,7,0.357213,0.371978,0.000002,No
1,1,1,1,1,2,1,1,2,8,0.262961,0.268793,0.000002,No
17,16,272,8,9,17,17,17,34,7,0.335978,0.347399,0.000002,No
9,9,81,5,4,9,9,9,18,8,0.292636,0.299646,0.000002,No
4,3,12,4,4,8,4,4,8,7,0.337534,0.348309,0.000002,No
2,2,4,2,1,3,2,2,4,9,0.255052,0.260139,0.000002,No
3,3,9,2,2,4,3,3,6,8,0.301936,0.309937,0.000002,No
2,2,4,2,2,4,2,2,4,9,0.268118,0.274871,0.000002,No
1,1,1,1,1,2,1,1,2,9,0.251689,0.257038,0.000002,No
6,6,36,6,6,12,6,6,12,8,0.334779,0.347821,0.000002,No
1,1,1,1,1,2,1,1,2,8,0.317304,0.324396,0.000002,No
2,2,4,2,2,4,2,2,4,8,0.332638,0.343982,0.000002,No
2,2,4,2,2,4,2,2,4,8,0.335048,0.346732,0.000002,No
20,20,400,10,9,19,20,20,40,7,0.342204,0.354338,0.000002,No
1,1,1,1,1,2,1,1,2,8,0.306657,0.315385,0.000002,No
6,5,30,2,3,5,6,6,12,8,0.340586,0.353078,0.000002,No
9,9,81,4,7,11,9,9,18,7,0.366702,0.383237,0.000002,No
6,6,36,5,5,10,6,6,12,7,0.358301,0.373848,0.000002,No
1,1,1,1,1,2,1,1,2,8,0.331571,0.343073,0.000002,No
7,7,49,5,6,11,7,7,14,8,0.319334,0.333858,0.000002,No
12,12,144,8,7,15,12,12,24,7,0.343299,0.355673,0.000002,No
2,2,4,2,2,4,2,2,4,8,0.301824,0.308791,0.000002,No
4,4,16,3,4,7,4,4,8,8,0.313675,0.320487,0.000002,No
2,2,4,2,2,4,2,2,4,7,0.331288,0.342337,0.000002,No
4,4,16,4,4,8,4,4,8,8,0.326552,0.337935,0.000002,No
5,5,25,3,4,7,5,5,10,7,0.339292,0.350712,0.000002,No
3,3,9,2,2,4,3,3,6,8,0.309135,0.321159,0.000002,No
14,14,196,7,5,12,14,14,28,8,0.330717,0.341568,0.000002,No
2,2,4,1,1,2,2,2,4,8,0.306657,0.315385,0.000002,No
14,14,196,6,12,18,14,14,28,7,0.373902,0.391986,0.000002,No
6,6,36,4,4,8,6,6,12,7,0.31764,0.324823,0.000002,No
5,5,25,2,4,6,5,5,10,8,0.341663,0.3554,0.000002,No
3,3,9,2,3,5,3,3,6,8,0.346569,0.359597,0.000002,No
3,3,9,2,2,4,3,3,6,8,0.316538,0.324537,0.000002,No
4,4,16,3,2,5,4,4,8,8,0.324022,0.334945,0.000002,No
3,3,9,2,3,5,3,3,6,8,0.336363,0.34847,0.000002,No
1,1,1,1,1,2,1,1,2,7,0.327819,0.338512,0.000002,No
2,2,4,2,2,4,2,2,4,7,0.331971,0.343315,0.000002,No
1,1,1,1,1,2,1,1,2,8,0.339941,0.352199,0.000002,No
15,15,225,9,9,18,15,15,30,8,0.347983,0.361679,0.000002,No
5,5,25,4,4,8,5,5,10,8,0.323371,0.334426,0.000002,No
1,1,1,1,1,2,1,1,2,8,0.306977,0.313343,0.000002,No
4,4,16,3,4,7,4,4,8,8,0.331365,0.342565,0.000002,No
2,2,4,2,2,4,2,2,4,8,0.312979,0.324985,0.000002,No
3,3,9,3,3,6,3,3,6,8,0.331147,0.341632,0.000002,No
18,16,288,6,14,20,18,18,36,7,0.35782,0.373062,0.000002,No
2,2,4,2,2,4,2,2,4,7,0.314051,0.320744,0.000002,No
1,1,1,1,1,2,1,1,2,8,0.339941,0.352199,0.000002,No
6,6,36,5,5,10,6,6,12,7,0.343272,0.355996,0.000002,No
2,2,4,2,2,4,2,2,4,8,0.34516,0.358804,0.000002,No
1,1,1,1,1,2,1,1,2,8,0.323426,0.334429,0.000002,No
2,2,4,2,2,4,2,2,4,8,0.303866,0.314006,0.000002,No
2,2,4,2,2,4,2,2,4,8,0.30753,0.320059,0.000002,No
2,2,4,2,2,4,2,2,4,8,0.346281,0.360278,0.000002,No
12,12,144,4,7,11,12,12,24,7,0.35669,0.371648,0.000002,No
5,5,25,4,4,8,5,5,10,8,0.307796,0.318728,0.000002,No
5,4,20,3,3,6,5,5,10,7,0.34011,0.352769,0.000002,No
1,1,1,1,1,2,1,1,2,9,0.261154,0.266929,0.000002,No
3,3,9,2,2,4,3,3,6,8,0.30732,0.319667,0.000002,No
7,7,49,7,5,12,7,7,14,7,0.372701,0.390268,0.000002,No
12,12,144,5,10,15,12,12,24,7,0.376858,0.394737,0.000002,No
14,14,196,8,12,20,14,14,28,8,0.384683,0.403553,0.000002,No
7,7,49,6,4,10,7,7,14,8,0.339779,0.352255,0.000002,No
3,3,9,3,3,6,3,3,6,8,0.315724,0.322598,0.000002,No
1,1,1,1,1,2,1,1,2,9,0.23227,0.235317,0.000002,No
1,1,1,1,1,2,1,1,2,8,0.339934,0.352194,0.000002,No
1,1,1,1,1,2,1,1,2,8,0.301589,0.314491,0.000002,No
2,2,4,2,2,4,2,2,4,8,0.324478,0.33538,0.000002,No
14,14,196,7,10,17,14,14,28,8,0.357183,0.372539,0.000002,No
5,5,25,5,4,9,5,5,10,8,0.313964,0.323697,0.000002,No
6,6,36,2,5,7,6,6,12,8,0.334025,0.345252,0.000002,No
3,3,9,2,2,4,3,3,6,8,0.324084,0.335001,0.000002,No
1,1,1,1,1,2,1,1,2,8,0.289257,0.299292,0.000002,No
5,5,25,3,3,6,5,5,10,8,0.315491,0.323647,0.000002,No
2,2,4,1,1,2,2,2,4,8,0.339934,0.352194,0.000002,No
5,5,25,3,5,8,5,5,10,7,0.33706,0.347619,0.000002,No
4,4,16,4,4,8,4,4,8,8,0.357468,0.373655,0.000002,No
2,1,2,2,2,4,2,2,4,7,0.34799,0.361931,0.000002,No
17,17,289,4,11,15,17,17,34,8,0.374304,0.392615,0.000002,No
11,11,121,4,5,9,11,11,22,8,0.327775,0.336687,0.000002,No
2,2,4,1,1,2,2,2,4,8,0.28349,0.292904,0.000002,No
4,3,12,2,3,5,4,4,8,7,0.355168,0.36971,0.000002,No
3,3,9,3,3,6,3,3,6,8,0.281326,0.28834,0.000002,No
3,3,9,1,1,2,3,3,6,8,0.269843,0.276101,0.000002,No
6,6,36,5,5,10,6,6,12,8,0.357011,0.373062,0.000002,No
15,15,225,6,14,20,15,15,30,8,0.369305,0.387264,0.000002,No
4,4,16,4,4,8,4,4,8,8,0.334444,0.346041,0.000002,No
10,9,90,8,8,16,10,10,20,8,0.365617,0.381868,0.000002,No
4,4,16,3,3,6,4,4,8,8,0.325574,0.33426,0.000002,No
4,4,16,4,4,8,4,4,8,8,0.288392,0.295989,0.000002,No
4,4,16,3,4,7,4,4,8,8,0.32669,0.337303,0.000002,No
1,1,1,1,1,2,1,1,2,7,0.327826,0.338517,0.000002,No
3,3,9,1,3,4,3,3,6,8,0.317753,0.326914,0.000002,No
9,9,81,5,8,13,9,9,18,8,0.335575,0.347133,0.000002,No
4,4,16,4,3,7,4,4,8,8,0.332813,0.343523,0.000002,No
1,1,1,1,1,2,1,1,2,8,0.271687,0.278326,0.000002,No
3,3,9,3,3,6,3,3,6,8,0.317984,0.326232,0.000002,No
8,8,64,5,6,11,8,8,16,8,0.333764,0.345389,0.000002,No
5,5,25,5,4,9,5,5,10,8,0.339549,0.351197,0.000002,No
3,3,9,1,2,3,3,3,6,8,0.305799,0.314985,0.000002,No
11,11,121,8,7,15,11,11,22,7,0.335569,0.346275,0.000002,No
21,21,441,5,8,13,21,21,42,8,0.356735,0.37216,0.000002,No
6,6,36,5,4,9,6,6,12,8,0.313773,0.321775,0.000002,No
7,7,49,4,5,9,7,7,14,7,0.34314,0.356091,0.000002,No
4,4,16,2,3,5,4,4,8,7,0.336243,0.347461,0.000002,No
3,3,9,3,3,6,3,3,6,8,0.34352,0.358144,0.000002,No
3,3,9,2,2,4,3,3,6,8,0.332133,0.343646,0.000002,No
3,3,9,3,3,6,3,3,6,8,0.346654,0.360677,0.000002,No
3,3,9,3,3,6,3,3,6,8,0.340056,0.35238,0.000002,No
6,6,36,5,4,9,6,6,12,7,0.34314,0.356628,0.000002,No
2,2,4,1,1,2,2,2,4,7,0.327819,0.338512,0.000002,No
2,2,4,1,1,2,2,2,4,9,0.248149,0.253067,0.000002,No
8,8,64,6,8,14,8,8,16,8,0.349358,0.363525,0.000002,No
5,4,20,5,5,10,5,5,10,8,0.346372,0.359749,0.000002,No
14,14,196,7,8,15,14,14,28,7,0.361336,0.377546,0.000002,No
6,6,36,5,4,9,6,6,12,8,0.352789,0.367267,0.000002,No
7,7,49,6,7,13,7,7,14,8,0.342493,0.3558,0.000002,No
1,1,1,1,1,2,1,1,2,9,0.256478,0.261676,0.000002,No
3,3,9,2,2,4,3,3,6,7,0.328773,0.339462,0.000002,No
1,1,1,1,1,2,1,1,2,8,0.301584,0.314486,0.000002,No
1,1,1,1,1,2,1,1,2,7,0.327819,0.338512,0.000002,No
1,1,1,1,1,2,1,1,2,9,0.24923,0.253915,0.000002,No
6,6,36,6,6,12,6,6,12,8,0.332742,0.345448,0.000002,No
4,4,16,3,2,5,4,4,8,8,0.333633,0.34531,0.000002,No
4,4,16,1,4,5,4,4,8,8,0.329866,0.341882,0.000002,No
2,1,2,2,2,4,2,2,4,8,0.296727,0.303663,0.000002,No
6,6,36,3,3,6,6,6,12,7,0.333288,0.343785,0.000002,No
6,5,30,3,2,5,6,6,12,7,0.328609,0.339226,0.000002,No
1,1,1,1,1,2,1,1,2,8,0.288163,0.299063,0.000002,No
5,5,25,3,5,8,5,5,10,7,0.334038,0.34581,0.000002,No
2,2,4,2,2,4,2,2,4,8,0.34361,0.356903,0.000002,No
2,2,4,2,2,4,2,2,4,8,0.303299,0.316554,0.000002,No
2,2,4,2,2,4,2,2,4,8,0.318941,0.326892,0.000002,No
2,2,4,2,2,4,2,2,4,8,0.294245,0.302144,0.000002,No
12,11,132,7,10,17,12,12,24,8,0.347353,0.361024,0.000002,No
14,14,196,6,8,14,14,14,28,8,0.338089,0.349341,0.000002,No
3,3,9,3,3,6,3,3,6,8,0.346436,0.360502,0.000002,No
7,7,49,7,5,12,7,7,14,8,0.311102,0.317544,0.000002,No
8,8,64,7,7,14,8,8,16,8,0.280291,0.287458,0.000002,No
9,9,81,4,5,9,9,9,18,8,0.31524,0.323936,0.000002,No
4,3,12,3,4,7,4,4,8,7,0.341718,0.354718,0.000002,No
9,6,54,6,3,9,9,9,18,8,0.315876,0.323682,0.000002,No
2,2,4,2,2,4,2,2,4,7,0.296356,0.304952,0.000002,No
5,5,25,5,5,10,5,5,10,7,0.351221,0.365899,0.000002,No
7,7,49,4,4,8,7,7,14,8,0.322796,0.332681,0.000002,No
1,1,1,1,1,2,1,1,2,7,0.327819,0.338512,0.000002,No
5,5,25,3,4,7,5,5,10,8,0.315432,0.323241,0.000002,No
2,2,4,2,2,4,2,2,4,7,0.333614,0.345149,0.000002,No
6,6,36,6,6,12,6,6,12,8,0.332657,0.34433,0.000002,No
1,1,1,1,1,2,1,1,2,8,0.339934,0.352194,0.000002,No
9,8,72,4,3,7,9,9,18,7,0.33621,0.348037,0.000002,No
5,5,25,5,3,8,5,5,10,8,0.323641,0.332404,0.000002,No
3,3,9,3,2,5,3,3,6,8,0.318827,0.329775,0.000002,No
14,13,182,8,6,14,14,14,28,8,0.340681,0.353559,0.000002,No
16,15,240,10,7,17,16,16,32,7,0.346872,0.36163,0.000002,No
5,5,25,3,4,7,5,5,10,8,0.302627,0.311433,0.000002,No
2,2,4,2,2,4,2,2,4,8,0.278107,0.286444,0.000002,No
9,9,81,5,2,7,9,9,18,7,0.332256,0.3428,0.000002,No
6,6,36,5,3,8,6,6,12,8,0.323463,0.334527,0.000002,No
8,8,64,6,4,10,8,8,16,7,0.355102,0.36978,0.000002,No
3,3,9,3,3,6,3,3,6,8,0.327819,0.336312,0.000002,No
12,12,144,6,10,16,12,12,24,8,0.325171,0.333115,0.000002,No
4,4,16,3,3,6,4,4,8,8,0.340538,0.353383,0.000002,No
4,4,16,3,3,6,4,4,8,8,0.302032,0.309079,0.000002,No
14,14,196,9,8,17,14,14,28,8,0.364337,0.38043,0.000002,No
2,1,2,2,1,3,2,2,4,8,0.309325,0.317943,0.000002,No
4,4,16,3,3,6,4,4,8,7,0.338498,0.349191,0.000002,No
11,11,121,7,8,15,11,11,22,8,0.349566,0.363758,0.000002,No
16,16,256,7,11,18,16,16,32,8,0.341137,0.353707,0.000002,No
7,7,49,5,7,12,7,7,14,8,0.366214,0.383321,0.000002,No
2,2,4,2,2,4,2,2,4,8,0.338243,0.351497,0.000002,No
3,2,6,2,3,5,3,3,6,8,0.339718,0.352697,0.000002,No
6,6,36,5,5,10,6,6,12,7,0.331353,0.343581,0.000002,No
12,12,144,6,8,14,12,12,24,7,0.345811,0.359428,0.000002,No
1,1,1,1,1,2,1,1,2,7,0.327826,0.338517,0.000002,No
15,13,195,6,8,14,15,15,30,7,0.351974,0.366354,0.000002,No
10,9,90,6,5,11,10,10,20,7,0.312824,0.320463,0.000002,No
4,4,16,4,4,8,4,4,8,8,0.330039,0.340518,0.000002,No
6,6,36,5,3,8,6,6,12,8,0.335939,0.349452,0.000002,No
2,2,4,2,2,4,2,2,4,8,0.286831,0.294692,0.000002,No
6,6,36,6,6,12,6,6,12,7,0.335846,0.347326,0.000002,No
1,1,1,1,1,2,1,1,2,8,0.339934,0.352194,0.000002,No
30,28,840,10,2,12,30,30,60,7,0.328242,0.338903,0.000002,No
7,7,49,4,5,9,7,7,14,8,0.332198,0.34416,0.000002,No
4,4,16,4,4,8,4,4,8,7,0.356206,0.371961,0.000002,No
7,7,49,3,3,6,7,7,14,8,0.324182,0.335585,0.000002,No
12,12,144,8,5,13,12,12,24,8,0.33518,0.348074,0.000002,No
5,5,25,2,4,6,5,5,10,8,0.352454,0.366602,0.000002,No
2,2,4,2,1,3,2,2,4,9,0.253744,0.258643,0.000002,No
3,3,9,3,2,5,3,3,6,8,0.27262,0.280761,0.000002,No
5,5,25,3,3,6,5,5,10,8,0.346879,0.360445,0.000002,No
1,1,1,1,1,2,1,1,2,8,0.288168,0.299068,0.000002,No
2,2,4,1,1,2,2,2,4,8,0.310033,0.318684,0.000002,No
1,1,1,1,1,2,1,1,2,8,0.339934,0.352194,0.000002,No
2,2,4,2,1,3,2,2,4,8,0.339934,0.352194,0.000002,No
12,12,144,8,8,16,12,12,24,8,0.363824,0.379945,0.000002,No
3,3,9,3,3,6,3,3,6,8,0.309051,0.316882,0.000002,No
9,9,81,7,5,12,9,9,18,7,0.354836,0.369657,0.000002,No
1,1,1,1,1,2,1,1,2,8,0.253831,0.259171,0.000002,No
5,5,25,5,5,10,5,5,10,8,0.345776,0.359985,0.000002,No
2,2,4,2,2,4,2,2,4,8,0.333672,0.345559,0.000002,No
5,4,20,4,5,9,5,5,10,8,0.325879,0.334823,0.000002,No
2,2,4,2,2,4,2,2,4,8,0.332262,0.343927,0.000002,No
15,15,225,9,3,12,15,15,30,7,0.348758,0.362686,0.000002,No
35,35,1225,15,2,17,35,35,70,7,0.328989,0.339759,0.000002,No
5,5,25,4,5,9,5,5,10,7,0.331359,0.34038,0.000002,No
5,5,25,4,4,8,5,5,10,8,0.298732,0.312019,0.000002,No
3,3,9,3,3,6,3,3,6,8,0.306701,0.314962,0.000002,No
4,4,16,4,4,8,4,4,8,8,0.344443,0.357363,0.000002,No
1,1,1,1,1,2,1,1,2,8,0.303661,0.312967,0.000002,No
6,6,36,5,6,11,6,6,12,8,0.320914,0.33001,0.000002,No
3,3,9,3,3,6,3,3,6,8,0.338283,0.351561,0.000002,No
3,3,9,2,2,4,3,3,6,8,0.331636,0.342481,0.000002,No
2,2,4,2,2,4,2,2,4,8,0.34516,0.358804,0.000002,No
1,1,1,1,1,2,1,1,2,8,0.339934,0.352194,0.000002,No
3,3,9,2,3,5,3,3,6,8,0.340647,0.352881,0.000002,No
1,1,1,1,1,2,1,1,2,9,0.262193,0.267775,0.000002,No
2,2,4,1,2,3,2,2,4,8,0.307286,0.315145,0.000002,No
2,2,4,2,2,4,2,2,4,8,0.28502,0.29441,0.000002,No
2,2,4,2,2,4,2,2,4,8,0.323463,0.334503,0.000002,No
2,2,4,2,2,4,2,2,4,8,0.302509,0.315894,0.000002,No
13,13,169,7,6,13,13,13,26,7,0.362026,0.378727,0.000002,No
6,6,36,5,5,10,6,6,12,8,0.332288,0.34309,0.000002,No
4,4,16,2,4,6,4,4,8,8,0.343306,0.356188,0.000002,No
6,6,36,5,4,9,6,6,12,8,0.317617,0.325009,0.000002,No
3,3,9,1,2,3,3,3,6,8,0.314972,0.323206,0.000002,No
3,3,9,1,2,3,3,3,6,8,0.315077,0.329701,0.000002,No
14,12,168,5,7,12,14,14,28,8,0.345181,0.35885,0.000002,No
1,1,1,1,1,2,1,1,2,8,0.339934,0.352194,0.000002,No
8,6,48,8,4,12,8,8,16,8,0.321737,0.331396,0.000002,No
4,4,16,1,3,4,4,4,8,8,0.354725,0.369676,0.000002,No
1,1,1,1,1,2,1,1,2,7,0.327819,0.338512,0.000002,No
4,4,16,4,4,8,4,4,8,8,0.34447,0.357333,0.000002,No
2,2,4,2,2,4,2,2,4,8,0.331584,0.343112,0.000002,No
6,5,30,5,4,9,6,6,12,8,0.339177,0.352281,0.000002,No
7,7,49,4,5,9,7,7,14,8,0.358451,0.373595,0.000002,No
4,4,16,3,3,6,4,4,8,8,0.323402,0.333785,0.000002,No
2,2,4,1,2,3,2,2,4,9,0.268328,0.274799,0.000002,No
6,6,36,5,5,10,6,6,12,8,0.340002,0.352243,0.000002,No
5,5,25,5,3,8,5,5,10,7,0.340974,0.354495,0.000002,No
1,1,1,1,1,2,1,1,2,8,0.267781,0.274223,0.000002,No
4,3,12,4,3,7,4,4,8,8,0.341533,0.355138,0.000002,No
2,2,4,2,2,4,2,2,4,8,0.340022,0.352292,0.000002,No
2,2,4,2,2,4,2,2,4,8,0.298111,0.306238,0.000002,No
8,8,64,4,5,9,8,8,16,8,0.354173,0.370068,0.000002,No
5,5,25,4,4,8,5,5,10,8,0.345412,0.360049,0.000002,No
1,1,1,1,1,2,1,1,2,8,0.339934,0.352194,0.000002,No
1,1,1,1,1,2,1,1,2,8,0.323426,0.334429,0.000002,No
8,8,64,6,8,14,8,8,16,8,0.333881,0.343889,0.000002,No
2,2,4,2,2,4,2,2,4,8,0.303197,0.316004,0.000002,No
1,1,1,1,1,2,1,1,2,9,0.248243,0.253439,0.000002,No
3,3,9,3,2,5,3,3,6,8,0.315537,0.324889,0.000002,No
4,4,16,2,2,4,4,4,8,8,0.293633,0.30057,0.000002,No
2,2,4,2,2,4,2,2,4,8,0.322692,0.331021,0.000002,No
9,9,81,4,4,8,9,9,18,7,0.338599,0.349853,0.000002,No
3,3,9,2,3,5,3,3,6,7,0.331121,0.341611,0.000002,No
10,10,100,8,9,17,10,10,20,7,0.371978,0.389402,0.000002,No
2,2,4,2,2,4,2,2,4,8,0.331952,0.343576,0.000002,No
1,1,1,1,1,2,1,1,2,9,0.268721,0.277328,0.000002,No
1,1,1,1,1,2,1,1,2,9,0.256413,0.261521,0.000002,No
1,1,1,1,1,2,1,1,2,8,0.292285,0.300565,0.000002,No
18,18,324,7,9,16,18,18,36,7,0.353015,0.368081,0.000002,No
5,5,25,2,3,5,5,5,10,8,0.320095,0.327068,0.000002,No
24,23,552,6,11,17,24,24,48,8,0.36248,0.37882,0.000002,No
9,9,81,4,4,8,9,9,18,7,0.326321,0.334639,0.000002,No
6,6,36,2,5,7,6,6,12,7,0.335582,0.346903,0.000002,No
4,4,16,4,4,8,4,4,8,8,0.342479,0.355212,0.000002,No
3,3,9,2,3,5,3,3,6,8,0.340077,0.352419,0.000002,No
7,7,49,5,7,12,7,7,14,8,0.352352,0.366904,0.000002,No
8,8,64,6,7,13,8,8,16,8,0.333738,0.344779,0.000002,No
1,1,1,1,1,2,1,1,2,8,0.32342,0.334424,0.000002,No
8,8,64,6,5,11,8,8,16,8,0.336416,0.349363,0.000002,No
6,6,36,3,3,6,6,6,12,8,0.344429,0.357951,0.000002,No
1,1,1,1,1,2,1,1,2,8,0.339934,0.352194,0.000002,No
3,3,9,3,3,6,3,3,6,8,0.361359,0.37701,0.000002,No
3,3,9,2,2,4,3,3,6,8,0.326771,0.337971,0.000002,No
3,3,9,3,3,6,3,3,6,8,0.343437,0.357601,0.000002,No
4,4,16,3,3,6,4,4,8,8,0.318239,0.328184,0.000002,No
9,9,81,6,5,11,9,9,18,7,0.341923,0.355376,0.000002,No
2,2,4,2,2,4,2,2,4,8,0.305171,0.318405,0.000002,No
3,3,9,3,3,6,3,3,6,8,0.303742,0.314251,0.000002,No
5,5,25,3,5,8,5,5,10,8,0.343306,0.355949,0.000002,No
13,13,169,6,7,13,13,13,26,8,0.344199,0.35788,0.000002,No
8,8,64,5,3,8,8,8,16,7,0.335926,0.346732,0.000002,No
4,4,16,4,4,8,4,4,8,8,0.33258,0.344848,0.000002,No
2,2,4,2,2,4,2,2,4,7,0.316052,0.325456,0.000002,No
6,6,36,4,4,8,6,6,12,8,0.326627,0.337271,0.000002,No
4,4,16,3,2,5,4,4,8,8,0.323629,0.33463,0.000002,No
3,3,9,3,3,6,3,3,6,8,0.316632,0.324651,0.000002,No
14,13,182,8,8,16,14,14,28,8,0.364213,0.381136,0.000002,No
3,3,9,2,3,5,3,3,6,8,0.341158,0.353472,0.000002,No
3,3,9,2,3,5,3,3,6,8,0.331288,0.342334,0.000002,No
3,3,9,3,2,5,3,3,6,8,0.311045,0.318511,0.000002,No
9,9,81,5,7,12,9,9,18,8,0.345049,0.358049,0.000002,No
8,8,64,3,5,8,8,8,16,7,0.345335,0.358133,0.000002,No
10,10,100,8,4,12,10,10,20,8,0.338962,0.351987,0.000002,No
1,1,1,1,1,2,1,1,2,9,0.255744,0.260978,0.000002,No
3,3,9,3,2,5,3,3,6,8,0.323469,0.334507,0.000002,No
12,12,144,8,3,11,12,12,24,8,0.318643,0.327746,0.000002,No
18,18,324,8,11,19,18,18,36,7,0.36885,0.385541,0.000002,No
3,3,9,3,2,5,3,3,6,7,0.327845,0.338571,0.000002,No
3,3,9,3,3,6,3,3,6,7,0.343617,0.356387,0.000002,No
6,6,36,6,3,9,6,6,12,8,0.30411,0.31103,0.000002,No
2,2,4,1,1,2,2,2,4,8,0.282804,0.289975,0.000002,No
4,4,16,4,4,8,4,4,8,8,0.346401,0.359892,0.000002,No
7,7,49,6,7,13,7,7,14,8,0.331057,0.342965,0.000002,No
10,10,100,8,8,16,10,10,20,8,0.355976,0.370954,0.000002,No
14,14,196,6,8,14,14,14,28,8,0.346999,0.361884,0.000002,No
2,2,4,2,2,4,2,2,4,8,0.34516,0.358804,0.000002,No
2,1,2,2,2,4,2,2,4,8,0.326758,0.337103,0.000002,No
4,4,16,2,4,6,4,4,8,8,0.327279,0.336941,0.000002,No
8,8,64,4,7,11,8,8,16,7,0.340151,0.351744,0.000002,No
6,6,36,4,5,9,6,6,12,8,0.299803,0.306525,0.000001,yes
5,5,25,4,4,8,5,5,10,8,0.315025,0.32522,0.000001,yes
6,6,36,5,4,9,6,6,12,8,0.315071,0.323577,0.000001,No
2,2,4,2,2,4,2,2,4,8,0.340348,0.352539,0.000001,No
1,1,1,1,1,2,1,1,2,8,0.339934,0.352194,0.000001,No
3,3,9,2,3,5,3,3,6,8,0.293108,0.301086,0.000001,No
5,4,20,2,4,6,5,5,10,8,0.35029,0.365548,0.000001,No
4,4,16,3,3,6,4,4,8,7,0.330288,0.341215,0.000001,No
1,1,1,1,1,2,1,1,2,8,0.277096,0.285605,0.000001,No
3,2,6,1,2,3,3,3,6,7,0.328236,0.338874,0.000001,No
4,4,16,4,2,6,4,4,8,8,0.311864,0.319858,0.000001,No
1,1,1,1,1,2,1,1,2,9,0.2425,0.245948,0.000001,No
1,1,1,1,1,2,1,1,2,7,0.296305,0.304855,0.000001,No
1,1,1,1,1,2,1,1,2,9,0.303807,0.312038,0.000001,No
1,1,1,1,1,2,1,1,2,8,0.278003,0.285466,0.000001,No
2,2,4,2,2,4,2,2,4,8,0.287871,0.299119,0.000001,No
14,11,154,2,9,11,14,14,28,7,0.369137,0.386346,0.000001,No
6,6,36,4,4,8,6,6,12,7,0.350514,0.365055,0.000001,No
4,4,16,3,4,7,4,4,8,8,0.338605,0.35138,0.000001,No
2,1,2,2,2,4,2,2,4,8,0.34664,0.360933,0.000001,No
1,1,1,1,1,2,1,1,2,9,0.255733,0.261996,0.000001,No
4,4,16,3,3,6,4,4,8,8,0.332372,0.343976,0.000001,No
3,3,9,2,3,5,3,3,6,8,0.319221,0.329467,0.000001,No
2,2,4,2,2,4,2,2,4,8,0.29185,0.301288,0.000001,No
9,8,72,7,4,11,9,9,18,8,0.339637,0.353239,0.000001,No
7,7,49,7,3,10,7,7,14,8,0.35446,0.369362,0.000001,No
4,4,16,3,2,5,4,4,8,8,0.32604,0.337402,0.000001,No
4,4,16,3,3,6,4,4,8,8,0.329166,0.341095,0.000001,No
8,8,64,6,5,11,8,8,16,8,0.332308,0.34446,0.000001,No
1,1,1,1,1,2,1,1,2,8,0.310033,0.318684,0.000001,No
2,2,4,2,2,4,2,2,4,8,0.312824,0.321667,0.000001,No
4,4,16,4,4,8,4,4,8,8,0.339434,0.352777,0.000001,No
2,2,4,2,2,4,2,2,4,7,0.331971,0.343315,0.000001,No
7,7,49,4,5,9,7,7,14,7,0.363344,0.379375,0.000001,No
3,3,9,3,3,6,3,3,6,8,0.317315,0.325997,0.000001,No
3,3,9,2,2,4,3,3,6,7,0.33152,0.343063,0.000001,No
2,2,4,2,2,4,2,2,4,8,0.332794,0.344157,0.000001,No
8,8,64,5,6,11,8,8,16,7,0.344874,0.356988,0.000001,No
3,3,9,3,3,6,3,3,6,7,0.318565,0.330662,0.000001,No
4,4,16,4,4,8,4,4,8,8,0.30598,0.314352,0.000001,No
1,1,1,1,1,2,1,1,2,8,0.29089,0.298101,0.000001,No
7,7,49,3,5,8,7,7,14,8,0.352519,0.367067,0.000001,No
3,3,9,2,3,5,3,3,6,8,0.346851,0.361194,0.000001,No
2,2,4,2,2,4,2,2,4,8,0.301674,0.31097,0.000001,No
16,16,256,10,8,18,16,16,32,7,0.341308,0.355173,0.000001,No
1,1,1,1,1,2,1,1,2,8,0.310717,0.317502,0.000001,No
4,2,8,2,2,4,4,4,8,8,0.287614,0.298849,0.000001,No
1,1,1,1,1,2,1,1,2,8,0.278743,0.288253,0.000001,No
20,20,400,6,10,16,20,20,40,7,0.378639,0.396415,0.000001,No
1,1,1,1,1,2,1,1,2,8,0.277732,0.284547,0.000001,No
2,2,4,1,1,2,2,2,4,7,0.327826,0.338517,0.000001,No
3,3,9,3,3,6,3,3,6,7,0.353887,0.368486,0.000001,No
5,5,25,3,5,8,5,5,10,8,0.349187,0.362592,0.000001,No
1,1,1,1,1,2,1,1,2,8,0.32342,0.334424,0.000001,No
9,9,81,7,3,10,9,9,18,7,0.353887,0.368486,0.000001,No
2,2,4,2,2,4,2,2,4,8,0.315654,0.325653,0.000001,No
2,2,4,1,2,3,2,2,4,8,0.321222,0.331358,0.000001,No
3,3,9,3,3,6,3,3,6,8,0.305051,0.317819,0.000001,No
2,2,4,1,1,2,2,2,4,8,0.304626,0.311242,0.000001,No
1,1,1,1,1,2,1,1,2,8,0.339941,0.352199,0.000001,No
2,2,4,2,2,4,2,2,4,8,0.322802,0.330195,0.000001,No
8,8,64,6,5,11,8,8,16,8,0.327618,0.338872,0.000001,No
6,6,36,5,4,9,6,6,12,8,0.307746,0.316331,0.000001,No
1,1,1,1,1,2,1,1,2,8,0.339941,0.352199,0.000001,No
2,2,4,2,1,3,2,2,4,8,0.32342,0.334424,0.000001,No
5,5,25,4,2,6,5,5,10,7,0.32902,0.339805,0.000001,No
7,7,49,5,5,10,7,7,14,8,0.32649,0.337611,0.000001,No
8,8,64,4,6,10,8,8,16,8,0.356489,0.372387,0.000001,No
7,7,49,4,5,9,7,7,14,8,0.358941,0.374231,0.000001,No
3,3,9,3,3,6,3,3,6,8,0.353081,0.369358,0.000001,No
3,3,9,3,3,6,3,3,6,8,0.341444,0.354322,0.000001,No
2,2,4,2,2,4,2,2,4,8,0.285334,0.292894,0.000001,No
2,2,4,2,2,4,2,2,4,8,0.264641,0.270943,0.000001,No
7,7,49,2,5,7,7,7,14,8,0.365125,0.382059,0.000001,No
1,1,1,1,1,2,1,1,2,8,0.288168,0.299068,0.000001,No
9,8,72,7,8,15,9,9,18,7,0.350276,0.364364,0.000001,No
3,3,9,3,3,6,3,3,6,8,0.307027,0.315891,0.000001,No
7,5,35,3,5,8,7,7,14,8,0.34009,0.352783,0.000001,No
8,8,64,3,4,7,8,8,16,7,0.332528,0.344316,0.000001,No
1,1,1,1,1,2,1,1,2,8,0.309325,0.317943,0.000001,No
1,1,1,1,1,2,1,1,2,8,0.317445,0.327454,0.000001,No
1,1,1,1,1,2,1,1,2,8,0.306651,0.31538,0.000001,No
2,2,4,2,2,4,2,2,4,8,0.307558,0.317061,0.000001,No
4,4,16,1,3,4,4,4,8,7,0.331282,0.342096,0.000001,No
1,1,1,1,1,2,1,1,2,8,0.278743,0.288253,0.000001,No
2,2,4,2,2,4,2,2,4,8,0.34011,0.352439,0.000001,No
2,2,4,1,2,3,2,2,4,8,0.312985,0.32499,0.000001,No
2,2,4,1,2,3,2,2,4,8,0.331784,0.343272,0.000001,No
2,2,4,2,2,4,2,2,4,8,0.314352,0.321928,0.000001,No
1,1,1,1,1,2,1,1,2,8,0.281791,0.289268,0.000001,No
5,5,25,5,5,10,5,5,10,8,0.314323,0.321843,0.000001,No
2,2,4,2,2,4,2,2,4,8,0.326765,0.337657,0.000001,No
8,8,64,5,3,8,8,8,16,8,0.317333,0.330326,0.000001,No
1,1,1,1,1,2,1,1,2,8,0.277096,0.285605,0.000001,No
1,1,1,1,1,2,1,1,2,8,0.317292,0.324388,0.000001,No
1,1,1,1,1,2,1,1,2,7,0.2963,0.30485,0.000001,No
3,3,9,3,1,4,3,3,6,8,0.288168,0.299068,0.000001,No
13,13,169,8,5,13,13,13,26,7,0.351858,0.366239,0.000001,No
7,7,49,4,5,9,7,7,14,7,0.346499,0.359819,0.000001,No
12,11,132,5,7,12,12,12,24,7,0.354232,0.368526,0.000001,No
1,1,1,1,1,2,1,1,2,7,0.327819,0.338512,0.000001,No
2,2,4,2,1,3,2,2,4,9,0.268721,0.277328,0.000001,No
5,5,25,4,1,5,5,5,10,9,0.268721,0.277328,0.000001,No
1,1,1,1,1,2,1,1,2,7,0.327826,0.338517,0.000001,No
2,2,4,2,1,3,2,2,4,8,0.339934,0.352194,0.000001,No
2,2,4,2,2,4,2,2,4,8,0.3185,0.326718,0.000001,No
4,4,16,3,3,6,4,4,8,8,0.323825,0.332806,0.000001,No
4,4,16,3,3,6,4,4,8,7,0.316198,0.325627,0.000001,No
2,2,4,2,2,4,2,2,4,8,0.315707,0.324485,0.000001,No
4,4,16,3,2,5,4,4,8,8,0.352396,0.367736,0.000001,No
1,1,1,1,1,2,1,1,2,8,0.288163,0.299063,0.000001,No
6,6,36,1,4,5,6,6,12,8,0.307857,0.320049,0.000001,No
8,8,64,3,7,10,8,8,16,8,0.335213,0.347428,0.000001,No
9,9,81,1,6,7,9,9,18,7,0.326677,0.335872,0.000001,No
8,8,64,2,6,8,8,8,16,8,0.325481,0.335894,0.000001,No
13,13,169,5,6,11,13,13,26,8,0.318911,0.331755,0.000001,No
2,2,4,1,2,3,2,2,4,8,0.291227,0.298646,0.000001,No
10,10,100,6,5,11,10,10,20,8,0.341732,0.355539,0.000001,No
3,3,9,2,2,4,3,3,6,8,0.323463,0.334503,0.000001,No
5,5,25,5,5,10,5,5,10,8,0.321325,0.331479,0.000001,No
2,2,4,2,2,4,2,2,4,8,0.326458,0.336457,0.000001,No
3,3,9,2,3,5,3,3,6,8,0.329198,0.341022,0.000001,No
5,5,25,3,3,6,5,5,10,8,0.341431,0.354115,0.000001,No
18,18,324,6,12,18,18,18,36,7,0.346886,0.359903,0.000001,No
3,3,9,3,3,6,3,3,6,7,0.352651,0.367024,0.000001,No
5,5,25,5,2,7,5,5,10,8,0.282575,0.289553,0.000001,No
6,6,36,5,5,10,6,6,12,7,0.338229,0.350218,0.000001,No
8,8,64,6,6,12,8,8,16,7,0.342314,0.355436,0.000001,No
8,8,64,1,4,5,8,8,16,7,0.329917,0.340343,0.000001,No
4,4,16,3,2,5,4,4,8,8,0.30161,0.314545,0.000001,No
2,2,4,2,2,4,2,2,4,7,0.319801,0.327136,0.000001,No
2,2,4,2,2,4,2,2,4,8,0.352003,0.366286,0.000001,No
1,1,1,1,1,2,1,1,2,8,0.29596,0.304319,0.000001,No
3,3,9,3,1,4,3,3,6,8,0.288163,0.299063,0.000001,No
1,1,1,1,1,2,1,1,2,9,0.284336,0.292278,0.000001,No
2,2,4,1,1,2,2,2,4,8,0.305078,0.312168,0.000001,No
4,4,16,2,2,4,4,4,8,8,0.317705,0.324907,0.000001,No
2,2,4,2,2,4,2,2,4,7,0.347983,0.361927,0.000001,No
4,4,16,2,3,5,4,4,8,7,0.335417,0.347617,0.000001,No
10,10,100,3,6,9,10,10,20,8,0.357206,0.372993,0.000001,No
3,3,9,3,3,6,3,3,6,8,0.317824,0.327473,0.000001,No
1,1,1,1,1,2,1,1,2,9,0.254949,0.25998,0.000001,No
12,12,144,4,6,10,12,12,24,8,0.35268,0.367451,0.000001,No
3,3,9,2,3,5,3,3,6,7,0.335345,0.346752,0.000001,No
1,1,1,1,1,2,1,1,2,7,0.296305,0.304855,0.000001,No
3,3,9,2,3,5,3,3,6,8,0.346837,0.360943,0.000001,No
1,1,1,1,1,2,1,1,2,8,0.339941,0.352199,0.000001,No
4,4,16,2,4,6,4,4,8,8,0.316585,0.324066,0.000001,No
5,5,25,4,5,9,5,5,10,8,0.325276,0.335265,0.000001,No
6,6,36,2,4,6,6,6,12,8,0.340586,0.353103,0.000001,No
1,1,1,1,1,2,1,1,2,9,0.252057,0.257025,0.000001,No
5,5,25,2,4,6,5,5,10,8,0.346316,0.360047,0.000001,No
5,5,25,4,4,8,5,5,10,8,0.328932,0.340618,0.000001,No
3,3,9,3,3,6,3,3,6,7,0.320818,0.330717,0.000001,No
2,2,4,2,2,4,2,2,4,8,0.321035,0.331369,0.000001,No
4,4,16,4,4,8,4,4,8,8,0.325897,0.335165,0.000001,No
1,1,1,1,1,2,1,1,2,8,0.301589,0.314491,0.000001,No
4,4,16,2,3,5,4,4,8,8,0.307552,0.314403,0.000001,No
9,9,81,6,3,9,9,9,18,8,0.346295,0.360317,0.000001,No
1,1,1,1,1,2,1,1,2,9,0.26237,0.268107,0.000001,No
1,1,1,1,1,2,1,1,2,9,0.256301,0.261322,0.000001,No
2,2,4,2,2,4,2,2,4,8,0.308358,0.314942,0.000001,No
2,2,4,2,2,4,2,2,4,8,0.320131,0.330419,0.000001,No
5,5,25,3,4,7,5,5,10,8,0.316515,0.324306,0.000001,No
12,12,144,11,6,17,12,12,24,8,0.349237,0.363394,0.000001,No
5,4,20,2,5,7,5,5,10,8,0.349738,0.363614,0.000001,No
7,7,49,5,5,10,7,7,14,7,0.346569,0.360361,0.000001,No
4,4,16,4,3,7,4,4,8,8,0.342294,0.355074,0.000001,No
1,1,1,1,1,2,1,1,2,8,0.248038,0.252431,0.000001,No
1,1,1,1,1,2,1,1,2,9,0.273367,0.280259,0.000001,No
2,2,4,2,2,4,2,2,4,8,0.32218,0.330697,0.000001,No
2,1,2,1,2,3,2,2,4,8,0.291297,0.298354,0.000001,No
4,4,16,3,4,7,4,4,8,8,0.343714,0.356374,0.000001,No
6,6,36,5,5,10,6,6,12,7,0.355464,0.370117,0.000001,No
6,6,36,5,6,11,6,6,12,7,0.349165,0.363032,0.000001,No
3,3,9,2,2,4,3,3,6,8,0.342156,0.354836,0.000001,No
1,1,1,1,1,2,1,1,2,7,0.327826,0.338517,0.000001,No
5,5,25,3,4,7,5,5,10,8,0.324022,0.332683,0.000001,No
15,14,210,3,5,8,15,15,30,7,0.355657,0.37063,0.000001,No
8,8,64,3,5,8,8,8,16,8,0.351271,0.365588,0.000001,No
9,9,81,7,5,12,9,9,18,7,0.363035,0.3789,0.000001,No
19,16,304,7,11,18,19,19,38,8,0.327568,0.337172,0.000001,No
2,2,4,1,1,2,2,2,4,8,0.302584,0.309507,0.000001,No
4,4,16,3,4,7,4,4,8,7,0.337794,0.348261,0.000001,No
2,2,4,2,2,4,2,2,4,8,0.317628,0.324757,0.000001,No
3,3,9,2,3,5,3,3,6,7,0.339333,0.352131,0.000001,No
1,1,1,1,1,2,1,1,2,8,0.310717,0.317502,0.000001,No
5,4,20,4,3,7,5,5,10,7,0.354917,0.369875,0.000001,No
6,6,36,6,6,12,6,6,12,8,0.334562,0.346516,0.000001,No
3,3,9,3,3,6,3,3,6,7,0.341526,0.354983,0.000001,No
8,8,64,2,2,4,8,8,16,8,0.32054,0.328535,0.000001,No
3,3,9,2,3,5,3,3,6,8,0.318643,0.32862,0.000001,No
2,2,4,2,2,4,2,2,4,8,0.338243,0.351497,0.000001,No
1,1,1,1,1,2,1,1,2,8,0.317292,0.324388,0.000001,No
9,9,81,8,6,14,9,9,18,8,0.350334,0.364528,0.000001,No
3,3,9,3,2,5,3,3,6,8,0.326465,0.336462,0.000001,No
5,5,25,3,5,8,5,5,10,7,0.321949,0.332413,0.000001,No
3,3,9,3,3,6,3,3,6,8,0.346957,0.359952,0.000001,No
5,5,25,5,3,8,5,5,10,8,0.340022,0.352312,0.000001,No
2,2,4,1,1,2,2,2,4,8,0.28699,0.295341,0.000001,No
6,6,36,2,5,7,6,6,12,7,0.341622,0.354327,0.000001,No
4,4,16,4,4,8,4,4,8,8,0.316509,0.325419,0.000001,No
17,17,289,9,4,13,17,17,34,8,0.34463,0.357662,0.000001,No
1,1,1,1,1,2,1,1,2,8,0.271899,0.280395,0.000001,No
2,2,4,2,2,4,2,2,4,8,0.341923,0.354371,0.000001,No
5,5,25,5,4,9,5,5,10,8,0.355531,0.370999,0.000001,No
2,2,4,2,2,4,2,2,4,8,0.337814,0.352069,0.000001,No
4,4,16,1,3,4,4,4,8,7,0.328109,0.338859,0.000001,No
4,4,16,4,3,7,4,4,8,8,0.30462,0.313913,0.000001,No
1,1,1,1,1,2,1,1,2,8,0.277096,0.285605,0.000001,No
1,1,1,1,1,2,1,1,2,8,0.26015,0.26574,0.000001,No
1,1,1,1,1,2,1,1,2,8,0.315759,0.323487,0.000001,No
3,3,9,2,3,5,3,3,6,8,0.352178,0.36653,0.000001,No
1,1,1,1,1,2,1,1,2,9,0.255014,0.260229,0.000001,No
1,1,1,1,1,2,1,1,2,8,0.288168,0.299068,0.000001,No
1,1,1,1,1,2,1,1,2,8,0.301589,0.314491,0.000001,No
5,5,25,4,5,9,5,5,10,7,0.339488,0.351854,0.000001,No
5,4,20,4,5,9,5,5,10,8,0.355294,0.370206,0.000001,No
1,1,1,1,1,2,1,1,2,8,0.323426,0.334429,0.000001,No
1,1,1,1,1,2,1,1,2,8,0.317445,0.327454,0.000001,No
3,3,9,1,3,4,3,3,6,8,0.323138,0.333362,0.000001,No
8,8,64,4,6,10,8,8,16,7,0.327191,0.33631,0.000001,No
1,1,1,1,1,2,1,1,2,8,0.291401,0.298476,0.000001,No
1,1,1,1,1,2,1,1,2,8,0.323426,0.334429,0.000001,No
7,7,49,4,5,9,7,7,14,8,0.358534,0.374564,0.000001,No
2,2,4,2,2,4,2,2,4,8,0.337347,0.34954,0.000001,No
1,1,1,1,1,2,1,1,2,9,0.268721,0.277328,0.000001,No
4,4,16,4,4,8,4,4,8,8,0.322912,0.330983,0.000001,No
4,4,16,1,2,3,4,4,8,8,0.30783,0.314525,0.000001,No
1,1,1,1,1,2,1,1,2,8,0.310717,0.317502,0.000001,No
1,1,1,1,1,2,1,1,2,8,0.331578,0.343078,0.000001,No
1,1,1,1,1,2,1,1,2,8,0.317292,0.324388,0.000001,No
6,6,36,2,5,7,6,6,12,8,0.317451,0.324412,0.000001,No
4,4,16,2,4,6,4,4,8,8,0.326777,0.336954,0.000001,No
1,1,1,1,1,2,1,1,2,8,0.288168,0.299068,0.000001,No
6,6,36,3,2,5,6,6,12,7,0.328647,0.339557,0.000001,No
12,12,144,3,10,13,12,12,24,8,0.352185,0.366785,0.000001,No
11,11,121,9,8,17,11,11,22,7,0.344728,0.357079,0.000001,No
9,7,63,9,7,16,9,9,18,8,0.359206,0.374842,0.000001,No
3,3,9,3,3,6,3,3,6,7,0.304751,0.314816,0.000001,No
3,3,9,3,3,6,3,3,6,8,0.340776,0.35306,0.000001,No
1,1,1,1,1,2,1,1,2,8,0.268345,0.275546,0.000001,No
3,3,9,1,1,2,3,3,6,8,0.268345,0.275546,0.000001,No
8,8,64,7,3,10,8,8,16,8,0.342658,0.356583,0.000001,No
5,5,25,3,2,5,5,5,10,8,0.315765,0.324947,0.000001,No
7,7,49,3,7,10,7,7,14,8,0.333438,0.344169,0.000001,No
7,7,49,3,5,8,7,7,14,8,0.327291,0.336607,0.000001,No
1,1,1,1,1,2,1,1,2,8,0.301584,0.314486,0.000001,No
1,1,1,1,1,2,1,1,2,8,0.28214,0.289603,0.000001,No
1,1,1,1,1,2,1,1,2,8,0.32342,0.334424,0.000001,No
4,4,16,3,3,6,4,4,8,8,0.331462,0.344388,0.000001,No
3,3,9,3,2,5,3,3,6,8,0.31834,0.325688,0.000001,No
2,2,4,2,2,4,2,2,4,8,0.271479,0.278112,0.000001,No
2,2,4,1,1,2,2,2,4,8,0.310028,0.318679,0.000001,No
2,2,4,2,2,4,2,2,4,8,0.303294,0.316544,0.000001,No
2,2,4,2,2,4,2,2,4,8,0.301765,0.308743,0.000001,No
5,5,25,4,3,7,5,5,10,8,0.338686,0.351976,0.000001,No
6,6,36,5,4,9,6,6,12,8,0.313255,0.321178,0.000001,No
8,7,56,7,5,12,8,8,16,8,0.329097,0.340827,0.000001,No
3,3,9,2,3,5,3,3,6,8,0.317339,0.325087,0.000001,No
2,2,4,2,2,4,2,2,4,8,0.277195,0.287213,0.000001,No
3,3,9,2,2,4,3,3,6,7,0.336363,0.346863,0.000001,No
6,6,36,5,3,8,6,6,12,8,0.331295,0.343685,0.000001,No
1,1,1,1,1,2,1,1,2,8,0.310717,0.317502,0.000001,No
2,2,4,2,2,4,2,2,4,8,0.290904,0.298025,0.000001,No
5,5,25,3,4,7,5,5,10,7,0.337694,0.349616,0.000001,No
5,5,25,4,3,7,5,5,10,8,0.351691,0.366153,0.000001,No
3,3,9,3,3,6,3,3,6,8,0.29782,0.305034,0.000001,No
2,2,4,2,2,4,2,2,4,8,0.341752,0.354359,0.000001,No
2,2,4,2,1,3,2,2,4,8,0.301089,0.307726,0.000001,No
1,1,1,1,1,2,1,1,2,8,0.323426,0.334429,0.000001,No
1,1,1,1,1,2,1,1,2,8,0.301589,0.314491,0.000001,No
1,1,1,1,1,2,1,1,2,8,0.281712,0.288995,0.000001,No
1,1,1,1,1,2,1,1,2,8,0.249656,0.254213,0.000001,No
4,4,16,4,3,7,4,4,8,8,0.295233,0.306301,0.000001,No
1,1,1,1,1,2,1,1,2,9,0.263403,0.271075,0.000001,No
6,6,36,4,5,9,6,6,12,7,0.347374,0.36047,0.000001,No
6,6,36,4,4,8,6,6,12,8,0.341274,0.354534,0.000001,No
10,10,100,3,5,8,10,10,20,8,0.350247,0.365375,0.000001,No
8,6,48,8,6,14,8,8,16,8,0.342754,0.35652,0.000001,No
1,1,1,1,1,2,1,1,2,9,0.236009,0.239115,0.000001,No
5,5,25,5,4,9,5,5,10,8,0.332327,0.344361,0.000001,No
6,6,36,6,5,11,6,6,12,8,0.316116,0.329246,0.000001,No
3,3,9,3,2,5,3,3,6,8,0.315095,0.322797,0.000001,No
1,1,1,1,1,2,1,1,2,8,0.288168,0.299068,0.000001,No
1,1,1,1,1,2,1,1,2,9,0.246529,0.250769,0.000001,No
7,7,49,6,6,12,7,7,14,8,0.356214,0.372899,0.000001,No
3,3,9,2,2,4,3,3,6,8,0.327832,0.339198,0.000001,No
1,1,1,1,1,2,1,1,2,8,0.272285,0.27868,0.000001,No
9,9,81,2,6,8,9,9,18,7,0.364992,0.38171,0.000001,No
2,2,4,2,2,4,2,2,4,8,0.323432,0.334464,0.000001,No
2,2,4,2,1,3,2,2,4,8,0.301584,0.314486,0.000001,No
1,1,1,1,1,2,1,1,2,9,0.303807,0.312038,0.000001,No
3,3,9,2,3,5,3,3,6,8,0.348509,0.361987,0.000001,No
7,6,42,4,3,7,7,7,14,7,0.332521,0.343236,0.000001,No
21,21,441,7,8,15,21,21,42,8,0.341055,0.35326,0.000001,No
8,8,64,1,1,2,8,8,16,8,0.277096,0.285605,0.000001,No
2,2,4,2,2,4,2,2,4,8,0.318197,0.32603,0.000001,No
2,2,4,2,2,4,2,2,4,8,0.29983,0.307732,0.000001,No
1,1,1,1,1,2,1,1,2,8,0.301584,0.314486,0.000001,No
7,7,49,2,5,7,7,7,14,7,0.342143,0.355566,0.000001,No
4,4,16,4,4,8,4,4,8,8,0.316403,0.325314,0.000001,No
4,4,16,3,4,7,4,4,8,8,0.322741,0.333997,0.000001,No
1,1,1,1,1,2,1,1,2,7,0.2963,0.30485,0.000001,No
2,2,4,2,2,4,2,2,4,8,0.305394,0.317799,0.000001,No
3,3,9,1,3,4,3,3,6,8,0.322083,0.333067,0.000001,No
1,1,1,1,1,2,1,1,2,8,0.309073,0.31582,0.000001,No
1,1,1,1,1,2,1,1,2,8,0.301589,0.314491,0.000001,No
1,1,1,1,1,2,1,1,2,9,0.252143,0.25648,0.000001,No
2,2,4,1,2,3,2,2,4,8,0.291351,0.29902,0.000001,No
3,3,9,3,3,6,3,3,6,7,0.301137,0.310237,0.000001,No
1,1,1,1,1,2,1,1,2,8,0.277096,0.285605,0.000001,No
4,4,16,3,4,7,4,4,8,8,0.363731,0.379912,0.000001,No
12,12,144,6,6,12,12,12,24,8,0.342975,0.355367,0.000001,No
6,6,36,4,3,7,6,6,12,8,0.315876,0.32373,0.000001,No
1,1,1,1,1,2,1,1,2,8,0.331571,0.343073,0.000001,No
2,2,4,1,1,2,2,2,4,8,0.289744,0.297204,0.000001,No
6,6,36,1,1,2,6,6,12,8,0.277096,0.285605,0.000001,No
2,2,4,1,2,3,2,2,4,8,0.288368,0.295488,0.000001,No
6,6,36,3,5,8,6,6,12,8,0.344491,0.357939,0.000001,No
6,5,30,5,6,11,6,6,12,8,0.344846,0.358294,0.000001,No
4,4,16,3,4,7,4,4,8,8,0.342858,0.355903,0.000001,No
4,4,16,4,4,8,4,4,8,8,0.327015,0.34262,0.000001,No
10,10,100,7,6,13,10,10,20,8,0.33942,0.351829,0.000001,No
13,13,169,9,10,19,13,13,26,8,0.329662,0.34068,0.000001,No
5,4,20,4,4,8,5,5,10,8,0.347756,0.361285,0.000001,No
1,1,1,1,1,2,1,1,2,9,0.249037,0.253725,0.000001,No
2,2,4,2,2,4,2,2,4,7,0.339299,0.352072,0.000001,No
1,1,1,1,1,2,1,1,2,8,0.323426,0.334429,0.000001,No
10,9,90,4,3,7,10,10,20,8,0.306596,0.313073,0.000001,No
5,5,25,5,1,6,5,5,10,8,0.310028,0.318679,0.000001,No
5,4,20,3,4,7,5,5,10,7,0.352789,0.367205,0.000001,No
2,2,4,2,2,4,2,2,4,9,0.268438,0.274638,0.000001,No
2,2,4,2,2,4,2,2,4,8,0.32095,0.32901,0.000001,No
1,1,1,1,1,2,1,1,2,8,0.263705,0.270309,0.000001,No
1,1,1,1,1,2,1,1,2,8,0.317445,0.327454,0.000001,No
5,5,25,5,4,9,5,5,10,8,0.325412,0.335731,0.000001,No
5,5,25,4,3,7,5,5,10,8,0.317652,0.326714,0.000001,No
6,6,36,2,2,4,6,6,12,8,0.311585,0.320075,0.000001,No
29,29,841,5,5,10,29,29,58,8,0.346422,0.360709,0.000001,No
1,1,1,1,1,2,1,1,2,8,0.29166,0.299213,0.000001,No
2,2,4,2,2,4,2,2,4,9,0.279955,0.289203,0.000001,No
8,7,56,4,5,9,8,8,16,8,0.353103,0.368202,0.000001,No
19,19,361,5,9,14,19,19,38,7,0.376077,0.394097,0.000001,No
6,6,36,4,3,7,6,6,12,8,0.353315,0.36874,0.000001,No
3,3,9,2,2,4,3,3,6,8,0.342342,0.354886,0.000001,No
4,3,12,2,4,6,4,4,8,8,0.341253,0.353739,0.000001,No
3,3,9,2,2,4,3,3,6,8,0.342129,0.354809,0.000001,No
3,3,9,3,2,5,3,3,6,7,0.329484,0.34031,0.000001,No
4,4,16,3,3,6,4,4,8,8,0.356772,0.372396,0.000001,No
2,2,4,1,2,3,2,2,4,8,0.34516,0.358804,0.000001,No
2,2,4,1,2,3,2,2,4,8,0.274957,0.281722,0.000001,No
4,4,16,1,3,4,4,4,8,7,0.331031,0.342113,0.000001,No
1,1,1,1,1,2,1,1,2,8,0.309325,0.317943,0.000001,No
2,2,4,2,2,4,2,2,4,8,0.339975,0.352268,0.000001,No
7,7,49,5,6,11,7,7,14,8,0.360062,0.375564,0.000001,No
7,7,49,5,6,11,7,7,14,8,0.329065,0.338377,0.000001,No
1,1,1,1,1,2,1,1,2,8,0.323426,0.334429,0.000001,No
2,2,4,2,2,4,2,2,4,8,0.331849,0.343345,0.000001,No
6,6,36,5,4,9,6,6,12,7,0.332599,0.343825,0.000001,No
6,6,36,3,3,6,6,6,12,7,0.334032,0.345201,0.000001,No
4,4,16,4,4,8,4,4,8,7,0.310881,0.318331,0.000001,No
3,3,9,2,2,4,3,3,6,8,0.34361,0.356903,0.000001,No
2,2,4,2,2,4,2,2,4,8,0.28222,0.289361,0.000001,No
1,1,1,1,1,2,1,1,2,8,0.323426,0.334429,0.000001,No
4,4,16,2,4,6,4,4,8,8,0.289424,0.300618,0.000001,No
5,5,25,4,5,9,5,5,10,7,0.349308,0.363809,0.000001,No
1,1,1,1,1,2,1,1,2,8,0.30338,0.311471,0.000001,No
5,5,25,3,5,8,5,5,10,7,0.346985,0.360215,0.000001,No
1,1,1,1,1,2,1,1,2,8,0.339941,0.352199,0.000001,No
1,1,1,1,1,2,1,1,2,8,0.339941,0.352199,0.000001,No
3,3,9,2,2,4,3,3,6,8,0.339955,0.352243,0.000001,No
1,1,1,1,1,2,1,1,2,8,0.309331,0.317947,0.000001,No
5,5,25,3,5,8,5,5,10,8,0.35681,0.37256,0.000001,No
1,1,1,1,1,2,1,1,2,8,0.271899,0.280395,0.000001,No
1,1,1,1,1,2,1,1,2,8,0.331571,0.343073,0.000001,No
5,5,25,4,2,6,5,5,10,8,0.287159,0.294191,0.000001,No
4,4,16,3,3,6,4,4,8,8,0.326153,0.336943,0.000001,No
1,1,1,1,1,2,1,1,2,7,0.327826,0.338517,0.000001,No
3,3,9,1,3,4,3,3,6,8,0.346274,0.360117,0.000001,No
2,2,4,2,2,4,2,2,4,7,0.336363,0.346863,0.000001,No
2,2,4,2,2,4,2,2,4,8,0.296867,0.305552,0.000001,No
5,4,20,1,4,5,5,5,10,8,0.347013,0.360176,0.000001,No
4,4,16,3,2,5,4,4,8,7,0.342211,0.354859,0.000001,No
10,10,100,2,5,7,10,10,20,7,0.343638,0.356542,0.000001,No
4,4,16,4,4,8,4,4,8,8,0.345272,0.35899,0.000001,No
1,1,1,1,1,2,1,1,2,8,0.310028,0.318679,0.000001,No
5,5,25,4,4,8,5,5,10,8,0.354873,0.370624,0.000001,No
10,10,100,6,4,10,10,10,20,8,0.309342,0.323486,0.000001,No
2,2,4,2,2,4,2,2,4,8,0.320739,0.330846,0.000001,No
8,8,64,6,6,12,8,8,16,8,0.333457,0.346304,0.000001,No
6,6,36,6,5,11,6,6,12,8,0.339549,0.351988,0.000001,No
2,2,4,1,2,3,2,2,4,8,0.34461,0.357406,0.000001,No
1,1,1,1,1,2,1,1,2,8,0.268345,0.275546,0.000001,No
10,10,100,6,7,13,10,10,20,8,0.368914,0.387182,0.000001,No
10,10,100,6,3,9,10,10,20,8,0.317847,0.327691,0.000001,No
1,1,1,1,1,2,1,1,2,8,0.339934,0.352194,0.000001,No
5,5,25,3,4,7,5,5,10,8,0.350132,0.364136,0.000001,No
3,3,9,2,2,4,3,3,6,8,0.321464,0.329859,0.000001,No
5,5,25,5,5,10,5,5,10,8,0.31559,0.324354,0.000001,No
3,3,9,3,3,6,3,3,6,8,0.339921,0.353213,0.000001,No
2,2,4,2,2,4,2,2,4,8,0.308754,0.316717,0.000001,No
6,6,36,3,2,5,6,6,12,7,0.32799,0.338698,0.000001,No
4,4,16,2,4,6,4,4,8,8,0.345769,0.359615,0.000001,No
6,6,36,3,4,7,6,6,12,8,0.354984,0.371019,0.000001,No
3,3,9,2,2,4,3,3,6,8,0.323475,0.33451,0.000001,No
2,2,4,2,2,4,2,2,4,8,0.302498,0.312731,0.000001,No
1,1,1,1,1,2,1,1,2,8,0.235735,0.239273,0.000001,No
6,6,36,5,4,9,6,6,12,8,0.3068,0.314934,0.000001,No
1,1,1,1,1,2,1,1,2,8,0.317445,0.327454,0.000001,No
5,5,25,2,3,5,5,5,10,8,0.334149,0.346414,0.000001,No
2,2,4,2,2,4,2,2,4,7,0.315549,0.324581,0.000001,No
1,1,1,1,1,2,1,1,2,8,0.301589,0.314491,0.000001,No
6,6,36,5,5,10,6,6,12,8,0.340878,0.353482,0.000001,No
1,1,1,1,1,2,1,1,2,8,0.279241,0.286909,0.000001,No
3,3,9,1,1,2,3,3,6,7,0.327826,0.338517,0.000001,No
1,1,1,1,1,2,1,1,2,9,0.254508,0.259512,0.000001,No
1,1,1,1,1,2,1,1,2,8,0.266509,0.272957,0.000001,No
4,4,16,4,4,8,4,4,8,8,0.32393,0.333866,0.000001,No
1,1,1,1,1,2,1,1,2,8,0.242869,0.246439,0.000001,No
5,5,25,3,3,6,5,5,10,8,0.311625,0.318489,0.000001,No
2,2,4,1,2,3,2,2,4,8,0.339948,0.352234,0.000001,No
4,4,16,3,3,6,4,4,8,8,0.342266,0.354807,0.000001,No
7,7,49,5,5,10,7,7,14,8,0.320468,0.327874,0.000001,No
1,1,1,1,1,2,1,1,2,8,0.339941,0.352199,0.000001,No
6,6,36,4,5,9,6,6,12,8,0.348004,0.363685,0.000001,No
5,4,20,5,4,9,5,5,10,8,0.330211,0.341974,0.000001,No
10,10,100,9,1,10,10,10,20,8,0.309325,0.317943,0.000001,No
19,16,304,17,2,19,19,19,38,8,0.319072,0.326986,0.000001,No
2,2,4,2,2,4,2,2,4,8,0.344408,0.357419,0.000001,No
2,2,4,2,2,4,2,2,4,8,0.313198,0.322823,0.000001,No
4,4,16,3,4,7,4,4,8,8,0.364088,0.380074,0.000001,No
7,7,49,3,4,7,7,7,14,8,0.325568,0.338872,0.000001,No
4,3,12,4,4,8,4,4,8,8,0.319921,0.327402,0.000001,No
2,2,4,2,2,4,2,2,4,8,0.341212,0.353843,0.000001,No
7,7,49,5,6,11,7,7,14,8,0.353352,0.368912,0.000001,No
6,6,36,4,5,9,6,6,12,8,0.328375,0.339761,0.000001,No
4,4,16,4,3,7,4,4,8,8,0.321634,0.329283,0.000001,No
5,5,25,4,3,7,5,5,10,8,0.342699,0.356395,0.000001,No
9,8,72,3,6,9,9,9,18,8,0.321398,0.331886,0.000001,No
2,2,4,2,2,4,2,2,4,8,0.331649,0.343176,0.000001,No
7,6,42,4,5,9,7,7,14,7,0.354556,0.368984,0.000001,No
4,4,16,2,4,6,4,4,8,8,0.30951,0.316194,0.000001,No
9,9,81,8,3,11,9,9,18,8,0.33718,0.349246,0.000001,No
2,2,4,2,2,4,2,2,4,8,0.346281,0.360278,0.000001,No
5,5,25,3,3,6,5,5,10,8,0.314085,0.325657,0.000001,No
2,2,4,2,2,4,2,2,4,8,0.316673,0.324748,0.000001,No
1,1,1,1,1,2,1,1,2,8,0.310717,0.317502,0.000001,No
1,1,1,1,1,2,1,1,2,9,0.265932,0.272147,0.000001,No
4,4,16,3,4,7,4,4,8,8,0.318899,0.327464,0.000001,No
1,1,1,1,1,2,1,1,2,8,0.303666,0.31297,0.000001,No
5,5,25,4,4,8,5,5,10,7,0.361657,0.377295,0.000001,No
9,9,81,5,7,12,9,9,18,8,0.331205,0.341214,0.000001,No
7,7,49,2,5,7,7,7,14,7,0.356028,0.37108,0.000001,No
7,7,49,4,6,10,7,7,14,7,0.350348,0.364493,0.000001,No
2,2,4,2,2,4,2,2,4,8,0.326408,0.338223,0.000001,No
2,1,2,2,2,4,2,2,4,8,0.333294,0.344918,0.000001,No
4,4,16,3,3,6,4,4,8,8,0.316579,0.323769,0.000001,No
2,2,4,2,2,4,2,2,4,8,0.311664,0.320485,0.000001,No
14,14,196,9,5,14,14,14,28,8,0.354313,0.369057,0.000001,No
5,5,25,2,4,6,5,5,10,8,0.339117,0.353384,0.000001,No
10,8,80,3,9,12,10,10,20,7,0.34009,0.352466,0.000001,No
5,5,25,3,4,7,5,5,10,8,0.352957,0.367513,0.000001,No
2,2,4,2,2,4,2,2,4,7,0.322199,0.329935,0.000001,No
2,2,4,2,2,4,2,2,4,7,0.331597,0.34297,0.000001,No
2,2,4,2,2,4,2,2,4,8,0.278876,0.288469,0.000001,No
13,13,169,7,6,13,13,13,26,7,0.341178,0.35312,0.000001,No
1,1,1,1,1,2,1,1,2,7,0.29631,0.304858,0.000001,No
3,3,9,3,3,6,3,3,6,8,0.332236,0.343301,0.000001,No
5,4,20,3,4,7,5,5,10,8,0.353396,0.368258,0.000001,No
1,1,1,1,1,2,1,1,2,9,0.238814,0.241839,0.000001,No
9,9,81,4,5,9,9,9,18,8,0.332904,0.346625,0.000001,No
1,1,1,1,1,2,1,1,2,9,0.244964,0.248826,0.000001,No
5,4,20,3,3,6,5,5,10,8,0.34404,0.357143,0.000001,No
9,9,81,6,4,10,9,9,18,7,0.339745,0.352683,0.000001,No
1,1,1,1,1,2,1,1,2,8,0.266964,0.273196,0.000001,No
2,2,4,2,2,4,2,2,4,8,0.320372,0.331711,0.000001,No
1,1,1,1,1,2,1,1,2,8,0.265159,0.271386,0.000001,No
1,1,1,1,1,2,1,1,2,8,0.286566,0.293675,0.000001,No
1,1,1,1,1,2,1,1,2,8,0.301584,0.314486,0.000001,No
2,2,4,2,2,4,2,2,4,8,0.3124,0.32099,0.000001,No
7,7,49,4,6,10,7,7,14,7,0.356855,0.371656,0.000001,No
11,11,121,4,4,8,11,11,22,7,0.345629,0.359195,0.000001,No
1,1,1,1,1,2,1,1,2,8,0.272873,0.280386,0.000001,No
4,3,12,4,4,8,4,4,8,8,0.336276,0.348967,0.000001,No
3,3,9,3,3,6,3,3,6,7,0.344756,0.357959,0.000001,No
4,4,16,2,4,6,4,4,8,7,0.331597,0.34329,0.000001,No
3,3,9,1,3,4,3,3,6,7,0.331913,0.34215,0.000001,No
3,3,9,3,3,6,3,3,6,8,0.327977,0.338568,0.000001,No
2,2,4,1,2,3,2,2,4,8,0.272159,0.27929,0.000001,No
11,11,121,8,6,14,11,11,22,7,0.362203,0.378404,0.000001,No
3,3,9,1,3,4,3,3,6,7,0.330141,0.340709,0.000001,No
1,1,1,1,1,2,1,1,2,8,0.290483,0.297493,0.000001,No
5,3,15,2,4,6,5,5,10,8,0.345279,0.358206,0.000001,No
5,5,25,2,3,5,5,5,10,8,0.334005,0.344703,0.000001,No
2,2,4,2,2,4,2,2,4,8,0.308548,0.315827,0.000001,No
4,4,16,1,4,5,4,4,8,8,0.335351,0.347193,0.000001,No
2,2,4,1,1,2,2,2,4,8,0.311312,0.322315,0.000001,No
2,2,4,2,2,4,2,2,4,8,0.340036,0.352312,0.000001,No
1,1,1,1,1,2,1,1,2,8,0.242762,0.247079,0.000001,No
2,2,4,2,2,4,2,2,4,8,0.313037,0.321784,0.000001,No
3,3,9,2,2,4,3,3,6,8,0.339982,0.352273,0.000001,No
8,6,48,1,5,6,8,8,16,8,0.331127,0.343044,0.000001,No
11,9,99,9,7,16,11,11,22,8,0.33986,0.351528,0.000001,No
3,3,9,3,2,5,3,3,6,8,0.31005,0.318733,0.000001,No
5,5,25,4,4,8,5,5,10,7,0.364042,0.380774,0.000001,No
1,1,1,1,1,2,1,1,2,9,0.240717,0.245738,0.000001,No
9,9,81,6,7,13,9,9,18,8,0.342624,0.355666,0.000001,No
2,2,4,2,2,4,2,2,4,8,0.309606,0.316037,0.000001,No
3,3,9,3,3,6,3,3,6,8,0.287896,0.296873,0.000001,No
3,3,9,1,3,4,3,3,6,8,0.310705,0.317553,0.000001,No
6,6,36,6,5,11,6,6,12,8,0.345888,0.35882,0.000001,No
4,4,16,1,4,5,4,4,8,8,0.347891,0.362609,0.000001,No
3,3,9,3,3,6,3,3,6,7,0.33114,0.34163,0.000001,No
5,5,25,5,5,10,5,5,10,8,0.351662,0.365681,0.000001,No
3,3,9,2,2,4,3,3,6,8,0.309135,0.321159,0.000001,No
2,2,4,2,2,4,2,2,4,8,0.287517,0.298111,0.000001,No
4,4,16,2,2,4,4,4,8,8,0.333125,0.344881,0.000001,No
12,12,144,3,5,8,12,12,24,7,0.34731,0.360662,0.000001,No
10,10,100,3,7,10,10,10,20,7,0.368818,0.386257,0.000001,No
2,2,4,1,2,3,2,2,4,9,0.250694,0.255645,0.000001,No
1,1,1,1,1,2,1,1,2,8,0.284364,0.291686,0.000001,No
3,3,9,3,3,6,3,3,6,8,0.333086,0.344586,0.000001,No
2,2,4,2,2,4,2,2,4,8,0.315648,0.323184,0.000001,No
4,4,16,3,2,5,4,4,8,8,0.327832,0.339198,0.000001,No
9,9,81,6,7,13,9,9,18,8,0.370243,0.3875,0.000001,No
14,14,196,5,5,10,14,14,28,7,0.341403,0.354542,0.000001,No
4,4,16,3,3,6,4,4,8,7,0.331308,0.342696,0.000001,No
1,1,1,1,1,2,1,1,2,8,0.277096,0.285605,0.000001,No
3,3,9,3,3,6,3,3,6,8,0.327964,0.338669,0.000001,No
5,5,25,4,4,8,5,5,10,8,0.349745,0.364164,0.000001,No
5,5,25,3,2,5,5,5,10,8,0.286249,0.293484,0.000001,No
4,2,8,2,2,4,4,4,8,8,0.296387,0.305505,0.000001,No
5,5,25,3,3,6,5,5,10,8,0.316468,0.328063,0.000001,No
1,1,1,1,1,2,1,1,2,8,0.310717,0.317502,0.000001,No
3,2,6,1,3,4,3,3,6,8,0.284953,0.295174,0.000001,No
1,1,1,1,1,2,1,1,2,8,0.278003,0.285466,0.000001,No
3,3,9,2,1,3,3,3,6,8,0.331571,0.343073,0.000001,No
1,1,1,1,1,2,1,1,2,8,0.315759,0.323487,0.000001,No
7,7,49,5,5,10,7,7,14,8,0.358579,0.374421,0.000001,No
4,4,16,3,4,7,4,4,8,8,0.339258,0.35175,0.000001,No
2,2,4,2,2,4,2,2,4,8,0.340117,0.352409,0.000001,No
4,4,16,3,4,7,4,4,8,8,0.308447,0.317857,0.000001,No
1,1,1,1,1,2,1,1,2,9,0.235387,0.238475,0.000001,No
7,7,49,5,5,10,7,7,14,7,0.311193,0.321463,0.000001,No
2,2,4,2,2,4,2,2,4,8,0.306233,0.313597,0.000001,No
2,1,2,1,1,2,2,2,4,7,0.312584,0.319273,0.000001,No
1,1,1,1,1,2,1,1,2,8,0.317298,0.324393,0.000001,No
3,3,9,2,2,4,3,3,6,7,0.352621,0.366966,0.000001,No
1,1,1,1,1,2,1,1,2,7,0.327826,0.338517,0.000001,No
2,2,4,2,2,4,2,2,4,8,0.313924,0.322271,0.000001,No
5,5,25,3,4,7,5,5,10,8,0.335193,0.346962,0.000001,No
1,1,1,1,1,2,1,1,2,9,0.217993,0.222362,0.000001,No
1,1,1,1,1,2,1,1,2,9,0.23756,0.241234,0.000001,No
5,5,25,3,4,7,5,5,10,8,0.353872,0.368551,0.000001,No
9,9,81,2,3,5,9,9,18,8,0.315532,0.32524,0.000001,No
1,1,1,1,1,2,1,1,2,9,0.266935,0.272984,0.000001,No
24,24,576,7,4,11,24,24,48,8,0.338505,0.350916,0.000001,No
7,7,49,5,1,6,7,7,14,8,0.32342,0.334424,0.000001,No
1,1,1,1,1,2,1,1,2,8,0.339934,0.352194,0.000001,No
9,9,81,6,6,12,9,9,18,8,0.330281,0.341523,0.000001,No
3,3,9,2,2,4,3,3,6,8,0.338357,0.350876,0.000001,No
2,2,4,1,2,3,2,2,4,7,0.352629,0.366971,0.000001,No
3,3,9,2,2,4,3,3,6,8,0.351996,0.366276,0.000001,No
9,9,81,2,4,6,9,9,18,8,0.322607,0.334196,0.000001,No
6,6,36,5,4,9,6,6,12,8,0.349982,0.36375,0.000001,No
21,19,399,7,7,14,21,21,42,8,0.330986,0.341863,0.000001,No
2,2,4,2,1,3,2,2,4,7,0.327826,0.338517,0.000001,No
3,3,9,3,3,6,3,3,6,8,0.343763,0.356874,0.000001,No
7,7,49,2,5,7,7,7,14,8,0.32483,0.336436,0.000001,No
1,1,1,1,1,2,1,1,2,9,0.279305,0.286645,0.000001,No
2,2,4,2,2,4,2,2,4,8,0.28685,0.293914,0.000001,No
1,1,1,1,1,2,1,1,2,9,0.249375,0.253865,0.000001,No
1,1,1,1,1,2,1,1,2,8,0.289262,0.299295,0.000001,No
2,2,4,2,2,4,2,2,4,8,0.343209,0.355815,0.000001,No
3,3,9,1,2,3,3,3,6,8,0.331584,0.343112,0.000001,No
2,2,4,2,2,4,2,2,4,8,0.332269,0.343757,0.000001,No
1,1,1,1,1,2,1,1,2,8,0.248826,0.253454,0.000001,No
3,3,9,2,2,4,3,3,6,8,0.318488,0.325905,0.000001,No
3,3,9,3,3,6,3,3,6,8,0.317298,0.328505,0.000001,No
2,2,4,1,1,2,2,2,4,9,0.247962,0.253469,0.000001,No
2,2,4,2,2,4,2,2,4,8,0.342102,0.354638,0.000001,No
3,3,9,2,3,5,3,3,6,8,0.338364,0.35095,0.000001,No
10,10,100,7,7,14,10,10,20,8,0.356944,0.372329,0.000001,No
3,3,9,3,3,6,3,3,6,7,0.332567,0.344314,0.000001,No
2,2,4,2,2,4,2,2,4,8,0.287116,0.294248,0.000001,No
3,3,9,2,3,5,3,3,6,8,0.344304,0.357465,0.000001,No
7,5,35,3,4,7,7,7,14,8,0.325561,0.336838,0.000001,No
5,5,25,4,4,8,5,5,10,7,0.361305,0.376923,0.000001,No
4,4,16,3,4,7,4,4,8,8,0.318078,0.326862,0.000001,No
3,3,9,2,3,5,3,3,6,7,0.348516,0.362448,0.000001,No
13,13,169,5,8,13,13,13,26,8,0.356199,0.372681,0.000001,No
7,6,42,6,5,11,7,7,14,8,0.324194,0.335505,0.000001,No
1,1,1,1,1,2,1,1,2,8,0.339934,0.352194,0.000001,No
4,4,16,3,3,6,4,4,8,8,0.315549,0.322953,0.000001,No
1,1,1,1,1,2,1,1,2,8,0.286086,0.29329,0.000001,No
10,9,90,8,6,14,10,10,20,7,0.331262,0.340689,0.000001,No
4,4,16,4,4,8,4,4,8,8,0.320462,0.328106,0.000001,No
3,3,9,3,3,6,3,3,6,8,0.329027,0.34092,0.000001,No
1,1,1,1,1,2,1,1,2,8,0.331571,0.343073,0.000001,No
1,1,1,1,1,2,1,1,2,8,0.310717,0.317502,0.000001,No
1,1,1,1,1,2,1,1,2,7,0.2963,0.30485,0.000001,No
3,3,9,2,2,4,3,3,6,8,0.320047,0.328286,0.000001,No
1,1,1,1,1,2,1,1,2,8,0.331578,0.343078,0.000001,No
1,1,1,1,1,2,1,1,2,9,0.256633,0.262378,0.000001,No
2,2,4,2,2,4,2,2,4,8,0.311107,0.320078,0.000001,No
4,4,16,1,3,4,4,4,8,7,0.343465,0.356463,0.000001,No
2,2,4,2,2,4,2,2,4,8,0.304034,0.313359,0.000001,No
5,5,25,4,3,7,5,5,10,8,0.314172,0.322197,0.000001,No
4,4,16,3,2,5,4,4,8,8,0.325084,0.336656,0.000001,No
4,4,16,2,4,6,4,4,8,7,0.336137,0.347108,0.000001,No
2,2,4,1,2,3,2,2,4,8,0.323439,0.334473,0.000001,No
2,2,4,2,2,4,2,2,4,8,0.30424,0.310916,0.000001,No
6,6,36,6,6,12,6,6,12,8,0.347239,0.361572,0.000001,No
8,8,64,1,6,7,8,8,16,8,0.351351,0.366134,0.000001,No
2,2,4,1,1,2,2,2,4,8,0.317451,0.327459,0.000001,No
1,1,1,1,1,2,1,1,2,9,0.303807,0.312038,0.000001,No
5,3,15,3,3,6,5,5,10,8,0.324645,0.333315,0.000001,No
2,2,4,2,2,4,2,2,4,8,0.335437,0.34739,0.000001,No
9,9,81,5,5,10,9,9,18,8,0.331642,0.342465,0.000001,No
1,1,1,1,1,2,1,1,2,8,0.296166,0.303813,0.000001,No
9,9,81,5,6,11,9,9,18,7,0.331926,0.341284,0.000001,No
2,2,4,1,1,2,2,2,4,8,0.293133,0.30075,0.000001,No
1,1,1,1,1,2,1,1,2,9,0.252094,0.256373,0.000001,No
1,1,1,1,1,2,1,1,2,8,0.278743,0.288253,0.000001,No
2,2,4,2,2,4,2,2,4,7,0.327945,0.338644,0.000001,No
3,2,6,3,2,5,3,3,6,8,0.303299,0.316554,0.000001,No
7,7,49,6,4,10,7,7,14,8,0.342527,0.355148,0.000001,No
5,4,20,5,5,10,5,5,10,8,0.339515,0.352056,0.000001,No
3,3,9,3,3,6,3,3,6,8,0.311579,0.320194,0.000001,No
2,2,4,2,2,4,2,2,4,8,0.338243,0.351497,0.000001,No
2,2,4,2,2,4,2,2,4,8,0.329211,0.341152,0.000001,No
1,1,1,1,1,2,1,1,2,9,0.23815,0.241459,0.000001,No
1,1,1,1,1,2,1,1,2,9,0.23582,0.241037,0.000001,No
2,2,4,2,2,4,2,2,4,8,0.290133,0.301038,0.000001,No
3,3,9,3,3,6,3,3,6,7,0.341985,0.355297,0.000001,No
4,4,16,4,3,7,4,4,8,7,0.334012,0.345611,0.000001,No
3,3,9,3,2,5,3,3,6,7,0.352621,0.366966,0.000001,No
3,3,9,3,2,5,3,3,6,8,0.342102,0.354638,0.000001,No
2,2,4,2,2,4,2,2,4,8,0.300675,0.308544,0.000001,No
1,1,1,1,1,2,1,1,2,8,0.310717,0.317502,0.000001,No
2,2,4,1,1,2,2,2,4,9,0.269392,0.275726,0.000001,No
3,3,9,3,3,6,3,3,6,8,0.337915,0.350434,0.000001,No
2,2,4,2,2,4,2,2,4,8,0.34516,0.358804,0.000001,No
13,13,169,7,5,12,13,13,26,7,0.341999,0.353832,0.000001,No
1,1,1,1,1,2,1,1,2,9,0.258679,0.264996,0.000001,No
3,3,9,3,3,6,3,3,6,8,0.284915,0.294547,0.000001,No
5,5,25,2,3,5,5,5,10,8,0.31232,0.320997,0.000001,No
2,2,4,2,2,4,2,2,4,8,0.298309,0.305414,0.000001,No
1,1,1,1,1,2,1,1,2,8,0.311312,0.322315,0.000001,No
12,12,144,6,6,12,12,12,24,8,0.336084,0.348551,0.000001,No
9,9,81,5,6,11,9,9,18,8,0.358286,0.373639,0.000001,No
2,1,2,2,2,4,2,2,4,8,0.288885,0.295977,0.000001,No
11,11,121,2,4,6,11,11,22,7,0.35268,0.367175,0.000001,No
4,4,16,4,3,7,4,4,8,8,0.3418,0.355377,0.000001,No
3,3,9,3,1,4,3,3,6,8,0.277096,0.285605,0.000001,No
1,1,1,1,1,2,1,1,2,9,0.256297,0.261464,0.000001,No
3,3,9,3,3,6,3,3,6,8,0.308525,0.315593,0.000001,No
2,2,4,2,2,4,2,2,4,8,0.327838,0.339203,0.000001,No
3,3,9,2,3,5,3,3,6,8,0.315748,0.324195,0.000001,No
2,2,4,1,2,3,2,2,4,8,0.331952,0.343576,0.000001,No
3,3,9,2,3,5,3,3,6,8,0.324176,0.335181,0.000001,No
5,5,25,4,3,7,5,5,10,8,0.312566,0.321859,0.000001,No
3,2,6,2,3,5,3,3,6,8,0.300601,0.30745,0.000001,No
1,1,1,1,1,2,1,1,2,9,0.240263,0.244672,0.000001,No
1,1,1,1,1,2,1,1,2,8,0.267491,0.27391,0.000001,No
2,2,4,2,2,4,2,2,4,8,0.306492,0.314195,0.000001,No
7,7,49,5,6,11,7,7,14,8,0.34314,0.356182,0.000001,No
5,5,25,3,4,7,5,5,10,8,0.331494,0.344592,0.000001,No
1,1,1,1,1,2,1,1,2,8,0.274334,0.282192,0.000001,No
1,1,1,1,1,2,1,1,2,9,0.261186,0.266859,0.000001,No
5,5,25,4,5,9,5,5,10,7,0.325239,0.335472,0.000001,No
6,6,36,5,6,11,6,6,12,8,0.318055,0.326049,0.000001,No
5,4,20,5,4,9,5,5,10,8,0.304702,0.311899,0.000001,No
3,3,9,2,3,5,3,3,6,8,0.342301,0.355084,0.000001,No
7,7,49,4,6,10,7,7,14,8,0.356676,0.372687,0.000001,No
6,6,36,2,4,6,6,6,12,8,0.322509,0.330215,0.000001,No
2,2,4,1,1,2,2,2,4,8,0.299445,0.306325,0.000001,No
2,2,4,2,2,4,2,2,4,8,0.335437,0.347732,0.000001,No
5,5,25,5,5,10,5,5,10,8,0.32036,0.330372,0.000001,No
1,1,1,1,1,2,1,1,2,8,0.285698,0.293452,0.000001,No
1,1,1,1,1,2,1,1,2,8,0.339941,0.352199,0.000001,No
1,1,1,1,1,2,1,1,2,8,0.310717,0.317502,0.000001,No
1,1,1,1,1,2,1,1,2,9,0.259869,0.26568,0.000001,No
1,1,1,1,1,2,1,1,2,8,0.315759,0.323487,0.000001,No
3,3,9,3,3,6,3,3,6,7,0.322778,0.33062,0.000001,No
12,12,144,8,10,18,12,12,24,7,0.365774,0.382067,0.000001,No
5,5,25,4,3,7,5,5,10,8,0.340531,0.353367,0.000001,No
1,1,1,1,1,2,1,1,2,8,0.301589,0.314491,0.000001,No
3,3,9,3,3,6,3,3,6,8,0.294958,0.306931,0.000001,No
3,3,9,2,2,4,3,3,6,8,0.322132,0.330749,0.000001,No
2,1,2,1,2,3,2,2,4,7,0.315543,0.324576,0.000001,No
2,2,4,1,2,3,2,2,4,8,0.341663,0.354514,0.000001,No
3,3,9,3,3,6,3,3,6,8,0.280526,0.288008,0.000001,No
6,6,36,4,3,7,6,6,12,8,0.347714,0.362279,0.000001,No
1,1,1,1,1,2,1,1,2,8,0.269634,0.276022,0.000001,No
5,5,25,5,5,10,5,5,10,7,0.347162,0.360427,0.000001,No
1,1,1,1,1,2,1,1,2,9,0.244968,0.248775,0.000001,No
5,5,25,3,3,6,5,5,10,8,0.309219,0.3175,0.000001,No
1,1,1,1,1,2,1,1,2,8,0.315765,0.323492,0.000001,No
2,2,4,2,2,4,2,2,4,7,0.310954,0.31903,0.000001,No
2,2,4,2,2,4,2,2,4,9,0.257613,0.263735,0.000001,No
3,3,9,2,2,4,3,3,6,8,0.312985,0.320023,0.000001,No
4,4,16,4,4,8,4,4,8,8,0.319042,0.326349,0.000001,No
4,4,16,3,4,7,4,4,8,8,0.355191,0.370265,0.000001,No
1,1,1,1,1,2,1,1,2,8,0.317451,0.327459,0.000001,No
3,3,9,3,3,6,3,3,6,7,0.348224,0.362195,0.000001,No
1,1,1,1,1,2,1,1,2,8,0.32342,0.334424,0.000001,No
2,2,4,2,2,4,2,2,4,8,0.310626,0.319111,0.000001,No
3,3,9,2,3,5,3,3,6,8,0.330365,0.341241,0.000001,No
4,4,16,3,2,5,4,4,8,8,0.324305,0.335748,0.000001,No
2,2,4,2,2,4,2,2,4,8,0.316915,0.328394,0.000001,No
2,2,4,1,1,2,2,2,4,9,0.303801,0.312033,0.000001,No
11,11,121,8,7,15,11,11,22,8,0.331494,0.34364,0.000001,No
2,2,4,2,2,4,2,2,4,8,0.323543,0.334625,0.000001,No
6,4,24,2,4,6,6,6,12,8,0.307635,0.321685,0.000001,No
2,2,4,2,2,4,2,2,4,8,0.295177,0.302348,0.000001,No
1,1,1,1,1,2,1,1,2,8,0.281108,0.28812,0.000001,No
4,4,16,3,3,6,4,4,8,8,0.313727,0.320488,0.000001,No
3,3,9,2,3,5,3,3,6,8,0.324601,0.33518,0.000001,No
5,5,25,4,2,6,5,5,10,8,0.311898,0.323884,0.000001,No
5,5,25,5,4,9,5,5,10,8,0.344805,0.358336,0.000001,No
15,15,225,6,2,8,15,15,30,8,0.340457,0.35263,0.000001,No
2,2,4,2,2,4,2,2,4,8,0.352003,0.366286,0.000001,No
6,6,36,4,5,9,6,6,12,8,0.354181,0.368898,0.000001,No
21,21,441,4,5,9,21,21,42,8,0.334483,0.347124,0.000001,No
1,1,1,1,1,2,1,1,2,8,0.32342,0.334424,0.000001,No
8,8,64,6,6,12,8,8,16,8,0.353418,0.367999,0.000001,No
6,6,36,4,3,7,6,6,12,8,0.340974,0.354183,0.000001,No
4,4,16,2,4,6,4,4,8,8,0.316856,0.326674,0.000001,No
3,3,9,2,2,4,3,3,6,8,0.301546,0.308574,0.000001,No
2,2,4,2,2,4,2,2,4,8,0.33825,0.351502,0.000001,No
5,5,25,5,4,9,5,5,10,8,0.346007,0.359094,0.000001,No
2,2,4,2,2,4,2,2,4,8,0.321561,0.329642,0.000001,No
12,11,132,5,5,10,12,12,24,7,0.366836,0.383546,0.000001,No
4,4,16,4,4,8,4,4,8,8,0.361987,0.37876,0.000001,No
4,4,16,3,1,4,4,4,8,8,0.323426,0.334429,0.000001,No
4,4,16,3,3,6,4,4,8,8,0.338276,0.351561,0.000001,No
2,2,4,2,2,4,2,2,4,8,0.338243,0.351497,0.000001,No
3,3,9,2,2,4,3,3,6,8,0.33172,0.343252,0.000001,No
2,2,4,2,1,3,2,2,4,8,0.339934,0.352194,0.000001,No
3,3,9,2,2,4,3,3,6,8,0.329433,0.339833,0.000001,No
1,1,1,1,1,2,1,1,2,9,0.240976,0.245252,0.000001,No
4,4,16,2,3,5,4,4,8,8,0.344415,0.357449,0.000001,No
1,1,1,1,1,2,1,1,2,7,0.327826,0.338517,0.000001,No
1,1,1,1,1,2,1,1,2,9,0.260365,0.265882,0.000001,No
3,3,9,2,3,5,3,3,6,8,0.314045,0.322716,0.000001,No
4,4,16,2,2,4,4,4,8,8,0.331604,0.343137,0.000001,No
2,2,4,2,1,3,2,2,4,7,0.327826,0.338517,0.000001,No
6,6,36,1,2,3,6,6,12,8,0.341219,0.353853,0.000001,No
2,2,4,1,1,2,2,2,4,8,0.339934,0.352194,0.000001,No
2,2,4,1,1,2,2,2,4,8,0.309758,0.316292,0.000001,No
2,2,4,1,1,2,2,2,4,8,0.339934,0.352194,0.000001,No
2,2,4,1,2,3,2,2,4,8,0.314427,0.322562,0.000001,No
1,1,1,1,1,2,1,1,2,8,0.310028,0.318679,0.000001,No
1,1,1,1,1,2,1,1,2,8,0.309752,0.316287,0.000001,No
1,1,1,1,1,2,1,1,2,8,0.278003,0.285466,0.000001,No
2,2,4,2,2,4,2,2,4,8,0.291048,0.298381,0.000001,No
7,7,49,4,7,11,7,7,14,7,0.363886,0.380283,0.000001,No
6,6,36,5,5,10,6,6,12,7,0.3394,0.351254,0.000001,No
3,3,9,2,3,5,3,3,6,8,0.30405,0.310813,0.000001,No
3,2,6,2,3,5,3,3,6,8,0.318458,0.325864,0.000001,No
3,3,9,2,3,5,3,3,6,8,0.312326,0.320174,0.000001,No
1,1,1,1,1,2,1,1,2,8,0.29596,0.304319,0.000001,No
4,4,16,3,3,6,4,4,8,8,0.316574,0.324381,0.000001,No
4,4,16,3,3,6,4,4,8,8,0.309538,0.318219,0.000001,No
7,7,49,2,4,6,7,7,14,8,0.356288,0.371952,0.000001,No
1,1,1,1,1,2,1,1,2,8,0.278743,0.288253,0.000001,No
2,2,4,2,2,4,2,2,4,8,0.312155,0.322339,0.000001,No
3,3,9,2,1,3,3,3,6,7,0.327813,0.338503,0.000001,No
19,19,361,12,6,18,19,19,38,8,0.331063,0.34247,0.000001,No
8,8,64,3,5,8,8,8,16,7,0.347862,0.361416,0.000001,No
5,5,25,2,3,5,5,5,10,7,0.350809,0.364963,0.000001,No
15,15,225,6,4,10,15,15,30,7,0.353542,0.368264,0.000001,No
14,14,196,7,6,13,14,14,28,7,0.343175,0.355083,0.000001,No
7,7,49,2,6,8,7,7,14,8,0.358534,0.373683,0.000001,No
1,1,1,1,1,2,1,1,2,8,0.311306,0.32231,0.000001,No
6,6,36,4,3,7,6,6,12,8,0.332495,0.343949,0.000001,No
1,1,1,1,1,2,1,1,2,8,0.288934,0.297717,0.000001,No
3,3,9,2,3,5,3,3,6,7,0.349953,0.364097,0.000001,No
2,2,4,2,2,4,2,2,4,9,0.271013,0.277599,0.000001,No
3,3,9,2,2,4,3,3,6,8,0.306173,0.312726,0.000001,No
1,1,1,1,1,2,1,1,2,7,0.327826,0.338517,0.000001,No
4,3,12,4,4,8,4,4,8,8,0.295965,0.303766,0.000001,No
2,1,2,2,2,4,2,2,4,8,0.311397,0.319387,0.000001,No
4,4,16,3,4,7,4,4,8,8,0.341021,0.354787,0.000001,No
8,8,64,3,4,7,8,8,16,8,0.339637,0.353671,0.000001,No
2,2,4,2,2,4,2,2,4,8,0.294438,0.301403,0.000001,No
3,3,9,3,3,6,3,3,6,8,0.328824,0.340092,0.000001,No
3,3,9,1,2,3,3,3,6,7,0.305416,0.3169,0.000001,No
11,10,110,5,7,12,11,11,22,8,0.354438,0.369473,0.000001,No
4,4,16,4,4,8,4,4,8,7,0.346429,0.359502,0.000001,No
11,11,121,4,5,9,11,11,22,8,0.340138,0.352512,0.000001,No
1,1,1,1,1,2,1,1,2,8,0.339934,0.352194,0.000001,No
1,1,1,1,1,2,1,1,2,8,0.339934,0.352194,0.000001,No
2,2,4,2,2,4,2,2,4,8,0.30881,0.315205,0.000001,No
7,7,49,4,4,8,7,7,14,8,0.333907,0.346272,0.000001,No
1,1,1,1,1,2,1,1,2,9,0.244634,0.248099,0.000001,No
2,2,4,2,2,4,2,2,4,8,0.294093,0.301709,0.000001,No
3,3,9,2,2,4,3,3,6,8,0.285344,0.295844,0.000001,No
2,2,4,2,2,4,2,2,4,8,0.320125,0.330993,0.000001,No
1,1,1,1,1,2,1,1,2,9,0.255733,0.261996,0.000001,No
2,2,4,2,2,4,2,2,4,8,0.286754,0.293919,0.000001,No
1,1,1,1,1,2,1,1,2,8,0.271899,0.280395,0.000001,No
4,4,16,2,3,5,4,4,8,8,0.288533,0.299137,0.000001,No
8,8,64,5,5,10,8,8,16,7,0.309056,0.320269,0.000001,No
10,10,100,6,4,10,10,10,20,8,0.329205,0.340135,0.000001,No
12,12,144,6,6,12,12,12,24,8,0.330941,0.342932,0.000001,No
5,5,25,4,4,8,5,5,10,8,0.306657,0.314733,0.000001,No
6,6,36,5,6,11,6,6,12,8,0.340171,0.352311,0.000001,No
12,12,144,9,6,15,12,12,24,8,0.347423,0.362071,0.000001,No
9,9,81,3,5,8,9,9,18,7,0.341971,0.355372,0.000001,No
3,3,9,1,3,4,3,3,6,8,0.308883,0.316163,0.000001,No
4,2,8,2,4,6,4,4,8,8,0.321992,0.331792,0.000001,No
1,1,1,1,1,2,1,1,2,8,0.277976,0.285012,0.000001,No
2,2,4,2,2,4,2,2,4,9,0.272676,0.28122,0.000001,No
3,3,9,1,2,3,3,3,6,8,0.340165,0.352451,0.000001,No
1,1,1,1,1,2,1,1,2,9,0.257874,0.2639,0.000001,No
1,1,1,1,1,2,1,1,2,8,0.286244,0.293449,0.000001,No
5,4,20,3,3,6,5,5,10,8,0.295356,0.306841,0.000001,No
10,10,100,3,7,10,10,10,20,8,0.343783,0.35667,0.000001,No
1,1,1,1,1,2,1,1,2,8,0.310028,0.318679,0.000001,No
2,2,4,2,2,4,2,2,4,8,0.277908,0.285055,0.000001,No
1,1,1,1,1,2,1,1,2,8,0.339941,0.352199,0.000001,No
5,5,25,4,5,9,5,5,10,8,0.318536,0.327148,0.000001,No
3,3,9,2,2,4,3,3,6,8,0.312498,0.32088,0.000001,No
3,3,9,2,3,5,3,3,6,8,0.302836,0.310229,0.000001,No
3,3,9,3,3,6,3,3,6,8,0.342789,0.356509,0.000001,No
2,2,4,1,2,3,2,2,4,8,0.335094,0.3468,0.000001,No
2,2,4,2,2,4,2,2,4,8,0.291282,0.301312,0.000001,No
3,3,9,3,3,6,3,3,6,8,0.33089,0.343659,0.000001,No
1,1,1,1,1,2,1,1,2,9,0.268721,0.277328,0.000001,No
1,1,1,1,1,2,1,1,2,9,0.249375,0.254064,0.000001,No
9,9,81,4,5,9,9,9,18,8,0.320836,0.332248,0.000001,No
1,1,1,1,1,2,1,1,2,8,0.339934,0.352194,0.000001,No
1,1,1,1,1,2,1,1,2,8,0.288168,0.299068,0.000001,No
1,1,1,1,1,2,1,1,2,8,0.339941,0.352199,0.000001,No
2,2,4,1,1,2,2,2,4,8,0.331578,0.343078,0.000001,No
2,2,4,2,2,4,2,2,4,8,0.296161,0.303251,0.000001,No
2,2,4,2,2,4,2,2,4,8,0.315054,0.323288,0.000001,No
8,7,56,5,5,10,8,8,16,8,0.332036,0.343351,0.000001,No
2,2,4,2,2,4,2,2,4,7,0.328053,0.338762,0.000001,No
12,11,132,10,10,20,12,12,24,7,0.363654,0.379754,0.000001,No
5,5,25,5,5,10,5,5,10,8,0.34111,0.353741,0.000001,No
6,6,36,5,6,11,6,6,12,7,0.346225,0.35974,0.000001,No
4,4,16,3,4,7,4,4,8,7,0.322589,0.331202,0.000001,No
2,2,4,1,1,2,2,2,4,9,0.277709,0.284589,0.000001,No
5,5,25,5,5,10,5,5,10,8,0.322552,0.330289,0.000001,No
2,2,4,2,2,4,2,2,4,8,0.34361,0.356903,0.000001,No
4,4,16,2,2,4,4,4,8,8,0.316415,0.326415,0.000001,No
2,2,4,2,2,4,2,2,4,8,0.322241,0.329873,0.000001,No
3,3,9,2,2,4,3,3,6,8,0.344283,0.357109,0.000001,No
5,5,25,2,3,5,5,5,10,8,0.307181,0.32136,0.000001,No
11,11,121,7,5,12,11,11,22,8,0.346901,0.361695,0.000001,No
9,9,81,4,4,8,9,9,18,7,0.342927,0.356474,0.000001,No
3,3,9,3,3,6,3,3,6,8,0.312486,0.321283,0.000001,No
4,4,16,2,4,6,4,4,8,8,0.312035,0.319938,0.000001,No
1,1,1,1,1,2,1,1,2,9,0.272059,0.279013,0.000001,No
3,3,9,3,3,6,3,3,6,8,0.357243,0.372522,0.000001,No
1,1,1,1,1,2,1,1,2,7,0.296305,0.304855,0.000001,No
1,1,1,1,1,2,1,1,2,9,0.254474,0.259437,0.000001,No
2,2,4,2,2,4,2,2,4,7,0.329605,0.340411,0.000001,No
3,2,6,2,3,5,3,3,6,8,0.342754,0.355498,0.000001,No
3,3,9,2,3,5,3,3,6,8,0.324534,0.335151,0.000001,No
10,10,100,6,5,11,10,10,20,8,0.326608,0.337725,0.000001,No
1,1,1,1,1,2,1,1,2,9,0.246194,0.250002,0.000001,No
3,3,9,3,3,6,3,3,6,8,0.327065,0.337895,0.000001,No
2,2,4,2,2,4,2,2,4,8,0.304343,0.313274,0.000001,No
5,5,25,5,5,10,5,5,10,7,0.316392,0.324322,0.000001,No
7,7,49,2,4,6,7,7,14,8,0.313054,0.321265,0.000001,No
13,11,143,10,6,16,13,13,26,8,0.337034,0.349816,0.000001,No
3,3,9,2,2,4,3,3,6,8,0.298848,0.307768,0.000001,No
3,3,9,2,3,5,3,3,6,8,0.317327,0.324756,0.000001,No
3,3,9,3,2,5,3,3,6,8,0.342672,0.355554,0.000001,No
10,9,90,5,7,12,10,10,20,8,0.3506,0.365727,0.000001,No
1,1,1,1,1,2,1,1,2,8,0.315759,0.323487,0.000001,No
2,2,4,2,2,4,2,2,4,8,0.32409,0.334988,0.000001,No
2,2,4,2,2,4,2,2,4,8,0.334326,0.344905,0.000001,No
3,3,9,2,2,4,3,3,6,8,0.293855,0.30084,0.000001,No
4,4,16,3,3,6,4,4,8,7,0.331237,0.341839,0.000001,No
1,1,1,1,1,2,1,1,2,8,0.32342,0.334424,0.000001,No
4,4,16,3,2,5,4,4,8,8,0.301211,0.310469,0.000001,No
4,4,16,2,4,6,4,4,8,8,0.333034,0.344789,0.000001,No
1,1,1,1,1,2,1,1,2,8,0.317451,0.327459,0.000001,No
5,1,5,3,3,6,5,5,10,8,0.335622,0.347606,0.000001,No
1,1,1,1,1,2,1,1,2,9,0.249044,0.253959,0.000001,No
1,1,1,1,1,2,1,1,2,8,0.288929,0.297713,0.000001,No
3,3,9,1,2,3,3,3,6,8,0.323445,0.334478,0.000001,No
3,3,9,3,3,6,3,3,6,8,0.335259,0.347344,0.000001,No
2,2,4,2,1,3,2,2,4,7,0.327819,0.338512,0.000001,No
7,7,49,6,2,8,7,7,14,7,0.335562,0.34584,0.000001,No
4,3,12,3,4,7,4,4,8,8,0.332852,0.344373,0.000001,No
14,14,196,11,3,14,14,14,28,8,0.334956,0.348507,0.000001,No
7,7,49,4,2,6,7,7,14,8,0.323979,0.335279,0.000001,No
6,6,36,1,4,5,6,6,12,8,0.299403,0.310333,0.000001,No
8,8,64,6,6,12,8,8,16,7,0.343092,0.356532,0.000001,No
1,1,1,1,1,2,1,1,2,9,0.266759,0.273146,0.000001,No
3,3,9,3,2,5,3,3,6,8,0.352003,0.366286,0.000001,No
3,3,9,3,3,6,3,3,6,8,0.329975,0.342275,0.000001,No
5,5,25,5,5,10,5,5,10,7,0.347784,0.361052,0.000001,No
6,6,36,2,3,5,6,6,12,7,0.330441,0.341591,0.000001,No
1,1,1,1,1,2,1,1,2,8,0.28968,0.296712,0.000001,No
2,2,4,2,2,4,2,2,4,8,0.31492,0.321918,0.000001,No
3,3,9,2,2,4,3,3,6,8,0.33319,0.345213,0.000001,No
2,2,4,1,1,2,2,2,4,7,0.327826,0.338517,0.000001,No
8,8,64,7,5,12,8,8,16,8,0.330717,0.34105,0.000001,No
2,2,4,2,2,4,2,2,4,7,0.331224,0.342603,0.000001,No
8,8,64,6,4,10,8,8,16,7,0.344512,0.357914,0.000001,No
8,8,64,2,4,6,8,8,16,8,0.329624,0.34079,0.000001,No
5,5,25,2,2,4,5,5,10,8,0.343223,0.356253,0.000001,No
1,1,1,1,1,2,1,1,2,8,0.339934,0.352194,0.000001,No
5,5,25,4,5,9,5,5,10,8,0.332625,0.3418,0.000001,No
2,2,4,1,2,3,2,2,4,8,0.313376,0.320621,0.000001,No
3,3,9,3,3,6,3,3,6,8,0.348402,0.361869,0.000001,No
38,38,1444,3,10,13,38,38,76,8,0.344415,0.357141,0.000001,No
1,1,1,1,1,2,1,1,2,8,0.315759,0.323487,0.000001,No
10,10,100,6,8,14,10,10,20,8,0.367983,0.385843,0.000001,No
2,2,4,2,2,4,2,2,4,8,0.322753,0.333214,0.000001,No
2,2,4,2,2,4,2,2,4,7,0.33161,0.341859,0.000001,No
20,20,400,9,14,23,20,20,40,8,0.371654,0.388766,0.000001,No
3,3,9,2,3,5,3,3,6,8,0.340382,0.352829,0.000001,No
2,1,2,2,2,4,2,2,4,8,0.342102,0.354638,0.000001,No
1,1,1,1,1,2,1,1,2,8,0.268345,0.275546,0.000001,No
1,1,1,1,1,2,1,1,2,9,0.303801,0.312033,0.000001,No
3,3,9,2,3,5,3,3,6,8,0.323163,0.333252,0.000001,No
11,11,121,6,9,15,11,11,22,8,0.366269,0.383329,0.000001,No
5,5,25,5,5,10,5,5,10,8,0.328179,0.340123,0.000001,No
3,3,9,2,2,4,3,3,6,8,0.304696,0.311339,0.000001,No
1,1,1,1,1,2,1,1,2,8,0.339941,0.352199,0.000001,No
2,2,4,2,2,4,2,2,4,8,0.34361,0.356903,0.000001,No
5,5,25,4,4,8,5,5,10,8,0.319233,0.329296,0.000001,No
3,3,9,2,3,5,3,3,6,8,0.312755,0.321134,0.000001,No
6,6,36,4,5,9,6,6,12,7,0.308319,0.316541,0.000001,No
5,5,25,4,4,8,5,5,10,7,0.32334,0.333823,0.000001,No
3,3,9,2,3,5,3,3,6,8,0.343417,0.356487,0.000001,No
7,7,49,6,4,10,7,7,14,8,0.342631,0.355948,0.000001,No
16,16,256,6,12,18,16,16,32,7,0.353132,0.36727,0.000001,No
1,1,1,1,1,2,1,1,2,8,0.339934,0.352194,0.000001,No
1,1,1,1,1,2,1,1,2,8,0.29983,0.307297,0.000001,No
7,7,49,3,6,9,7,7,14,8,0.318031,0.327577,0.000001,No
8,8,64,6,5,11,8,8,16,8,0.314242,0.32195,0.000001,No
7,7,49,4,3,7,7,7,14,8,0.309275,0.320352,0.000001,No
1,1,1,1,1,2,1,1,2,8,0.301594,0.314494,0.000001,No
5,5,25,3,5,8,5,5,10,8,0.306354,0.315776,0.000001,No
5,5,25,5,5,10,5,5,10,8,0.322314,0.331945,0.000001,No
2,2,4,2,2,4,2,2,4,8,0.31672,0.325796,0.000001,No
5,5,25,1,5,6,5,5,10,7,0.359903,0.375566,0.000001,No
11,11,121,6,5,11,11,11,22,8,0.350305,0.365332,0.000001,No
12,12,144,5,5,10,12,12,24,7,0.333738,0.34604,0.000001,No
4,4,16,4,4,8,4,4,8,7,0.334963,0.345878,0.000001,No
2,2,4,2,2,4,2,2,4,8,0.342617,0.356522,0.000001,No
2,2,4,2,2,4,2,2,4,8,0.303294,0.316544,0.000001,No
4,4,16,2,3,5,4,4,8,8,0.355213,0.369975,0.000001,No
2,2,4,2,2,4,2,2,4,8,0.340002,0.352302,0.000001,No
2,2,4,2,2,4,2,2,4,8,0.310988,0.318491,0.000001,No
2,2,4,1,2,3,2,2,4,8,0.323967,0.335063,0.000001,No
1,1,1,1,1,2,1,1,2,8,0.292962,0.300182,0.000001,No
7,7,49,5,6,11,7,7,14,8,0.329059,0.337851,0.000001,No
4,4,16,3,3,6,4,4,8,8,0.296681,0.303701,0.000001,No
4,4,16,4,4,8,4,4,8,8,0.327983,0.339583,0.000001,No
1,1,1,1,1,2,1,1,2,8,0.339934,0.352194,0.000001,No
2,2,4,2,2,4,2,2,4,8,0.339948,0.352234,0.000001,No
4,4,16,2,3,5,4,4,8,8,0.34888,0.363913,0.000001,No
10,10,100,8,9,17,10,10,20,8,0.359751,0.376025,0.000001,No
13,13,169,9,8,17,13,13,26,8,0.360351,0.377447,0.000001,No
2,2,4,1,1,2,2,2,4,8,0.310028,0.318679,0.000001,No
5,5,25,3,3,6,5,5,10,7,0.337267,0.350107,0.000001,No
4,4,16,4,4,8,4,4,8,8,0.314265,0.320913,0.000001,No
2,2,4,2,2,4,2,2,4,8,0.301285,0.308713,0.000001,No
3,3,9,3,3,6,3,3,6,8,0.344095,0.356983,0.000001,No
2,2,4,2,2,4,2,2,4,8,0.343127,0.355994,0.000001,No
4,4,16,4,4,8,4,4,8,8,0.324188,0.335653,0.000001,No
1,1,1,1,1,2,1,1,2,8,0.323426,0.334429,0.000001,No
1,1,1,1,1,2,1,1,2,9,0.303801,0.312033,0.000001,No
1,1,1,1,1,2,1,1,2,8,0.266964,0.273196,0.000001,No
7,7,49,5,6,11,7,7,14,7,0.356534,0.372128,0.000001,No
1,1,1,1,1,2,1,1,2,8,0.339941,0.352199,0.000001,No
2,2,4,2,2,4,2,2,4,8,0.316621,0.324612,0.000001,No
3,3,9,2,2,4,3,3,6,8,0.330967,0.343859,0.000001,No
9,9,81,5,4,9,9,9,18,8,0.341199,0.353614,0.000001,No
1,1,1,1,1,2,1,1,2,8,0.339934,0.352194,0.000001,No
8,8,64,2,3,5,8,8,16,8,0.318043,0.325406,0.000001,No
3,3,9,3,3,6,3,3,6,8,0.340063,0.353103,0.000001,No
2,2,4,2,2,4,2,2,4,7,0.331604,0.34209,0.000001,No
3,3,9,1,1,2,3,3,6,9,0.261038,0.266606,0.000001,No
2,2,4,2,2,4,2,2,4,7,0.335807,0.34642,0.000001,No
3,3,9,2,3,5,3,3,6,7,0.311249,0.321417,0.000001,No
3,3,9,3,2,5,3,3,6,7,0.327845,0.338566,0.000001,No
2,2,4,2,2,4,2,2,4,7,0.338888,0.35214,0.000001,No
1,1,1,1,1,2,1,1,2,8,0.275068,0.281992,0.000001,No
3,1,3,2,3,5,3,3,6,8,0.335088,0.347056,0.000001,No
1,1,1,1,1,2,1,1,2,8,0.281791,0.289268,0.000001,No
8,6,48,1,6,7,8,8,16,8,0.343977,0.356766,0.000001,No
2,2,4,2,2,4,2,2,4,8,0.31367,0.323145,0.000001,No
1,1,1,1,1,2,1,1,2,8,0.263155,0.269091,0.000001,No
1,1,1,1,1,2,1,1,2,8,0.339941,0.352199,0.000001,No
9,7,63,2,5,7,9,9,18,7,0.33518,0.346885,0.000001,No
3,3,9,2,2,4,3,3,6,8,0.282725,0.29103,0.000001,No
3,3,9,3,3,6,3,3,6,7,0.334306,0.346077,0.000001,No
2,2,4,2,1,3,2,2,4,8,0.331565,0.343064,0.000001,No
7,7,49,5,5,10,7,7,14,8,0.339333,0.352409,0.000001,No
4,4,16,2,1,3,4,4,8,8,0.274545,0.283659,0.000001,No
3,3,9,3,3,6,3,3,6,8,0.323475,0.333772,0.000001,No
4,4,16,4,3,7,4,4,8,8,0.315252,0.326651,0.000001,No
3,3,9,1,3,4,3,3,6,7,0.328375,0.339156,0.000001,No
5,5,25,4,5,9,5,5,10,8,0.340756,0.352963,0.000001,No
5,5,25,4,3,7,5,5,10,8,0.339002,0.35222,0.000001,No
3,3,9,2,2,4,3,3,6,8,0.313508,0.320252,0.000001,No
3,3,9,2,2,4,3,3,6,8,0.32417,0.335546,0.000001,No
3,3,9,3,2,5,3,3,6,8,0.340355,0.352544,0.000001,No
2,2,4,2,2,4,2,2,4,8,0.310022,0.316585,0.000001,No
3,3,9,2,2,4,3,3,6,9,0.255863,0.261334,0.000001,No
1,1,1,1,1,2,1,1,2,8,0.303661,0.312967,0.000001,No
2,2,4,2,2,4,2,2,4,8,0.303866,0.316511,0.000001,No
1,1,1,1,1,2,1,1,2,8,0.306657,0.315385,0.000001,No
2,1,2,1,2,3,2,2,4,7,0.314601,0.321618,0.000001,No
2,2,4,2,2,4,2,2,4,8,0.324305,0.335748,0.000001,No
2,2,4,2,2,4,2,2,4,9,0.281772,0.290874,0.000001,No
6,6,36,4,4,8,6,6,12,7,0.33379,0.343977,0.000001,No
5,5,25,4,3,7,5,5,10,8,0.331907,0.344678,0.000001,No
9,9,81,5,8,13,9,9,18,8,0.354578,0.369566,0.000001,No
6,6,36,6,5,11,6,6,12,7,0.342548,0.355196,0.000001,No
4,4,16,3,1,4,4,4,8,8,0.32342,0.334424,0.000001,No
1,1,1,1,1,2,1,1,2,8,0.288173,0.299071,0.000001,No
7,7,49,6,6,12,7,7,14,7,0.314763,0.323424,0.000001,No
4,3,12,4,4,8,4,4,8,8,0.332346,0.343953,0.000001,No
1,1,1,1,1,2,1,1,2,7,0.327819,0.338512,0.000001,No
1,1,1,1,1,2,1,1,2,8,0.30338,0.311471,0.000001,No
12,12,144,6,6,12,12,12,24,7,0.344047,0.356403,0.000001,No
1,1,1,1,1,2,1,1,2,8,0.304626,0.311242,0.000001,No
1,1,1,1,1,2,1,1,2,8,0.301589,0.314491,0.000001,No
4,4,16,3,3,6,4,4,8,8,0.310011,0.322613,0.000001,No
21,21,441,7,8,15,21,21,42,8,0.343645,0.357768,0.000001,No
2,2,4,1,1,2,2,2,4,8,0.301594,0.314494,0.000001,No
2,2,4,1,2,3,2,2,4,9,0.265003,0.271314,0.000001,No
14,14,196,5,7,12,14,14,28,7,0.356512,0.371675,0.000001,No
1,1,1,1,1,2,1,1,2,8,0.311312,0.322315,0.000001,No
3,3,9,3,3,6,3,3,6,8,0.337774,0.349245,0.000001,No
1,1,1,1,1,2,1,1,2,7,0.327826,0.338517,0.000001,No
3,2,6,2,2,4,3,3,6,8,0.338243,0.351497,0.000001,No
4,4,16,4,4,8,4,4,8,8,0.313681,0.320564,0.000001,No
4,4,16,4,4,8,4,4,8,7,0.35669,0.371358,0.000001,No
5,5,25,5,5,10,5,5,10,8,0.350269,0.36489,0.000001,No
4,4,16,3,3,6,4,4,8,8,0.332308,0.343772,0.000001,No
4,4,16,4,3,7,4,4,8,7,0.352636,0.367005,0.000001,No
4,4,16,3,2,5,4,4,8,8,0.289596,0.300911,0.000001,No
7,7,49,7,5,12,7,7,14,8,0.35585,0.371262,0.000001,No
12,12,144,8,8,16,12,12,24,8,0.326708,0.334555,0.000001,No
11,11,121,6,9,15,11,11,22,8,0.343216,0.355409,0.000001,No
1,1,1,1,1,2,1,1,2,8,0.288168,0.299068,0.000001,No
3,3,9,3,2,5,3,3,6,8,0.328989,0.340847,0.000001,No
1,1,1,1,1,2,1,1,2,8,0.302584,0.309507,0.000001,No
1,1,1,1,1,2,1,1,2,8,0.323426,0.334429,0.000001,No
5,5,25,5,4,9,5,5,10,8,0.34671,0.360766,0.000001,No
6,6,36,3,5,8,6,6,12,8,0.344026,0.356638,0.000001,No
3,3,9,3,2,5,3,3,6,8,0.294169,0.304934,0.000001,No
2,2,4,2,2,4,2,2,4,8,0.343161,0.356004,0.000001,No
2,2,4,2,2,4,2,2,4,8,0.331907,0.343477,0.000001,No
3,3,9,3,3,6,3,3,6,8,0.314456,0.322515,0.000001,No
9,9,81,5,5,10,9,9,18,8,0.344895,0.358566,0.000001,No
1,1,1,1,1,2,1,1,2,8,0.301589,0.314491,0.000001,No
2,2,4,2,2,4,2,2,4,8,0.340253,0.35259,0.000001,No
4,4,16,2,3,5,4,4,8,7,0.327335,0.336545,0.000001,No
3,3,9,3,3,6,3,3,6,7,0.355131,0.369783,0.000001,No
1,1,1,1,1,2,1,1,2,8,0.339934,0.352194,0.000001,No
3,3,9,2,3,5,3,3,6,8,0.34397,0.357298,0.000001,No
2,2,4,2,1,3,2,2,4,8,0.339934,0.352194,0.000001,No
1,1,1,1,1,2,1,1,2,8,0.303661,0.312967,0.000001,No
7,7,49,5,5,10,7,7,14,8,0.332405,0.343219,0.000001,No
2,2,4,2,2,4,2,2,4,8,0.299898,0.308626,0.000001,No
3,3,9,3,3,6,3,3,6,8,0.336754,0.349947,0.000001,No
13,13,169,5,7,12,13,13,26,8,0.349494,0.364135,0.000001,No
8,8,64,6,4,10,8,8,16,8,0.32027,0.3286,0.000001,No
6,3,18,5,5,10,6,6,12,7,0.344679,0.357565,0.000001,No
1,1,1,1,1,2,1,1,2,8,0.323426,0.334429,0.000001,No
8,8,64,4,4,8,8,8,16,7,0.323973,0.332257,0.000001,No
2,2,4,2,2,4,2,2,4,8,0.327832,0.339198,0.000001,No
5,5,25,3,2,5,5,5,10,8,0.331758,0.343252,0.000001,No
8,8,64,4,7,11,8,8,16,8,0.331314,0.34217,0.000001,No
1,1,1,1,1,2,1,1,2,9,0.236671,0.240471,0.000001,No
1,1,1,1,1,2,1,1,2,8,0.315759,0.323487,0.000001,No
6,6,36,4,4,8,6,6,12,7,0.353879,0.368568,0.000001,No
5,5,25,3,5,8,5,5,10,8,0.332839,0.344373,0.000001,No
1,1,1,1,1,2,1,1,2,8,0.311312,0.322315,0.000001,No
1,1,1,1,1,2,1,1,2,9,0.247096,0.251419,0.000001,No
1,1,1,1,1,2,1,1,2,8,0.302842,0.310166,0.000001,No
3,2,6,3,3,6,3,3,6,8,0.306316,0.318772,0.000001,No
1,1,1,1,1,2,1,1,2,8,0.258229,0.263536,0.000001,No
8,8,64,4,4,8,8,8,16,8,0.305187,0.31221,0.000001,No
4,4,16,4,4,8,4,4,8,7,0.342321,0.354248,0.000001,No
2,2,4,2,2,4,2,2,4,8,0.312698,0.321141,0.000001,No
2,2,4,2,2,4,2,2,4,8,0.3347,0.34661,0.000001,No
1,1,1,1,1,2,1,1,2,8,0.296166,0.303813,0.000001,No
5,5,25,4,2,6,5,5,10,8,0.340831,0.353101,0.000001,No
4,4,16,3,2,5,4,4,8,8,0.321779,0.332125,0.000001,No
3,3,9,2,2,4,3,3,6,8,0.286263,0.295526,0.000001,No
4,4,16,3,4,7,4,4,8,7,0.331804,0.343953,0.000001,No
2,2,4,2,2,4,2,2,4,7,0.328628,0.33924,0.000001,No
4,4,16,3,4,7,4,4,8,7,0.346155,0.359381,0.000001,No
8,8,64,2,8,10,8,8,16,8,0.358775,0.375162,0.000001,No
10,10,100,2,8,10,10,10,20,7,0.342692,0.355824,0.000001,No
8,8,64,5,4,9,8,8,16,8,0.319042,0.329818,0.000001,No
6,6,36,4,4,8,6,6,12,8,0.334615,0.346231,0.000001,No
6,6,36,4,4,8,6,6,12,7,0.337233,0.348574,0.000001,No
4,4,16,3,3,6,4,4,8,7,0.348466,0.362476,0.000001,No
6,6,36,4,4,8,6,6,12,8,0.3319,0.343428,0.000001,No
7,7,49,5,4,9,7,7,14,7,0.334077,0.345316,0.000001,No
13,13,169,8,10,18,13,13,26,7,0.351401,0.365082,0.000001,No
1,1,1,1,1,2,1,1,2,8,0.32342,0.334424,0.000001,No
2,1,2,2,2,4,2,2,4,9,0.276525,0.283634,0.000001,No
4,4,16,4,4,8,4,4,8,8,0.320769,0.335045,0.000001,No
4,3,12,1,4,5,4,4,8,8,0.361773,0.378659,0.000001,No
14,13,182,8,5,13,14,14,28,8,0.329968,0.338648,0.000001,No
4,4,16,4,3,7,4,4,8,8,0.332424,0.343889,0.000001,No
28,28,784,6,3,9,28,28,56,8,0.349874,0.364073,0.000001,No
2,2,4,2,2,4,2,2,4,8,0.273454,0.280769,0.000001,No
4,4,16,3,3,6,4,4,8,8,0.314311,0.321758,0.000001,No
3,3,9,2,2,4,3,3,6,7,0.332114,0.342524,0.000001,No
3,3,9,3,3,6,3,3,6,8,0.304702,0.3135,0.000001,No
1,1,1,1,1,2,1,1,2,8,0.263383,0.269391,0.000001,No
2,2,4,2,2,4,2,2,4,8,0.316609,0.32539,0.000001,No
1,1,1,1,1,2,1,1,2,8,0.2917,0.298873,0.000001,No
2,2,4,1,2,3,2,2,4,8,0.294139,0.301237,0.000001,No
9,8,72,6,5,11,9,9,18,8,0.336078,0.348438,0.000001,No
1,1,1,1,1,2,1,1,2,9,0.255733,0.261996,0.000001,No
2,2,4,1,2,3,2,2,4,8,0.287193,0.294275,0.000001,No
2,2,4,2,2,4,2,2,4,7,0.32883,0.339618,0.000001,No
1,1,1,1,1,2,1,1,2,8,0.250518,0.255183,0.000001,No
3,3,9,1,2,3,3,3,6,8,0.27761,0.286901,0.000001,No
2,2,4,2,1,3,2,2,4,8,0.339934,0.352194,0.000001,No
2,2,4,2,2,4,2,2,4,8,0.31333,0.32048,0.000001,No
2,2,4,1,1,2,2,2,4,8,0.339934,0.352194,0.000001,No
10,10,100,8,4,12,10,10,20,8,0.33468,0.347056,0.000001,No
2,2,4,2,2,4,2,2,4,8,0.29596,0.308371,0.000001,No
2,2,4,1,1,2,2,2,4,9,0.251185,0.255815,0.000001,No
2,2,4,2,2,4,2,2,4,8,0.34461,0.357406,0.000001,No
7,7,49,4,3,7,7,7,14,8,0.338229,0.351001,0.000001,No
1,1,1,1,1,2,1,1,2,8,0.301589,0.314491,0.000001,No
3,3,9,1,2,3,3,3,6,8,0.340647,0.353161,0.000001,No
5,5,25,1,3,4,5,5,10,8,0.292832,0.303604,0.000001,No
6,5,30,3,4,7,6,6,12,7,0.335681,0.347599,0.000001,No
2,2,4,2,2,4,2,2,4,8,0.286648,0.293687,0.000001,No
2,2,4,2,2,4,2,2,4,8,0.293063,0.300432,0.000001,No
2,1,2,2,2,4,2,2,4,8,0.313198,0.322823,0.000001,No
4,4,16,1,3,4,4,4,8,7,0.32871,0.339304,0.000001,No
3,3,9,2,3,5,3,3,6,8,0.344436,0.357838,0.000001,No
4,4,16,4,3,7,4,4,8,8,0.320564,0.336079,0.000001,No
1,1,1,1,1,2,1,1,2,8,0.339941,0.352199,0.000001,No
4,4,16,3,3,6,4,4,8,7,0.355028,0.36984,0.000001,No
16,16,256,6,7,13,16,16,32,8,0.359304,0.37473,0.000001,No
9,9,81,4,6,10,9,9,18,8,0.33449,0.345167,0.000001,No
1,1,1,1,1,2,1,1,2,8,0.292285,0.300565,0.000001,No
1,1,1,1,1,2,1,1,2,8,0.310028,0.318679,0.000001,No
2,2,4,2,2,4,2,2,4,8,0.328995,0.340857,0.000001,No
5,5,25,3,4,7,5,5,10,8,0.349129,0.363482,0.000001,No
6,6,36,5,5,10,6,6,12,8,0.356668,0.37169,0.000001,No
7,6,42,2,3,5,7,7,14,8,0.32965,0.340011,0.000001,No
1,1,1,1,1,2,1,1,2,8,0.309977,0.317107,0.000001,No
1,1,1,1,1,2,1,1,2,8,0.323426,0.334429,0.000001,No
3,3,9,2,1,3,3,3,6,8,0.339934,0.352194,0.000001,No
3,3,9,2,2,4,3,3,6,8,0.339988,0.352282,0.000001,No
4,4,16,4,4,8,4,4,8,8,0.348004,0.361115,0.000001,No
3,3,9,3,3,6,3,3,6,8,0.312566,0.320804,0.000001,No
2,2,4,2,1,3,2,2,4,7,0.327819,0.338512,0.000001,No
5,5,25,3,2,5,5,5,10,8,0.352396,0.367736,0.000001,No
2,2,4,1,1,2,2,2,4,9,0.255733,0.261996,0.000001,No
3,3,9,2,2,4,3,3,6,8,0.338236,0.351488,0.000001,No
9,9,81,8,4,12,9,9,18,7,0.310564,0.319139,0.000001,No
11,10,110,6,7,13,11,11,22,8,0.336203,0.34874,0.000001,No
2,2,4,1,2,3,2,2,4,8,0.320643,0.327758,0.000001,No
7,5,35,4,4,8,7,7,14,8,0.329382,0.341417,0.000001,No
8,8,64,7,2,9,8,8,16,8,0.319275,0.32897,0.000001,No
1,1,1,1,1,2,1,1,2,9,0.269404,0.275896,0.000001,No
2,2,4,2,2,4,2,2,4,7,0.30303,0.312761,0.000001,No
1,1,1,1,1,2,1,1,2,8,0.323432,0.334432,0.000001,No
1,1,1,1,1,2,1,1,2,8,0.296166,0.303813,0.000001,No
1,1,1,1,1,2,1,1,2,8,0.27455,0.283664,0.000001,No
3,3,9,2,2,4,3,3,6,8,0.324793,0.335623,0.000001,No
1,1,1,1,1,2,1,1,2,8,0.258233,0.26354,0.000001,No
2,2,4,2,2,4,2,2,4,8,0.339961,0.352248,0.000001,No
3,3,9,3,2,5,3,3,6,8,0.330967,0.343859,0.000001,No
2,2,4,2,2,4,2,2,4,8,0.342672,0.355554,0.000001,No
10,10,100,4,6,10,10,10,20,7,0.356296,0.371246,0.000001,No
13,13,169,8,6,14,13,13,26,8,0.344526,0.357449,0.000001,No
1,1,1,1,1,2,1,1,2,8,0.27455,0.283664,0.000001,No
2,2,4,2,2,4,2,2,4,7,0.300723,0.309235,0.000001,No
7,7,49,6,5,11,7,7,14,8,0.349752,0.364275,0.000001,No
1,1,1,1,1,2,1,1,2,8,0.256899,0.262041,0.000001,No
3,3,9,3,3,6,3,3,6,8,0.325636,0.338627,0.000001,No
1,1,1,1,1,2,1,1,2,8,0.323426,0.334429,0.000001,No
4,4,16,1,1,2,4,4,8,9,0.245564,0.251698,0.000001,No
1,1,1,1,1,2,1,1,2,9,0.246711,0.250276,0.000001,No
3,3,9,3,3,6,3,3,6,8,0.327185,0.33788,0.000001,No
2,2,4,2,2,4,2,2,4,8,0.303672,0.313006,0.000001,No
1,1,1,1,1,2,1,1,2,10,0.197637,0.200169,0.000001,No
2,2,4,2,2,4,2,2,4,8,0.268316,0.274623,0.000001,No
1,1,1,1,1,2,1,1,2,8,0.339934,0.352194,0.000001,No
10,10,100,4,7,11,10,10,20,8,0.344686,0.357245,0.000001,No
3,3,9,3,3,6,3,3,6,8,0.325928,0.334392,0.000001,No
5,5,25,4,4,8,5,5,10,7,0.365821,0.382773,0.000001,No
9,9,81,7,8,15,9,9,18,8,0.363925,0.380116,0.000001,No
6,6,36,4,4,8,6,6,12,8,0.34128,0.353695,0.000001,No
2,2,4,2,2,4,2,2,4,8,0.273345,0.280063,0.000001,No
7,7,49,5,4,9,7,7,14,8,0.334477,0.345135,0.000001,No
8,8,64,7,7,14,8,8,16,8,0.318952,0.328467,0.000001,No
3,3,9,3,3,6,3,3,6,8,0.292616,0.29967,0.000001,No
8,8,64,6,6,12,8,8,16,8,0.308013,0.317121,0.000001,No
12,12,144,1,9,10,12,12,24,8,0.340647,0.353593,0.000001,No
5,5,25,3,4,7,5,5,10,8,0.282154,0.289165,0.000001,No
3,3,9,3,3,6,3,3,6,8,0.31909,0.329716,0.000001,No
1,1,1,1,1,2,1,1,2,9,0.257874,0.2639,0.000001,No
5,5,25,3,5,8,5,5,10,8,0.337367,0.349893,0.000001,No
2,2,4,1,1,2,2,2,4,8,0.309977,0.317107,0.000001,No
2,2,4,2,2,4,2,2,4,8,0.325854,0.336553,0.000001,No
6,6,36,5,4,9,6,6,12,8,0.321379,0.330056,0.000001,No
4,4,16,2,4,6,4,4,8,8,0.341547,0.354582,0.000001,No
2,2,4,1,1,2,2,2,4,8,0.265159,0.271386,0.000001,No
5,5,25,5,5,10,5,5,10,8,0.344693,0.359045,0.000001,No
3,3,9,2,3,5,3,3,6,8,0.291516,0.298627,0.000001,No
7,7,49,3,7,10,7,7,14,8,0.367397,0.384498,0.000001,No
4,4,16,4,3,7,4,4,8,7,0.35295,0.367364,0.000001,No
1,1,1,1,1,2,1,1,2,9,0.255733,0.261996,0.000001,No
9,9,81,4,5,9,9,9,18,8,0.337788,0.349971,0.000001,No
1,1,1,1,1,2,1,1,2,8,0.296166,0.303813,0.000001,No
1,1,1,1,1,2,1,1,2,8,0.315759,0.323487,0.000001,No
1,1,1,1,1,2,1,1,2,8,0.308475,0.314807,0.000001,No
10,10,100,7,5,12,10,10,20,7,0.32736,0.339148,0.000001,No
2,2,4,2,2,4,2,2,4,8,0.332075,0.343505,0.000001,No
22,22,484,4,7,11,22,22,44,7,0.347402,0.362249,0.000001,No
1,1,1,1,1,2,1,1,2,8,0.331571,0.343073,0.000001,No
18,18,324,3,6,9,18,18,36,8,0.327279,0.336689,0.000001,No
6,6,36,4,6,10,6,6,12,8,0.317304,0.328636,0.000001,No
1,1,1,1,1,2,1,1,2,8,0.339934,0.352194,0.000001,No
1,1,1,1,1,2,1,1,2,8,0.317292,0.324388,0.000001,No
3,2,6,2,3,5,3,3,6,8,0.330211,0.341491,0.000001,No
7,6,42,3,3,6,7,7,14,8,0.345181,0.358853,0.000001,No
3,3,9,3,3,6,3,3,6,7,0.351742,0.366269,0.000001,No
1,1,1,1,1,2,1,1,2,8,0.339941,0.352199,0.000001,No
8,8,64,5,5,10,8,8,16,8,0.351539,0.367787,0.000001,No
4,4,16,2,3,5,4,4,8,8,0.306734,0.317741,0.000001,No
4,4,16,3,3,6,4,4,8,8,0.338686,0.351863,0.000001,No
2,2,4,2,2,4,2,2,4,8,0.298299,0.308941,0.000001,No
2,2,4,2,2,4,2,2,4,8,0.310983,0.319434,0.000001,No
4,4,16,3,3,6,4,4,8,7,0.334378,0.345539,0.000001,No
7,7,49,5,5,10,7,7,14,8,0.369065,0.385723,0.000001,No
7,7,49,6,4,10,7,7,14,8,0.346802,0.359919,0.000001,No
4,4,16,4,2,6,4,4,8,8,0.325388,0.336241,0.000001,No
2,2,4,2,2,4,2,2,4,9,0.281127,0.289827,0.000001,No
2,2,4,2,2,4,2,2,4,8,0.306999,0.313858,0.000001,No
1,1,1,1,1,2,1,1,2,8,0.271436,0.277818,0.000001,No
5,5,25,3,4,7,5,5,10,8,0.321755,0.33002,0.000001,No
3,3,9,2,2,4,3,3,6,8,0.299782,0.309439,0.000001,No
3,3,9,1,2,3,3,3,6,8,0.288071,0.295688,0.000001,No
8,8,64,6,6,12,8,8,16,7,0.358233,0.37381,0.000001,No
6,6,36,4,4,8,6,6,12,7,0.360786,0.376632,0.000001,No
13,13,169,7,5,12,13,13,26,8,0.345825,0.360453,0.000001,No
3,3,9,2,2,4,3,3,6,8,0.340341,0.352751,0.000001,No
9,9,81,8,6,14,9,9,18,7,0.352848,0.367708,0.000001,No
7,7,49,4,6,10,7,7,14,8,0.336867,0.349882,0.000001,No
3,3,9,3,3,6,3,3,6,8,0.326358,0.338003,0.000001,No
6,6,36,4,4,8,6,6,12,8,0.321858,0.330073,0.000001,No
3,3,9,2,3,5,3,3,6,8,0.323635,0.33383,0.000001,No
5,4,20,4,4,8,5,5,10,8,0.315829,0.325483,0.000001,No
1,1,1,1,1,2,1,1,2,8,0.310717,0.317502,0.000001,No
7,7,49,3,4,7,7,7,14,7,0.308654,0.319322,0.000001,No
2,2,4,2,2,4,2,2,4,7,0.339306,0.352082,0.000001,No
1,1,1,1,1,2,1,1,2,8,0.32342,0.334424,0.000001,No
1,1,1,1,1,2,1,1,2,9,0.238693,0.241691,0.000001,No
2,2,4,2,2,4,2,2,4,8,0.312326,0.319039,0.000001,No
5,5,25,3,3,6,5,5,10,8,0.328387,0.339767,0.000001,No
5,5,25,4,5,9,5,5,10,7,0.35525,0.37034,0.000001,No
7,7,49,5,5,10,7,7,14,8,0.318025,0.328153,0.000001,No
3,3,9,1,3,4,3,3,6,8,0.338183,0.350503,0.000001,No
3,3,9,3,3,6,3,3,6,8,0.321222,0.329175,0.000001,No
3,3,9,3,2,5,3,3,6,8,0.304794,0.311264,0.000001,No
3,2,6,1,2,3,3,3,6,8,0.277199,0.287218,0.000001,No
1,1,1,1,1,2,1,1,2,8,0.307475,0.313771,0.000001,No
3,3,9,2,3,5,3,3,6,8,0.331991,0.343806,0.000001,No
8,6,48,6,7,13,8,8,16,8,0.34294,0.355102,0.000001,No
1,1,1,1,1,2,1,1,2,8,0.271899,0.280395,0.000001,No
1,1,1,1,1,2,1,1,2,8,0.301584,0.314486,0.000001,No
3,3,9,3,3,6,3,3,6,8,0.342383,0.355289,0.000001,No
2,2,4,2,2,4,2,2,4,8,0.288675,0.29809,0.000001,No
2,2,4,2,2,4,2,2,4,8,0.28633,0.293399,0.000001,No
1,1,1,1,1,2,1,1,2,8,0.2514,0.255662,0.000001,No
3,3,9,3,3,6,3,3,6,8,0.32679,0.338496,0.000001,No
3,3,9,3,3,6,3,3,6,8,0.301669,0.311336,0.000001,No
2,2,4,2,2,4,2,2,4,8,0.327832,0.339198,0.000001,No
6,6,36,5,5,10,6,6,12,8,0.34141,0.353023,0.000001,No
2,2,4,1,2,3,2,2,4,8,0.288037,0.299923,0.000001,No
5,5,25,3,4,7,5,5,10,7,0.34215,0.354723,0.000001,No
5,5,25,4,4,8,5,5,10,8,0.333933,0.346524,0.000001,No
4,4,16,2,3,5,4,4,8,8,0.324238,0.33187,0.000001,No
3,3,9,3,2,5,3,3,6,7,0.331224,0.342603,0.000001,No
2,2,4,2,2,4,2,2,4,8,0.326984,0.337478,0.000001,No
1,1,1,1,1,2,1,1,2,8,0.306651,0.31538,0.000001,No
3,3,9,3,2,5,3,3,6,8,0.341219,0.353853,0.000001,No
5,5,25,3,3,6,5,5,10,8,0.343576,0.356472,0.000001,No
5,5,25,4,4,8,5,5,10,8,0.332729,0.344075,0.000001,No
3,2,6,2,3,5,3,3,6,8,0.3026,0.312034,0.000001,No
1,1,1,1,1,2,1,1,2,8,0.28699,0.295341,0.000001,No
1,1,1,1,1,2,1,1,2,9,0.21888,0.222931,0.000001,No
1,1,1,1,1,2,1,1,2,8,0.323426,0.334429,0.000001,No
3,3,9,3,3,6,3,3,6,8,0.325412,0.336962,0.000001,No
3,3,9,3,3,6,3,3,6,8,0.327543,0.338712,0.000001,No
3,3,9,2,2,4,3,3,6,8,0.273498,0.281639,0.000001,No
13,12,156,5,9,14,13,13,26,7,0.337828,0.348625,0.000001,No
3,3,9,2,3,5,3,3,6,8,0.335384,0.347529,0.000001,No
2,1,2,2,2,4,2,2,4,8,0.273717,0.281494,0.000001,No
11,11,121,8,3,11,11,11,22,7,0.342562,0.355316,0.000001,No
2,2,4,1,1,2,2,2,4,9,0.303807,0.312038,0.000001,No
1,1,1,1,1,2,1,1,2,8,0.275281,0.282162,0.000001,No
1,1,1,1,1,2,1,1,2,9,0.268641,0.276936,0.000001,No
1,1,1,1,1,2,1,1,2,8,0.265159,0.271386,0.000001,No
5,5,25,4,4,8,5,5,10,8,0.343375,0.356244,0.000001,No
6,6,36,1,3,4,6,6,12,8,0.344116,0.356869,0.000001,No
2,2,4,2,2,4,2,2,4,8,0.324305,0.335748,0.000001,No
1,1,1,1,1,2,1,1,2,8,0.283095,0.290183,0.000001,No
1,1,1,1,1,2,1,1,2,9,0.248674,0.253915,0.000001,No
1,1,1,1,1,2,1,1,2,8,0.267299,0.273435,0.000001,No
5,5,25,3,2,5,5,5,10,8,0.343666,0.35637,0.000001,No
1,1,1,1,1,2,1,1,2,8,0.268929,0.275481,0.000001,No
6,4,24,3,4,7,6,6,12,7,0.353388,0.367732,0.000001,No
2,2,4,2,2,4,2,2,4,8,0.329287,0.341054,0.000001,No
5,5,25,3,5,8,5,5,10,7,0.358444,0.3745,0.000001,No
3,3,9,3,3,6,3,3,6,7,0.344061,0.357033,0.000001,No
4,4,16,2,3,5,4,4,8,8,0.323512,0.331091,0.000001,No
3,3,9,2,3,5,3,3,6,8,0.312046,0.320528,0.000001,No
1,1,1,1,1,2,1,1,2,9,0.249019,0.253703,0.000001,No
4,4,16,1,1,2,4,4,8,8,0.277096,0.285605,0.000001,No
2,2,4,1,2,3,2,2,4,8,0.308096,0.315573,0.000001,No
1,1,1,1,1,2,1,1,2,9,0.303807,0.312038,0.000001,No
2,2,4,2,2,4,2,2,4,9,0.269035,0.277887,0.000001,No
1,1,1,1,1,2,1,1,2,7,0.2963,0.30485,0.000001,No
7,7,49,6,6,12,7,7,14,8,0.321404,0.330628,0.000001,No
5,5,25,3,2,5,5,5,10,8,0.312423,0.320803,0.000001,No
10,10,100,7,7,14,10,10,20,8,0.357797,0.373136,0.000001,No
4,4,16,2,3,5,4,4,8,8,0.304909,0.311721,0.000001,No
1,1,1,1,1,2,1,1,2,9,0.268721,0.277328,0.000001,No
1,1,1,1,1,2,1,1,2,8,0.339934,0.352194,0.000001,No
5,3,15,4,5,9,5,5,10,8,0.32083,0.33109,0.000001,No
2,2,4,1,1,2,2,2,4,9,0.248576,0.253018,0.000001,No
5,4,20,4,4,8,5,5,10,8,0.350111,0.364461,0.000001,No
2,2,4,2,2,4,2,2,4,8,0.315543,0.324894,0.000001,No
8,8,64,3,5,8,8,8,16,8,0.345895,0.358991,0.000001,No
2,2,4,2,2,4,2,2,4,8,0.28287,0.29231,0.000001,No
7,7,49,4,6,10,7,7,14,8,0.352563,0.368539,0.000001,No
2,2,4,1,2,3,2,2,4,8,0.34007,0.352365,0.000001,No
1,1,1,1,1,2,1,1,2,9,0.303807,0.312038,0.000001,No
4,4,16,4,4,8,4,4,8,7,0.35396,0.368495,0.000001,No
3,3,9,3,1,4,3,3,6,7,0.327819,0.338512,0.000001,No
4,4,16,2,2,4,4,4,8,8,0.339941,0.352224,0.000001,No
1,1,1,1,1,2,1,1,2,8,0.339934,0.352194,0.000001,No
5,5,25,5,5,10,5,5,10,8,0.312229,0.319355,0.000001,No
3,3,9,3,2,5,3,3,6,8,0.276069,0.283526,0.000001,No
1,1,1,1,1,2,1,1,2,9,0.253732,0.259085,0.000001,No
4,4,16,1,2,3,4,4,8,8,0.30231,0.309128,0.000001,No
1,1,1,1,1,2,1,1,2,8,0.280052,0.287559,0.000001,No
4,4,16,3,3,6,4,4,8,8,0.352323,0.366725,0.000001,No
1,1,1,1,1,2,1,1,2,8,0.299745,0.307615,0.000001,No
2,2,4,1,2,3,2,2,4,8,0.295776,0.303494,0.000001,No
2,2,4,2,2,4,2,2,4,7,0.330435,0.340883,0.000001,No
2,2,4,2,2,4,2,2,4,7,0.332872,0.343166,0.000001,No
3,3,9,3,3,6,3,3,6,8,0.31352,0.324852,0.000001,No
3,3,9,3,3,6,3,3,6,8,0.34124,0.353902,0.000001,No
21,20,420,4,3,7,21,21,42,7,0.335265,0.34727,0.000001,No
6,5,30,3,4,7,6,6,12,8,0.330249,0.343706,0.000001,No
6,6,36,3,4,7,6,6,12,8,0.328343,0.339109,0.000001,No
1,1,1,1,1,2,1,1,2,8,0.302584,0.309507,0.000001,No
1,1,1,1,1,2,1,1,2,8,0.317292,0.324388,0.000001,No
3,3,9,2,3,5,3,3,6,8,0.304991,0.311763,0.000001,No
1,1,1,1,1,2,1,1,2,8,0.278743,0.288253,0.000001,No
2,2,4,2,1,3,2,2,4,8,0.271899,0.280395,0.000001,No
3,3,9,2,2,4,3,3,6,8,0.331946,0.343411,0.000001,No
2,2,4,2,1,3,2,2,4,8,0.306651,0.31538,0.000001,No
2,2,4,2,2,4,2,2,4,7,0.305384,0.313857,0.000001,No
1,1,1,1,1,2,1,1,2,8,0.280052,0.287559,0.000001,No
2,2,4,1,1,2,2,2,4,8,0.276266,0.283177,0.000001,No
2,2,4,2,2,4,2,2,4,8,0.328811,0.339441,0.000001,No
1,1,1,1,1,2,1,1,2,8,0.339934,0.352194,0.000001,No
2,2,4,1,1,2,2,2,4,8,0.309977,0.317107,0.000001,No
2,2,4,2,2,4,2,2,4,8,0.305094,0.311781,0.000001,No
3,3,9,3,3,6,3,3,6,8,0.333601,0.344838,0.000001,No
3,2,6,3,2,5,3,3,6,8,0.29481,0.303355,0.000001,No
5,5,25,2,3,5,5,5,10,8,0.318084,0.326624,0.000001,No
3,3,9,3,3,6,3,3,6,7,0.332956,0.343061,0.000001,No
7,7,49,6,6,12,7,7,14,8,0.33576,0.34708,0.000001,No
12,11,132,8,8,16,12,12,24,8,0.357325,0.372386,0.000001,No
2,2,4,1,2,3,2,2,4,8,0.349637,0.363925,0.000001,No
1,1,1,1,1,2,1,1,2,8,0.309331,0.317947,0.000001,No
6,6,36,3,2,5,6,6,12,7,0.332236,0.343545,0.000001,No
2,2,4,2,2,4,2,2,4,8,0.339975,0.352268,0.000001,No
3,3,9,3,2,5,3,3,6,8,0.327675,0.33951,0.000001,No
3,3,9,2,2,4,3,3,6,9,0.274188,0.283222,0.000001,No
3,3,9,3,3,6,3,3,6,7,0.333947,0.345355,0.000001,No
6,6,36,3,6,9,6,6,12,8,0.353352,0.367945,0.000001,No
1,1,1,1,1,2,1,1,2,8,0.2771,0.285608,0.000001,No
7,7,49,3,3,6,7,7,14,7,0.328564,0.339346,0.000001,No
3,3,9,2,2,4,3,3,6,7,0.332379,0.343252,0.000001,No
2,2,4,2,2,4,2,2,4,8,0.310197,0.318739,0.000001,No
1,1,1,1,1,2,1,1,2,8,0.339934,0.352194,0.000001,No
6,6,36,5,6,11,6,6,12,8,0.324028,0.333965,0.000001,No
8,8,64,6,4,10,8,8,16,8,0.354416,0.369172,0.000001,No
1,1,1,1,1,2,1,1,2,8,0.285597,0.293073,0.000001,No
7,7,49,6,4,10,7,7,14,8,0.342204,0.355617,0.000001,No
1,1,1,1,1,2,1,1,2,9,0.255733,0.261996,0.000001,No
37,36,1332,9,3,12,37,37,74,8,0.32923,0.340619,0.000001,No
2,2,4,2,2,4,2,2,4,8,0.344408,0.357419,0.000001,No
2,2,4,2,2,4,2,2,4,8,0.345153,0.358795,0.000001,No
5,3,15,3,3,6,5,5,10,8,0.342445,0.355004,0.000001,No
1,1,1,1,1,2,1,1,2,9,0.236901,0.240611,0.000001,No
2,2,4,2,2,4,2,2,4,8,0.335437,0.347732,0.000001,No
5,5,25,3,4,7,5,5,10,8,0.32377,0.331724,0.000001,No
7,5,35,5,6,11,7,7,14,8,0.353674,0.368526,0.000001,No
2,2,4,1,2,3,2,2,4,8,0.310881,0.317687,0.000001,No
5,4,20,3,3,6,5,5,10,8,0.311869,0.322065,0.000001,No
2,2,4,2,2,4,2,2,4,8,0.275059,0.284247,0.000001,No
14,14,196,2,6,8,14,14,28,7,0.366371,0.383314,0.000001,No
2,2,4,2,2,4,2,2,4,8,0.332573,0.344483,0.000001,No
1,1,1,1,1,2,1,1,2,8,0.311312,0.322315,0.000001,No
5,5,25,4,2,6,5,5,10,8,0.341219,0.353853,0.000001,No
1,1,1,1,1,2,1,1,2,7,0.327826,0.338517,0.000001,No
1,1,1,1,1,2,1,1,2,9,0.273017,0.280524,0.000001,No
1,1,1,1,1,2,1,1,2,8,0.274647,0.281458,0.000001,No
1,1,1,1,1,2,1,1,2,8,0.28699,0.295341,0.000001,No
2,2,4,1,2,3,2,2,4,8,0.285999,0.29547,0.000001,No
4,4,16,3,4,7,4,4,8,8,0.332198,0.342999,0.000001,No
2,2,4,2,2,4,2,2,4,9,0.26316,0.26938,0.000001,No
1,1,1,1,1,2,1,1,2,8,0.339934,0.352194,0.000001,No
15,15,225,8,8,16,15,15,30,7,0.339535,0.351161,0.000001,No
5,5,25,1,5,6,5,5,10,7,0.336562,0.347413,0.000001,No
9,9,81,3,8,11,9,9,18,7,0.361788,0.377355,0.000001,No
7,7,49,2,5,7,7,7,14,7,0.339718,0.351631,0.000001,No
8,8,64,3,5,8,8,8,16,7,0.356132,0.370888,0.000001,No
3,3,9,1,1,2,3,3,6,8,0.323426,0.334429,0.000001,No
1,1,1,1,1,2,1,1,2,8,0.339941,0.352199,0.000001,No
5,5,25,5,5,10,5,5,10,8,0.334982,0.345917,0.000001,No
1,1,1,1,1,2,1,1,2,8,0.323426,0.334429,0.000001,No
8,8,64,4,6,10,8,8,16,7,0.361926,0.377656,0.000001,No
2,2,4,2,2,4,2,2,4,8,0.323488,0.334547,0.000001,No
1,1,1,1,1,2,1,1,2,8,0.28699,0.295341,0.000001,No
12,12,144,6,6,12,12,12,24,8,0.329402,0.340724,0.000001,No
6,6,36,2,6,8,6,6,12,8,0.333255,0.346078,0.000001,No
2,2,4,2,2,4,2,2,4,8,0.312458,0.321495,0.000001,No
2,2,4,1,1,2,2,2,4,8,0.310717,0.317502,0.000001,No
4,4,16,2,2,4,4,4,8,7,0.331514,0.343058,0.000001,No
4,4,16,4,4,8,4,4,8,7,0.329065,0.339663,0.000001,No
2,2,4,2,2,4,2,2,4,8,0.304615,0.31769,0.000001,No
1,1,1,1,1,2,1,1,2,8,0.323426,0.334429,0.000001,No
5,5,25,4,4,8,5,5,10,8,0.335246,0.346647,0.000001,No
2,2,4,2,2,4,2,2,4,8,0.288037,0.299923,0.000001,No
6,6,36,3,6,9,6,6,12,8,0.340926,0.353839,0.000001,No
1,1,1,1,1,2,1,1,2,8,0.296166,0.303813,0.000001,No
3,3,9,2,2,4,3,3,6,8,0.318941,0.32612,0.000001,No
8,8,64,6,6,12,8,8,16,8,0.321289,0.332767,0.000001,No
8,8,64,2,6,8,8,8,16,8,0.342582,0.354745,0.000001,No
3,3,9,3,3,6,3,3,6,8,0.314456,0.320813,0.000001,No
13,12,156,4,6,10,13,13,26,8,0.352141,0.366618,0.000001,No
7,7,49,4,5,9,7,7,14,7,0.336184,0.348734,0.000001,No
6,6,36,4,5,9,6,6,12,7,0.355316,0.371061,0.000001,No
4,4,16,2,2,4,4,4,8,8,0.340402,0.352723,0.000001,No
4,4,16,4,4,8,4,4,8,7,0.344234,0.357079,0.000001,No
2,2,4,1,1,2,2,2,4,9,0.2538,0.258696,0.000001,No
8,8,64,6,5,11,8,8,16,7,0.335767,0.347207,0.000001,No
3,3,9,3,3,6,3,3,6,7,0.338814,0.34954,0.000001,No
7,6,42,6,6,12,7,7,14,8,0.357303,0.374051,0.000001,No
2,2,4,2,2,4,2,2,4,8,0.310045,0.318723,0.000001,No
1,1,1,1,1,2,1,1,2,8,0.288168,0.299068,0.000001,No
1,1,1,1,1,2,1,1,2,8,0.309331,0.317947,0.000001,No
1,1,1,1,1,2,1,1,2,9,0.280946,0.288054,0.000001,No
3,3,9,3,2,5,3,3,6,8,0.340043,0.352329,0.000001,No
6,6,36,3,3,6,6,6,12,7,0.328387,0.339147,0.000001,No
5,5,25,2,5,7,5,5,10,7,0.322028,0.330261,0.000001,No
3,3,9,2,2,4,3,3,6,8,0.313595,0.320333,0.000001,No
2,2,4,2,2,4,2,2,4,8,0.280066,0.286979,0.000001,No
6,6,36,4,5,9,6,6,12,8,0.358158,0.374373,0.000001,No
2,2,4,2,2,4,2,2,4,7,0.331481,0.341921,0.000001,No
1,1,1,1,1,2,1,1,2,9,0.240741,0.243771,0.000001,No
3,2,6,3,2,5,3,3,6,8,0.334326,0.344905,0.000001,No
2,2,4,2,2,4,2,2,4,8,0.301979,0.31488,0.000001,No
2,2,4,2,2,4,2,2,4,7,0.314485,0.322911,0.000001,No
3,3,9,2,2,4,3,3,6,8,0.301376,0.308771,0.000001,No
4,4,16,3,3,6,4,4,8,8,0.321919,0.337031,0.000001,No
1,1,1,1,1,2,1,1,2,8,0.261518,0.267142,0.000001,No
1,1,1,1,1,2,1,1,2,8,0.288173,0.299071,0.000001,No
3,3,9,1,3,4,3,3,6,8,0.318138,0.325387,0.000001,No
2,2,4,2,1,3,2,2,4,8,0.266509,0.272957,0.000001,No
2,2,4,2,2,4,2,2,4,8,0.310841,0.317657,0.000001,No
3,3,9,2,2,4,3,3,6,8,0.309797,0.318306,0.000001,No
2,2,4,2,2,4,2,2,4,8,0.304175,0.316794,0.000001,No
1,1,1,1,1,2,1,1,2,8,0.317292,0.324388,0.000001,No
7,7,49,4,5,9,7,7,14,7,0.345328,0.359424,0.000001,No
3,3,9,2,3,5,3,3,6,8,0.329822,0.340736,0.000001,No
13,13,169,3,9,12,13,13,26,7,0.361596,0.377712,0.000001,No
6,6,36,2,3,5,6,6,12,7,0.335055,0.346256,0.000001,No
4,4,16,3,2,5,4,4,8,7,0.299603,0.308036,0.000001,No
5,5,25,3,2,5,5,5,10,8,0.327927,0.338781,0.000001,No
12,12,144,7,7,14,12,12,24,8,0.343175,0.356384,0.000001,No
6,6,36,3,4,7,6,6,12,8,0.326465,0.335609,0.000001,No
21,21,441,11,9,20,21,21,42,8,0.341807,0.354313,0.000001,No
2,2,4,2,2,4,2,2,4,8,0.303407,0.311534,0.000001,No
4,4,16,3,4,7,4,4,8,8,0.355531,0.371145,0.000001,No
3,2,6,3,3,6,3,3,6,8,0.343189,0.357005,0.000001,No
1,1,1,1,1,2,1,1,2,7,0.296305,0.304855,0.000001,No
1,1,1,1,1,2,1,1,2,8,0.277091,0.2856,0.000001,No
4,4,16,3,4,7,4,4,8,7,0.353938,0.368526,0.000001,No
6,6,36,4,6,10,6,6,12,8,0.346506,0.359948,0.000001,No
2,2,4,2,1,3,2,2,4,8,0.323426,0.334429,0.000001,No
4,4,16,4,1,5,4,4,8,8,0.32342,0.334424,0.000001,No
3,3,9,2,3,5,3,3,6,8,0.320902,0.328793,0.000001,No
2,2,4,2,2,4,2,2,4,8,0.304696,0.313824,0.000001,No
5,4,20,3,5,8,5,5,10,7,0.358338,0.373671,0.000001,No
4,4,16,4,4,8,4,4,8,8,0.331076,0.34303,0.000001,No
8,8,64,1,5,6,8,8,16,7,0.348224,0.36144,0.000001,No
5,4,20,4,3,7,5,5,10,8,0.340239,0.352525,0.000001,No
2,2,4,1,2,3,2,2,4,8,0.28349,0.292642,0.000001,No
2,1,2,2,2,4,2,2,4,8,0.317498,0.327537,0.000001,No
4,4,16,3,4,7,4,4,8,8,0.30828,0.314984,0.000001,No
3,3,9,3,2,5,3,3,6,8,0.30664,0.318935,0.000001,No
6,6,36,3,4,7,6,6,12,8,0.33132,0.343224,0.000001,No
1,1,1,1,1,2,1,1,2,8,0.301589,0.314491,0.000001,No
1,1,1,1,1,2,1,1,2,9,0.260934,0.267118,0.000001,No
9,9,81,3,6,9,9,9,18,8,0.340926,0.354064,0.000001,No
3,3,9,2,2,4,3,3,6,7,0.342218,0.354868,0.000001,No
6,6,36,2,3,5,6,6,12,8,0.317936,0.326722,0.000001,No
11,11,121,4,8,12,11,11,22,8,0.344867,0.358409,0.000001,No
1,1,1,1,1,2,1,1,2,8,0.277096,0.285605,0.000001,No
2,2,4,2,2,4,2,2,4,7,0.338089,0.34914,0.000001,No
3,3,9,1,1,2,3,3,6,8,0.277096,0.285605,0.000001,No
9,8,72,5,3,8,9,9,18,7,0.352636,0.367005,0.000001,No
5,5,25,5,4,9,5,5,10,8,0.332236,0.343618,0.000001,No
4,4,16,4,4,8,4,4,8,8,0.342754,0.356009,0.000001,No
13,13,169,5,5,10,13,13,26,7,0.354195,0.368729,0.000001,No
14,14,196,7,10,17,14,14,28,8,0.364399,0.381757,0.000001,No
10,10,100,5,5,10,10,10,20,8,0.322217,0.33121,0.000001,No
6,6,36,4,6,10,6,6,12,8,0.352236,0.366667,0.000001,No
11,11,121,6,6,12,11,11,22,8,0.342809,0.355771,0.000001,No
4,4,16,3,3,6,4,4,8,8,0.335443,0.347419,0.000001,No
8,8,64,3,4,7,8,8,16,8,0.346985,0.360366,0.000001,No
8,5,40,7,5,12,8,8,16,8,0.350413,0.36418,0.000001,No
11,11,121,5,9,14,11,11,22,7,0.349874,0.364026,0.000001,No
1,1,1,1,1,2,1,1,2,7,0.2963,0.30485,0.000001,No
3,3,9,3,3,6,3,3,6,8,0.311124,0.320868,0.000001,No
2,2,4,1,1,2,2,2,4,8,0.32342,0.334424,0.000001,No
1,1,1,1,1,2,1,1,2,8,0.323426,0.334429,0.000001,No
8,8,64,5,4,9,8,8,16,8,0.345293,0.359009,0.000001,No
16,15,240,3,4,7,16,16,32,8,0.333021,0.344586,0.000001,No
9,9,81,4,4,8,9,9,18,8,0.332924,0.344336,0.000001,No
4,4,16,3,3,6,4,4,8,8,0.33734,0.349805,0.000001,No
1,1,1,1,1,2,1,1,2,9,0.270087,0.276477,0.000001,No
17,17,289,6,3,9,17,17,34,8,0.338915,0.351883,0.000001,No
1,1,1,1,1,2,1,1,2,8,0.301589,0.314491,0.000001,No
9,8,72,8,7,15,9,9,18,7,0.362303,0.378101,0.000001,No
5,5,25,4,4,8,5,5,10,8,0.363468,0.379523,0.000001,No
5,5,25,5,5,10,5,5,10,8,0.32483,0.333548,0.000001,No
5,5,25,4,5,9,5,5,10,8,0.330422,0.341383,0.000001,No
5,5,25,5,5,10,5,5,10,7,0.310818,0.32148,0.000001,No
5,5,25,4,4,8,5,5,10,7,0.33942,0.352839,0.000001,No
3,3,9,3,3,6,3,3,6,8,0.292315,0.303588,0.000001,No
2,2,4,2,1,3,2,2,4,8,0.277096,0.285605,0.000001,No
3,3,9,3,3,6,3,3,6,7,0.323696,0.333062,0.000001,No
2,2,4,2,2,4,2,2,4,8,0.311699,0.321756,0.000001,No
1,1,1,1,1,2,1,1,2,8,0.301589,0.314491,0.000001,No
5,5,25,4,3,7,5,5,10,8,0.329179,0.340849,0.000001,No
2,2,4,2,1,3,2,2,4,8,0.32342,0.334424,0.000001,No
2,2,4,2,2,4,2,2,4,8,0.338243,0.351497,0.000001,No
5,5,25,5,5,10,5,5,10,8,0.304925,0.314412,0.000001,No
1,1,1,1,1,2,1,1,2,8,0.339934,0.352194,0.000001,No
4,2,8,2,2,4,4,4,8,8,0.312481,0.319295,0.000001,No
7,7,49,4,5,9,7,7,14,7,0.328501,0.337109,0.000001,No
2,2,4,2,2,4,2,2,4,7,0.330096,0.341269,0.000001,No
3,3,9,3,3,6,3,3,6,8,0.348737,0.363263,0.000001,No
2,2,4,1,2,3,2,2,4,8,0.311738,0.322832,0.000001,No
3,3,9,3,3,6,3,3,6,8,0.325121,0.332882,0.000001,No
4,4,16,4,4,8,4,4,8,8,0.3232,0.330771,0.000001,No
4,4,16,4,4,8,4,4,8,8,0.31949,0.327121,0.000001,No
1,1,1,1,1,2,1,1,2,8,0.323426,0.334429,0.000001,No
3,3,9,3,3,6,3,3,6,8,0.308197,0.317453,0.000001,No
3,3,9,2,2,4,3,3,6,8,0.332482,0.343862,0.000001,No
1,1,1,1,1,2,1,1,2,8,0.297472,0.304266,0,yes
1,1,1,1,1,2,1,1,2,8,0.32342,0.334424,0,yes
1,1,1,1,1,2,1,1,2,9,0.259873,0.265127,0,yes
4,4,16,3,1,4,4,4,8,7,0.327819,0.338512,0,yes
2,2,4,1,1,2,2,2,4,7,0.327819,0.338512,0,yes
2,2,4,2,2,4,2,2,4,9,0.274431,0.281329,0,yes
5,5,25,5,4,9,5,5,10,8,0.313152,0.320664,0,yes
3,3,9,3,3,6,3,3,6,8,0.289022,0.297401,0,yes
2,2,4,1,1,2,2,2,4,8,0.331571,0.343073,0,No
8,8,64,1,2,3,8,8,16,8,0.302118,0.308737,0,No
4,4,16,3,3,6,4,4,8,8,0.285048,0.292253,0,No
5,5,25,1,3,4,5,5,10,8,0.290766,0.298012,0,No
1,1,1,1,1,2,1,1,2,8,0.331571,0.343073,0,No
1,1,1,1,1,2,1,1,2,8,0.339941,0.352199,0,No
1,1,1,1,1,2,1,1,2,8,0.301578,0.314477,0,No
4,4,16,1,3,4,4,4,8,8,0.348416,0.363595,0,No
8,8,64,3,3,6,8,8,16,7,0.315281,0.324208,0,No
2,2,4,2,2,4,2,2,4,8,0.346971,0.361663,0,No
1,1,1,1,1,2,1,1,2,9,0.250845,0.25593,0,No
3,3,9,2,3,5,3,3,6,8,0.352425,0.36779,0,No
5,5,25,3,4,7,5,5,10,8,0.346351,0.359588,0,No
2,2,4,1,2,3,2,2,4,8,0.316762,0.327784,0,No
1,1,1,1,1,2,1,1,2,8,0.274647,0.281458,0,No
1,1,1,1,1,2,1,1,2,8,0.317298,0.324393,0,No
1,1,1,1,1,2,1,1,2,8,0.303661,0.312967,0,No
1,1,1,1,1,2,1,1,2,8,0.290895,0.298106,0,No
1,1,1,1,1,2,1,1,2,8,0.339934,0.352194,0,No
10,10,100,2,5,7,10,10,20,8,0.343203,0.356461,0,No
1,1,1,1,1,2,1,1,2,8,0.288163,0.299063,0,No
1,1,1,1,1,2,1,1,2,7,0.327819,0.338512,0,No
1,1,1,1,1,2,1,1,2,7,0.327819,0.338512,0,No
1,1,1,1,1,2,1,1,2,8,0.317298,0.324393,0,No
2,2,4,2,2,4,2,2,4,8,0.270386,0.276731,0,No
1,1,1,1,1,2,1,1,2,8,0.310722,0.317507,0,No
2,2,4,1,1,2,2,2,4,8,0.27122,0.279026,0,No
10,10,100,1,8,9,10,10,20,7,0.36142,0.37684,0,No
3,3,9,1,1,2,3,3,6,9,0.250842,0.255927,0,No
1,1,1,1,1,2,1,1,2,9,0.255625,0.260652,0,No
3,3,9,3,2,5,3,3,6,8,0.340246,0.35258,0,No
2,1,2,2,2,4,2,2,4,8,0.302198,0.308977,0,No
1,1,1,1,1,2,1,1,2,8,0.331571,0.343073,0,No
1,1,1,1,1,2,1,1,2,9,0.259992,0.266705,0,No
1,1,1,1,1,2,1,1,2,9,0.259742,0.266039,0,No
2,2,4,1,1,2,2,2,4,8,0.331571,0.343073,0,No
1,1,1,1,1,2,1,1,2,8,0.284754,0.291767,0,No
4,4,16,1,1,2,4,4,8,7,0.327813,0.338503,0,No
1,1,1,1,1,2,1,1,2,8,0.258491,0.26565,0,No
1,1,1,1,1,2,1,1,2,9,0.257465,0.262623,0,No
1,1,1,1,1,2,1,1,2,8,0.270001,0.276247,0,No
1,1,1,1,1,2,1,1,2,8,0.305121,0.311597,0,No
2,2,4,1,1,2,2,2,4,8,0.289252,0.299287,0,No
3,3,9,1,3,4,3,3,6,8,0.361359,0.37701,0,No
1,1,1,1,1,2,1,1,2,8,0.317895,0.325039,0,No
1,1,1,1,1,2,1,1,2,8,0.331571,0.343073,0,No
3,3,9,1,2,3,3,3,6,8,0.273603,0.280522,0,No
4,4,16,3,3,6,4,4,8,7,0.328261,0.339067,0,No
4,3,12,2,2,4,4,4,8,7,0.319801,0.327136,0,No
1,1,1,1,1,2,1,1,2,8,0.302193,0.308972,0,No
2,2,4,2,2,4,2,2,4,7,0.342211,0.354859,0,No
16,16,256,1,12,13,16,16,32,7,0.368946,0.386796,0,No
1,1,1,1,1,2,1,1,2,8,0.29229,0.30057,0,No
1,1,1,1,1,2,1,1,2,8,0.288168,0.299068,0,No
1,1,1,1,1,2,1,1,2,8,0.281619,0.289092,0,No
1,1,1,1,1,2,1,1,2,8,0.32342,0.334424,0,No
1,1,1,1,1,2,1,1,2,8,0.310022,0.31867,0,No
2,2,4,1,1,2,2,2,4,8,0.278739,0.288248,0,No
1,1,1,1,1,2,1,1,2,8,0.289257,0.299292,0,No
1,1,1,1,1,2,1,1,2,8,0.317895,0.325039,0,No
1,1,1,1,1,2,1,1,2,8,0.29234,0.299883,0,No
1,1,1,1,1,2,1,1,2,8,0.258495,0.265653,0,No
1,1,1,1,1,2,1,1,2,8,0.339941,0.352199,0,No
1,1,1,1,1,2,1,1,2,8,0.317298,0.324393,0,No
1,1,1,1,1,2,1,1,2,9,0.272424,0.279226,0,No
4,4,16,1,2,3,4,4,8,8,0.319514,0.326984,0,No
1,1,1,1,1,2,1,1,2,8,0.282229,0.289282,0,No
2,2,4,1,2,3,2,2,4,8,0.336316,0.348402,0,No
5,5,25,5,5,10,5,5,10,8,0.338109,0.350405,0,No
2,2,4,2,2,4,2,2,4,8,0.302428,0.309237,0,No
1,1,1,1,1,2,1,1,2,8,0.323426,0.334429,0,No
1,1,1,1,1,2,1,1,2,8,0.264457,0.270739,0,No
1,1,1,1,1,2,1,1,2,9,0.253793,0.258648,0,No
2,2,4,2,2,4,2,2,4,8,0.298377,0.305137,0,No
1,1,1,1,1,2,1,1,2,8,0.307819,0.314416,0,No
1,1,1,1,1,2,1,1,2,8,0.339934,0.352194,0,No
1,1,1,1,1,2,1,1,2,7,0.327826,0.338517,0,No
1,1,1,1,1,2,1,1,2,8,0.339934,0.352194,0,No
1,1,1,1,1,2,1,1,2,8,0.32342,0.334424,0,No
4,4,16,3,2,5,4,4,8,8,0.32828,0.340062,0,No
1,1,1,1,1,2,1,1,2,8,0.288934,0.297717,0,No
1,1,1,1,1,2,1,1,2,8,0.275285,0.282167,0,No
1,1,1,1,1,2,1,1,2,8,0.323426,0.334429,0,No
4,4,16,4,3,7,4,4,8,7,0.328609,0.339881,0,No
1,1,1,1,1,2,1,1,2,8,0.310028,0.318679,0,No
1,1,1,1,1,2,1,1,2,8,0.32342,0.334424,0,No
4,4,16,3,1,4,4,4,8,8,0.310033,0.318684,0,No
1,1,1,1,1,2,1,1,2,8,0.275285,0.282167,0,No
1,1,1,1,1,2,1,1,2,9,0.269468,0.276176,0,No
2,2,4,2,1,3,2,2,4,8,0.287605,0.295192,0,No
1,1,1,1,1,2,1,1,2,8,0.268214,0.275186,0,No
3,3,9,2,2,4,3,3,6,8,0.274462,0.281815,0,No
1,1,1,1,1,2,1,1,2,8,0.282795,0.289819,0,No
1,1,1,1,1,2,1,1,2,8,0.310028,0.318679,0,No
1,1,1,1,1,2,1,1,2,8,0.306657,0.315385,0,No
1,1,1,1,1,2,1,1,2,8,0.339934,0.352194,0,No
2,2,4,2,2,4,2,2,4,9,0.281122,0.289822,0,No
2,2,4,1,1,2,2,2,4,8,0.310033,0.318684,0,No
1,1,1,1,1,2,1,1,2,8,0.317292,0.324388,0,No
2,2,4,1,1,2,2,2,4,8,0.308542,0.315798,0,No
1,1,1,1,1,2,1,1,2,8,0.313497,0.320213,0,No
12,12,144,3,8,11,12,12,24,7,0.344026,0.35618,0,No
3,3,9,2,2,4,3,3,6,7,0.342218,0.354868,0,No
10,10,100,4,4,8,10,10,20,8,0.310519,0.320554,0,No
1,1,1,1,1,2,1,1,2,9,0.268645,0.276939,0,No
1,1,1,1,1,2,1,1,2,7,0.327819,0.338512,0,No
1,1,1,1,1,2,1,1,2,8,0.27189,0.28038,0,No
1,1,1,1,1,2,1,1,2,9,0.268641,0.276936,0,No
1,1,1,1,1,2,1,1,2,8,0.32342,0.334424,0,No
1,1,1,1,1,2,1,1,2,9,0.268721,0.277328,0,No
2,2,4,1,2,3,2,2,4,8,0.288416,0.299274,0,No
5,5,25,4,3,7,5,5,10,7,0.336263,0.347291,0,No
2,2,4,2,2,4,2,2,4,8,0.320029,0.327808,0,No
3,3,9,3,3,6,3,3,6,8,0.324892,0.335824,0,No
1,1,1,1,1,2,1,1,2,8,0.308548,0.315803,0,No
1,1,1,1,1,2,1,1,2,7,0.296305,0.304855,0,No
1,1,1,1,1,2,1,1,2,8,0.282743,0.289827,0,No
1,1,1,1,1,2,1,1,2,8,0.339934,0.352194,0,No
2,2,4,1,1,2,2,2,4,8,0.309325,0.317943,0,No
2,2,4,2,2,4,2,2,4,8,0.307835,0.318232,0,No
2,2,4,1,1,2,2,2,4,9,0.262241,0.268868,0,No
2,2,4,2,2,4,2,2,4,8,0.315176,0.324499,0,No
1,1,1,1,1,2,1,1,2,8,0.300685,0.307394,0,No
1,1,1,1,1,2,1,1,2,8,0.27122,0.279026,0,No
1,1,1,1,1,2,1,1,2,8,0.339934,0.352194,0,No
3,2,6,3,3,6,3,3,6,8,0.307242,0.320718,0,No
1,1,1,1,1,2,1,1,2,8,0.288168,0.299068,0,No
3,3,9,3,2,5,3,3,6,7,0.331243,0.342587,0,No
2,2,4,1,1,2,2,2,4,8,0.267857,0.275083,0,No
1,1,1,1,1,2,1,1,2,9,0.249499,0.253819,0,No
1,1,1,1,1,2,1,1,2,8,0.339934,0.352194,0,No
1,1,1,1,1,2,1,1,2,8,0.28349,0.292904,0,No
2,2,4,1,1,2,2,2,4,9,0.265932,0.272147,0,No
2,2,4,2,2,4,2,2,4,8,0.310598,0.319237,0,No
2,2,4,2,1,3,2,2,4,8,0.310028,0.318679,0,No
1,1,1,1,1,2,1,1,2,8,0.294479,0.3016,0,No
1,1,1,1,1,2,1,1,2,8,0.310028,0.318679,0,No
6,6,36,4,4,8,6,6,12,7,0.328748,0.339389,0,No
1,1,1,1,1,2,1,1,2,8,0.288163,0.299063,0,No
1,1,1,1,1,2,1,1,2,8,0.32342,0.334424,0,No
1,1,1,1,1,2,1,1,2,8,0.278743,0.288253,0,No
2,2,4,2,2,4,2,2,4,8,0.303688,0.316418,0,No
4,4,16,2,1,3,4,4,8,8,0.301584,0.314486,0,No
1,1,1,1,1,2,1,1,2,8,0.317451,0.327459,0,No
1,1,1,1,1,2,1,1,2,8,0.317895,0.325039,0,No
1,1,1,1,1,2,1,1,2,8,0.274682,0.281691,0,No
1,1,1,1,1,2,1,1,2,8,0.339934,0.352194,0,No
1,1,1,1,1,2,1,1,2,8,0.296171,0.303818,0,No
2,2,4,1,1,2,2,2,4,8,0.315759,0.323487,0,No
1,1,1,1,1,2,1,1,2,8,0.277096,0.285605,0,No
1,1,1,1,1,2,1,1,2,8,0.261968,0.267976,0,No
1,1,1,1,1,2,1,1,2,8,0.262949,0.268946,0,No
1,1,1,1,1,2,1,1,2,8,0.274554,0.283667,0,No
3,3,9,3,3,6,3,3,6,7,0.335272,0.34728,0,No
1,1,1,1,1,2,1,1,2,8,0.339941,0.352199,0,No
3,3,9,2,1,3,3,3,6,8,0.288163,0.299063,0,No
1,1,1,1,1,2,1,1,2,8,0.323426,0.334429,0,No
2,2,4,1,1,2,2,2,4,8,0.2876,0.295187,0,No
1,1,1,1,1,2,1,1,2,8,0.323414,0.334415,0,No
2,2,4,1,1,2,2,2,4,8,0.339934,0.352194,0,No
1,1,1,1,1,2,1,1,2,8,0.2876,0.295187,0,No
1,1,1,1,1,2,1,1,2,8,0.339934,0.352194,0,No
4,4,16,2,2,4,4,4,8,8,0.313422,0.321761,0,No
4,4,16,3,4,7,4,4,8,8,0.354541,0.369051,0,No
1,1,1,1,1,2,1,1,2,9,0.256094,0.261014,0,No
1,1,1,1,1,2,1,1,2,8,0.310033,0.318684,0,No
1,1,1,1,1,2,1,1,2,8,0.278008,0.285471,0,No
1,1,1,1,1,2,1,1,2,8,0.271224,0.279029,0,No
1,1,1,1,1,2,1,1,2,8,0.339934,0.352194,0,No
1,1,1,1,1,2,1,1,2,8,0.273617,0.280207,0,No
1,1,1,1,1,2,1,1,2,9,0.268721,0.277328,0,No
1,1,1,1,1,2,1,1,2,8,0.309331,0.317947,0,No
1,1,1,1,1,2,1,1,2,8,0.331578,0.343078,0,No
1,1,1,1,1,2,1,1,2,8,0.331571,0.343073,0,No
2,2,4,2,1,3,2,2,4,7,0.296305,0.304855,0,No
1,1,1,1,1,2,1,1,2,8,0.310033,0.318684,0,No
1,1,1,1,1,2,1,1,2,9,0.250845,0.25593,0,No
3,3,9,2,2,4,3,3,6,8,0.298377,0.305335,0,No
3,3,9,1,3,4,3,3,6,7,0.333125,0.345134,0,No
2,2,4,2,2,4,2,2,4,7,0.330058,0.340547,0,No
2,2,4,1,1,2,2,2,4,8,0.311312,0.322315,0,No
1,1,1,1,1,2,1,1,2,7,0.327819,0.338512,0,No
4,4,16,2,2,4,4,4,8,8,0.33541,0.346459,0,No
1,1,1,1,1,2,1,1,2,7,0.296305,0.304855,0,No
1,1,1,1,1,2,1,1,2,7,0.327819,0.338512,0,No
2,2,4,2,2,4,2,2,4,7,0.329745,0.340907,0,No
3,3,9,1,2,3,3,3,6,7,0.3358,0.346415,0,No
1,1,1,1,1,2,1,1,2,7,0.296305,0.304855,0,No
1,1,1,1,1,2,1,1,2,8,0.323426,0.334429,0,No
1,1,1,1,1,2,1,1,2,8,0.287605,0.295192,0,No
1,1,1,1,1,2,1,1,2,9,0.261062,0.266841,0,No
5,5,25,4,4,8,5,5,10,8,0.356877,0.372502,0,No
1,1,1,1,1,2,1,1,2,8,0.278743,0.288253,0,No
1,1,1,1,1,2,1,1,2,8,0.276387,0.283159,0,No
2,2,4,1,2,3,2,2,4,8,0.331578,0.343103,0,No
1,1,1,1,1,2,1,1,2,8,0.311312,0.322315,0,No
1,1,1,1,1,2,1,1,2,8,0.288153,0.295426,0,No
1,1,1,1,1,2,1,1,2,7,0.296305,0.304855,0,No
2,2,4,2,2,4,2,2,4,8,0.323979,0.335279,0,No
2,2,4,1,1,2,2,2,4,8,0.310033,0.318684,0,No
2,2,4,2,2,4,2,2,4,8,0.297208,0.304419,0,No
2,2,4,2,2,4,2,2,4,8,0.296634,0.303874,0,No
3,3,9,2,2,4,3,3,6,8,0.338243,0.351497,0,No
1,1,1,1,1,2,1,1,2,8,0.299367,0.306897,0,No
1,1,1,1,1,2,1,1,2,8,0.310717,0.317502,0,No
1,1,1,1,1,2,1,1,2,7,0.327819,0.338512,0,No
1,1,1,1,1,2,1,1,2,9,0.303801,0.312033,0,No
1,1,1,1,1,2,1,1,2,8,0.331571,0.343073,0,No
2,2,4,2,2,4,2,2,4,8,0.340307,0.352678,0,No
2,2,4,2,2,4,2,2,4,8,0.318375,0.325437,0,No
2,2,4,1,1,2,2,2,4,8,0.32342,0.334424,0,No
1,1,1,1,1,2,1,1,2,8,0.317292,0.324388,0,No
1,1,1,1,1,2,1,1,2,8,0.323426,0.334429,0,No
1,1,1,1,1,2,1,1,2,8,0.317298,0.324393,0,No
1,1,1,1,1,2,1,1,2,8,0.288163,0.299063,0,No
6,4,24,3,3,6,6,6,12,8,0.30758,0.315926,0,No
1,1,1,1,1,2,1,1,2,8,0.282257,0.289281,0,No
1,1,1,1,1,2,1,1,2,8,0.339934,0.352194,0,No
1,1,1,1,1,2,1,1,2,9,0.237905,0.241554,0,No
1,1,1,1,1,2,1,1,2,8,0.310028,0.318679,0,No
1,1,1,1,1,2,1,1,2,9,0.268721,0.277328,0,No
2,2,4,1,2,3,2,2,4,8,0.287009,0.294562,0,No
1,1,1,1,1,2,1,1,2,9,0.268721,0.277328,0,No
1,1,1,1,1,2,1,1,2,8,0.303693,0.310789,0,No
1,1,1,1,1,2,1,1,2,8,0.309325,0.317943,0,No
3,3,9,1,1,2,3,3,6,8,0.301589,0.314491,0,No
4,4,16,2,1,3,4,4,8,8,0.32342,0.334424,0,No
3,3,9,3,3,6,3,3,6,8,0.333249,0.344321,0,No
2,2,4,1,2,3,2,2,4,8,0.338189,0.350948,0,No
3,3,9,3,1,4,3,3,6,8,0.301584,0.314486,0,No
1,1,1,1,1,2,1,1,2,8,0.303688,0.310784,0,No
2,2,4,2,2,4,2,2,4,8,0.280974,0.288106,0,No
6,6,36,4,4,8,6,6,12,8,0.34239,0.35619,0,No
1,1,1,1,1,2,1,1,2,8,0.310033,0.318684,0,No
1,1,1,1,1,2,1,1,2,9,0.226513,0.230948,0,No
1,1,1,1,1,2,1,1,2,8,0.274545,0.283659,0,No
1,1,1,1,1,2,1,1,2,8,0.27455,0.283664,0,No
9,9,81,5,5,10,9,9,18,8,0.364018,0.380018,0,No
1,1,1,1,1,2,1,1,2,8,0.339934,0.352194,0,No
1,1,1,1,1,2,1,1,2,8,0.32342,0.334424,0,No
4,3,12,3,4,7,4,4,8,8,0.341335,0.353797,0,No
1,1,1,1,1,2,1,1,2,8,0.32342,0.334424,0,No
2,2,4,2,2,4,2,2,4,8,0.296351,0.303691,0,No
4,4,16,2,3,5,4,4,8,8,0.318583,0.326347,0,No
1,1,1,1,1,2,1,1,2,8,0.27392,0.280749,0,No
1,1,1,1,1,2,1,1,2,7,0.2963,0.30485,0,No
1,1,1,1,1,2,1,1,2,9,0.268721,0.277328,0,No
1,1,1,1,1,2,1,1,2,8,0.317451,0.327459,0,No
1,1,1,1,1,2,1,1,2,8,0.32342,0.334424,0,No
1,1,1,1,1,2,1,1,2,9,0.249474,0.254542,0,No
2,2,4,1,1,2,2,2,4,8,0.32342,0.334424,0,No
1,1,1,1,1,2,1,1,2,7,0.312584,0.319273,0,No
1,1,1,1,1,2,1,1,2,8,0.309331,0.317947,0,No
2,2,4,1,2,3,2,2,4,8,0.269724,0.276159,0,No
1,1,1,1,1,2,1,1,2,8,0.306651,0.31538,0,No
2,2,4,1,2,3,2,2,4,8,0.317729,0.324814,0,No
2,2,4,1,1,2,2,2,4,8,0.294479,0.3016,0,No
2,1,2,2,2,4,2,2,4,7,0.314578,0.32161,0,No
2,2,4,1,1,2,2,2,4,8,0.339934,0.352194,0,No
2,2,4,1,1,2,2,2,4,8,0.339934,0.352194,0,No
2,2,4,1,1,2,2,2,4,8,0.281833,0.289891,0,No
1,1,1,1,1,2,1,1,2,8,0.308542,0.315798,0,No
1,1,1,1,1,2,1,1,2,8,0.288163,0.299063,0,No
4,4,16,1,3,4,4,4,8,8,0.308252,0.316532,0,No
3,3,9,2,2,4,3,3,6,8,0.338243,0.351497,0,No
1,1,1,1,1,2,1,1,2,9,0.259742,0.266039,0,No
1,1,1,1,1,2,1,1,2,8,0.317445,0.327454,0,No
1,1,1,1,1,2,1,1,2,9,0.242793,0.246514,0,No
1,1,1,1,1,2,1,1,2,8,0.310717,0.317502,0,No
7,7,49,2,3,5,7,7,14,7,0.343009,0.355912,0,No
4,4,16,3,2,5,4,4,8,8,0.328002,0.338706,0,No
2,2,4,1,1,2,2,2,4,8,0.32342,0.334424,0,No
2,2,4,1,1,2,2,2,4,8,0.26792,0.274346,0,No
1,1,1,1,1,2,1,1,2,8,0.32342,0.334424,0,No
2,2,4,2,2,4,2,2,4,8,0.325183,0.336094,0,No
2,2,4,1,1,2,2,2,4,8,0.308548,0.315803,0,No
8,7,56,5,4,9,8,8,16,8,0.343493,0.357028,0,No
1,1,1,1,1,2,1,1,2,8,0.308542,0.315798,0,No
1,1,1,1,1,2,1,1,2,8,0.30338,0.311471,0,No
1,1,1,1,1,2,1,1,2,8,0.29596,0.304319,0,No
1,1,1,1,1,2,1,1,2,8,0.264457,0.270739,0,No
1,1,1,1,1,2,1,1,2,7,0.296305,0.304855,0,No
1,1,1,1,1,2,1,1,2,9,0.242796,0.246517,0,No
1,1,1,1,1,2,1,1,2,9,0.265308,0.271483,0,No
1,1,1,1,1,2,1,1,2,7,0.296305,0.304855,0,No
1,1,1,1,1,2,1,1,2,8,0.303585,0.310469,0,No
1,1,1,1,1,2,1,1,2,8,0.260123,0.265863,0,No
2,2,4,1,1,2,2,2,4,8,0.323414,0.334415,0,No
2,2,4,2,2,4,2,2,4,8,0.298278,0.30887,0,No
1,1,1,1,1,2,1,1,2,7,0.296305,0.304855,0,No
2,2,4,2,2,4,2,2,4,7,0.331514,0.343058,0,No
1,1,1,1,1,2,1,1,2,8,0.254797,0.25938,0,No
5,5,25,3,3,6,5,5,10,8,0.324262,0.335332,0,No
1,1,1,1,1,2,1,1,2,7,0.327819,0.338512,0,No
2,2,4,1,1,2,2,2,4,8,0.29191,0.299154,0,No
1,1,1,1,1,2,1,1,2,8,0.27455,0.283664,0,No
3,3,9,3,1,4,3,3,6,8,0.339934,0.352194,0,No
5,5,25,2,3,5,5,5,10,8,0.33839,0.351722,0,No
2,2,4,2,2,4,2,2,4,8,0.307685,0.320435,0,No
3,3,9,3,3,6,3,3,6,8,0.342699,0.356395,0,No
1,1,1,1,1,2,1,1,2,9,0.257244,0.262702,0,No
2,2,4,2,2,4,2,2,4,9,0.278525,0.286998,0,No
2,2,4,1,1,2,2,2,4,9,0.263403,0.271075,0,No
6,6,36,4,4,8,6,6,12,7,0.342947,0.356566,0,No
1,1,1,1,1,2,1,1,2,9,0.254911,0.260674,0,No
2,2,4,1,1,2,2,2,4,8,0.288168,0.299068,0,No
1,1,1,1,1,2,1,1,2,8,0.295136,0.302087,0,No
1,1,1,1,1,2,1,1,2,8,0.310033,0.318684,0,No
1,1,1,1,1,2,1,1,2,8,0.310722,0.317507,0,No
6,5,30,5,5,10,6,6,12,8,0.326796,0.3363,0,No
1,1,1,1,1,2,1,1,2,8,0.309325,0.317943,0,No
1,1,1,1,1,2,1,1,2,8,0.281805,0.28952,0,No
1,1,1,1,1,2,1,1,2,8,0.30338,0.311471,0,No
1,1,1,1,1,2,1,1,2,9,0.248674,0.253668,0,No
1,1,1,1,1,2,1,1,2,7,0.327826,0.338517,0,No
2,2,4,2,2,4,2,2,4,7,0.331217,0.342593,0,No
1,1,1,1,1,2,1,1,2,8,0.32342,0.334424,0,No
1,1,1,1,1,2,1,1,2,8,0.32342,0.334424,0,No
1,1,1,1,1,2,1,1,2,9,0.276056,0.283078,0,No
10,10,100,1,4,5,10,10,20,7,0.340776,0.352395,0,No
2,2,4,1,1,2,2,2,4,8,0.288929,0.297713,0,No
1,1,1,1,1,2,1,1,2,9,0.249634,0.253522,0,No
1,1,1,1,1,2,1,1,2,8,0.295596,0.303244,0,No
4,4,16,2,2,4,4,4,8,8,0.294703,0.303984,0,No
4,4,16,4,1,5,4,4,8,9,0.252117,0.257189,0,No
1,1,1,1,1,2,1,1,2,9,0.24383,0.247502,0,No
1,1,1,1,1,2,1,1,2,8,0.310028,0.318679,0,No
1,1,1,1,1,2,1,1,2,8,0.277917,0.284869,0,No
1,1,1,1,1,2,1,1,2,8,0.292345,0.299887,0,No
4,4,16,2,3,5,4,4,8,8,0.352221,0.366891,0,No
3,3,9,2,3,5,3,3,6,8,0.33295,0.345514,0,No
2,2,4,1,2,3,2,2,4,8,0.292701,0.301471,0,No
2,2,4,1,1,2,2,2,4,8,0.27455,0.283664,0,No
1,1,1,1,1,2,1,1,2,8,0.288163,0.299063,0,No
1,1,1,1,1,2,1,1,2,8,0.317901,0.325044,0,No
2,2,4,1,1,2,2,2,4,8,0.317451,0.327459,0,No
2,2,4,2,2,4,2,2,4,8,0.319173,0.329215,0,No
2,2,4,1,1,2,2,2,4,8,0.301584,0.314486,0,No
1,1,1,1,1,2,1,1,2,9,0.257835,0.263356,0,No
1,1,1,1,1,2,1,1,2,8,0.303655,0.312962,0,No
3,3,9,2,2,4,3,3,6,8,0.310903,0.31771,0,No
1,1,1,1,1,2,1,1,2,8,0.317292,0.324388,0,No
1,1,1,1,1,2,1,1,2,8,0.339941,0.352199,0,No
1,1,1,1,1,2,1,1,2,9,0.252318,0.257273,0,No
2,2,4,2,2,4,2,2,4,8,0.290217,0.297354,0,No
1,1,1,1,1,2,1,1,2,8,0.303585,0.310469,0,No
1,1,1,1,1,2,1,1,2,8,0.331578,0.343078,0,No
1,1,1,1,1,2,1,1,2,8,0.32342,0.334424,0,No
1,1,1,1,1,2,1,1,2,8,0.309331,0.317947,0,No
1,1,1,1,1,2,1,1,2,8,0.288163,0.299063,0,No
2,2,4,1,1,2,2,2,4,8,0.313497,0.320213,0,No
1,1,1,1,1,2,1,1,2,8,0.289125,0.296342,0,No
2,2,4,2,2,4,2,2,4,8,0.329217,0.339871,0,No
1,1,1,1,1,2,1,1,2,9,0.268641,0.276936,0,No
1,1,1,1,1,2,1,1,2,8,0.289694,0.297055,0,No
1,1,1,1,1,2,1,1,2,8,0.284061,0.291205,0,No
2,2,4,2,2,4,2,2,4,7,0.316046,0.325451,0,No
1,1,1,1,1,2,1,1,2,8,0.331578,0.343078,0,No
1,1,1,1,1,2,1,1,2,8,0.277389,0.284283,0,No
2,2,4,1,1,2,2,2,4,8,0.331571,0.343073,0,No
3,3,9,3,3,6,3,3,6,8,0.323696,0.33404,0,No
2,2,4,2,2,4,2,2,4,8,0.30636,0.318803,0,No
1,1,1,1,1,2,1,1,2,8,0.301589,0.314491,0,No
2,2,4,2,2,4,2,2,4,8,0.323887,0.334875,0,No
2,2,4,1,1,2,2,2,4,8,0.281856,0.2891,0,No
2,2,4,1,2,3,2,2,4,8,0.29576,0.302857,0,No
3,3,9,3,3,6,3,3,6,8,0.343106,0.355661,0,No
1,1,1,1,1,2,1,1,2,8,0.309325,0.317943,0,No
2,2,4,2,2,4,2,2,4,8,0.30059,0.310613,0,No
3,3,9,1,1,2,3,3,6,9,0.244979,0.249046,0,No
2,2,4,2,2,4,2,2,4,8,0.306922,0.314033,0,No
4,4,16,2,2,4,4,4,8,8,0.328995,0.340857,0,No
1,1,1,1,1,2,1,1,2,8,0.309325,0.317943,0,No
2,2,4,2,2,4,2,2,4,8,0.341752,0.354359,0,No
1,1,1,1,1,2,1,1,2,8,0.331571,0.343073,0,No
1,1,1,1,1,2,1,1,2,8,0.309325,0.317943,0,No
4,4,16,2,4,6,4,4,8,7,0.335516,0.346868,0,No
2,2,4,2,1,3,2,2,4,8,0.255948,0.260961,0,No
3,3,9,2,2,4,3,3,6,8,0.276709,0.283611,0,No
1,1,1,1,1,2,1,1,2,8,0.28214,0.289603,0,No
1,1,1,1,1,2,1,1,2,8,0.278666,0.285579,0,No
1,1,1,1,1,2,1,1,2,8,0.287605,0.295192,0,No
1,1,1,1,1,2,1,1,2,8,0.296438,0.303515,0,No
2,2,4,1,1,2,2,2,4,7,0.327819,0.338512,0,No
1,1,1,1,1,2,1,1,2,9,0.265932,0.272147,0,No
1,1,1,1,1,2,1,1,2,8,0.29224,0.299243,0,No
1,1,1,1,1,2,1,1,2,8,0.339934,0.352194,0,No
1,1,1,1,1,2,1,1,2,9,0.274303,0.281233,0,No
1,1,1,1,1,2,1,1,2,8,0.339934,0.352194,0,No
1,1,1,1,1,2,1,1,2,9,0.249499,0.253819,0,No
4,4,16,2,4,6,4,4,8,8,0.345097,0.357976,0,No
1,1,1,1,1,2,1,1,2,7,0.327826,0.338517,0,No
2,2,4,2,2,4,2,2,4,7,0.352621,0.366966,0,No
2,2,4,2,2,4,2,2,4,8,0.34493,0.357689,0,No
2,2,4,1,1,2,2,2,4,9,0.254911,0.260674,0,No
1,1,1,1,1,2,1,1,2,8,0.315765,0.323492,0,No
2,2,4,1,1,2,2,2,4,8,0.288163,0.299063,0,No
4,4,16,3,1,4,4,4,8,8,0.288168,0.299068,0,No
1,1,1,1,1,2,1,1,2,8,0.309325,0.317943,0,No
5,5,25,3,2,5,5,5,10,8,0.314688,0.323796,0,No
2,2,4,2,2,4,2,2,4,8,0.31538,0.325075,0,No
3,3,9,2,2,4,3,3,6,8,0.312945,0.32186,0,No
8,8,64,3,5,8,8,8,16,8,0.356594,0.37225,0,No
4,4,16,3,3,6,4,4,8,8,0.311073,0.317968,0,No
2,2,4,1,1,2,2,2,4,8,0.30338,0.311471,0,No
1,1,1,1,1,2,1,1,2,8,0.262799,0.26874,0,No
2,2,4,1,1,2,2,2,4,7,0.327826,0.338517,0,No
1,1,1,1,1,2,1,1,2,8,0.27455,0.283664,0,No
2,2,4,2,2,4,2,2,4,8,0.282786,0.292425,0,No
4,4,16,2,3,5,4,4,8,8,0.29454,0.303319,0,No
5,5,25,5,5,10,5,5,10,7,0.333816,0.345494,0,No
1,1,1,1,1,2,1,1,2,8,0.308325,0.314705,0,No
1,1,1,1,1,2,1,1,2,8,0.278739,0.288248,0,No
1,1,1,1,1,2,1,1,2,8,0.32342,0.334424,0,No
3,2,6,2,2,4,3,3,6,8,0.277199,0.287218,0,No
1,1,1,1,1,2,1,1,2,8,0.303655,0.312962,0,No
1,1,1,1,1,2,1,1,2,8,0.303655,0.312962,0,No
1,1,1,1,1,2,1,1,2,9,0.255737,0.261999,0,No
1,1,1,1,1,2,1,1,2,9,0.23841,0.242312,0,No
1,1,1,1,1,2,1,1,2,8,0.27455,0.283664,0,No
1,1,1,1,1,2,1,1,2,8,0.288168,0.299068,0,No
2,2,4,2,1,3,2,2,4,8,0.288163,0.299063,0,No
3,3,9,2,3,5,3,3,6,7,0.338558,0.350657,0,No
8,8,64,4,2,6,8,8,16,7,0.329745,0.340907,0,No
2,2,4,2,2,4,2,2,4,7,0.329745,0.340907,0,No
2,2,4,2,2,4,2,2,4,8,0.323432,0.334464,0,No
4,4,16,4,4,8,4,4,8,7,0.322601,0.332671,0,No
3,3,9,3,3,6,3,3,6,8,0.307043,0.319808,0,No
2,2,4,1,1,2,2,2,4,8,0.27122,0.279026,0,No
1,1,1,1,1,2,1,1,2,8,0.296166,0.303813,0,No
1,1,1,1,1,2,1,1,2,8,0.287605,0.295192,0,No
1,1,1,1,1,2,1,1,2,9,0.250845,0.25593,0,No
1,1,1,1,1,2,1,1,2,8,0.30338,0.311471,0,No
2,2,4,2,1,3,2,2,4,8,0.32342,0.334424,0,No
1,1,1,1,1,2,1,1,2,8,0.301584,0.314486,0,No
4,4,16,3,3,6,4,4,8,8,0.352192,0.366535,0,No
2,2,4,2,2,4,2,2,4,8,0.30876,0.316722,0,No
2,2,4,2,2,4,2,2,4,8,0.307708,0.315606,0,No
1,1,1,1,1,2,1,1,2,9,0.250842,0.255927,0,No
4,4,16,2,2,4,4,4,8,8,0.327455,0.338576,0,No
1,1,1,1,1,2,1,1,2,8,0.268345,0.275546,0,No
1,1,1,1,1,2,1,1,2,9,0.280683,0.28796,0,No
3,2,6,2,2,4,3,3,6,7,0.332236,0.343545,0,No
1,1,1,1,1,2,1,1,2,8,0.301589,0.314491,0,No
1,1,1,1,1,2,1,1,2,9,0.268641,0.276936,0,No
1,1,1,1,1,2,1,1,2,8,0.28349,0.292904,0,No
1,1,1,1,1,2,1,1,2,8,0.288168,0.299068,0,No
5,5,25,3,4,7,5,5,10,8,0.324805,0.335763,0,No
1,1,1,1,1,2,1,1,2,8,0.309325,0.317943,0,No
2,2,4,1,1,2,2,2,4,8,0.309325,0.317943,0,No
1,1,1,1,1,2,1,1,2,8,0.280066,0.287114,0,No
1,1,1,1,1,2,1,1,2,8,0.301584,0.314486,0,No
2,2,4,1,1,2,2,2,4,9,0.249499,0.253819,0,No
3,3,9,2,2,4,3,3,6,8,0.323702,0.334805,0,No
2,2,4,2,2,4,2,2,4,8,0.327927,0.338781,0,No
2,2,4,2,2,4,2,2,4,8,0.323457,0.334493,0,No
3,3,9,3,2,5,3,3,6,8,0.30268,0.315633,0,No
2,2,4,2,2,4,2,2,4,9,0.251786,0.256529,0,No
2,2,4,1,1,2,2,2,4,8,0.277389,0.284283,0,No
1,1,1,1,1,2,1,1,2,8,0.32342,0.334424,0,No
1,1,1,1,1,2,1,1,2,7,0.327819,0.338512,0,No
2,2,4,1,1,2,2,2,4,8,0.310028,0.318679,0,No
1,1,1,1,1,2,1,1,2,8,0.303585,0.310469,0,No
1,1,1,1,1,2,1,1,2,8,0.310028,0.318679,0,No
1,1,1,1,1,2,1,1,2,8,0.310033,0.318684,0,No
3,2,6,3,2,5,3,3,6,8,0.311505,0.32001,0,No
1,1,1,1,1,2,1,1,2,7,0.327819,0.338512,0,No
1,1,1,1,1,2,1,1,2,8,0.309325,0.317943,0,No
1,1,1,1,1,2,1,1,2,8,0.310028,0.318679,0,No
3,3,9,3,3,6,3,3,6,7,0.334752,0.346663,0,No
1,1,1,1,1,2,1,1,2,8,0.30359,0.310474,0,No
1,1,1,1,1,2,1,1,2,8,0.309331,0.317947,0,No
1,1,1,1,1,2,1,1,2,8,0.309325,0.317943,0,No
2,2,4,1,1,2,2,2,4,8,0.301584,0.314486,0,No
3,3,9,2,2,4,3,3,6,8,0.314427,0.324044,0,No
2,2,4,1,1,2,2,2,4,8,0.306651,0.31538,0,No
1,1,1,1,1,2,1,1,2,8,0.331571,0.343073,0,No
2,2,4,1,1,2,2,2,4,9,0.268641,0.276936,0,No
2,2,4,1,1,2,2,2,4,8,0.256903,0.262046,0,No
1,1,1,1,1,2,1,1,2,8,0.32342,0.334424,0,No
1,1,1,1,1,2,1,1,2,8,0.339934,0.352194,0,No
2,2,4,2,1,3,2,2,4,8,0.32342,0.334424,0,No
4,4,16,2,2,4,4,4,8,8,0.329147,0.339568,0,No
2,2,4,1,1,2,2,2,4,7,0.296305,0.304855,0,No
6,6,36,4,3,7,6,6,12,8,0.327908,0.337439,0,No
2,2,4,1,1,2,2,2,4,9,0.268641,0.276936,0,No
3,3,9,2,3,5,3,3,6,8,0.323016,0.333463,0,No
3,3,9,3,3,6,3,3,6,8,0.317256,0.326448,0,No
1,1,1,1,1,2,1,1,2,8,0.301589,0.314491,0,No
1,1,1,1,1,2,1,1,2,8,0.339941,0.352199,0,No
2,2,4,1,1,2,2,2,4,9,0.246589,0.250624,0,No
2,2,4,2,2,4,2,2,4,8,0.32558,0.336445,0,No
1,1,1,1,1,2,1,1,2,8,0.310028,0.318679,0,No
2,2,4,2,2,4,2,2,4,8,0.343127,0.355994,0,No
1,1,1,1,1,2,1,1,2,8,0.32342,0.334424,0,No
4,4,16,2,3,5,4,4,8,8,0.296269,0.305,0,No
1,1,1,1,1,2,1,1,2,8,0.309325,0.317943,0,No
7,6,42,5,4,9,7,7,14,8,0.317623,0.327023,0,No
1,1,1,1,1,2,1,1,2,8,0.264916,0.270689,0,No
1,1,1,1,1,2,1,1,2,9,0.267014,0.27338,0,No
1,1,1,1,1,2,1,1,2,8,0.299835,0.307302,0,No
1,1,1,1,1,2,1,1,2,9,0.265932,0.272147,0,No
3,3,9,3,3,6,3,3,6,7,0.336091,0.346705,0,No
7,7,49,5,3,8,7,7,14,7,0.30862,0.318271,0,No
1,1,1,1,1,2,1,1,2,8,0.339934,0.352194,0,No
3,3,9,3,3,6,3,3,6,7,0.318055,0.325521,0,No
1,1,1,1,1,2,1,1,2,8,0.339934,0.352194,0,No
2,2,4,2,2,4,2,2,4,8,0.307187,0.317326,0,No
1,1,1,1,1,2,1,1,2,8,0.339941,0.352199,0,No
1,1,1,1,1,2,1,1,2,9,0.22496,0.22831,0,No
2,2,4,1,1,2,2,2,4,7,0.296305,0.304855,0,No
1,1,1,1,1,2,1,1,2,8,0.303688,0.310784,0,No
1,1,1,1,1,2,1,1,2,8,0.296438,0.303643,0,No
1,1,1,1,1,2,1,1,2,8,0.30592,0.312609,0,No
1,1,1,1,1,2,1,1,2,8,0.289749,0.297209,0,No
2,2,4,2,2,4,2,2,4,8,0.349637,0.363925,0,No
1,1,1,1,1,2,1,1,2,8,0.323426,0.334429,0,No
2,2,4,1,2,3,2,2,4,8,0.335193,0.345963,0,No
1,1,1,1,1,2,1,1,2,8,0.2876,0.295187,0,No
2,2,4,1,1,2,2,2,4,8,0.29232,0.299303,0,No
2,2,4,1,2,3,2,2,4,8,0.291073,0.2982,0,No
3,3,9,1,3,4,3,3,6,8,0.307403,0.31728,0,No
1,1,1,1,1,2,1,1,2,8,0.255476,0.260233,0,No
8,8,64,1,5,6,8,8,16,8,0.319592,0.328153,0,No
4,4,16,2,2,4,4,4,8,8,0.299661,0.308047,0,No
1,1,1,1,1,2,1,1,2,9,0.223014,0.227649,0,No
2,2,4,2,2,4,2,2,4,8,0.303974,0.311354,0,No
2,2,4,1,2,3,2,2,4,8,0.304164,0.31079,0,No
1,1,1,1,1,2,1,1,2,8,0.29232,0.299303,0,No
1,1,1,1,1,2,1,1,2,8,0.303655,0.312962,0,No
6,6,36,1,5,6,6,6,12,8,0.322766,0.332256,0,No
1,1,1,1,1,2,1,1,2,8,0.289522,0.296926,0,No
2,2,4,2,2,4,2,2,4,8,0.332573,0.344483,0,No
1,1,1,1,1,2,1,1,2,8,0.255775,0.260982,0,No
1,1,1,1,1,2,1,1,2,8,0.323426,0.334429,0,No
2,2,4,1,2,3,2,2,4,8,0.304854,0.311383,0,No
1,1,1,1,1,2,1,1,2,8,0.292821,0.30033,0,No
1,1,1,1,1,2,1,1,2,8,0.301584,0.314486,0,No
1,1,1,1,1,2,1,1,2,8,0.339934,0.352194,0,No
1,1,1,1,1,2,1,1,2,7,0.327813,0.338503,0,No
4,4,16,3,2,5,4,4,8,8,0.285063,0.292456,0,No
1,1,1,1,1,2,1,1,2,8,0.323426,0.334429,0,No
1,1,1,1,1,2,1,1,2,8,0.297415,0.304434,0,No
1,1,1,1,1,2,1,1,2,8,0.32342,0.334424,0,No
2,2,4,2,1,3,2,2,4,8,0.284042,0.291117,0,No
1,1,1,1,1,2,1,1,2,9,0.276521,0.283438,0,No
8,8,64,2,2,4,8,8,16,8,0.323567,0.334605,0,No
2,2,4,2,1,3,2,2,4,8,0.32342,0.334424,0,No
2,2,4,1,2,3,2,2,4,8,0.298497,0.307417,0,No
2,2,4,2,2,4,2,2,4,8,0.294703,0.301786,0,No
2,2,4,2,2,4,2,2,4,8,0.338243,0.351497,0,No
4,4,16,4,3,7,4,4,8,8,0.341185,0.353548,0,No
3,3,9,3,3,6,3,3,6,7,0.329363,0.340335,0,No
2,2,4,2,2,4,2,2,4,7,0.298372,0.307366,0,No
3,3,9,3,1,4,3,3,6,7,0.327819,0.338512,0,No
1,1,1,1,1,2,1,1,2,7,0.2963,0.30485,0,No
2,2,4,2,2,4,2,2,4,8,0.304343,0.311006,0,No
1,1,1,1,1,2,1,1,2,8,0.281452,0.288543,0,No
1,1,1,1,1,2,1,1,2,9,0.280678,0.287955,0,No
2,2,4,2,2,4,2,2,4,8,0.274758,0.283899,0,No
2,2,4,2,2,4,2,2,4,7,0.339306,0.352082,0,No
1,1,1,1,1,2,1,1,2,8,0.263155,0.269091,0,No
2,2,4,1,1,2,2,2,4,9,0.238363,0.242038,0,No
2,2,4,1,2,3,2,2,4,7,0.327996,0.338691,0,No
1,1,1,1,1,2,1,1,2,8,0.2793,0.286579,0,No
3,3,9,3,3,6,3,3,6,8,0.339982,0.352292,0,No
2,2,4,1,1,2,2,2,4,8,0.339934,0.352194,0,No
1,1,1,1,1,2,1,1,2,8,0.311312,0.322315,0,No
3,3,9,2,2,4,3,3,6,8,0.301963,0.31061,0,No
1,1,1,1,1,2,1,1,2,7,0.327819,0.338512,0,No
2,2,4,2,2,4,2,2,4,8,0.301936,0.314961,0,No
1,1,1,1,1,2,1,1,2,9,0.249499,0.253819,0,No
1,1,1,1,1,2,1,1,2,8,0.32342,0.334424,0,No
1,1,1,1,1,2,1,1,2,8,0.277096,0.285605,0,No
2,2,4,2,2,4,2,2,4,8,0.32454,0.335418,0,No
3,3,9,2,3,5,3,3,6,8,0.306222,0.312783,0,No
1,1,1,1,1,2,1,1,2,8,0.274545,0.283659,0,No
1,1,1,1,1,2,1,1,2,9,0.2425,0.245948,0,No
11,11,121,5,4,9,11,11,22,7,0.353359,0.367659,0,No
3,3,9,3,2,5,3,3,6,8,0.288032,0.299918,0,No
1,1,1,1,1,2,1,1,2,8,0.299835,0.307302,0,No
4,4,16,2,1,3,4,4,8,8,0.303412,0.309915,0,No
1,1,1,1,1,2,1,1,2,8,0.303661,0.312967,0,No
1,1,1,1,1,2,1,1,2,8,0.303655,0.312962,0,No
1,1,1,1,1,2,1,1,2,7,0.327819,0.338512,0,No
2,2,4,2,2,4,2,2,4,8,0.310773,0.322553,0,No
2,2,4,2,2,4,2,2,4,8,0.312893,0.31995,0,No
2,2,4,1,2,3,2,2,4,8,0.297213,0.31,0,No
1,1,1,1,1,2,1,1,2,8,0.288163,0.299063,0,No
1,1,1,1,1,2,1,1,2,8,0.307819,0.314416,0,No
1,1,1,1,1,2,1,1,2,8,0.339934,0.352194,0,No
1,1,1,1,1,2,1,1,2,8,0.27455,0.283664,0,No
1,1,1,1,1,2,1,1,2,9,0.243701,0.248226,0,No
2,2,4,2,2,4,2,2,4,8,0.300405,0.308792,0,No
1,1,1,1,1,2,1,1,2,8,0.323426,0.334429,0,No
1,1,1,1,1,2,1,1,2,8,0.27455,0.283664,0,No
1,1,1,1,1,2,1,1,2,8,0.32342,0.334424,0,No
4,4,16,2,1,3,4,4,8,7,0.327819,0.338512,0,No
1,1,1,1,1,2,1,1,2,8,0.286287,0.293488,0,No
1,1,1,1,1,2,1,1,2,9,0.268637,0.276931,0,No
1,1,1,1,1,2,1,1,2,8,0.299367,0.306897,0,No
2,2,4,2,2,4,2,2,4,8,0.303753,0.313089,0,No
1,1,1,1,1,2,1,1,2,9,0.268641,0.276936,0,No
1,1,1,1,1,2,1,1,2,9,0.255117,0.260285,0,No
2,2,4,1,2,3,2,2,4,8,0.32089,0.331575,0,No
3,3,9,2,2,4,3,3,6,7,0.328191,0.338829,0,No
1,1,1,1,1,2,1,1,2,8,0.286995,0.295346,0,No
1,1,1,1,1,2,1,1,2,8,0.339934,0.352194,0,No
1,1,1,1,1,2,1,1,2,9,0.254417,0.260027,0,No
1,1,1,1,1,2,1,1,2,9,0.263627,0.269442,0,No
2,2,4,1,2,3,2,2,4,8,0.316368,0.324094,0,No
1,1,1,1,1,2,1,1,2,8,0.28214,0.289603,0,No
1,1,1,1,1,2,1,1,2,8,0.301584,0.314486,0,No
1,1,1,1,1,2,1,1,2,8,0.32342,0.334424,0,No
3,3,9,2,1,3,3,3,6,8,0.301584,0.314486,0,No
2,2,4,1,1,2,2,2,4,8,0.32342,0.334424,0,No
2,2,4,2,1,3,2,2,4,8,0.32342,0.334424,0,No
1,1,1,1,1,2,1,1,2,8,0.32342,0.334424,0,No
1,1,1,1,1,2,1,1,2,8,0.292345,0.299887,0,No
2,2,4,1,2,3,2,2,4,8,0.331578,0.343103,0,No
2,2,4,1,1,2,2,2,4,9,0.263403,0.271075,0,No
4,4,16,2,2,4,4,4,8,9,0.264428,0.272505,0,No
1,1,1,1,1,2,1,1,2,8,0.268219,0.275191,0,No
1,1,1,1,1,2,1,1,2,8,0.339934,0.352194,0,No
1,1,1,1,1,2,1,1,2,8,0.289145,0.296989,0,No
3,3,9,2,2,4,3,3,6,8,0.319245,0.32991,0,No
2,1,2,2,2,4,2,2,4,8,0.297379,0.305678,0,No
3,3,9,2,3,5,3,3,6,8,0.33362,0.345296,0,No
1,1,1,1,1,2,1,1,2,8,0.249506,0.254198,0,No
1,1,1,1,1,2,1,1,2,8,0.278739,0.288248,0,No
1,1,1,1,1,2,1,1,2,9,0.250941,0.255205,0,No
15,8,120,1,5,6,15,15,30,8,0.325885,0.33563,0,No
1,1,1,1,1,2,1,1,2,8,0.309325,0.317943,0,No
5,5,25,3,3,6,5,5,10,8,0.309859,0.318674,0,No
1,1,1,1,1,2,1,1,2,8,0.304996,0.311353,0,No
2,2,4,1,1,2,2,2,4,8,0.258883,0.26458,0,No
1,1,1,1,1,2,1,1,2,8,0.315765,0.323492,0,No
11,11,121,5,7,12,11,11,22,8,0.335292,0.345893,0,No
1,1,1,1,1,2,1,1,2,8,0.313502,0.320218,0,No
5,5,25,3,5,8,5,5,10,8,0.310445,0.317547,0,No
2,2,4,1,1,2,2,2,4,9,0.255733,0.261996,0,No
3,3,9,3,2,5,3,3,6,8,0.34081,0.353188,0,No
4,4,16,3,2,5,4,4,8,8,0.285258,0.292402,0,No
1,1,1,1,1,2,1,1,2,8,0.268865,0.275199,0,No
1,1,1,1,1,2,1,1,2,8,0.301584,0.314486,0,No
2,2,4,2,2,4,2,2,4,7,0.31809,0.330229,0,No
2,2,4,2,2,4,2,2,4,8,0.330961,0.343854,0,No
1,1,1,1,1,2,1,1,2,8,0.32342,0.334424,0,No
1,1,1,1,1,2,1,1,2,9,0.268717,0.277323,0,No
1,1,1,1,1,2,1,1,2,8,0.301584,0.308533,0,No
1,1,1,1,1,2,1,1,2,8,0.32342,0.334424,0,No
4,4,16,3,3,6,4,4,8,8,0.338089,0.349763,0,No
2,2,4,2,2,4,2,2,4,7,0.31809,0.330229,0,No
1,1,1,1,1,2,1,1,2,9,0.244979,0.249046,0,No
1,1,1,1,1,2,1,1,2,8,0.288168,0.299068,0,No
1,1,1,1,1,2,1,1,2,9,0.271721,0.278269,0,No
1,1,1,1,1,2,1,1,2,8,0.323426,0.334429,0,No
2,2,4,2,2,4,2,2,4,7,0.307126,0.315014,0,No
1,1,1,1,1,2,1,1,2,8,0.331578,0.343078,0,No
1,1,1,1,1,2,1,1,2,8,0.32342,0.334424,0,No
1,1,1,1,1,2,1,1,2,8,0.253755,0.258221,0,No
1,1,1,1,1,2,1,1,2,9,0.250783,0.255585,0,No
1,1,1,1,1,2,1,1,2,8,0.29338,0.300813,0,No
1,1,1,1,1,2,1,1,2,9,0.268696,0.275106,0,No
2,2,4,1,1,2,2,2,4,8,0.303693,0.310789,0,No
3,3,9,2,3,5,3,3,6,8,0.285478,0.292674,0,No
2,2,4,1,1,2,2,2,4,8,0.306651,0.31538,0,No
2,2,4,2,2,4,2,2,4,8,0.330941,0.343957,0,No
5,5,25,2,5,7,5,5,10,8,0.316826,0.32512,0,No
4,4,16,4,4,8,4,4,8,8,0.324071,0.334328,0,No
1,1,1,1,1,2,1,1,2,8,0.27585,0.282586,0,No
1,1,1,1,1,2,1,1,2,8,0.301584,0.314486,0,No
2,2,4,2,2,4,2,2,4,8,0.291446,0.298504,0,No
1,1,1,1,1,2,1,1,2,9,0.269345,0.275617,0,No
1,1,1,1,1,2,1,1,2,8,0.309325,0.317943,0,No
2,2,4,1,1,2,2,2,4,8,0.339934,0.352194,0,No
1,1,1,1,1,2,1,1,2,8,0.277831,0.285019,0,No
1,1,1,1,1,2,1,1,2,8,0.258848,0.264107,0,No
1,1,1,1,1,2,1,1,2,8,0.313848,0.32086,0,No
3,3,9,2,1,3,3,3,6,8,0.313497,0.320213,0,No
1,1,1,1,1,2,1,1,2,8,0.309977,0.317107,0,No
1,1,1,1,1,2,1,1,2,8,0.307813,0.314411,0,No
1,1,1,1,1,2,1,1,2,8,0.303375,0.311466,0,No
2,2,4,2,2,4,2,2,4,8,0.30417,0.312216,0,No
4,4,16,3,2,5,4,4,8,8,0.327455,0.338576,0,No
1,1,1,1,1,2,1,1,2,8,0.264457,0.270739,0,No
1,1,1,1,1,2,1,1,2,8,0.339934,0.352194,0,No
5,5,25,4,3,7,5,5,10,7,0.346584,0.360599,0,No
1,1,1,1,1,2,1,1,2,8,0.323426,0.334429,0,No
1,1,1,1,1,2,1,1,2,8,0.32342,0.334424,0,No
1,1,1,1,1,2,1,1,2,8,0.313848,0.32086,0,No
1,1,1,1,1,2,1,1,2,8,0.30359,0.310474,0,No
3,3,9,2,1,3,3,3,6,8,0.32342,0.334424,0,No
2,2,4,1,1,2,2,2,4,8,0.288168,0.299068,0,No
2,2,4,2,1,3,2,2,4,8,0.32342,0.334424,0,No
1,1,1,1,1,2,1,1,2,8,0.303655,0.312962,0,No
1,1,1,1,1,2,1,1,2,8,0.32342,0.334424,0,No
2,2,4,1,1,2,2,2,4,8,0.339934,0.352194,0,No
1,1,1,1,1,2,1,1,2,7,0.327819,0.338512,0,No
1,1,1,1,1,2,1,1,2,8,0.310033,0.318684,0,No
1,1,1,1,1,2,1,1,2,8,0.250823,0.255499,0,No
1,1,1,1,1,2,1,1,2,8,0.339941,0.352199,0,No
2,2,4,1,1,2,2,2,4,8,0.331571,0.343073,0,No
1,1,1,1,1,2,1,1,2,8,0.295596,0.303244,0,No
1,1,1,1,1,2,1,1,2,8,0.30338,0.311471,0,No
1,1,1,1,1,2,1,1,2,8,0.32342,0.334424,0,No
1,1,1,1,1,2,1,1,2,8,0.28699,0.295341,0,No
1,1,1,1,1,2,1,1,2,8,0.28349,0.292904,0,No
1,1,1,1,1,2,1,1,2,8,0.2469,0.251301,0,No
2,2,4,1,1,2,2,2,4,8,0.257411,0.26273,0,No
1,1,1,1,1,2,1,1,2,8,0.278743,0.288253,0,No
1,1,1,1,1,2,1,1,2,8,0.339934,0.352194,0,No
1,1,1,1,1,2,1,1,2,8,0.32342,0.334424,0,No
1,1,1,1,1,2,1,1,2,8,0.276284,0.283503,0,No
1,1,1,1,1,2,1,1,2,8,0.266897,0.272942,0,No
2,2,4,1,2,3,2,2,4,8,0.317481,0.324586,0,No
1,1,1,1,1,2,1,1,2,8,0.309331,0.317947,0,No
1,1,1,1,1,2,1,1,2,8,0.255007,0.260008,0,No
1,1,1,1,1,2,1,1,2,8,0.310033,0.318684,0,No
2,2,4,2,1,3,2,2,4,8,0.306145,0.312643,0,No
1,1,1,1,1,2,1,1,2,9,0.261426,0.266868,0,No
1,1,1,1,1,2,1,1,2,8,0.339934,0.352194,0,No
1,1,1,1,1,2,1,1,2,8,0.27847,0.285462,0,No
1,1,1,1,1,2,1,1,2,8,0.268345,0.275546,0,No
1,1,1,1,1,2,1,1,2,8,0.264457,0.270739,0,No
1,1,1,1,1,2,1,1,2,8,0.339934,0.352194,0,No
1,1,1,1,1,2,1,1,2,9,0.303801,0.312033,0,No
1,1,1,1,1,2,1,1,2,8,0.281805,0.28952,0,No
2,2,4,1,1,2,2,2,4,8,0.323414,0.334415,0,No
5,5,25,3,4,7,5,5,10,8,0.32454,0.333775,0,No
1,1,1,1,1,2,1,1,2,8,0.331571,0.343073,0,No
1,1,1,1,1,2,1,1,2,8,0.339934,0.352194,0,No
1,1,1,1,1,2,1,1,2,8,0.281414,0.288457,0,No
1,1,1,1,1,2,1,1,2,8,0.310033,0.318684,0,No
5,5,25,1,1,2,5,5,10,8,0.282243,0.289425,0,No
1,1,1,1,1,2,1,1,2,8,0.317445,0.327454,0,No
1,1,1,1,1,2,1,1,2,8,0.291361,0.298432,0,No
1,1,1,1,1,2,1,1,2,8,0.317451,0.327459,0,No
2,2,4,1,2,3,2,2,4,8,0.349637,0.363925,0,No
2,2,4,1,2,3,2,2,4,8,0.335193,0.347351,0,No
4,4,16,3,3,6,4,4,8,8,0.303019,0.312822,0,No
1,1,1,1,1,2,1,1,2,8,0.317298,0.324393,0,No
3,3,9,2,2,4,3,3,6,8,0.323439,0.334468,0,No
1,1,1,1,1,2,1,1,2,8,0.295909,0.302837,0,No
1,1,1,1,1,2,1,1,2,8,0.32342,0.334424,0,No
1,1,1,1,1,2,1,1,2,9,0.269099,0.277068,0,No
2,2,4,2,2,4,2,2,4,8,0.323445,0.334478,0,No
1,1,1,1,1,2,1,1,2,8,0.313502,0.320218,0,No
1,1,1,1,1,2,1,1,2,8,0.309325,0.317943,0,No
1,1,1,1,1,2,1,1,2,8,0.268345,0.275546,0,No
3,3,9,3,1,4,3,3,6,9,0.261158,0.266934,0,No
1,1,1,1,1,2,1,1,2,8,0.303688,0.310784,0,No
2,2,4,1,1,2,2,2,4,8,0.339941,0.352199,0,No
1,1,1,1,1,2,1,1,2,8,0.339934,0.352194,0,No
1,1,1,1,1,2,1,1,2,8,0.30338,0.311471,0,No
2,2,4,1,1,2,2,2,4,9,0.262241,0.268868,0,No
1,1,1,1,1,2,1,1,2,8,0.267403,0.273827,0,No
1,1,1,1,1,2,1,1,2,7,0.327826,0.338517,0,No
2,2,4,1,1,2,2,2,4,7,0.327819,0.338512,0,No
1,1,1,1,1,2,1,1,2,8,0.339934,0.352194,0,No
1,1,1,1,1,2,1,1,2,8,0.301584,0.314486,0,No
1,1,1,1,1,2,1,1,2,7,0.296305,0.304855,0,No
2,2,4,1,1,2,2,2,4,8,0.299835,0.307302,0,No
2,2,4,1,2,3,2,2,4,8,0.332385,0.344,0,No
1,1,1,1,1,2,1,1,2,8,0.294606,0.302082,0,No
1,1,1,1,1,2,1,1,2,7,0.296305,0.304855,0,No
2,2,4,1,1,2,2,2,4,8,0.309977,0.317107,0,No
1,1,1,1,1,2,1,1,2,8,0.310028,0.318679,0,No
3,3,9,2,2,4,3,3,6,8,0.300299,0.308645,0,No
1,1,1,1,1,2,1,1,2,8,0.289365,0.29723,0,No
3,3,9,3,1,4,3,3,6,8,0.331571,0.343073,0,No
1,1,1,1,1,2,1,1,2,9,0.241727,0.24571,0,No
1,1,1,1,1,2,1,1,2,8,0.32342,0.334424,0,No
1,1,1,1,1,2,1,1,2,8,0.301584,0.314486,0,No
2,2,4,2,2,4,2,2,4,8,0.340756,0.352989,0,No
4,4,16,2,2,4,4,4,8,8,0.314607,0.321514,0,No
1,1,1,1,1,2,1,1,2,8,0.301584,0.314486,0,No
2,1,2,2,1,3,2,2,4,8,0.32342,0.334424,0,No
5,5,25,1,1,2,5,5,10,8,0.310028,0.318679,0,No
1,1,1,1,1,2,1,1,2,8,0.301584,0.314486,0,No
1,1,1,1,1,2,1,1,2,8,0.309325,0.317943,0,No
1,1,1,1,1,2,1,1,2,9,0.261875,0.267717,0,No
1,1,1,1,1,2,1,1,2,9,0.244979,0.249046,0,No
1,1,1,1,1,2,1,1,2,8,0.256903,0.262046,0,No
4,4,16,4,3,7,4,4,8,8,0.300882,0.309244,0,No
2,2,4,2,1,3,2,2,4,8,0.331571,0.343073,0,No
3,3,9,2,1,3,3,3,6,8,0.331571,0.343073,0,No
2,2,4,2,2,4,2,2,4,8,0.293537,0.302936,0,No
1,1,1,1,1,2,1,1,2,8,0.32342,0.334424,0,No
2,2,4,1,1,2,2,2,4,8,0.317445,0.327454,0,No
1,1,1,1,1,2,1,1,2,8,0.310028,0.318679,0,No
2,2,4,2,2,4,2,2,4,8,0.34516,0.358804,0,No
2,2,4,2,2,4,2,2,4,8,0.2777,0.285787,0,No
2,2,4,2,2,4,2,2,4,7,0.332236,0.343545,0,No
2,2,4,1,1,2,2,2,4,8,0.339934,0.352194,0,No
1,1,1,1,1,2,1,1,2,9,0.267979,0.274502,0,No
1,1,1,1,1,2,1,1,2,8,0.309062,0.315813,0,No
2,2,4,2,1,3,2,2,4,8,0.32342,0.334424,0,No
1,1,1,1,1,2,1,1,2,8,0.273082,0.279921,0,No
2,2,4,2,2,4,2,2,4,7,0.32878,0.339624,0,No
1,1,1,1,1,2,1,1,2,8,0.339934,0.352194,0,No
1,1,1,1,1,2,1,1,2,8,0.317292,0.324388,0,No
1,1,1,1,1,2,1,1,2,9,0.268721,0.277328,0,No
1,1,1,1,1,2,1,1,2,8,0.278953,0.286023,0,No
1,1,1,1,1,2,1,1,2,8,0.309325,0.317943,0,No
1,1,1,1,1,2,1,1,2,8,0.275019,0.281639,0,No
1,1,1,1,1,2,1,1,2,8,0.331578,0.343078,0,No
1,1,1,1,1,2,1,1,2,8,0.288168,0.299068,0,No
3,3,9,1,2,3,3,3,6,8,0.32124,0.328604,0,No
1,1,1,1,1,2,1,1,2,9,0.261134,0.266727,0,No
16,16,256,7,1,8,16,16,32,8,0.28808,0.29514,0,No
1,1,1,1,1,2,1,1,2,8,0.313497,0.320213,0,No
1,1,1,1,1,2,1,1,2,8,0.288168,0.299068,0,No
2,2,4,2,2,4,2,2,4,8,0.315882,0.323609,0,No
5,5,25,4,3,7,5,5,10,8,0.323899,0.335108,0,No
1,1,1,1,1,2,1,1,2,8,0.32342,0.334424,0,No
1,1,1,1,1,2,1,1,2,9,0.253115,0.258182,0,No
1,1,1,1,1,2,1,1,2,9,0.252344,0.257198,0,No
1,1,1,1,1,2,1,1,2,9,0.254417,0.260027,0,No
1,1,1,1,1,2,1,1,2,8,0.27122,0.279026,0,No
6,5,30,5,3,8,6,6,12,8,0.328292,0.339828,0,No
2,2,4,2,2,4,2,2,4,8,0.343603,0.356999,0,No
1,1,1,1,1,2,1,1,2,8,0.288163,0.299063,0,No
1,1,1,1,1,2,1,1,2,8,0.317451,0.327459,0,No
1,1,1,1,1,2,1,1,2,8,0.267958,0.274163,0,No
1,1,1,1,1,2,1,1,2,8,0.331571,0.343073,0,No
1,1,1,1,1,2,1,1,2,8,0.274364,0.281254,0,No
1,1,1,1,1,2,1,1,2,9,0.246586,0.250621,0,No
1,1,1,1,1,2,1,1,2,8,0.331571,0.343073,0,No
1,1,1,1,1,2,1,1,2,8,0.301584,0.314486,0,No
1,1,1,1,1,2,1,1,2,8,0.323426,0.334429,0,No
5,5,25,2,3,5,5,5,10,8,0.361359,0.37701,0,No
1,1,1,1,1,2,1,1,2,8,0.339927,0.352185,0,No
4,4,16,2,1,3,4,4,8,8,0.32342,0.334424,0,No
1,1,1,1,1,2,1,1,2,8,0.339941,0.352199,0,No
1,1,1,1,1,2,1,1,2,8,0.30338,0.311471,0,No
2,2,4,2,1,3,2,2,4,8,0.310033,0.318684,0,No
4,3,12,4,2,6,4,4,8,8,0.294652,0.301739,0,No
1,1,1,1,1,2,1,1,2,8,0.268214,0.275186,0,No
1,1,1,1,1,2,1,1,2,8,0.268219,0.275191,0,No
1,1,1,1,1,2,1,1,2,8,0.255167,0.259813,0,No
1,1,1,1,1,2,1,1,2,8,0.27455,0.283664,0,No
1,1,1,1,1,2,1,1,2,8,0.278743,0.288253,0,No
1,1,1,1,1,2,1,1,2,8,0.253078,0.258073,0,No
2,2,4,2,2,4,2,2,4,8,0.312475,0.319684,0,No
1,1,1,1,1,2,1,1,2,9,0.268721,0.277328,0,No
1,1,1,1,1,2,1,1,2,8,0.301589,0.314491,0,No
1,1,1,1,1,2,1,1,2,7,0.327819,0.338512,0,No
1,1,1,1,1,2,1,1,2,8,0.301589,0.314491,0,No
1,1,1,1,1,2,1,1,2,8,0.308481,0.314811,0,No
1,1,1,1,1,2,1,1,2,8,0.30338,0.311471,0,No
1,1,1,1,1,2,1,1,2,8,0.305926,0.312614,0,No
1,1,1,1,1,2,1,1,2,8,0.292345,0.299887,0,No
1,1,1,1,1,2,1,1,2,8,0.339934,0.352194,0,No
4,4,16,3,3,6,4,4,8,8,0.32792,0.339211,0,No
4,4,16,4,3,7,4,4,8,8,0.328292,0.339828,0,No
1,1,1,1,1,2,1,1,2,8,0.339934,0.352194,0,No
1,1,1,1,1,2,1,1,2,8,0.323426,0.334429,0,No
1,1,1,1,1,2,1,1,2,8,0.32342,0.334424,0,No
1,1,1,1,1,2,1,1,2,8,0.27122,0.279026,0,No
2,2,4,1,1,2,2,2,4,8,0.28565,0.292652,0,No
2,2,4,2,2,4,2,2,4,8,0.29596,0.308371,0,No
3,3,9,1,2,3,3,3,6,8,0.323881,0.335064,0,No
2,2,4,1,1,2,2,2,4,8,0.32342,0.334424,0,No
2,2,4,1,1,2,2,2,4,8,0.27122,0.279026,0,No
2,2,4,1,2,3,2,2,4,8,0.316732,0.324481,0,No
1,1,1,1,1,2,1,1,2,8,0.301584,0.314486,0,No
1,1,1,1,1,2,1,1,2,9,0.261859,0.267784,0,No
2,2,4,2,2,4,2,2,4,8,0.312452,0.321491,0,No
1,1,1,1,1,2,1,1,2,8,0.265287,0.271053,0,No
5,5,25,4,4,8,5,5,10,8,0.323862,0.334093,0,No
2,2,4,1,2,3,2,2,4,7,0.352621,0.366966,0,No
3,3,9,3,2,5,3,3,6,8,0.327832,0.339198,0,No
1,1,1,1,1,2,1,1,2,8,0.317298,0.324393,0,No
6,5,30,2,3,5,6,6,12,8,0.327549,0.338717,0,No
1,1,1,1,1,2,1,1,2,8,0.288934,0.297717,0,No
1,1,1,1,1,2,1,1,2,8,0.296444,0.303647,0,No
1,1,1,1,1,2,1,1,2,8,0.287605,0.295192,0,No
1,1,1,1,1,2,1,1,2,9,0.241436,0.245718,0,No
1,1,1,1,1,2,1,1,2,8,0.27761,0.284551,0,No
3,3,9,2,3,5,3,3,6,8,0.340138,0.352497,0,No
2,2,4,2,1,3,2,2,4,9,0.249368,0.254055,0,No
2,2,4,2,2,4,2,2,4,8,0.326053,0.336736,0,No
2,2,4,1,2,3,2,2,4,8,0.276925,0.283835,0,No
1,1,1,1,1,2,1,1,2,9,0.276056,0.283078,0,No
1,1,1,1,1,2,1,1,2,8,0.270652,0.277202,0,No
1,1,1,1,1,2,1,1,2,8,0.27313,0.279839,0,No
2,2,4,2,2,4,2,2,4,8,0.300701,0.308297,0,No
1,1,1,1,1,2,1,1,2,9,0.269417,0.275849,0,No
11,10,110,1,9,10,11,11,22,8,0.352432,0.367864,0,No
1,1,1,1,1,2,1,1,2,9,0.268717,0.277323,0,No
1,1,1,1,1,2,1,1,2,8,0.301584,0.314486,0,No
1,1,1,1,1,2,1,1,2,8,0.339934,0.352194,0,No
1,1,1,1,1,2,1,1,2,8,0.296161,0.303803,0,No
1,1,1,1,1,2,1,1,2,9,0.279309,0.28665,0,No
2,2,4,2,2,4,2,2,4,7,0.305394,0.313477,0,No
1,1,1,1,1,2,1,1,2,8,0.303375,0.311466,0,No
1,1,1,1,1,2,1,1,2,8,0.308548,0.315803,0,No
1,1,1,1,1,2,1,1,2,7,0.2963,0.30485,0,No
1,1,1,1,1,2,1,1,2,8,0.271894,0.28039,0,No
1,1,1,1,1,2,1,1,2,9,0.244305,0.248584,0,No
3,3,9,3,2,5,3,3,6,8,0.324188,0.335221,0,No
3,3,9,3,1,4,3,3,6,7,0.327819,0.338512,0,No
1,1,1,1,1,2,1,1,2,8,0.296171,0.303818,0,No
2,2,4,1,2,3,2,2,4,7,0.342225,0.354873,0,No
2,2,4,2,1,3,2,2,4,8,0.303655,0.312962,0,No
2,2,4,2,2,4,2,2,4,8,0.326408,0.338223,0,No
1,1,1,1,1,2,1,1,2,10,0.189078,0.190746,0,No
1,1,1,1,1,2,1,1,2,8,0.331571,0.343073,0,No
1,1,1,1,1,2,1,1,2,8,0.30833,0.31471,0,No
2,2,4,1,1,2,2,2,4,9,0.26085,0.266454,0,No
1,1,1,1,1,2,1,1,2,8,0.339934,0.352194,0,No
4,4,16,3,3,6,4,4,8,8,0.32731,0.338976,0,No
3,3,9,2,2,4,3,3,6,8,0.317723,0.326062,0,No
3,3,9,2,2,4,3,3,6,8,0.310977,0.319597,0,No
4,4,16,1,2,3,4,4,8,8,0.31831,0.326055,0,No
1,1,1,1,1,2,1,1,2,8,0.331578,0.343078,0,No
1,1,1,1,1,2,1,1,2,9,0.255875,0.261005,0,No
1,1,1,1,1,2,1,1,2,8,0.271899,0.280395,0,No
1,1,1,1,1,2,1,1,2,8,0.271899,0.280395,0,No
2,2,4,2,2,4,2,2,4,8,0.287464,0.296449,0,No
1,1,1,1,1,2,1,1,2,8,0.26143,0.267011,0,No
1,1,1,1,1,2,1,1,2,8,0.288168,0.299068,0,No
1,1,1,1,1,2,1,1,2,8,0.339941,0.352199,0,No
1,1,1,1,1,2,1,1,2,8,0.339934,0.352194,0,No
4,4,16,3,2,5,4,4,8,7,0.319795,0.327131,0,No
2,2,4,2,1,3,2,2,4,7,0.296305,0.304855,0,No
1,1,1,1,1,2,1,1,2,9,0.248478,0.252871,0,No
1,1,1,1,1,2,1,1,2,7,0.296305,0.304855,0,No
3,3,9,3,3,6,3,3,6,8,0.34368,0.357005,0,No
1,1,1,1,1,2,1,1,2,8,0.296171,0.303818,0,No
3,3,9,3,2,5,3,3,6,9,0.281744,0.29074,0,No
1,1,1,1,1,2,1,1,2,8,0.311312,0.322315,0,No
1,1,1,1,1,2,1,1,2,8,0.30833,0.31471,0,No
3,3,9,2,2,4,3,3,6,8,0.319526,0.326756,0,No
1,1,1,1,1,2,1,1,2,9,0.258982,0.264573,0,No
2,2,4,2,2,4,2,2,4,8,0.340219,0.352534,0,No
1,1,1,1,1,2,1,1,2,8,0.28714,0.294153,0,No
2,2,4,2,1,3,2,2,4,8,0.32342,0.334424,0,No
1,1,1,1,1,2,1,1,2,8,0.28349,0.292904,0,No
1,1,1,1,1,2,1,1,2,7,0.296305,0.304855,0,No
1,1,1,1,1,2,1,1,2,8,0.339934,0.352194,0,No
2,2,4,2,2,4,2,2,4,8,0.323702,0.331692,0,No
2,2,4,1,2,3,2,2,4,8,0.343666,0.35637,0,No
2,2,4,1,2,3,2,2,4,7,0.342218,0.354868,0,No
1,1,1,1,1,2,1,1,2,8,0.303375,0.311466,0,No
1,1,1,1,1,2,1,1,2,8,0.317292,0.324388,0,No
2,2,4,1,1,2,2,2,4,8,0.310722,0.317507,0,No
1,1,1,1,1,2,1,1,2,7,0.327819,0.338512,0,No
1,1,1,1,1,2,1,1,2,8,0.288168,0.299068,0,No
1,1,1,1,1,2,1,1,2,8,0.27122,0.279026,0,No
2,2,4,1,2,3,2,2,4,8,0.297099,0.304355,0,No
1,1,1,1,1,2,1,1,2,8,0.293138,0.300755,0,No
1,1,1,1,1,2,1,1,2,9,0.268721,0.277328,0,No
1,1,1,1,1,2,1,1,2,8,0.32342,0.334424,0,No
1,1,1,1,1,2,1,1,2,8,0.30833,0.31471,0,No
3,3,9,3,3,6,3,3,6,8,0.290895,0.300509,0,No
2,2,4,2,2,4,2,2,4,7,0.331282,0.342332,0,No
1,1,1,1,1,2,1,1,2,9,0.268641,0.276936,0,No
1,1,1,1,1,2,1,1,2,7,0.296305,0.304855,0,No
3,3,9,2,1,3,3,3,6,7,0.296305,0.304855,0,No
2,2,4,2,2,4,2,2,4,8,0.305165,0.3184,0,No
1,1,1,1,1,2,1,1,2,7,0.2963,0.30485,0,No
1,1,1,1,1,2,1,1,2,8,0.278739,0.288248,0,No
1,1,1,1,1,2,1,1,2,8,0.317445,0.327454,0,No
1,1,1,1,1,2,1,1,2,8,0.315759,0.323487,0,No
5,5,25,5,4,9,5,5,10,8,0.329128,0.338792,0,No
1,1,1,1,1,2,1,1,2,8,0.32342,0.334424,0,No
2,2,4,2,2,4,2,2,4,8,0.301339,0.308173,0,No
1,1,1,1,1,2,1,1,2,9,0.284331,0.292273,0,No
1,1,1,1,1,2,1,1,2,8,0.303688,0.310784,0,No
5,5,25,2,4,6,5,5,10,7,0.333008,0.344029,0,No
8,8,64,4,4,8,8,8,16,7,0.352265,0.367298,0,No
1,1,1,1,1,2,1,1,2,8,0.339934,0.352194,0,No
1,1,1,1,1,2,1,1,2,8,0.306657,0.315385,0,No
2,1,2,2,2,4,2,2,4,8,0.34361,0.356903,0,No
3,3,9,2,2,4,3,3,6,9,0.27262,0.279415,0,No
1,1,1,1,1,2,1,1,2,8,0.287721,0.295004,0,No
6,6,36,4,4,8,6,6,12,8,0.347657,0.362026,0,No
2,2,4,1,1,2,2,2,4,8,0.339934,0.352194,0,No
3,3,9,2,1,3,3,3,6,7,0.296305,0.304855,0,No
6,6,36,3,3,6,6,6,12,8,0.324084,0.335455,0,No
1,1,1,1,1,2,1,1,2,7,0.296305,0.304855,0,No
3,3,9,1,3,4,3,3,6,8,0.309814,0.318002,0,No
1,1,1,1,1,2,1,1,2,8,0.331571,0.343073,0,No
2,2,4,1,1,2,2,2,4,8,0.297306,0.304183,0,No
1,1,1,1,1,2,1,1,2,9,0.263403,0.271075,0,No
1,1,1,1,1,2,1,1,2,9,0.242793,0.246514,0,No
2,2,4,1,1,2,2,2,4,9,0.240806,0.244754,0,No
7,7,49,4,7,11,7,7,14,7,0.358384,0.373673,0,No
2,2,4,2,2,4,2,2,4,8,0.282364,0.291918,0,No
3,3,9,2,2,4,3,3,6,8,0.352396,0.367736,0,No
1,1,1,1,1,2,1,1,2,9,0.263542,0.270046,0,No
1,1,1,1,1,2,1,1,2,8,0.29596,0.304319,0,No
1,1,1,1,1,2,1,1,2,8,0.310033,0.318684,0,No
1,1,1,1,1,2,1,1,2,8,0.32342,0.334424,0,No
1,1,1,1,1,2,1,1,2,8,0.288163,0.299063,0,No
1,1,1,1,1,2,1,1,2,8,0.339927,0.352185,0,No
2,2,4,1,1,2,2,2,4,8,0.293274,0.300358,0,No
2,2,4,2,2,4,2,2,4,8,0.29983,0.308354,0,No
2,2,4,2,2,4,2,2,4,8,0.334326,0.344905,0,No
1,1,1,1,1,2,1,1,2,8,0.301584,0.314486,0,No
1,1,1,1,1,2,1,1,2,8,0.291053,0.298049,0,No
1,1,1,1,1,2,1,1,2,9,0.261875,0.267717,0,No
4,4,16,3,3,6,4,4,8,8,0.340701,0.354487,0,No
1,1,1,1,1,2,1,1,2,8,0.339941,0.352199,0,No
1,1,1,1,1,2,1,1,2,8,0.32342,0.334424,0,No
2,2,4,1,1,2,2,2,4,8,0.315759,0.323487,0,No
1,1,1,1,1,2,1,1,2,8,0.283486,0.292899,0,No
1,1,1,1,1,2,1,1,2,8,0.331571,0.343073,0,No
1,1,1,1,1,2,1,1,2,8,0.301584,0.314486,0,No
1,1,1,1,1,2,1,1,2,8,0.309325,0.317943,0,No
3,3,9,2,2,4,3,3,6,8,0.299761,0.307664,0,No
7,7,49,2,1,3,7,7,14,7,0.327813,0.338503,0,No
1,1,1,1,1,2,1,1,2,8,0.27436,0.280884,0,No
1,1,1,1,1,2,1,1,2,8,0.331571,0.343073,0,No
2,2,4,1,1,2,2,2,4,8,0.309331,0.317947,0,No
1,1,1,1,1,2,1,1,2,8,0.307813,0.314411,0,No
4,4,16,3,3,6,4,4,8,8,0.33141,0.344465,0,No
2,2,4,2,1,3,2,2,4,8,0.32342,0.334424,0,No
4,4,16,3,2,5,4,4,8,8,0.330954,0.343844,0,No
1,1,1,1,1,2,1,1,2,8,0.277096,0.285605,0,No
1,1,1,1,1,2,1,1,2,9,0.255733,0.261996,0,No
1,1,1,1,1,2,1,1,2,8,0.288173,0.299071,0,No
1,1,1,1,1,2,1,1,2,8,0.32342,0.334424,0,No
1,1,1,1,1,2,1,1,2,8,0.258883,0.26458,0,No
1,1,1,1,1,2,1,1,2,8,0.304653,0.311376,0,No
6,6,36,4,5,9,6,6,12,8,0.332185,0.342197,0,No
1,1,1,1,1,2,1,1,2,8,0.300685,0.307394,0,No
3,3,9,3,3,6,3,3,6,8,0.331365,0.342997,0,No
1,1,1,1,1,2,1,1,2,8,0.28349,0.292904,0,No
1,1,1,1,1,2,1,1,2,8,0.288934,0.297717,0,No
1,1,1,1,1,2,1,1,2,7,0.327819,0.338512,0,No
1,1,1,1,1,2,1,1,2,8,0.278511,0.285433,0,No
2,2,4,2,2,4,2,2,4,8,0.34664,0.360933,0,No
3,3,9,2,2,4,3,3,6,8,0.340239,0.35261,0,No
1,1,1,1,1,2,1,1,2,8,0.262552,0.267892,0,No
1,1,1,1,1,2,1,1,2,8,0.32342,0.334424,0,No
2,2,4,2,2,4,2,2,4,8,0.331842,0.343404,0,No
1,1,1,1,1,2,1,1,2,9,0.262084,0.267971,0,No
2,2,4,1,1,2,2,2,4,7,0.296305,0.304855,0,No
5,5,25,4,5,9,5,5,10,8,0.344457,0.357691,0,No
1,1,1,1,1,2,1,1,2,8,0.313497,0.320213,0,No
1,1,1,1,1,2,1,1,2,9,0.268721,0.277328,0,No
3,3,9,3,1,4,3,3,6,8,0.32342,0.334424,0,No
4,4,16,2,2,4,4,4,8,8,0.302503,0.315889,0,No
2,2,4,2,2,4,2,2,4,8,0.315648,0.325643,0,No
1,1,1,1,1,2,1,1,2,8,0.294728,0.301557,0,No
1,1,1,1,1,2,1,1,2,8,0.288163,0.299063,0,No
1,1,1,1,1,2,1,1,2,8,0.27455,0.283664,0,No
1,1,1,1,1,2,1,1,2,8,0.306651,0.31538,0,No
1,1,1,1,1,2,1,1,2,8,0.278743,0.288253,0,No
1,1,1,1,1,2,1,1,2,8,0.308542,0.315798,0,No
2,2,4,1,2,3,2,2,4,8,0.317599,0.324684,0,No
1,1,1,1,1,2,1,1,2,8,0.339934,0.352194,0,No
1,1,1,1,1,2,1,1,2,8,0.271216,0.279021,0,No
5,5,25,1,3,4,5,5,10,8,0.284906,0.295268,0,No
1,1,1,1,1,2,1,1,2,8,0.308542,0.315798,0,No
2,2,4,2,2,4,2,2,4,9,0.270528,0.27717,0,No
1,1,1,1,1,2,1,1,2,8,0.286282,0.293483,0,No
7,6,42,2,5,7,7,7,14,8,0.330416,0.34167,0,No
1,1,1,1,1,2,1,1,2,8,0.282636,0.289754,0,No
1,1,1,1,1,2,1,1,2,9,0.276056,0.283078,0,No
1,1,1,1,1,2,1,1,2,8,0.303661,0.312967,0,No
3,3,9,1,3,4,3,3,6,8,0.313422,0.323051,0,No
1,1,1,1,1,2,1,1,2,9,0.268641,0.276936,0,No
1,1,1,1,1,2,1,1,2,9,0.253793,0.258648,0,No
1,1,1,1,1,2,1,1,2,8,0.27122,0.279026,0,No
1,1,1,1,1,2,1,1,2,8,0.27122,0.279026,0,No
1,1,1,1,1,2,1,1,2,8,0.32342,0.334424,0,No
1,1,1,1,1,2,1,1,2,8,0.287338,0.294477,0,No
4,4,16,3,4,7,4,4,8,8,0.319376,0.328651,0,No
3,3,9,2,3,5,3,3,6,8,0.32483,0.333112,0,No
6,6,36,1,3,4,6,6,12,8,0.34343,0.356092,0,No
1,1,1,1,1,2,1,1,2,8,0.281452,0.288543,0,No
1,1,1,1,1,2,1,1,2,8,0.331578,0.343078,0,No
1,1,1,1,1,2,1,1,2,8,0.299835,0.307302,0,No
1,1,1,1,1,2,1,1,2,8,0.277096,0.285605,0,No
2,2,4,1,1,2,2,2,4,9,0.264096,0.270221,0,No
1,1,1,1,1,2,1,1,2,8,0.339934,0.352194,0,No
1,1,1,1,1,2,1,1,2,8,0.310028,0.318679,0,No
1,1,1,1,1,2,1,1,2,8,0.339934,0.352194,0,No
2,2,4,1,1,2,2,2,4,8,0.317445,0.327454,0,No
3,3,9,1,2,3,3,3,6,8,0.320288,0.330439,0,No
1,1,1,1,1,2,1,1,2,8,0.307813,0.314411,0,No
3,3,9,1,1,2,3,3,6,9,0.246586,0.250621,0,No
1,1,1,1,1,2,1,1,2,8,0.302193,0.308972,0,No
2,2,4,1,1,2,2,2,4,9,0.253277,0.2585,0,No
1,1,1,1,1,2,1,1,2,8,0.282795,0.289819,0,No
3,3,9,3,2,5,3,3,6,8,0.312882,0.321068,0,No
9,8,72,2,5,7,9,9,18,8,0.317741,0.326291,0,No
1,1,1,1,1,2,1,1,2,8,0.301589,0.314491,0,No
2,2,4,1,2,3,2,2,4,7,0.352621,0.366966,0,No
1,1,1,1,1,2,1,1,2,8,0.331578,0.343078,0,No
5,5,25,2,4,6,5,5,10,8,0.344095,0.35673,0,No
1,1,1,1,1,2,1,1,2,8,0.270988,0.277567,0,No
1,1,1,1,1,2,1,1,2,8,0.29234,0.299883,0,No
1,1,1,1,1,2,1,1,2,8,0.32342,0.334424,0,No
2,2,4,1,1,2,2,2,4,8,0.310717,0.317502,0,No
2,2,4,2,2,4,2,2,4,7,0.301078,0.310998,0,No
1,1,1,1,1,2,1,1,2,8,0.301584,0.314486,0,No
3,3,9,2,2,4,3,3,6,7,0.330441,0.341036,0,No
1,1,1,1,1,2,1,1,2,9,0.257886,0.263107,0,No
2,2,4,1,1,2,2,2,4,8,0.331571,0.343073,0,No
1,1,1,1,1,2,1,1,2,8,0.32342,0.334424,0,No
1,1,1,1,1,2,1,1,2,8,0.271899,0.280395,0,No
2,2,4,2,1,3,2,2,4,8,0.303655,0.312962,0,No
1,1,1,1,1,2,1,1,2,9,0.262092,0.267978,0,No
6,6,36,4,3,7,6,6,12,8,0.317009,0.328149,0,No
7,7,49,5,3,8,7,7,14,8,0.338283,0.351571,0,No
2,2,4,1,1,2,2,2,4,8,0.255243,0.260573,0,No
1,1,1,1,1,2,1,1,2,8,0.310028,0.318679,0,No
1,1,1,1,1,2,1,1,2,9,0.26137,0.267227,0,No
2,2,4,1,1,2,2,2,4,9,0.269103,0.277072,0,No
1,1,1,1,1,2,1,1,2,8,0.32342,0.334424,0,No
1,1,1,1,1,2,1,1,2,8,0.32342,0.334424,0,No
1,1,1,1,1,2,1,1,2,9,0.269392,0.276048,0,No
1,1,1,1,1,2,1,1,2,8,0.309062,0.315813,0,No
1,1,1,1,1,2,1,1,2,8,0.278821,0.286094,0,No
1,1,1,1,1,2,1,1,2,8,0.297467,0.304363,0,No
1,1,1,1,1,2,1,1,2,8,0.268219,0.275191,0,No
1,1,1,1,1,2,1,1,2,8,0.27455,0.283664,0,No
1,1,1,1,1,2,1,1,2,8,0.339934,0.352194,0,No
2,2,4,2,2,4,2,2,4,8,0.340192,0.352477,0,No
1,1,1,1,1,2,1,1,2,7,0.327819,0.338512,0,No
1,1,1,1,1,2,1,1,2,8,0.301589,0.314491,0,No
3,3,9,2,2,4,3,3,6,8,0.335094,0.3468,0,No
2,2,4,1,2,3,2,2,4,8,0.292666,0.303358,0,No
1,1,1,1,1,2,1,1,2,8,0.27455,0.283664,0,No
2,1,2,2,2,4,2,2,4,8,0.340375,0.352776,0,No
5,5,25,3,4,7,5,5,10,8,0.344234,0.35689,0,No
3,3,9,3,3,6,3,3,6,8,0.332359,0.343893,0,No
1,1,1,1,1,2,1,1,2,8,0.307819,0.314416,0,No
2,2,4,2,2,4,2,2,4,8,0.340579,0.353057,0,No
1,1,1,1,1,2,1,1,2,8,0.30338,0.311471,0,No
1,1,1,1,1,2,1,1,2,8,0.287605,0.295192,0,No
3,3,9,3,3,6,3,3,6,7,0.332677,0.343073,0,No
2,2,4,1,1,2,2,2,4,8,0.287338,0.294477,0,No
4,4,16,3,3,6,4,4,8,7,0.341164,0.352806,0,No
1,1,1,1,1,2,1,1,2,8,0.270309,0.276579,0,No
1,1,1,1,1,2,1,1,2,9,0.25707,0.262914,0,No
4,4,16,3,3,6,4,4,8,8,0.333914,0.345921,0,No
1,1,1,1,1,2,1,1,2,8,0.317451,0.327459,0,No
1,1,1,1,1,2,1,1,2,8,0.293542,0.300706,0,No
2,2,4,1,1,2,2,2,4,7,0.327819,0.338512,0,No
2,2,4,1,1,2,2,2,4,8,0.32342,0.334424,0,No
1,1,1,1,1,2,1,1,2,7,0.2963,0.30485,0,No
3,3,9,2,2,4,3,3,6,7,0.326846,0.336921,0,No
2,2,4,2,2,4,2,2,4,8,0.324552,0.335301,0,No
1,1,1,1,1,2,1,1,2,7,0.327819,0.338512,0,No
4,4,16,1,3,4,4,4,8,7,0.35675,0.372289,0,No
1,1,1,1,1,2,1,1,2,8,0.271894,0.28039,0,No
1,1,1,1,1,2,1,1,2,9,0.250842,0.255927,0,No
1,1,1,1,1,2,1,1,2,8,0.301584,0.314486,0,No
1,1,1,1,1,2,1,1,2,7,0.327826,0.338517,0,No
1,1,1,1,1,2,1,1,2,8,0.331578,0.343078,0,No
2,2,4,2,2,4,2,2,4,8,0.294861,0.302128,0,No
1,1,1,1,1,2,1,1,2,8,0.306151,0.312648,0,No
1,1,1,1,1,2,1,1,2,8,0.301584,0.314486,0,No
1,1,1,1,1,2,1,1,2,9,0.269396,0.275731,0,No
1,1,1,1,1,2,1,1,2,9,0.250842,0.255927,0,No
1,1,1,1,1,2,1,1,2,8,0.301589,0.314491,0,No
5,5,25,4,5,9,5,5,10,7,0.349058,0.362618,0,No
2,2,4,2,2,4,2,2,4,8,0.299503,0.30621,0,No
2,2,4,1,1,2,2,2,4,8,0.252778,0.257347,0,No
1,1,1,1,1,2,1,1,2,8,0.30338,0.311471,0,No
1,1,1,1,1,2,1,1,2,8,0.313502,0.320218,0,No
1,1,1,1,1,2,1,1,2,8,0.314583,0.32146,0,No
1,1,1,1,1,2,1,1,2,8,0.260926,0.266318,0,No
2,2,4,1,1,2,2,2,4,8,0.30338,0.311471,0,No
2,2,4,1,2,3,2,2,4,8,0.340538,0.352749,0,No
1,1,1,1,1,2,1,1,2,8,0.277096,0.285605,0,No
1,1,1,1,1,2,1,1,2,8,0.258848,0.264107,0,No
5,5,25,2,3,5,5,5,10,8,0.340586,0.353091,0,No
1,1,1,1,1,2,1,1,2,8,0.29596,0.304319,0,No
5,4,20,3,4,7,5,5,10,8,0.339731,0.353197,0,No
2,2,4,1,1,2,2,2,4,8,0.339934,0.352194,0,No
1,1,1,1,1,2,1,1,2,8,0.289257,0.299292,0,No
3,3,9,3,3,6,3,3,6,8,0.329822,0.341602,0,No
1,1,1,1,1,2,1,1,2,8,0.32342,0.334424,0,No
1,1,1,1,1,2,1,1,2,8,0.323426,0.334429,0,No
1,1,1,1,1,2,1,1,2,8,0.277091,0.2856,0,No
1,1,1,1,1,2,1,1,2,8,0.32342,0.334424,0,No
1,1,1,1,1,2,1,1,2,8,0.288163,0.299063,0,No
1,1,1,1,1,2,1,1,2,8,0.310028,0.318679,0,No
1,1,1,1,1,2,1,1,2,9,0.268637,0.276931,0,No
2,2,4,1,2,3,2,2,4,8,0.309152,0.321662,0,No
1,1,1,1,1,2,1,1,2,9,0.255733,0.261996,0,No
1,1,1,1,1,2,1,1,2,8,0.323414,0.334415,0,No
1,1,1,1,1,2,1,1,2,7,0.296305,0.304855,0,No
1,1,1,1,1,2,1,1,2,8,0.317451,0.327459,0,No
2,2,4,2,2,4,2,2,4,8,0.340016,0.352302,0,No
2,2,4,1,1,2,2,2,4,7,0.327819,0.338512,0,No
2,2,4,1,1,2,2,2,4,7,0.327819,0.338512,0,No
4,4,16,3,3,6,4,4,8,8,0.318357,0.327279,0,No
1,1,1,1,1,2,1,1,2,9,0.259324,0.264744,0,No
1,1,1,1,1,2,1,1,2,8,0.27455,0.283664,0,No
1,1,1,1,1,2,1,1,2,8,0.317292,0.324388,0,No
2,1,2,2,2,4,2,2,4,8,0.26862,0.274975,0,No
1,1,1,1,1,2,1,1,2,8,0.305116,0.311592,0,No
1,1,1,1,1,2,1,1,2,8,0.301589,0.308538,0,No
4,4,16,2,3,5,4,4,8,8,0.331539,0.344782,0,No
4,4,16,1,4,5,4,4,8,8,0.336184,0.348303,0,No
2,2,4,1,2,3,2,2,4,8,0.337347,0.34954,0,No
1,1,1,1,1,2,1,1,2,8,0.301584,0.314486,0,No
1,1,1,1,1,2,1,1,2,8,0.296438,0.303643,0,No
1,1,1,1,1,2,1,1,2,8,0.301594,0.314494,0,No
3,3,9,2,2,4,3,3,6,8,0.338243,0.351497,0,No
1,1,1,1,1,2,1,1,2,8,0.331578,0.343078,0,No
1,1,1,1,1,2,1,1,2,8,0.32342,0.334424,0,No
5,5,25,3,3,6,5,5,10,8,0.309353,0.319634,0,No
1,1,1,1,1,2,1,1,2,8,0.323426,0.334429,0,No
2,2,4,1,1,2,2,2,4,8,0.32342,0.334424,0,No
1,1,1,1,1,2,1,1,2,8,0.32342,0.334424,0,No
1,1,1,1,1,2,1,1,2,9,0.234064,0.23952,0,No
3,3,9,3,2,5,3,3,6,7,0.331514,0.343058,0,No
1,1,1,1,1,2,1,1,2,9,0.254417,0.260027,0,No
2,2,4,2,2,4,2,2,4,8,0.323543,0.334598,0,No
1,1,1,1,1,2,1,1,2,7,0.296305,0.304855,0,No
1,1,1,1,1,2,1,1,2,8,0.314583,0.32146,0,No
2,2,4,2,2,4,2,2,4,7,0.322199,0.329935,0,No
1,1,1,1,1,2,1,1,2,8,0.288934,0.297717,0,No
2,2,4,1,2,3,2,2,4,8,0.311397,0.319909,0,No
1,1,1,1,1,2,1,1,2,8,0.331571,0.343073,0,No
1,1,1,1,1,2,1,1,2,8,0.331578,0.343078,0,No
1,1,1,1,1,2,1,1,2,8,0.310033,0.318684,0,No
1,1,1,1,1,2,1,1,2,8,0.331571,0.343073,0,No
4,4,16,4,2,6,4,4,8,8,0.342617,0.356522,0,No
1,1,1,1,1,2,1,1,2,8,0.299372,0.306902,0,No
1,1,1,1,1,2,1,1,2,8,0.331571,0.343073,0,No
4,4,16,2,1,3,4,4,8,8,0.331578,0.343078,0,No
1,1,1,1,1,2,1,1,2,8,0.331578,0.343078,0,No
1,1,1,1,1,2,1,1,2,8,0.317298,0.324393,0,No
1,1,1,1,1,2,1,1,2,8,0.331571,0.343073,0,No
1,1,1,1,1,2,1,1,2,8,0.27455,0.283664,0,No
1,1,1,1,1,2,1,1,2,8,0.281712,0.288655,0,No
1,1,1,1,1,2,1,1,2,8,0.32342,0.334424,0,No
1,1,1,1,1,2,1,1,2,8,0.255955,0.260644,0,No
1,1,1,1,1,2,1,1,2,8,0.331578,0.343078,0,No
1,1,1,1,1,2,1,1,2,7,0.327826,0.338517,0,No
5,5,25,1,4,5,5,5,10,8,0.343278,0.35611,0,No
1,1,1,1,1,2,1,1,2,9,0.268717,0.277323,0,No
1,1,1,1,1,2,1,1,2,8,0.296171,0.303818,0,No
1,1,1,1,1,2,1,1,2,8,0.288163,0.299063,0,No
1,1,1,1,1,2,1,1,2,8,0.274541,0.28365,0,No
4,4,16,2,2,4,4,4,8,9,0.3043,0.312553,0,No
2,2,4,1,2,3,2,2,4,8,0.314914,0.321909,0,No
2,2,4,2,2,4,2,2,4,8,0.325829,0.336375,0,No
1,1,1,1,1,2,1,1,2,9,0.254664,0.259591,0,No
1,1,1,1,1,2,1,1,2,9,0.250842,0.255927,0,No
2,2,4,1,2,3,2,2,4,8,0.326165,0.337197,0,No
1,1,1,1,1,2,1,1,2,9,0.268717,0.277323,0,No
1,1,1,1,1,2,1,1,2,8,0.268345,0.275546,0,No
2,2,4,2,2,4,2,2,4,8,0.307946,0.32196,0,No
1,1,1,1,1,2,1,1,2,8,0.302842,0.310166,0,No
1,1,1,1,1,2,1,1,2,9,0.250842,0.255927,0,No
1,1,1,1,1,2,1,1,2,9,0.238657,0.242289,0,No
1,1,1,1,1,2,1,1,2,8,0.331571,0.343073,0,No
3,3,9,3,3,6,3,3,6,8,0.330294,0.342093,0,No
1,1,1,1,1,2,1,1,2,8,0.313502,0.320218,0,No
1,1,1,1,1,2,1,1,2,8,0.268219,0.275191,0,No
2,2,4,2,2,4,2,2,4,7,0.342211,0.354859,0,No
1,1,1,1,1,2,1,1,2,9,0.242793,0.246514,0,No
1,1,1,1,1,2,1,1,2,8,0.283368,0.29034,0,No
2,2,4,1,2,3,2,2,4,7,0.305422,0.31691,0,No
1,1,1,1,1,2,1,1,2,9,0.250418,0.255203,0,No
1,1,1,1,1,2,1,1,2,7,0.297732,0.304629,0,No
1,1,1,1,1,2,1,1,2,8,0.28349,0.292904,0,No
1,1,1,1,1,2,1,1,2,8,0.32342,0.334424,0,No
1,1,1,1,1,2,1,1,2,8,0.28349,0.292904,0,No
1,1,1,1,1,2,1,1,2,8,0.339934,0.352194,0,No
1,1,1,1,1,2,1,1,2,8,0.339934,0.352194,0,No
1,1,1,1,1,2,1,1,2,8,0.288934,0.297717,0,No
1,1,1,1,1,2,1,1,2,8,0.288934,0.297717,0,No
1,1,1,1,1,2,1,1,2,8,0.331571,0.343073,0,No
5,4,20,2,3,5,5,5,10,8,0.304773,0.317866,0,No
2,2,4,2,1,3,2,2,4,9,0.268717,0.277323,0,No
1,1,1,1,1,2,1,1,2,9,0.236487,0.240265,0,No
1,1,1,1,1,2,1,1,2,8,0.339934,0.352194,0,No
2,2,4,2,1,3,2,2,4,7,0.327826,0.338517,0,No
2,2,4,1,1,2,2,2,4,8,0.291655,0.298837,0,No
1,1,1,1,1,2,1,1,2,8,0.293138,0.300755,0,No
1,1,1,1,1,2,1,1,2,7,0.296305,0.304855,0,No
2,2,4,2,1,3,2,2,4,8,0.282795,0.289819,0,No
2,2,4,2,2,4,2,2,4,8,0.341219,0.353853,0,No
3,3,9,2,2,4,3,3,6,8,0.31741,0.325613,0,No
3,3,9,2,2,4,3,3,6,8,0.289901,0.297607,0,No
2,2,4,2,2,4,2,2,4,8,0.320444,0.328897,0,No
1,1,1,1,1,2,1,1,2,8,0.27455,0.283664,0,No
1,1,1,1,1,2,1,1,2,8,0.339934,0.352194,0,No
1,1,1,1,1,2,1,1,2,8,0.311312,0.322315,0,No
1,1,1,1,1,2,1,1,2,7,0.327819,0.338512,0,No
1,1,1,1,1,2,1,1,2,8,0.339941,0.352199,0,No
1,1,1,1,1,2,1,1,2,8,0.301578,0.314477,0,No
1,1,1,1,1,2,1,1,2,8,0.339934,0.352194,0,No
1,1,1,1,1,2,1,1,2,9,0.268721,0.277328,0,No
1,1,1,1,1,2,1,1,2,8,0.331571,0.343073,0,No
1,1,1,1,1,2,1,1,2,8,0.303661,0.312967,0,No
2,2,4,2,2,4,2,2,4,8,0.287067,0.294152,0,No
2,2,4,1,1,2,2,2,4,8,0.339941,0.352199,0,No
1,1,1,1,1,2,1,1,2,8,0.278366,0.285639,0,No
2,2,4,1,2,3,2,2,4,7,0.317569,0.324788,0,No
1,1,1,1,1,2,1,1,2,8,0.313497,0.320213,0,No
4,4,16,4,3,7,4,4,8,8,0.319885,0.328778,0,No
3,3,9,3,3,6,3,3,6,7,0.333457,0.344381,0,No
2,2,4,1,1,2,2,2,4,8,0.269643,0.276191,0,No
5,5,25,3,4,7,5,5,10,7,0.319346,0.32668,0,No
4,4,16,4,4,8,4,4,8,7,0.328191,0.339608,0,No
5,5,25,4,2,6,5,5,10,8,0.312503,0.321429,0,No
6,6,36,4,5,9,6,6,12,8,0.332839,0.344545,0,No
1,1,1,1,1,2,1,1,2,8,0.301584,0.314486,0,No
1,1,1,1,1,2,1,1,2,8,0.317445,0.327454,0,No
1,1,1,1,1,2,1,1,2,8,0.323426,0.334429,0,No
1,1,1,1,1,2,1,1,2,8,0.32342,0.334424,0,No
3,3,9,2,2,4,3,3,6,8,0.326896,0.337518,0,No
2,2,4,1,1,2,2,2,4,7,0.296305,0.304855,0,No
1,1,1,1,1,2,1,1,2,9,0.270644,0.277247,0,No
1,1,1,1,1,2,1,1,2,8,0.32342,0.334424,0,No
3,2,6,1,1,2,3,3,6,8,0.339934,0.352194,0,No
3,3,9,2,2,4,3,3,6,8,0.330961,0.343854,0,No
1,1,1,1,1,2,1,1,2,8,0.301584,0.314486,0,No
1,1,1,1,1,2,1,1,2,9,0.257831,0.263353,0,No
1,1,1,1,1,2,1,1,2,8,0.339934,0.352194,0,No
1,1,1,1,1,2,1,1,2,8,0.315759,0.323487,0,No
1,1,1,1,1,2,1,1,2,8,0.314583,0.32146,0,No
1,1,1,1,1,2,1,1,2,8,0.310028,0.318679,0,No
1,1,1,1,1,2,1,1,2,8,0.293184,0.300185,0,No
10,7,70,2,2,4,10,10,20,8,0.288037,0.299923,0,No
1,1,1,1,1,2,1,1,2,7,0.327819,0.338512,0,No
1,1,1,1,1,2,1,1,2,7,0.327826,0.338517,0,No
1,1,1,1,1,2,1,1,2,9,0.268641,0.276936,0,No
1,1,1,1,1,2,1,1,2,8,0.288168,0.299068,0,No
7,6,42,3,3,6,7,7,14,8,0.309409,0.318689,0,No
1,1,1,1,1,2,1,1,2,9,0.268721,0.277328,0,No
4,4,16,3,3,6,4,4,8,8,0.331571,0.34447,0,No
2,2,4,2,2,4,2,2,4,7,0.330441,0.341036,0,No
2,2,4,2,2,4,2,2,4,8,0.305761,0.31425,0,No
9,9,81,4,6,10,9,9,18,8,0.335351,0.347805,0,No
1,1,1,1,1,2,1,1,2,8,0.339934,0.352194,0,No
1,1,1,1,1,2,1,1,2,8,0.271899,0.280395,0,No
1,1,1,1,1,2,1,1,2,8,0.288168,0.299068,0,No
2,2,4,2,2,4,2,2,4,8,0.341171,0.353509,0,No
2,2,4,1,2,3,2,2,4,8,0.319042,0.327453,0,No
2,2,4,2,2,4,2,2,4,8,0.308732,0.315131,0,No
1,1,1,1,1,2,1,1,2,8,0.310033,0.318684,0,No
1,1,1,1,1,2,1,1,2,8,0.28349,0.292904,0,No
1,1,1,1,1,2,1,1,2,8,0.309331,0.317947,0,No
1,1,1,1,1,2,1,1,2,9,0.253793,0.258648,0,No
1,1,1,1,1,2,1,1,2,9,0.268641,0.276936,0,No
1,1,1,1,1,2,1,1,2,8,0.339934,0.352194,0,No
1,1,1,1,1,2,1,1,2,8,0.317445,0.327454,0,No
1,1,1,1,1,2,1,1,2,8,0.310028,0.318679,0,No
3,3,9,3,1,4,3,3,6,8,0.32342,0.334424,0,No
1,1,1,1,1,2,1,1,2,8,0.281833,0.289891,0,No
2,2,4,1,2,3,2,2,4,8,0.34011,0.352439,0,No
2,2,4,2,2,4,2,2,4,7,0.326777,0.338298,0,No
1,1,1,1,1,2,1,1,2,8,0.339941,0.352199,0,No
1,1,1,1,1,2,1,1,2,8,0.32342,0.334424,0,No
1,1,1,1,1,2,1,1,2,8,0.32342,0.334424,0,No
1,1,1,1,1,2,1,1,2,8,0.339934,0.352194,0,No
1,1,1,1,1,2,1,1,2,8,0.32342,0.334424,0,No
1,1,1,1,1,2,1,1,2,9,0.268721,0.277328,0,No
1,1,1,1,1,2,1,1,2,8,0.323426,0.334429,0,No
1,1,1,1,1,2,1,1,2,8,0.301589,0.314491,0,No
1,1,1,1,1,2,1,1,2,8,0.339941,0.352199,0,No
4,4,16,3,4,7,4,4,8,8,0.314114,0.32893,0,No
3,3,9,3,2,5,3,3,6,8,0.316099,0.32721,0,No
1,1,1,1,1,2,1,1,2,7,0.327819,0.338512,0,No
1,1,1,1,1,2,1,1,2,8,0.297467,0.304363,0,No
1,1,1,1,1,2,1,1,2,8,0.301584,0.314486,0,No
1,1,1,1,1,2,1,1,2,8,0.30338,0.311471,0,No
1,1,1,1,1,2,1,1,2,8,0.301589,0.314491,0,No
1,1,1,1,1,2,1,1,2,8,0.339934,0.352194,0,No
1,1,1,1,1,2,1,1,2,8,0.32342,0.334424,0,No
2,2,4,1,1,2,2,2,4,9,0.236789,0.239935,0,No
1,1,1,1,1,2,1,1,2,8,0.30833,0.31471,0,No
1,1,1,1,1,2,1,1,2,8,0.308325,0.314705,0,No
3,3,9,2,1,3,3,3,6,8,0.309331,0.317947,0,No
1,1,1,1,1,2,1,1,2,8,0.309325,0.317943,0,No
1,1,1,1,1,2,1,1,2,8,0.256903,0.262046,0,No
2,2,4,1,1,2,2,2,4,8,0.309325,0.317943,0,No
4,4,16,2,1,3,4,4,8,8,0.278739,0.288248,0,No
4,4,16,3,3,6,4,4,8,8,0.315397,0.32484,0,No
3,3,9,2,2,4,3,3,6,8,0.296438,0.305949,0,No
3,3,9,2,3,5,3,3,6,7,0.328406,0.339228,0,No
1,1,1,1,1,2,1,1,2,8,0.32342,0.334424,0,No
2,2,4,1,1,2,2,2,4,8,0.289522,0.296926,0,No
1,1,1,1,1,2,1,1,2,7,0.327819,0.338512,0,No
2,2,4,1,2,3,2,2,4,8,0.308609,0.315896,0,No
1,1,1,1,1,2,1,1,2,8,0.331571,0.343073,0,No
1,1,1,1,1,2,1,1,2,9,0.249102,0.253899,0,No
3,3,9,2,1,3,3,3,6,8,0.32342,0.334424,0,No
1,1,1,1,1,2,1,1,2,8,0.311306,0.32231,0,No
2,2,4,2,2,4,2,2,4,8,0.296794,0.304267,0,No
1,1,1,1,1,2,1,1,2,8,0.32342,0.334424,0,No
2,2,4,1,1,2,2,2,4,8,0.296991,0.30415,0,No
1,1,1,1,1,2,1,1,2,8,0.274545,0.283659,0,No
1,1,1,1,1,2,1,1,2,8,0.309325,0.317943,0,No
4,4,16,1,3,4,4,4,8,8,0.341725,0.354547,0,No
1,1,1,1,1,2,1,1,2,8,0.288173,0.295474,0,No
1,1,1,1,1,2,1,1,2,9,0.253115,0.258182,0,No
1,1,1,1,1,2,1,1,2,8,0.301584,0.314486,0,No
1,1,1,1,1,2,1,1,2,9,0.253115,0.258182,0,No
6,6,36,4,4,8,6,6,12,8,0.322193,0.333513,0,No
1,1,1,1,1,2,1,1,2,8,0.288163,0.299063,0,No
1,1,1,1,1,2,1,1,2,9,0.263277,0.269553,0,No
1,1,1,1,1,2,1,1,2,7,0.296305,0.304855,0,No
1,1,1,1,1,2,1,1,2,8,0.317292,0.324388,0,No
1,1,1,1,1,2,1,1,2,8,0.314583,0.32146,0,No
1,1,1,1,1,2,1,1,2,8,0.281861,0.289104,0,No
1,1,1,1,1,2,1,1,2,8,0.273393,0.280213,0,No
1,1,1,1,1,2,1,1,2,8,0.339934,0.352194,0,No
1,1,1,1,1,2,1,1,2,8,0.292671,0.299793,0,No
1,1,1,1,1,2,1,1,2,8,0.309466,0.316145,0,No
1,1,1,1,1,2,1,1,2,8,0.303353,0.310116,0,No
1,1,1,1,1,2,1,1,2,8,0.310717,0.317502,0,No
2,1,2,1,2,3,2,2,4,8,0.340457,0.352808,0,No
1,1,1,1,1,2,1,1,2,9,0.271276,0.277863,0,No
1,1,1,1,1,2,1,1,2,8,0.317901,0.325044,0,No
1,1,1,1,1,2,1,1,2,8,0.271894,0.28039,0,No
1,1,1,1,1,2,1,1,2,8,0.29195,0.299049,0,No
3,3,9,2,3,5,3,3,6,8,0.321501,0.32905,0,No
5,5,25,3,5,8,5,5,10,7,0.332482,0.343233,0,No
11,11,121,2,3,5,11,11,22,8,0.277357,0.287401,0,No
1,1,1,1,1,2,1,1,2,9,0.268641,0.276936,0,No
2,2,4,1,2,3,2,2,4,8,0.309836,0.318571,0,No
4,4,16,3,2,5,4,4,8,7,0.326777,0.338298,0,No
2,2,4,1,2,3,2,2,4,8,0.331681,0.343191,0,No
2,2,4,2,2,4,2,2,4,8,0.304773,0.31341,0,No
1,1,1,1,1,2,1,1,2,8,0.317292,0.324388,0,No
1,1,1,1,1,2,1,1,2,8,0.32342,0.334424,0,No
1,1,1,1,1,2,1,1,2,9,0.268641,0.276936,0,No
52,52,2704,2,9,11,52,52,104,8,0.355242,0.370457,0,No
2,2,4,2,2,4,2,2,4,8,0.309516,0.316101,0,No
3,3,9,3,3,6,3,3,6,8,0.331526,0.342969,0,No
1,1,1,1,1,2,1,1,2,8,0.295402,0.302692,0,No
1,1,1,1,1,2,1,1,2,8,0.288934,0.297717,0,No
14,14,196,6,6,12,14,14,28,8,0.330409,0.341612,0,No
3,3,9,3,3,6,3,3,6,8,0.30492,0.313582,0,No
1,1,1,1,1,2,1,1,2,8,0.288168,0.299068,0,No
1,1,1,1,1,2,1,1,2,8,0.288934,0.297717,0,No
1,1,1,1,1,2,1,1,2,8,0.268476,0.274902,0,No
1,1,1,1,1,2,1,1,2,8,0.301589,0.308538,0,No
1,1,1,1,1,2,1,1,2,8,0.253081,0.258078,0,No
1,1,1,1,1,2,1,1,2,8,0.286995,0.295346,0,No
1,1,1,1,1,2,1,1,2,8,0.304126,0.310933,0,No
1,1,1,1,1,2,1,1,2,8,0.289262,0.299295,0,No
2,2,4,2,2,4,2,2,4,8,0.301392,0.310531,0,No
1,1,1,1,1,2,1,1,2,8,0.32342,0.334424,0,No
1,1,1,1,1,2,1,1,2,8,0.288163,0.299063,0,No
2,2,4,1,1,2,2,2,4,8,0.301589,0.314491,0,No
1,1,1,1,1,2,1,1,2,9,0.303801,0.312033,0,No
1,1,1,1,1,2,1,1,2,8,0.32342,0.334424,0,No
2,2,4,1,1,2,2,2,4,8,0.296433,0.30351,0,No
5,5,25,3,2,5,5,5,10,8,0.330961,0.343854,0,No
4,4,16,3,4,7,4,4,8,7,0.346619,0.359428,0,No
3,3,9,3,3,6,3,3,6,8,0.330781,0.341663,0,No
1,1,1,1,1,2,1,1,2,8,0.339934,0.352194,0,No
1,1,1,1,1,2,1,1,2,7,0.296305,0.304855,0,No
1,1,1,1,1,2,1,1,2,8,0.288168,0.299068,0,No
1,1,1,1,1,2,1,1,2,8,0.291925,0.298976,0,No
1,1,1,1,1,2,1,1,2,9,0.268721,0.277328,0,No
1,1,1,1,1,2,1,1,2,9,0.2687,0.274793,0,No
3,3,9,2,3,5,3,3,6,8,0.307519,0.317273,0,No
1,1,1,1,1,2,1,1,2,8,0.288168,0.299068,0,No
1,1,1,1,1,2,1,1,2,8,0.283368,0.29034,0,No
1,1,1,1,1,2,1,1,2,9,0.268641,0.276936,0,No
1,1,1,1,1,2,1,1,2,9,0.268721,0.277328,0,No
2,2,4,2,2,4,2,2,4,8,0.311221,0.319783,0,No
1,1,1,1,1,2,1,1,2,8,0.258883,0.26458,0,No
1,1,1,1,1,2,1,1,2,8,0.289941,0.297462,0,No
2,2,4,1,1,2,2,2,4,8,0.296171,0.303818,0,No
1,1,1,1,1,2,1,1,2,8,0.271216,0.279021,0,No
3,3,9,3,3,6,3,3,6,8,0.340314,0.352707,0,No
1,1,1,1,1,2,1,1,2,8,0.27122,0.279026,0,No
2,2,4,2,2,4,2,2,4,8,0.352003,0.366286,0,No
1,1,1,1,1,2,1,1,2,9,0.252344,0.257198,0,No
2,2,4,2,2,4,2,2,4,8,0.323249,0.331081,0,No
1,1,1,1,1,2,1,1,2,8,0.279104,0.28624,0,No
1,1,1,1,1,2,1,1,2,8,0.309331,0.317947,0,No
1,1,1,1,1,2,1,1,2,7,0.2963,0.30485,0,No
1,1,1,1,1,2,1,1,2,8,0.309325,0.317943,0,No
1,1,1,1,1,2,1,1,2,8,0.301589,0.314491,0,No
1,1,1,1,1,2,1,1,2,8,0.271899,0.280395,0,No
1,1,1,1,1,2,1,1,2,9,0.272602,0.279338,0,No
1,1,1,1,1,2,1,1,2,8,0.276284,0.283503,0,No
1,1,1,1,1,2,1,1,2,9,0.239494,0.243144,0,No
1,1,1,1,1,2,1,1,2,8,0.323426,0.334429,0,No
1,1,1,1,1,2,1,1,2,8,0.268219,0.275191,0,No
2,2,4,1,2,3,2,2,4,8,0.34493,0.357689,0,No
1,1,1,1,1,2,1,1,2,9,0.26388,0.270162,0,No
1,1,1,1,1,2,1,1,2,9,0.255737,0.261999,0,No
1,1,1,1,1,2,1,1,2,7,0.327819,0.338512,0,No
1,1,1,1,1,2,1,1,2,8,0.27455,0.283664,0,No
2,2,4,2,2,4,2,2,4,8,0.312138,0.321318,0,No
1,1,1,1,1,2,1,1,2,8,0.288168,0.299068,0,No
1,1,1,1,1,2,1,1,2,8,0.292345,0.299887,0,No
1,1,1,1,1,2,1,1,2,8,0.317292,0.324388,0,No
2,2,4,1,2,3,2,2,4,7,0.339306,0.352082,0,No
1,1,1,1,1,2,1,1,2,7,0.327819,0.338512,0,No
2,2,4,1,1,2,2,2,4,8,0.331571,0.343073,0,No
2,2,4,1,1,2,2,2,4,8,0.323426,0.334429,0,No
1,1,1,1,1,2,1,1,2,8,0.313497,0.320213,0,No
2,2,4,2,2,4,2,2,4,8,0.343666,0.35637,0,No
10,10,100,2,6,8,10,10,20,8,0.351141,0.366193,0,No
1,1,1,1,1,2,1,1,2,8,0.323426,0.334429,0,No
1,1,1,1,1,2,1,1,2,8,0.275019,0.281639,0,No
2,2,4,2,2,4,2,2,4,8,0.318381,0.326395,0,No
1,1,1,1,1,2,1,1,2,9,0.25609,0.261133,0,No
1,1,1,1,1,2,1,1,2,8,0.274329,0.282188,0,No
1,1,1,1,1,2,1,1,2,8,0.323426,0.334429,0,No
3,3,9,2,1,3,3,3,6,8,0.301584,0.314486,0,No
1,1,1,1,1,2,1,1,2,8,0.32342,0.334424,0,No
2,2,4,1,1,2,2,2,4,8,0.301584,0.314486,0,No
1,1,1,1,1,2,1,1,2,9,0.268721,0.277328,0,No
2,2,4,2,2,4,2,2,4,8,0.305761,0.31425,0,No
1,1,1,1,1,2,1,1,2,9,0.250842,0.255927,0,No
1,1,1,1,1,2,1,1,2,8,0.268219,0.275191,0,No
1,1,1,1,1,2,1,1,2,8,0.292666,0.299788,0,No
1,1,1,1,1,2,1,1,2,9,0.268721,0.277328,0,No
6,6,36,4,4,8,6,6,12,7,0.32721,0.339437,0,No
1,1,1,1,1,2,1,1,2,8,0.301584,0.314486,0,No
1,1,1,1,1,2,1,1,2,7,0.2963,0.30485,0,No
3,3,9,3,3,6,3,3,6,8,0.331565,0.34446,0,No
1,1,1,1,1,2,1,1,2,8,0.309977,0.317107,0,No
1,1,1,1,1,2,1,1,2,8,0.289257,0.299292,0,No
1,1,1,1,1,2,1,1,2,8,0.296444,0.303607,0,No
1,1,1,1,1,2,1,1,2,8,0.274554,0.283667,0,No
1,1,1,1,1,2,1,1,2,8,0.27455,0.283664,0,No
2,2,4,1,1,2,2,2,4,7,0.327826,0.338517,0,No
3,3,9,1,1,2,3,3,6,8,0.301584,0.314486,0,No
4,4,16,3,2,5,4,4,8,8,0.29596,0.308371,0,No
1,1,1,1,1,2,1,1,2,9,0.268726,0.277331,0,No
1,1,1,1,1,2,1,1,2,9,0.268721,0.277328,0,No
1,1,1,1,1,2,1,1,2,8,0.339934,0.352194,0,No
1,1,1,1,1,2,1,1,2,8,0.279104,0.286806,0,No
1,1,1,1,1,2,1,1,2,8,0.287726,0.294881,0,No
1,1,1,1,1,2,1,1,2,9,0.244982,0.249049,0,No
1,1,1,1,1,2,1,1,2,8,0.251034,0.255346,0,No
2,2,4,2,2,4,2,2,4,8,0.292155,0.301534,0,No
1,1,1,1,1,2,1,1,2,8,0.323414,0.334415,0,No
1,1,1,1,1,2,1,1,2,8,0.331571,0.343073,0,No
1,1,1,1,1,2,1,1,2,8,0.288163,0.299063,0,No
3,3,9,3,2,5,3,3,6,7,0.30303,0.312761,0,No
3,3,9,2,3,5,3,3,6,7,0.310824,0.32323,0,No
1,1,1,1,1,2,1,1,2,8,0.301584,0.314486,0,No
4,4,16,2,4,6,4,4,8,7,0.301824,0.310312,0,No
1,1,1,1,1,2,1,1,2,9,0.268721,0.277328,0,No
1,1,1,1,1,2,1,1,2,8,0.331571,0.343073,0,No
1,1,1,1,1,2,1,1,2,8,0.271894,0.28039,0,No
1,1,1,1,1,2,1,1,2,8,0.331578,0.343078,0,No
1,1,1,1,1,2,1,1,2,8,0.339934,0.352194,0,No
1,1,1,1,1,2,1,1,2,9,0.254421,0.26003,0,No
3,3,9,2,2,4,3,3,6,8,0.323881,0.335064,0,No
3,2,6,3,2,5,3,3,6,8,0.325319,0.3366,0,No
2,1,2,1,2,3,2,2,4,8,0.318958,0.326129,0,No
1,1,1,1,1,2,1,1,2,8,0.32342,0.334424,0,No
1,1,1,1,1,2,1,1,2,8,0.32342,0.334424,0,No
1,1,1,1,1,2,1,1,2,8,0.323426,0.334429,0,No
3,3,9,2,1,3,3,3,6,9,0.268641,0.276936,0,No
1,1,1,1,1,2,1,1,2,8,0.32342,0.334424,0,No
1,1,1,1,1,2,1,1,2,8,0.281707,0.28865,0,No
1,1,1,1,1,2,1,1,2,9,0.240043,0.243522,0,No
1,1,1,1,1,2,1,1,2,8,0.32342,0.334424,0,No
1,1,1,1,1,2,1,1,2,9,0.265916,0.272113,0,No
1,1,1,1,1,2,1,1,2,8,0.278743,0.288253,0,No
1,1,1,1,1,2,1,1,2,9,0.268717,0.277323,0,No
1,1,1,1,1,2,1,1,2,8,0.29234,0.299883,0,No
1,1,1,1,1,2,1,1,2,9,0.255733,0.261996,0,No
2,2,4,2,1,3,2,2,4,8,0.27455,0.283664,0,No
1,1,1,1,1,2,1,1,2,8,0.339934,0.352194,0,No
1,1,1,1,1,2,1,1,2,8,0.317292,0.324388,0,No
1,1,1,1,1,2,1,1,2,8,0.301584,0.314486,0,No
1,1,1,1,1,2,1,1,2,8,0.301584,0.314486,0,No
2,2,4,2,1,3,2,2,4,8,0.301589,0.314491,0,No
1,1,1,1,1,2,1,1,2,8,0.301584,0.314486,0,No
1,1,1,1,1,2,1,1,2,8,0.323426,0.334429,0,No
1,1,1,1,1,2,1,1,2,8,0.339934,0.352194,0,No
3,3,9,2,1,3,3,3,6,8,0.278962,0.28591,0,No
1,1,1,1,1,2,1,1,2,8,0.277096,0.285605,0,No
6,3,18,2,3,5,6,6,12,7,0.332826,0.343987,0,No
1,1,1,1,1,2,1,1,2,7,0.296305,0.304855,0,No
1,1,1,1,1,2,1,1,2,8,0.303375,0.311466,0,No
3,3,9,3,3,6,3,3,6,8,0.345881,0.358951,0,No
1,1,1,1,1,2,1,1,2,9,0.280683,0.28796,0,No
1,1,1,1,1,2,1,1,2,9,0.265704,0.272578,0,No
1,1,1,1,1,2,1,1,2,8,0.274329,0.282188,0,No
1,1,1,1,1,2,1,1,2,8,0.273858,0.280724,0,No
1,1,1,1,1,2,1,1,2,8,0.290622,0.298005,0,No
6,6,36,2,2,4,6,6,12,8,0.296732,0.304042,0,No
2,2,4,2,2,4,2,2,4,8,0.320787,0.328165,0,No
1,1,1,1,1,2,1,1,2,7,0.296305,0.304855,0,No
1,1,1,1,1,2,1,1,2,8,0.309331,0.317947,0,No
1,1,1,1,1,2,1,1,2,8,0.2828,0.289824,0,No
6,6,36,5,2,7,6,6,12,7,0.308375,0.316065,0,No
1,1,1,1,1,2,1,1,2,7,0.296305,0.304855,0,No
4,4,16,1,1,2,4,4,8,7,0.296305,0.304855,0,No
1,1,1,1,1,2,1,1,2,8,0.32342,0.334424,0,No
1,1,1,1,1,2,1,1,2,8,0.339934,0.352194,0,No
2,2,4,1,1,2,2,2,4,8,0.32342,0.334424,0,No
1,1,1,1,1,2,1,1,2,8,0.271899,0.280395,0,No
1,1,1,1,1,2,1,1,2,9,0.268721,0.277328,0,No
1,1,1,1,1,2,1,1,2,8,0.310028,0.318679,0,No
3,3,9,1,1,2,3,3,6,8,0.32342,0.334424,0,No
1,1,1,1,1,2,1,1,2,8,0.32342,0.334424,0,No
2,2,4,2,2,4,2,2,4,8,0.321023,0.330223,0,No
1,1,1,1,1,2,1,1,2,8,0.259533,0.264985,0,No
1,1,1,1,1,2,1,1,2,8,0.313848,0.32086,0,No
2,2,4,2,2,4,2,2,4,8,0.324422,0.335307,0,No
1,1,1,1,1,2,1,1,2,8,0.264461,0.270742,0,No
1,1,1,1,1,2,1,1,2,8,0.290014,0.297126,0,No
10,10,100,3,5,8,10,10,20,7,0.315211,0.323486,0,No
1,1,1,1,1,2,1,1,2,8,0.323426,0.334429,0,No
3,3,9,3,2,5,3,3,6,8,0.309331,0.317103,0,No
2,2,4,1,2,3,2,2,4,8,0.307314,0.314923,0,No
3,3,9,3,3,6,3,3,6,7,0.315929,0.325072,0,No
2,2,4,1,1,2,2,2,4,8,0.310028,0.318679,0,No
1,1,1,1,1,2,1,1,2,7,0.296305,0.304855,0,No
1,1,1,1,1,2,1,1,2,9,0.265932,0.272147,0,No
1,1,1,1,1,2,1,1,2,7,0.2963,0.30485,0,No
1,1,1,1,1,2,1,1,2,8,0.339934,0.352194,0,No
1,1,1,1,1,2,1,1,2,8,0.32342,0.334424,0,No
2,2,4,2,2,4,2,2,4,8,0.299251,0.308731,0,No
2,2,4,1,2,3,2,2,4,8,0.342397,0.35483,0,No
2,2,4,2,2,4,2,2,4,8,0.314172,0.323388,0,No
1,1,1,1,1,2,1,1,2,8,0.288934,0.297717,0,No
2,2,4,1,2,3,2,2,4,8,0.294937,0.304172,0,No
1,1,1,1,1,2,1,1,2,8,0.301584,0.314486,0,No
1,1,1,1,1,2,1,1,2,8,0.288934,0.297717,0,No
1,1,1,1,1,2,1,1,2,8,0.339934,0.352194,0,No
2,2,4,1,1,2,2,2,4,8,0.313502,0.320218,0,No
1,1,1,1,1,2,1,1,2,8,0.28349,0.292904,0,No
1,1,1,1,1,2,1,1,2,8,0.269848,0.276275,0,No
1,1,1,1,1,2,1,1,2,8,0.271899,0.280395,0,No
1,1,1,1,1,2,1,1,2,8,0.271899,0.280395,0,No
4,4,16,1,1,2,4,4,8,8,0.309331,0.317947,0,No
2,2,4,1,1,2,2,2,4,9,0.244979,0.249046,0,No
1,1,1,1,1,2,1,1,2,8,0.339934,0.352194,0,No
1,1,1,1,1,2,1,1,2,8,0.271899,0.280395,0,No
1,1,1,1,1,2,1,1,2,7,0.327826,0.338517,0,No
1,1,1,1,1,2,1,1,2,8,0.32342,0.334424,0,No
2,2,4,2,2,4,2,2,4,8,0.318138,0.325939,0,No
3,3,9,2,1,3,3,3,6,8,0.29229,0.30057,0,No
1,1,1,1,1,2,1,1,2,8,0.27455,0.283664,0,No
1,1,1,1,1,2,1,1,2,8,0.271899,0.280395,0,No
1,1,1,1,1,2,1,1,2,8,0.27122,0.279026,0,No
1,1,1,1,1,2,1,1,2,8,0.32342,0.334424,0,No
1,1,1,1,1,2,1,1,2,8,0.32342,0.334424,0,No
6,5,30,2,3,5,6,6,12,8,0.322369,0.33057,0,No
3,3,9,2,2,4,3,3,6,7,0.339616,0.352609,0,No
3,3,9,1,1,2,3,3,6,7,0.312584,0.319273,0,No
1,1,1,1,1,2,1,1,2,8,0.277096,0.285605,0,No
1,1,1,1,1,2,1,1,2,8,0.309325,0.317943,0,No
1,1,1,1,1,2,1,1,2,8,0.301589,0.314491,0,No
3,3,9,2,2,4,3,3,6,8,0.274669,0.282868,0,No
1,1,1,1,1,2,1,1,2,8,0.27455,0.283664,0,No
1,1,1,1,1,2,1,1,2,8,0.285645,0.292647,0,No
2,2,4,2,2,4,2,2,4,7,0.331224,0.342603,0,No
2,2,4,2,2,4,2,2,4,8,0.318625,0.325781,0,No
1,1,1,1,1,2,1,1,2,8,0.272707,0.279684,0,No
1,1,1,1,1,2,1,1,2,8,0.281809,0.289524,0,No
1,1,1,1,1,2,1,1,2,8,0.287333,0.294472,0,No
1,1,1,1,1,2,1,1,2,8,0.287605,0.295192,0,No
1,1,1,1,1,2,1,1,2,8,0.27122,0.279026,0,No
1,1,1,1,1,2,1,1,2,8,0.302842,0.310166,0,No
2,2,4,2,2,4,2,2,4,8,0.316503,0.323577,0,No
4,4,16,1,1,2,4,4,8,8,0.32342,0.334424,0,No
8,8,64,1,3,4,8,8,16,8,0.329236,0.340629,0,No
6,6,36,2,2,4,6,6,12,8,0.327832,0.339198,0,No
1,1,1,1,1,2,1,1,2,9,0.254417,0.260027,0,No
1,1,1,1,1,2,1,1,2,8,0.289252,0.299287,0,No
6,6,36,1,5,6,6,6,12,8,0.318952,0.328237,0,No
3,3,9,2,2,4,3,3,6,8,0.327832,0.339198,0,No
4,4,16,1,4,5,4,4,8,8,0.329542,0.341636,0,No
1,1,1,1,1,2,1,1,2,9,0.253732,0.25861,0,No
1,1,1,1,1,2,1,1,2,8,0.317895,0.325039,0,No
1,1,1,1,1,2,1,1,2,8,0.32342,0.334424,0,No
1,1,1,1,1,2,1,1,2,7,0.327819,0.338512,0,No
1,1,1,1,1,2,1,1,2,9,0.263403,0.271075,0,No
1,1,1,1,1,2,1,1,2,8,0.32342,0.334424,0,No
2,2,4,2,2,4,2,2,4,8,0.325016,0.335747,0,No
1,1,1,1,1,2,1,1,2,8,0.299761,0.306442,0,No
2,2,4,2,1,3,2,2,4,8,0.32342,0.334424,0,No
1,1,1,1,1,2,1,1,2,8,0.323426,0.334429,0,No
7,7,49,5,3,8,7,7,14,7,0.341759,0.355133,0,No
1,1,1,1,1,2,1,1,2,8,0.32342,0.334424,0,No
1,1,1,1,1,2,1,1,2,8,0.30338,0.311471,0,No
1,1,1,1,1,2,1,1,2,7,0.327819,0.338512,0,No
1,1,1,1,1,2,1,1,2,8,0.309325,0.317943,0,No
1,1,1,1,1,2,1,1,2,9,0.253967,0.258814,0,No
1,1,1,1,1,2,1,1,2,9,0.303801,0.312033,0,No
1,1,1,1,1,2,1,1,2,8,0.32342,0.334424,0,No
3,3,9,2,2,4,3,3,6,8,0.332956,0.343616,0,No
1,1,1,1,1,2,1,1,2,9,0.252759,0.258047,0,No
2,2,4,1,1,2,2,2,4,8,0.301589,0.314491,0,No
1,1,1,1,1,2,1,1,2,8,0.32342,0.334424,0,No
1,1,1,1,1,2,1,1,2,8,0.32342,0.334424,0,No
1,1,1,1,1,2,1,1,2,8,0.32342,0.334424,0,No
1,1,1,1,1,2,1,1,2,8,0.32342,0.334424,0,No
5,5,25,2,2,4,5,5,10,8,0.327662,0.339718,0,No
4,4,16,2,2,4,4,4,8,8,0.338243,0.351497,0,No
1,1,1,1,1,2,1,1,2,9,0.268721,0.277328,0,No
3,3,9,2,3,5,3,3,6,8,0.332606,0.344004,0,No
1,1,1,1,1,2,1,1,2,8,0.278743,0.288253,0,No
1,1,1,1,1,2,1,1,2,9,0.268721,0.277328,0,No
1,1,1,1,1,2,1,1,2,9,0.279309,0.28665,0,No
1,1,1,1,1,2,1,1,2,8,0.301589,0.314491,0,No
2,2,4,2,2,4,2,2,4,8,0.297674,0.304762,0,No
1,1,1,1,1,2,1,1,2,8,0.323426,0.334429,0,No
4,4,16,2,4,6,4,4,8,8,0.354085,0.368918,0,No
1,1,1,1,1,2,1,1,2,8,0.296171,0.303818,0,No
1,1,1,1,1,2,1,1,2,8,0.339934,0.352194,0,No
1,1,1,1,1,2,1,1,2,8,0.339934,0.352194,0,No
1,1,1,1,1,2,1,1,2,8,0.272011,0.279039,0,No
1,1,1,1,1,2,1,1,2,9,0.268641,0.276936,0,No
1,1,1,1,1,2,1,1,2,8,0.27122,0.279026,0,No
1,1,1,1,1,2,1,1,2,7,0.296305,0.304855,0,No
1,1,1,1,1,2,1,1,2,8,0.27122,0.279026,0,No
1,1,1,1,1,2,1,1,2,8,0.27122,0.279026,0,No
3,3,9,3,2,5,3,3,6,8,0.325319,0.3366,0,No
1,1,1,1,1,2,1,1,2,8,0.310033,0.318684,0,No
1,1,1,1,1,2,1,1,2,8,0.32342,0.334424,0,No
3,3,9,2,1,3,3,3,6,8,0.323426,0.334429,0,No
1,1,1,1,1,2,1,1,2,8,0.311312,0.322315,0,No
2,2,4,1,1,2,2,2,4,8,0.27122,0.279026,0,No
1,1,1,1,1,2,1,1,2,8,0.266639,0.272711,0,No
1,1,1,1,1,2,1,1,2,8,0.294484,0.301605,0,No
1,1,1,1,1,2,1,1,2,8,0.32342,0.334424,0,No
1,1,1,1,1,2,1,1,2,8,0.339934,0.352194,0,No
1,1,1,1,1,2,1,1,2,9,0.268721,0.277328,0,No
2,2,4,2,1,3,2,2,4,8,0.301584,0.314486,0,No
2,2,4,2,2,4,2,2,4,8,0.314242,0.321032,0,No
3,3,9,2,2,4,3,3,6,8,0.305362,0.318711,0,No
1,1,1,1,1,2,1,1,2,9,0.254908,0.260671,0,No
1,1,1,1,1,2,1,1,2,8,0.301584,0.314486,0,No
4,4,16,3,3,6,4,4,8,8,0.356661,0.372224,0,No
3,3,9,3,2,5,3,3,6,8,0.331604,0.343137,0,No
3,3,9,3,3,6,3,3,6,8,0.321331,0.32884,0,No
1,1,1,1,1,2,1,1,2,8,0.314583,0.32146,0,No
1,1,1,1,1,2,1,1,2,8,0.268223,0.275194,0,No
2,2,4,2,2,4,2,2,4,8,0.313382,0.324771,0,No
5,5,25,3,1,4,5,5,10,8,0.331571,0.343073,0,No
1,1,1,1,1,2,1,1,2,9,0.271061,0.277626,0,No
1,1,1,1,1,2,1,1,2,8,0.331571,0.343073,0,No
1,1,1,1,1,2,1,1,2,9,0.271061,0.277626,0,No
1,1,1,1,1,2,1,1,2,8,0.323426,0.334429,0,No
6,6,36,6,2,8,6,6,12,8,0.33631,0.348392,0,No
10,10,100,7,4,11,10,10,20,7,0.354666,0.369909,0,No
4,4,16,4,3,7,4,4,8,7,0.314612,0.321738,0,No
3,3,9,1,1,2,3,3,6,7,0.296305,0.304855,0,No
1,1,1,1,1,2,1,1,2,7,0.2963,0.30485,0,No
2,2,4,1,1,2,2,2,4,8,0.303375,0.311466,0,No
1,1,1,1,1,2,1,1,2,8,0.32342,0.334424,0,No
1,1,1,1,1,2,1,1,2,7,0.2963,0.30485,0,No
2,2,4,1,1,2,2,2,4,8,0.310028,0.318679,0,No
1,1,1,1,1,2,1,1,2,8,0.285645,0.292647,0,No
2,2,4,2,2,4,2,2,4,8,0.325319,0.3366,0,No
2,1,2,2,2,4,2,2,4,8,0.329542,0.340471,0,No
1,1,1,1,1,2,1,1,2,8,0.248855,0.253352,0,No
2,2,4,1,1,2,2,2,4,8,0.250823,0.255499,0,No
2,2,4,2,2,4,2,2,4,8,0.338236,0.351488,0,No
1,1,1,1,1,2,1,1,2,8,0.301589,0.314491,0,No
2,2,4,2,2,4,2,2,4,8,0.323807,0.334811,0,No
1,1,1,1,1,2,1,1,2,7,0.327819,0.338512,0,No
1,1,1,1,1,2,1,1,2,8,0.308548,0.315803,0,No
1,1,1,1,1,2,1,1,2,8,0.277096,0.285605,0,No
1,1,1,1,1,2,1,1,2,8,0.339934,0.352194,0,No
3,3,9,3,3,6,3,3,6,8,0.342294,0.355074,0,No
1,1,1,1,1,2,1,1,2,9,0.276051,0.283073,0,No
1,1,1,1,1,2,1,1,2,8,0.292821,0.30033,0,No
1,1,1,1,1,2,1,1,2,8,0.331571,0.343073,0,No
2,2,4,1,1,2,2,2,4,8,0.317439,0.327445,0,No
4,4,16,2,2,4,4,4,8,7,0.31809,0.330229,0,No
2,2,4,2,2,4,2,2,4,8,0.314294,0.320971,0,No
1,1,1,1,1,2,1,1,2,8,0.310717,0.317502,0,No
1,1,1,1,1,2,1,1,2,8,0.271224,0.279029,0,No
1,1,1,1,1,2,1,1,2,8,0.339934,0.352194,0,No
1,1,1,1,1,2,1,1,2,9,0.280683,0.28796,0,No
2,1,2,2,2,4,2,2,4,8,0.314607,0.323924,0,No
1,1,1,1,1,2,1,1,2,8,0.30338,0.311471,0,No
4,4,16,1,2,3,4,4,8,8,0.338243,0.351497,0,No
2,2,4,2,2,4,2,2,4,8,0.282701,0.289727,0,No
1,1,1,1,1,2,1,1,2,7,0.2963,0.30485,0,No
1,1,1,1,1,2,1,1,2,9,0.268641,0.276936,0,No
2,2,4,1,2,3,2,2,4,8,0.305165,0.3184,0,No
1,1,1,1,1,2,1,1,2,9,0.268721,0.277328,0,No
1,1,1,1,1,2,1,1,2,8,0.301584,0.314486,0,No
1,1,1,1,1,2,1,1,2,8,0.301584,0.314486,0,No
2,2,4,2,2,4,2,2,4,8,0.304996,0.31423,0,No
2,2,4,2,2,4,2,2,4,8,0.31408,0.322719,0,No
3,3,9,3,2,5,3,3,6,8,0.32218,0.330697,0,No
5,5,25,2,3,5,5,5,10,8,0.33032,0.341945,0,No
2,2,4,2,1,3,2,2,4,8,0.301589,0.314491,0,No
1,1,1,1,1,2,1,1,2,8,0.274334,0.282192,0,No
1,1,1,1,1,2,1,1,2,9,0.255721,0.260674,0,No
3,3,9,2,2,4,3,3,6,8,0.317812,0.32873,0,No
1,1,1,1,1,2,1,1,2,8,0.339934,0.352194,0,No
1,1,1,1,1,2,1,1,2,8,0.339934,0.352194,0,No
1,1,1,1,1,2,1,1,2,8,0.314583,0.32146,0,No
1,1,1,1,1,2,1,1,2,8,0.309331,0.317947,0,No
1,1,1,1,1,2,1,1,2,8,0.290311,0.297572,0,No
1,1,1,1,1,2,1,1,2,9,0.268721,0.277328,0,No
1,1,1,1,1,2,1,1,2,8,0.288168,0.299068,0,No
1,1,1,1,1,2,1,1,2,8,0.288168,0.299068,0,No
1,1,1,1,1,2,1,1,2,9,0.276056,0.283078,0,No
1,1,1,1,1,2,1,1,2,8,0.303688,0.310784,0,No
4,4,16,2,4,6,4,4,8,8,0.338652,0.351369,0,No
1,1,1,1,1,2,1,1,2,9,0.276056,0.283078,0,No
1,1,1,1,1,2,1,1,2,9,0.276056,0.283078,0,No
2,2,4,1,1,2,2,2,4,9,0.276051,0.283073,0,No
1,1,1,1,1,2,1,1,2,8,0.313848,0.32086,0,No
1,1,1,1,1,2,1,1,2,8,0.301584,0.314486,0,No
2,2,4,2,1,3,2,2,4,8,0.301589,0.314491,0,No
1,1,1,1,1,2,1,1,2,8,0.317298,0.324393,0,No
1,1,1,1,1,2,1,1,2,8,0.296444,0.303647,0,No
1,1,1,1,1,2,1,1,2,8,0.290014,0.297126,0,No
1,1,1,1,1,2,1,1,2,8,0.301584,0.314486,0,No
1,1,1,1,1,2,1,1,2,8,0.310717,0.317502,0,No
1,1,1,1,1,2,1,1,2,8,0.32342,0.334424,0,No
2,2,4,2,2,4,2,2,4,8,0.307641,0.319873,0,No
1,1,1,1,1,2,1,1,2,9,0.269103,0.277072,0,No
2,2,4,1,2,3,2,2,4,8,0.341205,0.353536,0,No
2,2,4,2,2,4,2,2,4,8,0.313048,0.321125,0,No
1,1,1,1,1,2,1,1,2,8,0.27122,0.279026,0,No
1,1,1,1,1,2,1,1,2,8,0.309325,0.317943,0,No
1,1,1,1,1,2,1,1,2,8,0.278666,0.285579,0,No
1,1,1,1,1,2,1,1,2,9,0.268717,0.277323,0,No
2,2,4,2,2,4,2,2,4,8,0.324577,0.335516,0,No
2,2,4,2,2,4,2,2,4,8,0.340043,0.352326,0,No
7,7,49,2,5,7,7,7,14,8,0.327971,0.339413,0,No
2,2,4,1,1,2,2,2,4,9,0.246418,0.249942,0,No
1,1,1,1,1,2,1,1,2,9,0.248449,0.252735,0,No
1,1,1,1,1,2,1,1,2,8,0.28349,0.292904,0,No
1,1,1,1,1,2,1,1,2,8,0.315759,0.323487,0,No
4,4,16,4,4,8,4,4,8,8,0.319514,0.327346,0,No
4,4,16,2,3,5,4,4,8,8,0.321713,0.329844,0,No
3,3,9,2,3,5,3,3,6,8,0.345748,0.358967,0,No
2,2,4,2,2,4,2,2,4,8,0.314752,0.322041,0,No
1,1,1,1,1,2,1,1,2,8,0.301589,0.314491,0,No
1,1,1,1,1,2,1,1,2,8,0.331571,0.343073,0,No
5,4,20,3,3,6,5,5,10,8,0.331102,0.342494,0,No
1,1,1,1,1,2,1,1,2,8,0.306657,0.315385,0,No
1,1,1,1,1,2,1,1,2,8,0.331571,0.343073,0,No
1,1,1,1,1,2,1,1,2,8,0.32342,0.334424,0,No
1,1,1,1,1,2,1,1,2,8,0.29338,0.300813,0,No
1,1,1,1,1,2,1,1,2,8,0.2732,0.279851,0,No
1,1,1,1,1,2,1,1,2,8,0.292821,0.30033,0,No
1,1,1,1,1,2,1,1,2,8,0.287605,0.295192,0,No
2,2,4,1,1,2,2,2,4,8,0.2876,0.295187,0,No
1,1,1,1,1,2,1,1,2,9,0.254911,0.260674,0,No
2,2,4,2,1,3,2,2,4,9,0.268721,0.277328,0,No
2,2,4,1,1,2,2,2,4,8,0.289321,0.29644,0,No
2,2,4,2,2,4,2,2,4,9,0.267018,0.273875,0,No
2,2,4,1,2,3,2,2,4,9,0.246625,0.251574,0,No
1,1,1,1,1,2,1,1,2,8,0.339934,0.352194,0,No
1,1,1,1,1,2,1,1,2,8,0.262052,0.267994,0,No
1,1,1,1,1,2,1,1,2,8,0.303655,0.312962,0,No
2,2,4,2,2,4,2,2,4,8,0.339961,0.352253,0,No
1,1,1,1,1,2,1,1,2,8,0.32342,0.334424,0,No
1,1,1,1,1,2,1,1,2,8,0.303693,0.310789,0,No
1,1,1,1,1,2,1,1,2,8,0.288163,0.299063,0,No
1,1,1,1,1,2,1,1,2,8,0.288168,0.299068,0,No
4,4,16,4,2,6,4,4,8,9,0.277001,0.284133,0,No
1,1,1,1,1,2,1,1,2,9,0.26781,0.274291,0,No
7,7,49,2,4,6,7,7,14,7,0.338424,0.34976,0,No
2,2,4,2,2,4,2,2,4,8,0.29993,0.306581,0,No
1,1,1,1,1,2,1,1,2,7,0.327819,0.338512,0,No
1,1,1,1,1,2,1,1,2,8,0.30338,0.311471,0,No
1,1,1,1,1,2,1,1,2,9,0.268569,0.274904,0,No
2,2,4,1,2,3,2,2,4,8,0.289832,0.296995,0,No
1,1,1,1,1,2,1,1,2,8,0.32342,0.334424,0,No
1,1,1,1,1,2,1,1,2,8,0.339941,0.352199,0,No
1,1,1,1,1,2,1,1,2,8,0.30833,0.31471,0,No
1,1,1,1,1,2,1,1,2,8,0.288168,0.299068,0,No
1,1,1,1,1,2,1,1,2,8,0.287605,0.295192,0,No
2,2,4,1,1,2,2,2,4,8,0.303375,0.311466,0,No
2,2,4,2,1,3,2,2,4,9,0.268641,0.276936,0,No
1,1,1,1,1,2,1,1,2,8,0.317292,0.324388,0,No
1,1,1,1,1,2,1,1,2,8,0.2828,0.289824,0,No
1,1,1,1,1,2,1,1,2,8,0.310722,0.317507,0,No
1,1,1,1,1,2,1,1,2,8,0.30833,0.31471,0,No
1,1,1,1,1,2,1,1,2,8,0.296171,0.303818,0,No
1,1,1,1,1,2,1,1,2,8,0.287605,0.295192,0,No
1,1,1,1,1,2,1,1,2,9,0.267865,0.273982,0,No
1,1,1,1,1,2,1,1,2,8,0.282795,0.289819,0,No
2,2,4,2,1,3,2,2,4,8,0.32342,0.334424,0,No
1,1,1,1,1,2,1,1,2,9,0.226204,0.230008,0,No
1,1,1,1,1,2,1,1,2,8,0.286595,0.293671,0,No
1,1,1,1,1,2,1,1,2,9,0.268641,0.276936,0,No
2,2,4,1,2,3,2,2,4,7,0.304262,0.312508,0,No
1,1,1,1,1,2,1,1,2,8,0.304126,0.310933,0,No
2,2,4,1,2,3,2,2,4,8,0.305291,0.3122,0,No
4,4,16,3,4,7,4,4,8,8,0.318554,0.325971,0,No
7,7,49,1,6,7,7,7,14,8,0.3005,0.307599,0,No
1,1,1,1,1,2,1,1,2,8,0.29595,0.30471,0,No
1,1,1,1,1,2,1,1,2,8,0.286995,0.295346,0,No
1,1,1,1,1,2,1,1,2,8,0.274545,0.283659,0,No
8,8,64,1,6,7,8,8,16,7,0.332502,0.34275,0,No
2,2,4,1,1,2,2,2,4,9,0.272454,0.279296,0,No
3,3,9,1,1,2,3,3,6,8,0.339934,0.352194,0,No
1,1,1,1,1,2,1,1,2,8,0.339934,0.352194,0,No
4,4,16,1,2,3,4,4,8,8,0.309786,0.316988,0,No
1,1,1,1,1,2,1,1,2,8,0.32342,0.334424,0,No
1,1,1,1,1,2,1,1,2,8,0.303375,0.311466,0,No
1,1,1,1,1,2,1,1,2,8,0.306657,0.315385,0,No
1,1,1,1,1,2,1,1,2,9,0.25882,0.264658,0,No
1,1,1,1,1,2,1,1,2,9,0.303807,0.312038,0,No
1,1,1,1,1,2,1,1,2,8,0.301584,0.314486,0,No
1,1,1,1,1,2,1,1,2,9,0.265477,0.271774,0,No
3,3,9,2,1,3,3,3,6,8,0.339934,0.352194,0,No
3,3,9,1,2,3,3,3,6,8,0.313037,0.321784,0,No
1,1,1,1,1,2,1,1,2,8,0.317298,0.324393,0,No
1,1,1,1,1,2,1,1,2,7,0.296305,0.304855,0,No
1,1,1,1,1,2,1,1,2,8,0.302584,0.309507,0,No
2,2,4,2,1,3,2,2,4,9,0.276056,0.283078,0,No
1,1,1,1,1,2,1,1,2,7,0.312589,0.319278,0,No
2,2,4,1,1,2,2,2,4,8,0.32342,0.334424,0,No
3,3,9,3,2,5,3,3,6,8,0.328482,0.339644,0,No
1,1,1,1,1,2,1,1,2,9,0.256347,0.261604,0,No
3,3,9,3,2,5,3,3,6,8,0.292791,0.299864,0,No
2,2,4,1,1,2,2,2,4,7,0.2963,0.30485,0,No
1,1,1,1,1,2,1,1,2,8,0.323426,0.334429,0,No
2,2,4,1,2,3,2,2,4,8,0.338243,0.351497,0,No
5,5,25,1,3,4,5,5,10,8,0.346358,0.360279,0,No
1,1,1,1,1,2,1,1,2,9,0.242503,0.245951,0,No
3,3,9,3,3,6,3,3,6,7,0.334418,0.345942,0,No
1,1,1,1,1,2,1,1,2,8,0.310028,0.318679,0,No
1,1,1,1,1,2,1,1,2,8,0.310028,0.318679,0,No
1,1,1,1,1,2,1,1,2,8,0.277024,0.283891,0,No
2,2,4,1,2,3,2,2,4,8,0.323316,0.332085,0,No
1,1,1,1,1,2,1,1,2,8,0.310028,0.318679,0,No
1,1,1,1,1,2,1,1,2,8,0.339934,0.352194,0,No
1,1,1,1,1,2,1,1,2,7,0.327819,0.338512,0,No
1,1,1,1,1,2,1,1,2,8,0.301589,0.314491,0,No
1,1,1,1,1,2,1,1,2,8,0.29902,0.30606,0,No
5,5,25,3,3,6,5,5,10,8,0.314444,0.324399,0,No
4,4,16,4,1,5,4,4,8,9,0.271531,0.278836,0,No
1,1,1,1,1,2,1,1,2,8,0.303693,0.310789,0,No
1,1,1,1,1,2,1,1,2,8,0.30359,0.310474,0,No
1,1,1,1,1,2,1,1,2,9,0.249846,0.25449,0,No
2,2,4,1,1,2,2,2,4,9,0.274904,0.282013,0,No
5,4,20,2,4,6,5,5,10,7,0.311681,0.31902,0,No
2,2,4,1,1,2,2,2,4,8,0.310028,0.318679,0,No
3,3,9,3,2,5,3,3,6,8,0.310315,0.324453,0,No
1,1,1,1,1,2,1,1,2,8,0.32342,0.334424,0,No
1,1,1,1,1,2,1,1,2,9,0.268721,0.277328,0,No
2,2,4,2,2,4,2,2,4,8,0.315403,0.325138,0,No
2,2,4,2,2,4,2,2,4,8,0.306673,0.320221,0,No
2,2,4,2,2,4,2,2,4,8,0.293724,0.303385,0,No
2,2,4,1,2,3,2,2,4,8,0.327675,0.33951,0,No
1,1,1,1,1,2,1,1,2,8,0.27122,0.279026,0,No
2,2,4,2,2,4,2,2,4,8,0.315083,0.329711,0,No
1,1,1,1,1,2,1,1,2,7,0.2963,0.30485,0,No
1,1,1,1,1,2,1,1,2,7,0.327826,0.338517,0,No
2,2,4,1,1,2,2,2,4,8,0.32342,0.334424,0,No
2,2,4,2,2,4,2,2,4,8,0.323543,0.334625,0,No
1,1,1,1,1,2,1,1,2,7,0.327819,0.338512,0,No
2,2,4,2,2,4,2,2,4,7,0.311995,0.320459,0,No
1,1,1,1,1,2,1,1,2,7,0.327819,0.338512,0,No
3,3,9,2,2,4,3,3,6,8,0.284939,0.295125,0,No
1,1,1,1,1,2,1,1,2,8,0.277096,0.285605,0,No
1,1,1,1,1,2,1,1,2,8,0.313497,0.320213,0,No
1,1,1,1,1,2,1,1,2,8,0.284199,0.291467,0,No
1,1,1,1,1,2,1,1,2,8,0.301584,0.314486,0,No
3,3,9,3,3,6,3,3,6,8,0.310671,0.319315,0,No
1,1,1,1,1,2,1,1,2,9,0.242793,0.246514,0,No
1,1,1,1,1,2,1,1,2,7,0.327826,0.338517,0,No
3,3,9,3,3,6,3,3,6,8,0.299656,0.308297,0,No
1,1,1,1,1,2,1,1,2,9,0.268721,0.277328,0,No
1,1,1,1,1,2,1,1,2,8,0.282954,0.289913,0,No
2,2,4,1,2,3,2,2,4,7,0.352629,0.366971,0,No
1,1,1,1,1,2,1,1,2,8,0.339934,0.352194,0,No
1,1,1,1,1,2,1,1,2,7,0.327819,0.338512,0,No
4,4,16,3,2,5,4,4,8,8,0.297208,0.309996,0,No
1,1,1,1,1,2,1,1,2,8,0.317298,0.324393,0,No
4,4,16,1,2,3,4,4,8,7,0.321023,0.329504,0,No
2,2,4,1,2,3,2,2,4,8,0.309168,0.315868,0,No
2,2,4,1,2,3,2,2,4,8,0.304495,0.311225,0,No
1,1,1,1,1,2,1,1,2,8,0.339934,0.352194,0,No
1,1,1,1,1,2,1,1,2,8,0.32342,0.334424,0,No
1,1,1,1,1,2,1,1,2,8,0.265382,0.271498,0,No
1,1,1,1,1,2,1,1,2,8,0.309331,0.317947,0,No
1,1,1,1,1,2,1,1,2,8,0.339934,0.352194,0,No
1,1,1,1,1,2,1,1,2,8,0.2924,0.299556,0,No
2,2,4,1,2,3,2,2,4,8,0.325307,0.337114,0,No
2,2,4,2,2,4,2,2,4,8,0.279469,0.287954,0,No
1,1,1,1,1,2,1,1,2,8,0.331571,0.343073,0,No
4,4,16,4,4,8,4,4,8,8,0.328337,0.337595,0,No
2,2,4,2,2,4,2,2,4,8,0.339995,0.352297,0,No
3,3,9,2,2,4,3,3,6,8,0.309353,0.318006,0,No
3,3,9,3,3,6,3,3,6,8,0.33839,0.351722,0,No
2,2,4,2,2,4,2,2,4,8,0.324991,0.335851,0,No
1,1,1,1,1,2,1,1,2,8,0.301584,0.314486,0,No
1,1,1,1,1,2,1,1,2,8,0.306453,0.313109,0,No
1,1,1,1,1,2,1,1,2,8,0.284161,0.291393,0,No
1,1,1,1,1,2,1,1,2,8,0.278739,0.288248,0,No
1,1,1,1,1,2,1,1,2,8,0.331571,0.343073,0,No
2,2,4,1,1,2,2,2,4,8,0.281768,0.288888,0,No
2,2,4,2,2,4,2,2,4,8,0.330493,0.34092,0,No
1,1,1,1,1,2,1,1,2,8,0.264457,0.270739,0,No
3,3,9,2,1,3,3,3,6,8,0.310033,0.318684,0,No
5,5,25,2,3,5,5,5,10,8,0.345328,0.359709,0,No
1,1,1,1,1,2,1,1,2,8,0.331571,0.343073,0,No
1,1,1,1,1,2,1,1,2,8,0.28349,0.292904,0,No
6,6,36,4,4,8,6,6,12,8,0.357161,0.3728,0,No
5,5,25,3,4,7,5,5,10,8,0.352476,0.367212,0,No
1,1,1,1,1,2,1,1,2,8,0.294484,0.301605,0,No
2,2,4,1,1,2,2,2,4,8,0.317439,0.327445,0,No
1,1,1,1,1,2,1,1,2,7,0.327826,0.338517,0,No
1,1,1,1,1,2,1,1,2,8,0.301584,0.314486,0,No
1,1,1,1,1,2,1,1,2,7,0.327826,0.338517,0,No
1,1,1,1,1,2,1,1,2,8,0.310028,0.318679,0,No
1,1,1,1,1,2,1,1,2,8,0.302842,0.310166,0,No
1,1,1,1,1,2,1,1,2,8,0.331565,0.343064,0,No
2,2,4,1,1,2,2,2,4,8,0.301584,0.314486,0,No
3,3,9,1,1,2,3,3,6,8,0.32342,0.334424,0,No
3,3,9,1,1,2,3,3,6,8,0.32342,0.334424,0,No
1,1,1,1,1,2,1,1,2,8,0.301589,0.314491,0,No
1,1,1,1,1,2,1,1,2,8,0.331571,0.343073,0,No
2,2,4,1,2,3,2,2,4,8,0.29232,0.299305,0,No
1,1,1,1,1,2,1,1,2,9,0.255733,0.261996,0,No
1,1,1,1,1,2,1,1,2,8,0.301584,0.314486,0,No
1,1,1,1,1,2,1,1,2,9,0.276056,0.283078,0,No
1,1,1,1,1,2,1,1,2,9,0.276051,0.283073,0,No
1,1,1,1,1,2,1,1,2,9,0.276056,0.283078,0,No
1,1,1,1,1,2,1,1,2,8,0.252422,0.257362,0,No
2,2,4,2,2,4,2,2,4,8,0.321968,0.329277,0,No
1,1,1,1,1,2,1,1,2,8,0.309331,0.317947,0,No
2,2,4,2,2,4,2,2,4,8,0.309561,0.319106,0,No
7,7,49,5,4,9,7,7,14,8,0.357737,0.37299,0,No
2,2,4,1,1,2,2,2,4,8,0.288168,0.299068,0,No
2,2,4,2,2,4,2,2,4,8,0.293734,0.30608,0,No
2,2,4,1,1,2,2,2,4,7,0.327819,0.338512,0,No
3,3,9,1,2,3,3,3,6,8,0.34516,0.358804,0,No
1,1,1,1,1,2,1,1,2,8,0.277389,0.284283,0,No
1,1,1,1,1,2,1,1,2,8,0.277389,0.284283,0,No
1,1,1,1,1,2,1,1,2,7,0.296305,0.304855,0,No
1,1,1,1,1,2,1,1,2,8,0.277389,0.284283,0,No
1,1,1,1,1,2,1,1,2,8,0.339934,0.352194,0,No
1,1,1,1,1,2,1,1,2,8,0.277389,0.284283,0,No
2,2,4,1,1,2,2,2,4,8,0.30359,0.310474,0,No
1,1,1,1,1,2,1,1,2,8,0.245734,0.250215,0,No
1,1,1,1,1,2,1,1,2,8,0.309331,0.317947,0,No
1,1,1,1,1,2,1,1,2,8,0.315759,0.323487,0,No
1,1,1,1,1,2,1,1,2,8,0.305089,0.312176,0,No
1,1,1,1,1,2,1,1,2,8,0.277465,0.284727,0,No
2,2,4,1,2,3,2,2,4,8,0.341124,0.353438,0,No
1,1,1,1,1,2,1,1,2,8,0.309331,0.317947,0,No
2,2,4,2,2,4,2,2,4,8,0.320011,0.329872,0,No
1,1,1,1,1,2,1,1,2,8,0.313497,0.320213,0,No
1,1,1,1,1,2,1,1,2,8,0.309983,0.317112,0,No
1,1,1,1,1,2,1,1,2,8,0.32342,0.334424,0,No
1,1,1,1,1,2,1,1,2,8,0.27818,0.285585,0,No
4,4,16,1,4,5,4,4,8,8,0.298696,0.305512,0,No
1,1,1,1,1,2,1,1,2,8,0.293547,0.300711,0,No
1,1,1,1,1,2,1,1,2,8,0.281809,0.289524,0,No
1,1,1,1,1,2,1,1,2,8,0.28036,0.287381,0,No
1,1,1,1,1,2,1,1,2,8,0.32342,0.334424,0,No
1,1,1,1,1,2,1,1,2,8,0.303375,0.311466,0,No
5,5,25,1,1,2,5,5,10,8,0.264457,0.270739,0,No
3,3,9,2,2,4,3,3,6,8,0.323445,0.334478,0,No
1,1,1,1,1,2,1,1,2,8,0.309325,0.317943,0,No
1,1,1,1,1,2,1,1,2,9,0.268721,0.277328,0,No
3,3,9,3,2,5,3,3,6,8,0.338243,0.351497,0,No
1,1,1,1,1,2,1,1,2,8,0.296166,0.303813,0,No
1,1,1,1,1,2,1,1,2,9,0.268641,0.276936,0,No
1,1,1,1,1,2,1,1,2,8,0.272969,0.279821,0,No
1,1,1,1,1,2,1,1,2,8,0.259695,0.265243,0,No
1,1,1,1,1,2,1,1,2,8,0.32342,0.334424,0,No
6,6,36,2,2,4,6,6,12,8,0.325394,0.336176,0,No
7,7,49,4,2,6,7,7,14,8,0.325084,0.336656,0,No
1,1,1,1,1,2,1,1,2,8,0.301584,0.314486,0,No
1,1,1,1,1,2,1,1,2,8,0.308447,0.314966,0,No
1,1,1,1,1,2,1,1,2,8,0.313502,0.320218,0,No
2,2,4,2,2,4,2,2,4,8,0.294301,0.301503,0,No
2,2,4,2,2,4,2,2,4,8,0.323567,0.334593,0,No
1,1,1,1,1,2,1,1,2,8,0.32342,0.334424,0,No
5,5,25,3,3,6,5,5,10,8,0.305263,0.313642,0,No
1,1,1,1,1,2,1,1,2,8,0.29741,0.304429,0,No
1,1,1,1,1,2,1,1,2,8,0.294418,0.301272,0,No
1,1,1,1,1,2,1,1,2,8,0.287721,0.295004,0,No
2,2,4,1,1,2,2,2,4,8,0.331571,0.343073,0,No
1,1,1,1,1,2,1,1,2,8,0.331571,0.343073,0,No
1,1,1,1,1,2,1,1,2,8,0.323426,0.334429,0,No
1,1,1,1,1,2,1,1,2,8,0.339941,0.352199,0,No
2,2,4,2,1,3,2,2,4,7,0.327819,0.338512,0,No
1,1,1,1,1,2,1,1,2,8,0.339934,0.352194,0,No
3,3,9,1,1,2,3,3,6,8,0.339934,0.352194,0,No
1,1,1,1,1,2,1,1,2,8,0.270562,0.277162,0,No
1,1,1,1,1,2,1,1,2,8,0.270309,0.276579,0,No
2,2,4,2,2,4,2,2,4,8,0.340219,0.352534,0,No
2,2,4,2,2,4,2,2,4,8,0.32488,0.335829,0,No
2,2,4,2,2,4,2,2,4,8,0.282392,0.291569,0,No
1,1,1,1,1,2,1,1,2,9,0.268641,0.276936,0,No
2,2,4,1,1,2,2,2,4,9,0.260727,0.266288,0,No
2,2,4,1,2,3,2,2,4,8,0.307835,0.315599,0,No
1,1,1,1,1,2,1,1,2,8,0.309325,0.317943,0,No
2,2,4,2,2,4,2,2,4,8,0.326408,0.338223,0,No
1,1,1,1,1,2,1,1,2,8,0.310033,0.318684,0,No
1,1,1,1,1,2,1,1,2,7,0.327826,0.338517,0,No
2,2,4,1,2,3,2,2,4,8,0.303785,0.310466,0,No
1,1,1,1,1,2,1,1,2,8,0.277389,0.284283,0,No
1,1,1,1,1,2,1,1,2,8,0.275712,0.282592,0,No
2,2,4,2,2,4,2,2,4,8,0.284915,0.293873,0,No
1,1,1,1,1,2,1,1,2,8,0.339934,0.352194,0,No
1,1,1,1,1,2,1,1,2,9,0.265932,0.272147,0,No
2,2,4,1,1,2,2,2,4,8,0.288163,0.299063,0,No
2,2,4,2,2,4,2,2,4,8,0.339961,0.352253,0,No
1,1,1,1,1,2,1,1,2,8,0.271899,0.280395,0,No
1,1,1,1,1,2,1,1,2,8,0.323426,0.334429,0,No
3,3,9,2,2,4,3,3,6,8,0.323985,0.334902,0,No
3,3,9,3,1,4,3,3,6,8,0.283486,0.292899,0,No
1,1,1,1,1,2,1,1,2,8,0.283486,0.292899,0,No
1,1,1,1,1,2,1,1,2,8,0.268223,0.275194,0,No
1,1,1,1,1,2,1,1,2,8,0.301584,0.314486,0,No
1,1,1,1,1,2,1,1,2,8,0.301584,0.314486,0,No
1,1,1,1,1,2,1,1,2,8,0.301589,0.314491,0,No
1,1,1,1,1,2,1,1,2,8,0.310028,0.318679,0,No
1,1,1,1,1,2,1,1,2,8,0.29667,0.303664,0,No
2,2,4,2,2,4,2,2,4,8,0.340375,0.352562,0,No
6,6,36,5,5,10,6,6,12,8,0.321337,0.331359,0,No
3,3,9,2,2,4,3,3,6,8,0.282533,0.289552,0,No
2,2,4,1,2,3,2,2,4,8,0.273494,0.281636,0,No
2,2,4,2,2,4,2,2,4,8,0.308922,0.316219,0,No
1,1,1,1,1,2,1,1,2,8,0.286995,0.295346,0,No
1,1,1,1,1,2,1,1,2,8,0.277831,0.285019,0,No
1,1,1,1,1,2,1,1,2,9,0.268637,0.276931,0,No
1,1,1,1,1,2,1,1,2,8,0.331571,0.343073,0,No
1,1,1,1,1,2,1,1,2,8,0.303375,0.311466,0,No
1,1,1,1,1,2,1,1,2,9,0.284336,0.292278,0,No
1,1,1,1,1,2,1,1,2,8,0.317445,0.327454,0,No
1,1,1,1,1,2,1,1,2,8,0.292887,0.299995,0,No
3,3,9,3,3,6,3,3,6,8,0.349946,0.364557,0,No
3,3,9,3,3,6,3,3,6,7,0.321343,0.330527,0,No
2,2,4,2,2,4,2,2,4,8,0.332573,0.344483,0,No
2,2,4,1,1,2,2,2,4,9,0.261578,0.267336,0,No
1,1,1,1,1,2,1,1,2,8,0.32342,0.334424,0,No
3,3,9,3,2,5,3,3,6,8,0.29088,0.30173,0,No
1,1,1,1,1,2,1,1,2,8,0.309977,0.317107,0,No
1,1,1,1,1,2,1,1,2,9,0.268721,0.277328,0,No
1,1,1,1,1,2,1,1,2,9,0.245334,0.249814,0,No
3,3,9,3,3,6,3,3,6,8,0.338471,0.350598,0,No
3,3,9,3,2,5,3,3,6,8,0.330493,0.34092,0,No
2,2,4,2,1,3,2,2,4,8,0.301584,0.314486,0,No
3,3,9,2,2,4,3,3,6,8,0.324645,0.335488,0,No
1,1,1,1,1,2,1,1,2,9,0.268717,0.277323,0,No
2,2,4,2,2,4,2,2,4,8,0.315176,0.324499,0,No
8,8,64,3,2,5,8,8,16,8,0.288037,0.299923,0,No
5,5,25,5,5,10,5,5,10,8,0.34516,0.358378,0,No
2,2,4,2,2,4,2,2,4,8,0.309775,0.323433,0,No
1,1,1,1,1,2,1,1,2,8,0.289223,0.296402,0,No
1,1,1,1,1,2,1,1,2,8,0.288929,0.297713,0,No
1,1,1,1,1,2,1,1,2,8,0.29001,0.297121,0,No
1,1,1,1,1,2,1,1,2,8,0.27455,0.283664,0,No
3,3,9,3,3,6,3,3,6,7,0.331333,0.3427,0,No
4,4,16,3,2,5,4,4,8,7,0.332236,0.343545,0,No
3,3,9,2,2,4,3,3,6,8,0.313572,0.320316,0,No
2,2,4,2,2,4,2,2,4,8,0.317363,0.328426,0,No
2,2,4,1,1,2,2,2,4,8,0.310033,0.318684,0,No
1,1,1,1,1,2,1,1,2,8,0.296991,0.30415,0,No
1,1,1,1,1,2,1,1,2,8,0.303655,0.312962,0,No
1,1,1,1,1,2,1,1,2,8,0.27455,0.283664,0,No
2,2,4,1,1,2,2,2,4,8,0.30932,0.317933,0,No
1,1,1,1,1,2,1,1,2,8,0.309325,0.317943,0,No
1,1,1,1,1,2,1,1,2,8,0.271894,0.28039,0,No
2,1,2,2,2,4,2,2,4,8,0.324886,0.33473,0,No
1,1,1,1,1,2,1,1,2,8,0.27455,0.283664,0,No
1,1,1,1,1,2,1,1,2,8,0.317895,0.325039,0,No
1,1,1,1,1,2,1,1,2,8,0.278739,0.288248,0,No
2,2,4,2,2,4,2,2,4,8,0.288056,0.296488,0,No
5,4,20,3,3,6,5,5,10,7,0.34045,0.353713,0,No
1,1,1,1,1,2,1,1,2,9,0.260174,0.265734,0,No
1,1,1,1,1,2,1,1,2,8,0.282678,0.289714,0,No
1,1,1,1,1,2,1,1,2,8,0.303402,0.310001,0,No
1,1,1,1,1,2,1,1,2,8,0.282257,0.289547,0,No
1,1,1,1,1,2,1,1,2,8,0.288163,0.299063,0,No
2,2,4,1,1,2,2,2,4,8,0.288168,0.299068,0,No
2,2,4,1,1,2,2,2,4,8,0.331578,0.343078,0,No
1,1,1,1,1,2,1,1,2,8,0.307819,0.314416,0,No
1,1,1,1,1,2,1,1,2,8,0.339941,0.352199,0,No
2,2,4,2,2,4,2,2,4,8,0.303845,0.313196,0,No
1,1,1,1,1,2,1,1,2,9,0.260902,0.266721,0,No
1,1,1,1,1,2,1,1,2,9,0.280688,0.287963,0,No
1,1,1,1,1,2,1,1,2,8,0.277096,0.285605,0,No
1,1,1,1,1,2,1,1,2,8,0.30268,0.309675,0,No
1,1,1,1,1,2,1,1,2,9,0.253115,0.258182,0,No
1,1,1,1,1,2,1,1,2,8,0.313497,0.320213,0,No
1,1,1,1,1,2,1,1,2,9,0.267533,0.273758,0,No
2,2,4,1,1,2,2,2,4,8,0.289911,0.296906,0,No
1,1,1,1,1,2,1,1,2,8,0.289906,0.296901,0,No
2,2,4,2,1,3,2,2,4,7,0.327819,0.338512,0,No
1,1,1,1,1,2,1,1,2,8,0.310028,0.318679,0,No
2,2,4,2,1,3,2,2,4,8,0.275855,0.282523,0,No
2,2,4,2,2,4,2,2,4,8,0.309555,0.316759,0,No
1,1,1,1,1,2,1,1,2,8,0.286206,0.293197,0,No
1,1,1,1,1,2,1,1,2,8,0.286201,0.293192,0,No
1,1,1,1,1,2,1,1,2,9,0.240605,0.24412,0,No
3,3,9,3,3,6,3,3,6,8,0.309724,0.3161,0,No
1,1,1,1,1,2,1,1,2,8,0.297721,0.304393,0,No
1,1,1,1,1,2,1,1,2,8,0.286206,0.293197,0,No
1,1,1,1,1,2,1,1,2,8,0.288934,0.297717,0,No
1,1,1,1,1,2,1,1,2,8,0.281136,0.288272,0,No
3,3,9,3,3,6,3,3,6,8,0.321119,0.329372,0,No
3,3,9,2,2,4,3,3,6,8,0.304914,0.313656,0,No
1,1,1,1,1,2,1,1,2,8,0.323426,0.334429,0,No
3,3,9,1,2,3,3,3,6,8,0.323439,0.334473,0,No
3,3,9,3,3,6,3,3,6,8,0.311221,0.319233,0,No
1,1,1,1,1,2,1,1,2,8,0.27122,0.279026,0,No
1,1,1,1,1,2,1,1,2,8,0.303375,0.311466,0,No
2,2,4,2,2,4,2,2,4,8,0.279003,0.287691,0,No
2,2,4,2,1,3,2,2,4,8,0.278743,0.288253,0,No
6,6,36,5,3,8,6,6,12,8,0.311659,0.320186,0,No
1,1,1,1,1,2,1,1,2,8,0.301584,0.308533,0,No
1,1,1,1,1,2,1,1,2,8,0.276324,0.283394,0,No
1,1,1,1,1,2,1,1,2,8,0.32342,0.334424,0,No
8,8,64,3,2,5,8,8,16,8,0.327675,0.33951,0,No
1,1,1,1,1,2,1,1,2,8,0.274545,0.283659,0,No
2,2,4,2,2,4,2,2,4,8,0.308347,0.314759,0,No
1,1,1,1,1,2,1,1,2,8,0.278743,0.288253,0,No
1,1,1,1,1,2,1,1,2,8,0.30946,0.31614,0,No
2,2,4,1,1,2,2,2,4,8,0.281833,0.289891,0,No
1,1,1,1,1,2,1,1,2,7,0.327826,0.338517,0,No
3,3,9,2,3,5,3,3,6,8,0.318643,0.328247,0,No
1,1,1,1,1,2,1,1,2,9,0.268721,0.277328,0,No
1,1,1,1,1,2,1,1,2,8,0.315759,0.323487,0,No
6,6,36,4,3,7,6,6,12,8,0.339907,0.353598,0,No
2,2,4,2,2,4,2,2,4,8,0.319454,0.330277,0,No
1,1,1,1,1,2,1,1,2,8,0.301584,0.314486,0,No
1,1,1,1,1,2,1,1,2,9,0.268721,0.277328,0,No
1,1,1,1,1,2,1,1,2,8,0.301589,0.314491,0,No
1,1,1,1,1,2,1,1,2,8,0.27122,0.279026,0,No
2,2,4,1,1,2,2,2,4,8,0.301584,0.314486,0,No
2,2,4,2,1,3,2,2,4,8,0.303655,0.312962,0,No
5,5,25,3,3,6,5,5,10,8,0.349437,0.363477,0,No
2,2,4,2,2,4,2,2,4,8,0.315083,0.329711,0,No
1,1,1,1,1,2,1,1,2,7,0.296305,0.304855,0,No
3,2,6,2,3,5,3,3,6,7,0.323961,0.334648,0,No
1,1,1,1,1,2,1,1,2,8,0.286528,0.293662,0,No
2,2,4,1,2,3,2,2,4,7,0.331675,0.342078,0,No
8,8,64,1,5,6,8,8,16,7,0.338156,0.349661,0,No
1,1,1,1,1,2,1,1,2,8,0.287726,0.294881,0,No
1,1,1,1,1,2,1,1,2,7,0.296305,0.304855,0,No
3,3,9,1,2,3,3,3,6,7,0.297659,0.306496,0,No
1,1,1,1,1,2,1,1,2,8,0.288163,0.299063,0,No
2,2,4,1,1,2,2,2,4,8,0.323426,0.334429,0,No
2,2,4,1,1,2,2,2,4,8,0.281452,0.288543,0,No
12,12,144,1,7,8,12,12,24,7,0.339697,0.352278,0,No
1,1,1,1,1,2,1,1,2,7,0.296305,0.304855,0,No
2,2,4,1,1,2,2,2,4,7,0.296305,0.304855,0,No
1,1,1,1,1,2,1,1,2,7,0.297726,0.304624,0,No
4,4,16,3,3,6,4,4,8,8,0.292922,0.304298,0,No
1,1,1,1,1,2,1,1,2,8,0.313497,0.320213,0,No
3,3,9,1,3,4,3,3,6,8,0.339016,0.351433,0,No
1,1,1,1,1,2,1,1,2,8,0.317292,0.324388,0,No
2,2,4,1,1,2,2,2,4,8,0.317298,0.324393,0,No
1,1,1,1,1,2,1,1,2,8,0.30359,0.310474,0,No
3,3,9,3,3,6,3,3,6,8,0.324972,0.332738,0,No
1,1,1,1,1,2,1,1,2,8,0.309331,0.317947,0,No
3,3,9,3,3,6,3,3,6,8,0.310779,0.319404,0,No
1,1,1,1,1,2,1,1,2,8,0.29902,0.30606,0,No
3,3,9,2,2,4,3,3,6,8,0.323555,0.334649,0,No
1,1,1,1,1,2,1,1,2,8,0.309331,0.317947,0,No
2,2,4,2,2,4,2,2,4,8,0.315083,0.329711,0,No
2,2,4,2,2,4,2,2,4,8,0.315853,0.327325,0,No
1,1,1,1,1,2,1,1,2,8,0.288929,0.297713,0,No
1,1,1,1,1,2,1,1,2,8,0.310722,0.317507,0,No
2,2,4,1,2,3,2,2,4,8,0.330935,0.343947,0,No
6,6,36,6,6,12,6,6,12,7,0.325667,0.335593,0,No
3,3,9,2,2,4,3,3,6,8,0.301738,0.309138,0,No
1,1,1,1,1,2,1,1,2,8,0.32342,0.334424,0,No
4,4,16,2,3,5,4,4,8,8,0.327693,0.338818,0,No
4,4,16,4,4,8,4,4,8,7,0.357191,0.372602,0,No
5,5,25,4,4,8,5,5,10,8,0.336754,0.349068,0,No
1,1,1,1,1,2,1,1,2,8,0.32342,0.334424,0,No
2,2,4,2,2,4,2,2,4,8,0.328995,0.340857,0,No
2,2,4,2,2,4,2,2,4,8,0.288114,0.295197,0,No
1,1,1,1,1,2,1,1,2,8,0.288163,0.299063,0,No
5,5,25,3,2,5,5,5,10,8,0.336416,0.348399,0,No
5,5,25,3,3,6,5,5,10,8,0.344366,0.357226,0,No
10,10,100,5,3,8,10,10,20,8,0.325673,0.334093,0,No
4,4,16,3,3,6,4,4,8,8,0.293633,0.303209,0,No
4,4,16,4,4,8,4,4,8,8,0.345566,0.357889,0,No
1,1,1,1,1,2,1,1,2,8,0.317445,0.327454,0,No
1,1,1,1,1,2,1,1,2,8,0.301584,0.314486,0,No
2,2,4,2,2,4,2,2,4,8,0.305127,0.313294,0,No
1,1,1,1,1,2,1,1,2,8,0.331571,0.343073,0,No
1,1,1,1,1,2,1,1,2,8,0.263115,0.26899,0,No
1,1,1,1,1,2,1,1,2,8,0.27455,0.283664,0,No
3,3,9,3,3,6,3,3,6,8,0.338572,0.35301,0,No
3,3,9,2,2,4,3,3,6,8,0.298174,0.310964,0,No
1,1,1,1,1,2,1,1,2,9,0.252654,0.257293,0,No
1,1,1,1,1,2,1,1,2,8,0.30338,0.311471,0,No
1,1,1,1,1,2,1,1,2,8,0.267857,0.275083,0,No
1,1,1,1,1,2,1,1,2,8,0.314583,0.32146,0,No
4,4,16,3,3,6,4,4,8,7,0.333927,0.345625,0,No
1,1,1,1,1,2,1,1,2,8,0.339941,0.352199,0,No
1,1,1,1,1,2,1,1,2,8,0.299745,0.307615,0,No
1,1,1,1,1,2,1,1,2,8,0.271886,0.278359,0,No
1,1,1,1,1,2,1,1,2,8,0.280056,0.287563,0,No
1,1,1,1,1,2,1,1,2,8,0.32342,0.334424,0,No
1,1,1,1,1,2,1,1,2,8,0.303358,0.310126,0,No
1,1,1,1,1,2,1,1,2,8,0.303358,0.310126,0,No
2,2,4,1,2,3,2,2,4,8,0.288275,0.295595,0,No
2,2,4,2,1,3,2,2,4,7,0.327819,0.338512,0,No
2,2,4,1,2,3,2,2,4,8,0.28207,0.289064,0,No
1,1,1,1,1,2,1,1,2,7,0.327819,0.338512,0,No
1,1,1,1,1,2,1,1,2,7,0.327819,0.338512,0,No
1,1,1,1,1,2,1,1,2,8,0.303364,0.310131,0,No
1,1,1,1,1,2,1,1,2,7,0.327819,0.338512,0,No
4,4,16,3,3,6,4,4,8,8,0.340974,0.353361,0,No
2,2,4,2,2,4,2,2,4,7,0.332379,0.343252,0,No
1,1,1,1,1,2,1,1,2,7,0.327819,0.338512,0,No
4,4,16,3,3,6,4,4,8,7,0.334615,0.346352,0,No
1,1,1,1,1,2,1,1,2,8,0.311306,0.32231,0,No
2,2,4,2,2,4,2,2,4,8,0.324552,0.334824,0,No
1,1,1,1,1,2,1,1,2,7,0.327819,0.338512,0,No
1,1,1,1,1,2,1,1,2,9,0.268641,0.276936,0,No
1,1,1,1,1,2,1,1,2,8,0.309325,0.317943,0,No
1,1,1,1,1,2,1,1,2,8,0.296166,0.303813,0,No
1,1,1,1,1,2,1,1,2,7,0.327826,0.338517,0,No
1,1,1,1,1,2,1,1,2,8,0.288168,0.299068,0,No
6,6,36,5,2,7,6,6,12,8,0.309775,0.323433,0,No
4,4,16,1,2,3,4,4,8,8,0.323439,0.334473,0,No
4,4,16,2,2,4,4,4,8,8,0.329414,0.342904,0,No
1,1,1,1,1,2,1,1,2,9,0.268637,0.276931,0,No
1,1,1,1,1,2,1,1,2,8,0.28349,0.292904,0,No
1,1,1,1,1,2,1,1,2,9,0.268721,0.277328,0,No
1,1,1,1,1,2,1,1,2,8,0.301589,0.314491,0,No
1,1,1,1,1,2,1,1,2,8,0.279104,0.286806,0,No
1,1,1,1,1,2,1,1,2,9,0.26357,0.269699,0,No
1,1,1,1,1,2,1,1,2,8,0.294469,0.301552,0,No
2,2,4,2,2,4,2,2,4,8,0.316609,0.32539,0,No
8,8,64,3,4,7,8,8,16,8,0.318941,0.329662,0,No
2,2,4,1,1,2,2,2,4,8,0.323426,0.334429,0,No
2,2,4,1,1,2,2,2,4,8,0.323426,0.334429,0,No
1,1,1,1,1,2,1,1,2,9,0.268641,0.276936,0,No
1,1,1,1,1,2,1,1,2,8,0.277096,0.285605,0,No
2,2,4,2,2,4,2,2,4,8,0.308698,0.315073,0,No
2,2,4,1,1,2,2,2,4,8,0.287416,0.294491,0,No
1,1,1,1,1,2,1,1,2,7,0.327819,0.338512,0,No
3,3,9,3,3,6,3,3,6,8,0.321682,0.335794,0,No
2,2,4,1,1,2,2,2,4,8,0.310028,0.318679,0,No
1,1,1,1,1,2,1,1,2,8,0.290622,0.298005,0,No
1,1,1,1,1,2,1,1,2,8,0.331571,0.343073,0,No
15,15,225,6,3,9,15,15,30,8,0.308135,0.314605,0,No
1,1,1,1,1,2,1,1,2,9,0.244943,0.250799,0,No
2,2,4,1,1,2,2,2,4,8,0.303834,0.31039,0,No
1,1,1,1,1,2,1,1,2,8,0.292345,0.299887,0,No
1,1,1,1,1,2,1,1,2,8,0.306437,0.313195,0,No
1,1,1,1,1,2,1,1,2,8,0.271899,0.280395,0,No
1,1,1,1,1,2,1,1,2,9,0.268641,0.276936,0,No
1,1,1,1,1,2,1,1,2,9,0.268721,0.277328,0,No
2,2,4,1,2,3,2,2,4,8,0.288885,0.298277,0,No
4,4,16,3,1,4,4,4,8,8,0.30338,0.311471,0,No
2,2,4,1,1,2,2,2,4,8,0.303375,0.311466,0,No
1,1,1,1,1,2,1,1,2,8,0.30338,0.311471,0,No
5,5,25,1,4,5,5,5,10,8,0.322059,0.330594,0,No
1,1,1,1,1,2,1,1,2,8,0.323426,0.334429,0,No
1,1,1,1,1,2,1,1,2,8,0.294479,0.3016,0,No
3,3,9,2,3,5,3,3,6,7,0.347898,0.361321,0,No
3,3,9,1,3,4,3,3,6,8,0.341014,0.353438,0,No
1,1,1,1,1,2,1,1,2,8,0.28699,0.295341,0,No
1,1,1,1,1,2,1,1,2,8,0.32342,0.334424,0,No
1,1,1,1,1,2,1,1,2,8,0.331571,0.343073,0,No
1,1,1,1,1,2,1,1,2,8,0.339934,0.352194,0,No
6,6,36,1,4,5,6,6,12,8,0.331881,0.342656,0,No
1,1,1,1,1,2,1,1,2,9,0.255465,0.260315,0,No
5,5,25,3,3,6,5,5,10,8,0.298842,0.305942,0,No
6,6,36,3,5,8,6,6,12,8,0.348111,0.362199,0,No
2,2,4,1,2,3,2,2,4,8,0.292631,0.300051,0,No
5,5,25,4,5,9,5,5,10,8,0.337674,0.350287,0,No
2,2,4,1,1,2,2,2,4,7,0.327819,0.338512,0,No
1,1,1,1,1,2,1,1,2,8,0.27455,0.283664,0,No
1,1,1,1,1,2,1,1,2,8,0.287605,0.295192,0,No
2,2,4,2,2,4,2,2,4,8,0.305471,0.319297,0,No
1,1,1,1,1,2,1,1,2,8,0.339934,0.352194,0,No
1,1,1,1,1,2,1,1,2,8,0.331571,0.343073,0,No
1,1,1,1,1,2,1,1,2,8,0.267491,0.27391,0,No
1,1,1,1,1,2,1,1,2,8,0.302193,0.308972,0,No
1,1,1,1,1,2,1,1,2,8,0.301589,0.314491,0,No
1,1,1,1,1,2,1,1,2,8,0.296171,0.303818,0,No
2,2,4,2,1,3,2,2,4,7,0.327819,0.338512,0,No
1,1,1,1,1,2,1,1,2,8,0.339941,0.352199,0,No
2,2,4,1,2,3,2,2,4,7,0.332236,0.343545,0,No
5,5,25,4,4,8,5,5,10,8,0.322442,0.331739,0,No
4,4,16,1,2,3,4,4,8,8,0.32226,0.330812,0,No
1,1,1,1,1,2,1,1,2,8,0.313848,0.32086,0,No
6,6,36,6,3,9,6,6,12,8,0.329427,0.341443,0,No
1,1,1,1,1,2,1,1,2,8,0.309325,0.317943,0,No
2,2,4,2,2,4,2,2,4,8,0.327668,0.3395,0,No
1,1,1,1,1,2,1,1,2,9,0.271535,0.278839,0,No
1,1,1,1,1,2,1,1,2,8,0.313502,0.320218,0,No
2,2,4,2,2,4,2,2,4,8,0.328995,0.340857,0,No
1,1,1,1,1,2,1,1,2,9,0.266659,0.272921,0,No
1,1,1,1,1,2,1,1,2,9,0.26776,0.274477,0,No
1,1,1,1,1,2,1,1,2,8,0.331571,0.343073,0,No
1,1,1,1,1,2,1,1,2,8,0.270992,0.277735,0,No
2,2,4,1,2,3,2,2,4,8,0.340294,0.352542,0,No
1,1,1,1,1,2,1,1,2,8,0.27455,0.283664,0,No
1,1,1,1,1,2,1,1,2,8,0.331578,0.343078,0,No
2,2,4,2,2,4,2,2,4,8,0.306321,0.314755,0,No
2,2,4,2,2,4,2,2,4,8,0.30685,0.313587,0,No
1,1,1,1,1,2,1,1,2,8,0.289257,0.299292,0,No
1,1,1,1,1,2,1,1,2,9,0.274793,0.281439,0,No
1,1,1,1,1,2,1,1,2,8,0.30592,0.312609,0,No
1,1,1,1,1,2,1,1,2,8,0.297151,0.304591,0,No
1,1,1,1,1,2,1,1,2,8,0.27585,0.282586,0,No
1,1,1,1,1,2,1,1,2,8,0.27317,0.279741,0,No
3,3,9,2,2,4,3,3,6,8,0.303823,0.31067,0,No
1,1,1,1,1,2,1,1,2,8,0.296433,0.303283,0,No
1,1,1,1,1,2,1,1,2,9,0.276494,0.283276,0,No
4,4,16,2,3,5,4,4,8,8,0.314705,0.321659,0,No
1,1,1,1,1,2,1,1,2,8,0.2828,0.289824,0,No
3,3,9,2,2,4,3,3,6,8,0.297172,0.304315,0,No
1,1,1,1,1,2,1,1,2,8,0.279845,0.287076,0,No
1,1,1,1,1,2,1,1,2,8,0.301589,0.314491,0,No
1,1,1,1,1,2,1,1,2,9,0.268641,0.276936,0,No
2,2,4,1,1,2,2,2,4,9,0.24556,0.249318,0,No
1,1,1,1,1,2,1,1,2,9,0.229752,0.232901,0,No
1,1,1,1,1,2,1,1,2,8,0.339934,0.352194,0,No
2,2,4,1,1,2,2,2,4,8,0.317298,0.324393,0,No
1,1,1,1,1,2,1,1,2,8,0.279245,0.286914,0,No
2,2,4,2,2,4,2,2,4,8,0.287512,0.298106,0,No
1,1,1,1,1,2,1,1,2,8,0.301584,0.308533,0,No
2,2,4,1,1,2,2,2,4,8,0.26303,0.26883,0,No
2,2,4,1,1,2,2,2,4,8,0.331571,0.343073,0,No
2,1,2,2,2,4,2,2,4,8,0.325332,0.33619,0,No
1,1,1,1,1,2,1,1,2,9,0.259742,0.266039,0,No
1,1,1,1,1,2,1,1,2,8,0.32342,0.334424,0,No
2,1,2,2,2,4,2,2,4,8,0.352003,0.366286,0,No
1,1,1,1,1,2,1,1,2,9,0.242793,0.246514,0,No
1,1,1,1,1,2,1,1,2,8,0.301589,0.314491,0,No
1,1,1,1,1,2,1,1,2,9,0.246586,0.250621,0,No
1,1,1,1,1,2,1,1,2,8,0.301589,0.314491,0,No
2,2,4,1,1,2,2,2,4,8,0.301584,0.314486,0,No
1,1,1,1,1,2,1,1,2,9,0.253797,0.258651,0,No
4,4,16,4,2,6,4,4,8,8,0.327668,0.3395,0,No
1,1,1,1,1,2,1,1,2,8,0.29974,0.30761,0,No
1,1,1,1,1,2,1,1,2,8,0.301584,0.314486,0,No
2,2,4,2,1,3,2,2,4,8,0.253078,0.258073,0,No
1,1,1,1,1,2,1,1,2,9,0.268485,0.274897,0,No
1,1,1,1,1,2,1,1,2,8,0.339941,0.352199,0,No
2,2,4,1,2,3,2,2,4,8,0.303111,0.310785,0,No
2,1,2,2,2,4,2,2,4,7,0.328311,0.339053,0,No
2,2,4,1,2,3,2,2,4,8,0.31964,0.326905,0,No
5,5,25,4,3,7,5,5,10,8,0.317859,0.327389,0,No
2,2,4,1,1,2,2,2,4,8,0.310028,0.318679,0,No
1,1,1,1,1,2,1,1,2,9,0.268645,0.276939,0,No
1,1,1,1,1,2,1,1,2,9,0.271721,0.278269,0,No
2,2,4,1,1,2,2,2,4,8,0.2876,0.295187,0,No
1,1,1,1,1,2,1,1,2,8,0.339934,0.352194,0,No
1,1,1,1,1,2,1,1,2,9,0.303801,0.312033,0,No
2,2,4,1,1,2,2,2,4,8,0.294469,0.301552,0,No
4,4,16,4,3,7,4,4,8,8,0.315876,0.323055,0,No
1,1,1,1,1,2,1,1,2,9,0.244309,0.248587,0,No
2,2,4,1,1,2,2,2,4,9,0.259628,0.265175,0,No
1,1,1,1,1,2,1,1,2,8,0.317298,0.324393,0,No
1,1,1,1,1,2,1,1,2,8,0.293093,0.30049,0,No
1,1,1,1,1,2,1,1,2,9,0.259628,0.265175,0,No
4,4,16,1,3,4,4,4,8,8,0.312841,0.320063,0,No
3,3,9,2,2,4,3,3,6,8,0.3403,0.352668,0,No
5,5,25,4,4,8,5,5,10,7,0.331552,0.342151,0,No
2,2,4,2,2,4,2,2,4,8,0.308008,0.314362,0,No
1,1,1,1,1,2,1,1,2,8,0.313497,0.320213,0,No
1,1,1,1,1,2,1,1,2,7,0.296305,0.304855,0,No
1,1,1,1,1,2,1,1,2,8,0.317445,0.327454,0,No
2,2,4,1,1,2,2,2,4,8,0.323426,0.334429,0,No
1,1,1,1,1,2,1,1,2,8,0.27122,0.279026,0,No
1,1,1,1,1,2,1,1,2,8,0.288929,0.297713,0,No
1,1,1,1,1,2,1,1,2,8,0.339934,0.352194,0,No
7,7,49,5,7,12,7,7,14,8,0.360458,0.375991,0,No
3,3,9,2,1,3,3,3,6,8,0.32342,0.334424,0,No
2,2,4,2,2,4,2,2,4,8,0.323881,0.335064,0,No
1,1,1,1,1,2,1,1,2,8,0.27122,0.279026,0,No
1,1,1,1,1,2,1,1,2,8,0.288929,0.297713,0,No
2,2,4,1,1,2,2,2,4,8,0.317445,0.327454,0,No
1,1,1,1,1,2,1,1,2,8,0.292405,0.299561,0,No
1,1,1,1,1,2,1,1,2,7,0.327819,0.338512,0,No
2,2,4,2,2,4,2,2,4,8,0.30928,0.31571,0,No
1,1,1,1,1,2,1,1,2,8,0.296171,0.303818,0,No
1,1,1,1,1,2,1,1,2,9,0.255737,0.261999,0,No
1,1,1,1,1,2,1,1,2,8,0.339934,0.352194,0,No
1,1,1,1,1,2,1,1,2,8,0.309325,0.317943,0,No
2,2,4,2,1,3,2,2,4,8,0.309325,0.317943,0,No
2,2,4,2,1,3,2,2,4,8,0.309331,0.317947,0,No
1,1,1,1,1,2,1,1,2,8,0.309331,0.317947,0,No
1,1,1,1,1,2,1,1,2,8,0.309325,0.317943,0,No
1,1,1,1,1,2,1,1,2,8,0.309331,0.317947,0,No
3,3,9,2,2,4,3,3,6,8,0.314769,0.323185,0,No
1,1,1,1,1,2,1,1,2,8,0.309325,0.317943,0,No
6,6,36,5,1,6,6,6,12,8,0.309325,0.317943,0,No
1,1,1,1,1,2,1,1,2,9,0.254828,0.259834,0,No
2,1,2,2,2,4,2,2,4,8,0.311807,0.320089,0,No
1,1,1,1,1,2,1,1,2,8,0.296444,0.303647,0,No
5,5,25,1,4,5,5,5,10,8,0.318887,0.329269,0,No
6,6,36,1,3,4,6,6,12,8,0.353359,0.368787,0,No
1,1,1,1,1,2,1,1,2,9,0.268641,0.276936,0,No
2,2,4,1,2,3,2,2,4,7,0.330877,0.341362,0,No
2,2,4,2,2,4,2,2,4,8,0.34113,0.353413,0,No
8,8,64,6,3,9,8,8,16,8,0.331057,0.343971,0,No
1,1,1,1,1,2,1,1,2,8,0.278003,0.285466,0,No
1,1,1,1,1,2,1,1,2,8,0.32342,0.334424,0,No
2,2,4,2,2,4,2,2,4,8,0.304696,0.311303,0,No
2,2,4,2,2,4,2,2,4,8,0.308793,0.315363,0,No
4,4,16,3,3,6,4,4,8,8,0.318672,0.325962,0,No
1,1,1,1,1,2,1,1,2,7,0.296305,0.304855,0,No
1,1,1,1,1,2,1,1,2,8,0.331571,0.343073,0,No
17,17,289,9,3,12,17,17,34,8,0.335655,0.347588,0,No
1,1,1,1,1,2,1,1,2,8,0.27585,0.282586,0,No
1,1,1,1,1,2,1,1,2,8,0.331571,0.343073,0,No
1,1,1,1,1,2,1,1,2,8,0.331571,0.343073,0,No
2,2,4,2,1,3,2,2,4,8,0.331571,0.343073,0,No
1,1,1,1,1,2,1,1,2,8,0.317298,0.324393,0,No
2,2,4,2,2,4,2,2,4,8,0.331836,0.343335,0,No
1,1,1,1,1,2,1,1,2,8,0.331578,0.343078,0,No
2,2,4,1,1,2,2,2,4,8,0.331571,0.343073,0,No
2,2,4,1,1,2,2,2,4,8,0.310028,0.318679,0,No
3,3,9,2,2,4,3,3,6,8,0.331746,0.343257,0,No
9,9,81,4,4,8,9,9,18,8,0.35292,0.36892,0,No
1,1,1,1,1,2,1,1,2,9,0.264444,0.270269,0,No
9,9,81,5,4,9,9,9,18,8,0.361995,0.378738,0,No
2,2,4,2,2,4,2,2,4,8,0.311266,0.320085,0,No
1,1,1,1,1,2,1,1,2,8,0.282224,0.289322,0,No
6,6,36,4,4,8,6,6,12,8,0.306817,0.313226,0,No
2,2,4,2,2,4,2,2,4,8,0.277181,0.284269,0,No
3,3,9,3,3,6,3,3,6,8,0.295248,0.304087,0,No
1,1,1,1,1,2,1,1,2,8,0.309983,0.317112,0,No
1,1,1,1,1,2,1,1,2,8,0.339934,0.352194,0,No
1,1,1,1,1,2,1,1,2,8,0.295637,0.302489,0,No
2,2,4,2,2,4,2,2,4,9,0.289321,0.297417,0,No
2,2,4,1,1,2,2,2,4,8,0.27451,0.281294,0,No
1,1,1,1,1,2,1,1,2,8,0.30338,0.311471,0,No
2,2,4,2,2,4,2,2,4,8,0.314943,0.323499,0,No
5,5,25,2,4,6,5,5,10,8,0.34359,0.357509,0,No
3,3,9,2,3,5,3,3,6,8,0.326265,0.334495,0,No
3,3,9,3,3,6,3,3,6,8,0.345132,0.357968,0,No
1,1,1,1,1,2,1,1,2,8,0.25921,0.264675,0,No
1,1,1,1,1,2,1,1,2,8,0.317292,0.324388,0,No
1,1,1,1,1,2,1,1,2,8,0.279241,0.286909,0,No
2,2,4,2,2,4,2,2,4,8,0.331726,0.343278,0,No
1,1,1,1,1,2,1,1,2,8,0.303688,0.310784,0,No
3,2,6,3,3,6,3,3,6,8,0.312595,0.319227,0,No
1,1,1,1,1,2,1,1,2,9,0.259367,0.264984,0,No
1,1,1,1,1,2,1,1,2,9,0.265093,0.271684,0,No
2,2,4,2,2,4,2,2,4,8,0.352003,0.366286,0,No
1,1,1,1,1,2,1,1,2,8,0.268214,0.275186,0,No
2,2,4,2,2,4,2,2,4,7,0.329745,0.340907,0,No
1,1,1,1,1,2,1,1,2,8,0.313497,0.320213,0,No
1,1,1,1,1,2,1,1,2,7,0.327819,0.338512,0,No
1,1,1,1,1,2,1,1,2,9,0.26388,0.270162,0,No
1,1,1,1,1,2,1,1,2,8,0.301589,0.314491,0,No
1,1,1,1,1,2,1,1,2,8,0.29596,0.304319,0,No
1,1,1,1,1,2,1,1,2,8,0.268345,0.275546,0,No
1,1,1,1,1,2,1,1,2,8,0.302584,0.309507,0,No
1,1,1,1,1,2,1,1,2,9,0.244589,0.24915,0,No
1,1,1,1,1,2,1,1,2,8,0.339934,0.352194,0,No
1,1,1,1,1,2,1,1,2,8,0.292962,0.300182,0,No
1,1,1,1,1,2,1,1,2,8,0.268345,0.275546,0,No
3,2,6,3,2,5,3,3,6,8,0.308553,0.318468,0,No
3,2,6,2,2,4,3,3,6,8,0.318256,0.328459,0,No
1,1,1,1,1,2,1,1,2,8,0.288168,0.299068,0,No
1,1,1,1,1,2,1,1,2,8,0.288168,0.299068,0,No
1,1,1,1,1,2,1,1,2,8,0.288163,0.299063,0,No
2,2,4,2,2,4,2,2,4,8,0.320968,0.332012,0,No
1,1,1,1,1,2,1,1,2,9,0.303801,0.312033,0,No
2,2,4,2,2,4,2,2,4,7,0.329605,0.340411,0,No
5,5,25,4,3,7,5,5,10,8,0.333425,0.343871,0,No
3,3,9,3,3,6,3,3,6,8,0.323721,0.333317,0,No
1,1,1,1,1,2,1,1,2,8,0.32342,0.334424,0,No
3,3,9,1,3,4,3,3,6,8,0.329688,0.341083,0,No
7,7,49,6,4,10,7,7,14,8,0.302241,0.310126,0,No
4,4,16,3,2,5,4,4,8,8,0.338243,0.351497,0,No
3,3,9,2,2,4,3,3,6,8,0.323543,0.334625,0,No
1,1,1,1,1,2,1,1,2,8,0.32342,0.334424,0,No
1,1,1,1,1,2,1,1,2,8,0.32342,0.334424,0,No
2,2,4,2,2,4,2,2,4,7,0.339306,0.352082,0,No
5,5,25,4,4,8,5,5,10,8,0.318138,0.327789,0,No
2,2,4,2,2,4,2,2,4,8,0.338243,0.351497,0,No
1,1,1,1,1,2,1,1,2,8,0.301589,0.314491,0,No
1,1,1,1,1,2,1,1,2,8,0.32342,0.334424,0,No
1,1,1,1,1,2,1,1,2,9,0.253115,0.258182,0,No
3,3,9,3,3,6,3,3,6,8,0.338558,0.351808,0,No
3,3,9,3,3,6,3,3,6,8,0.278898,0.287908,0,No
1,1,1,1,1,2,1,1,2,8,0.339934,0.352194,0,No
1,1,1,1,1,2,1,1,2,9,0.268717,0.277323,0,No
1,1,1,1,1,2,1,1,2,8,0.32342,0.334424,0,No
1,1,1,1,1,2,1,1,2,8,0.32342,0.334424,0,No
1,1,1,1,1,2,1,1,2,8,0.32342,0.334424,0,No
1,1,1,1,1,2,1,1,2,8,0.331571,0.343073,0,No
1,1,1,1,1,2,1,1,2,8,0.30833,0.31471,0,No
2,2,4,1,1,2,2,2,4,8,0.30338,0.311471,0,No
1,1,1,1,1,2,1,1,2,8,0.331571,0.343073,0,No
8,8,64,6,2,8,8,8,16,8,0.338008,0.350304,0,No
1,1,1,1,1,2,1,1,2,8,0.309466,0.316145,0,No
1,1,1,1,1,2,1,1,2,8,0.331571,0.343073,0,No
4,4,16,3,2,5,4,4,8,8,0.3347,0.34661,0,No
1,1,1,1,1,2,1,1,2,8,0.331571,0.343073,0,No
6,6,36,5,2,7,6,6,12,8,0.346281,0.360278,0,No
7,7,49,4,3,7,7,7,14,8,0.353513,0.369186,0,No
4,4,16,3,1,4,4,4,8,8,0.331571,0.343073,0,No
4,4,16,3,2,5,4,4,8,8,0.332963,0.344541,0,No
2,2,4,1,1,2,2,2,4,8,0.303655,0.312962,0,No
4,4,16,2,3,5,4,4,8,8,0.313376,0.326572,0,No
7,7,49,5,4,9,7,7,14,7,0.351764,0.366255,0,No
1,1,1,1,1,2,1,1,2,8,0.306657,0.315385,0,No
1,1,1,1,1,2,1,1,2,8,0.317439,0.327445,0,No
1,1,1,1,1,2,1,1,2,9,0.257508,0.263395,0,No
6,6,36,2,1,3,6,6,12,9,0.276051,0.283073,0,No
1,1,1,1,1,2,1,1,2,8,0.274545,0.283659,0,No
1,1,1,1,1,2,1,1,2,7,0.327819,0.338512,0,No
2,2,4,1,2,3,2,2,4,8,0.320029,0.327266,0,No
2,2,4,2,2,4,2,2,4,8,0.306211,0.314267,0,No
3,3,9,2,2,4,3,3,6,8,0.338015,0.350314,0,No
11,11,121,10,5,15,11,11,22,8,0.345167,0.358376,0,No
1,1,1,1,1,2,1,1,2,9,0.268641,0.276936,0,No
1,1,1,1,1,2,1,1,2,9,0.268721,0.277328,0,No
1,1,1,1,1,2,1,1,2,7,0.327819,0.338512,0,No
4,4,16,4,4,8,4,4,8,8,0.350485,0.364113,0,No
3,3,9,2,2,4,3,3,6,8,0.302503,0.315889,0,No
1,1,1,1,1,2,1,1,2,8,0.256903,0.262046,0,No
1,1,1,1,1,2,1,1,2,8,0.308542,0.315798,0,No
6,6,36,6,3,9,6,6,12,8,0.337267,0.349774,0,No
1,1,1,1,1,2,1,1,2,8,0.274545,0.283659,0,No
1,1,1,1,1,2,1,1,2,9,0.244305,0.248584,0,No
2,2,4,2,2,4,2,2,4,8,0.302096,0.309358,0,No
1,1,1,1,1,2,1,1,2,8,0.339934,0.352194,0,No
1,1,1,1,1,2,1,1,2,8,0.301589,0.314491,0,No
1,1,1,1,1,2,1,1,2,8,0.32342,0.334424,0,No
1,1,1,1,1,2,1,1,2,8,0.317298,0.324393,0,No
2,2,4,1,1,2,2,2,4,8,0.288934,0.297717,0,No
1,1,1,1,1,2,1,1,2,8,0.285597,0.293073,0,No
1,1,1,1,1,2,1,1,2,8,0.265394,0.271499,0,No
3,3,9,2,2,4,3,3,6,8,0.275201,0.284325,0,No
1,1,1,1,1,2,1,1,2,9,0.268641,0.276936,0,No
4,3,12,2,2,4,4,4,8,7,0.331507,0.343048,0,No
3,3,9,1,3,4,3,3,6,8,0.340586,0.353088,0,No
2,2,4,1,1,2,2,2,4,8,0.306657,0.315385,0,No
2,2,4,2,2,4,2,2,4,8,0.337347,0.34954,0,No
2,2,4,1,1,2,2,2,4,8,0.317439,0.327445,0,No
2,2,4,1,1,2,2,2,4,8,0.303661,0.312967,0,No
2,2,4,2,2,4,2,2,4,8,0.307946,0.32196,0,No
2,2,4,2,2,4,2,2,4,8,0.317788,0.324397,0,No
1,1,1,1,1,2,1,1,2,8,0.30338,0.311471,0,No
3,3,9,3,2,5,3,3,6,8,0.310157,0.318704,0,No
1,1,1,1,1,2,1,1,2,8,0.282257,0.289547,0,No
1,1,1,1,1,2,1,1,2,9,0.268645,0.276939,0,No
1,1,1,1,1,2,1,1,2,8,0.339934,0.352194,0,No
2,2,4,1,1,2,2,2,4,8,0.268345,0.275546,0,No
1,1,1,1,1,2,1,1,2,8,0.331571,0.343073,0,No
1,1,1,1,1,2,1,1,2,9,0.242204,0.245283,0,No
2,2,4,2,2,4,2,2,4,8,0.317723,0.326062,0,No
3,3,9,2,2,4,3,3,6,8,0.339948,0.352234,0,No
2,2,4,2,2,4,2,2,4,8,0.33541,0.346459,0,No
1,1,1,1,1,2,1,1,2,8,0.296438,0.303643,0,No
1,1,1,1,1,2,1,1,2,8,0.268345,0.275546,0,No
2,2,4,1,1,2,2,2,4,9,0.279465,0.286694,0,No
5,5,25,1,1,2,5,5,10,7,0.327819,0.338512,0,No
2,2,4,1,1,2,2,2,4,8,0.281141,0.288277,0,No
2,2,4,1,1,2,2,2,4,8,0.315759,0.323487,0,No
1,1,1,1,1,2,1,1,2,8,0.313502,0.320218,0,No
2,2,4,1,1,2,2,2,4,8,0.272724,0.279994,0,No
1,1,1,1,1,2,1,1,2,8,0.339934,0.352194,0,No
1,1,1,1,1,2,1,1,2,8,0.305083,0.312173,0,No
2,2,4,2,2,4,2,2,4,8,0.303699,0.310605,0,No
1,1,1,1,1,2,1,1,2,8,0.310033,0.318684,0,No
1,1,1,1,1,2,1,1,2,7,0.327813,0.338503,0,No
1,1,1,1,1,2,1,1,2,8,0.288178,0.295479,0,No
1,1,1,1,1,2,1,1,2,8,0.29165,0.298832,0,No
2,2,4,2,2,4,2,2,4,8,0.301584,0.308822,0,No
1,1,1,1,1,2,1,1,2,8,0.28349,0.292904,0,No
2,2,4,1,1,2,2,2,4,8,0.317451,0.327459,0,No
1,1,1,1,1,2,1,1,2,8,0.289424,0.296547,0,No
2,2,4,2,1,3,2,2,4,8,0.30338,0.311471,0,No
1,1,1,1,1,2,1,1,2,9,0.253891,0.258784,0,No
1,1,1,1,1,2,1,1,2,9,0.262237,0.268863,0,No
1,1,1,1,1,2,1,1,2,9,0.268641,0.276936,0,No
1,1,1,1,1,2,1,1,2,8,0.301584,0.314486,0,No
1,1,1,1,1,2,1,1,2,8,0.301584,0.314486,0,No
1,1,1,1,1,2,1,1,2,8,0.303655,0.312962,0,No
6,6,36,3,4,7,6,6,12,8,0.342479,0.356273,0,No
1,1,1,1,1,2,1,1,2,8,0.301589,0.314491,0,No
1,1,1,1,1,2,1,1,2,9,0.252621,0.257729,0,No
1,1,1,1,1,2,1,1,2,8,0.287338,0.294477,0,No
5,5,25,1,5,6,5,5,10,8,0.318774,0.32607,0,No
1,1,1,1,1,2,1,1,2,8,0.309325,0.317943,0,No
3,3,9,2,1,3,3,3,6,8,0.310028,0.318679,0,No
1,1,1,1,1,2,1,1,2,8,0.339934,0.352194,0,No
6,6,36,5,3,8,6,6,12,8,0.319185,0.329232,0,No
2,2,4,1,1,2,2,2,4,8,0.27455,0.283664,0,No
1,1,1,1,1,2,1,1,2,9,0.241768,0.245561,0,No
1,1,1,1,1,2,1,1,2,9,0.268637,0.276931,0,No
1,1,1,1,1,2,1,1,2,8,0.278493,0.285418,0,No
1,1,1,1,1,2,1,1,2,8,0.271894,0.28039,0,No
7,4,28,3,4,7,7,7,14,7,0.336363,0.347454,0,No
4,4,16,2,2,4,4,4,8,8,0.319394,0.326502,0,No
4,4,16,3,2,5,4,4,8,8,0.310327,0.318616,0,No
3,3,9,2,2,4,3,3,6,8,0.334123,0.346355,0,No
4,4,16,2,2,4,4,4,8,8,0.309342,0.316771,0,No
1,1,1,1,1,2,1,1,2,8,0.301589,0.314491,0,No
1,1,1,1,1,2,1,1,2,8,0.295637,0.302489,0,No
3,3,9,2,3,5,3,3,6,8,0.281833,0.290039,0,No
2,2,4,1,1,2,2,2,4,8,0.288168,0.299068,0,No
2,2,4,1,1,2,2,2,4,8,0.28349,0.292904,0,No
2,2,4,1,1,2,2,2,4,8,0.313497,0.320213,0,No
1,1,1,1,1,2,1,1,2,9,0.268641,0.276936,0,No
2,2,4,2,2,4,2,2,4,8,0.293648,0.300613,0,No
2,2,4,2,2,4,2,2,4,8,0.282659,0.290016,0,No
1,1,1,1,1,2,1,1,2,9,0.234443,0.238394,0,No
1,1,1,1,1,2,1,1,2,7,0.327819,0.338512,0,No
1,1,1,1,1,2,1,1,2,9,0.247462,0.251403,0,No
1,1,1,1,1,2,1,1,2,8,0.288173,0.299071,0,No
1,1,1,1,1,2,1,1,2,8,0.310033,0.318684,0,No
3,3,9,3,3,6,3,3,6,7,0.332308,0.343652,0,No
1,1,1,1,1,2,1,1,2,7,0.2963,0.30485,0,No
1,1,1,1,1,2,1,1,2,8,0.32342,0.334424,0,No
2,2,4,2,1,3,2,2,4,8,0.301589,0.314491,0,No
3,3,9,3,2,5,3,3,6,8,0.316099,0.32721,0,No
3,3,9,3,2,5,3,3,6,7,0.308766,0.316449,0,No
1,1,1,1,1,2,1,1,2,7,0.327826,0.338517,0,No
2,2,4,2,1,3,2,2,4,8,0.32342,0.334424,0,No
2,2,4,2,2,4,2,2,4,8,0.315083,0.329711,0,No
1,1,1,1,1,2,1,1,2,8,0.29229,0.30057,0,No
2,2,4,2,2,4,2,2,4,8,0.291048,0.298205,0,No
1,1,1,1,1,2,1,1,2,9,0.253793,0.258648,0,No
4,4,16,4,2,6,4,4,8,7,0.352621,0.366966,0,No
1,1,1,1,1,2,1,1,2,8,0.278739,0.288248,0,No
3,3,9,3,3,6,3,3,6,7,0.353191,0.367493,0,No
2,2,4,2,2,4,2,2,4,8,0.291386,0.299214,0,No
3,3,9,2,2,4,3,3,6,8,0.27317,0.281936,0,No
1,1,1,1,1,2,1,1,2,8,0.277096,0.285605,0,No
1,1,1,1,1,2,1,1,2,7,0.327819,0.338512,0,No
1,1,1,1,1,2,1,1,2,8,0.309325,0.317943,0,No
1,1,1,1,1,2,1,1,2,8,0.278743,0.288253,0,No
2,2,4,1,1,2,2,2,4,8,0.271899,0.280395,0,No
2,2,4,2,2,4,2,2,4,7,0.303202,0.313323,0,No
1,1,1,1,1,2,1,1,2,8,0.271899,0.280395,0,No
1,1,1,1,1,2,1,1,2,9,0.268641,0.276936,0,No
2,2,4,2,2,4,2,2,4,9,0.273744,0.281502,0,No
2,2,4,2,2,4,2,2,4,7,0.329008,0.339516,0,No
1,1,1,1,1,2,1,1,2,9,0.260659,0.266396,0,No
1,1,1,1,1,2,1,1,2,8,0.310028,0.318679,0,No
1,1,1,1,1,2,1,1,2,8,0.27455,0.283664,0,No
1,1,1,1,1,2,1,1,2,8,0.339934,0.352194,0,No
1,1,1,1,1,2,1,1,2,8,0.339934,0.352194,0,No
1,1,1,1,1,2,1,1,2,8,0.271894,0.28039,0,No
3,3,9,2,2,4,3,3,6,7,0.298044,0.30662,0,No
1,1,1,1,1,2,1,1,2,9,0.259573,0.26534,0,No
2,2,4,1,1,2,2,2,4,8,0.303375,0.311466,0,No
1,1,1,1,1,2,1,1,2,9,0.218849,0.222131,0,No
1,1,1,1,1,2,1,1,2,8,0.275019,0.281639,0,No
5,5,25,3,3,6,5,5,10,7,0.334045,0.345156,0,No
10,10,100,5,4,9,10,10,20,7,0.310107,0.318647,0,No
1,1,1,1,1,2,1,1,2,8,0.273213,0.279982,0,No
4,3,12,3,3,6,4,4,8,8,0.313716,0.320875,0,No
2,1,2,2,2,4,2,2,4,8,0.339948,0.352234,0,No
4,4,16,3,3,6,4,4,8,7,0.316826,0.326184,0,No
1,1,1,1,1,2,1,1,2,8,0.303839,0.310394,0,No
2,2,4,2,2,4,2,2,4,7,0.328311,0.339053,0,No
1,1,1,1,1,2,1,1,2,7,0.327819,0.338512,0,No
1,1,1,1,1,2,1,1,2,7,0.327819,0.338512,0,No
5,5,25,3,1,4,5,5,10,8,0.274541,0.28365,0,No
3,3,9,3,2,5,3,3,6,7,0.331282,0.342332,0,No
3,3,9,2,2,4,3,3,6,8,0.339934,0.352214,0,No
1,1,1,1,1,2,1,1,2,8,0.291705,0.298878,0,No
2,2,4,2,2,4,2,2,4,8,0.330537,0.341041,0,No
4,4,16,3,2,5,4,4,8,7,0.335562,0.34584,0,No
2,2,4,2,2,4,2,2,4,8,0.331591,0.343122,0,No
1,1,1,1,1,2,1,1,2,8,0.289749,0.297209,0,No
1,1,1,1,1,2,1,1,2,8,0.32342,0.334424,0,No
1,1,1,1,1,2,1,1,2,8,0.274545,0.283659,0,No
1,1,1,1,1,2,1,1,2,8,0.331571,0.343073,0,No
1,1,1,1,1,2,1,1,2,8,0.331571,0.343073,0,No
1,1,1,1,1,2,1,1,2,7,0.327819,0.338512,0,No
1,1,1,1,1,2,1,1,2,8,0.313497,0.320213,0,No
1,1,1,1,1,2,1,1,2,7,0.327819,0.338512,0,No
1,1,1,1,1,2,1,1,2,8,0.261038,0.266636,0,No
1,1,1,1,1,2,1,1,2,8,0.331571,0.343073,0,No
1,1,1,1,1,2,1,1,2,9,0.28776,0.294983,0,No
6,6,36,4,2,6,6,6,12,8,0.338243,0.351497,0,No
1,1,1,1,1,2,1,1,2,8,0.32342,0.334424,0,No
3,3,9,2,2,4,3,3,6,8,0.304359,0.31767,0,No
2,2,4,2,2,4,2,2,4,8,0.304822,0.314031,0,No
1,1,1,1,1,2,1,1,2,8,0.286571,0.29368,0,No
6,6,36,2,4,6,6,6,12,8,0.34066,0.353549,0,No
1,1,1,1,1,2,1,1,2,8,0.286566,0.293675,0,No
2,2,4,1,1,2,2,2,4,8,0.32342,0.334424,0,No
3,3,9,2,3,5,3,3,6,8,0.341444,0.354156,0,No
5,5,25,4,5,9,5,5,10,8,0.326078,0.338498,0,No
4,4,16,2,4,6,4,4,8,8,0.342012,0.354784,0,No
1,1,1,1,1,2,1,1,2,8,0.279685,0.286739,0,No
1,1,1,1,1,2,1,1,2,8,0.255476,0.260233,0,No
1,1,1,1,1,2,1,1,2,9,0.244309,0.248587,0,No
1,1,1,1,1,2,1,1,2,9,0.262088,0.267976,0,No
2,2,4,2,2,4,2,2,4,8,0.30031,0.3078,0,No
2,2,4,1,2,3,2,2,4,7,0.299998,0.308443,0,No
2,2,4,2,2,4,2,2,4,8,0.313514,0.320262,0,No
2,1,2,2,1,3,2,2,4,9,0.273231,0.280286,0,No
1,1,1,1,1,2,1,1,2,8,0.339934,0.352194,0,No
1,1,1,1,1,2,1,1,2,8,0.289257,0.299292,0,No
2,2,4,2,2,4,2,2,4,8,0.317889,0.326166,0,No
1,1,1,1,1,2,1,1,2,8,0.331571,0.343073,0,No
4,4,16,4,3,7,4,4,8,8,0.338969,0.352172,0,No
1,1,1,1,1,2,1,1,2,8,0.283486,0.292899,0,No
2,2,4,1,1,2,2,2,4,7,0.327819,0.338512,0,No
4,4,16,3,3,6,4,4,8,8,0.356244,0.372117,0,No
4,3,12,2,4,6,4,4,8,8,0.339063,0.352226,0,No
1,1,1,1,1,2,1,1,2,8,0.32342,0.334424,0,No
1,1,1,1,1,2,1,1,2,8,0.32342,0.334424,0,No
2,2,4,2,2,4,2,2,4,8,0.342342,0.354886,0,No
1,1,1,1,1,2,1,1,2,9,0.261062,0.266841,0,No
1,1,1,1,1,2,1,1,2,8,0.301584,0.314486,0,No
2,2,4,2,2,4,2,2,4,7,0.320258,0.329392,0,No
2,2,4,2,2,4,2,2,4,8,0.340131,0.352409,0,No
1,1,1,1,1,2,1,1,2,9,0.276056,0.283078,0,No
1,1,1,1,1,2,1,1,2,8,0.323426,0.334429,0,No
1,1,1,1,1,2,1,1,2,8,0.292862,0.300033,0,No
1,1,1,1,1,2,1,1,2,8,0.339934,0.352194,0,No
1,1,1,1,1,2,1,1,2,9,0.259072,0.264626,0,No
1,1,1,1,1,2,1,1,2,8,0.301589,0.314491,0,No
1,1,1,1,1,2,1,1,2,8,0.27455,0.283664,0,No
6,6,36,2,1,3,6,6,12,7,0.327819,0.338512,0,No
1,1,1,1,1,2,1,1,2,8,0.281833,0.289891,0,No
4,4,16,2,3,5,4,4,8,8,0.318732,0.326237,0,No
1,1,1,1,1,2,1,1,2,8,0.275659,0.282618,0,No
4,4,16,1,2,3,4,4,8,8,0.336416,0.348399,0,No
2,2,4,1,1,2,2,2,4,7,0.327826,0.338517,0,No
1,1,1,1,1,2,1,1,2,8,0.331571,0.343073,0,No
9,9,81,5,7,12,9,9,18,7,0.356638,0.37198,0,No
7,7,49,4,4,8,7,7,14,8,0.347459,0.361394,0,No
5,5,25,1,3,4,5,5,10,8,0.321816,0.330109,0,No
4,4,16,1,2,3,4,4,8,7,0.331224,0.342603,0,No
1,1,1,1,1,2,1,1,2,7,0.327819,0.338512,0,No
15,13,195,1,3,4,15,15,30,7,0.335272,0.34728,0,No
3,3,9,3,3,6,3,3,6,8,0.33876,0.35222,0,No
1,1,1,1,1,2,1,1,2,8,0.301584,0.314486,0,No
1,1,1,1,1,2,1,1,2,8,0.339934,0.352194,0,No
1,1,1,1,1,2,1,1,2,8,0.288163,0.299063,0,No
1,1,1,1,1,2,1,1,2,8,0.331578,0.343078,0,No
1,1,1,1,1,2,1,1,2,8,0.331578,0.343078,0,No
2,2,4,2,2,4,2,2,4,8,0.325816,0.336856,0,No
1,1,1,1,1,2,1,1,2,9,0.242793,0.246514,0,No
7,7,49,5,6,11,7,7,14,8,0.359312,0.375104,0,No
3,3,9,2,2,4,3,3,6,8,0.342342,0.354886,0,No
3,3,9,1,3,4,3,3,6,8,0.319454,0.329754,0,No
1,1,1,1,1,2,1,1,2,8,0.27122,0.279026,0,No
1,1,1,1,1,2,1,1,2,8,0.303661,0.312967,0,No
1,1,1,1,1,2,1,1,2,7,0.327819,0.338512,0,No
1,1,1,1,1,2,1,1,2,7,0.327819,0.338512,0,No
1,1,1,1,1,2,1,1,2,8,0.317292,0.324388,0,No
5,5,25,2,3,5,5,5,10,8,0.323255,0.331211,0,No
3,3,9,1,3,4,3,3,6,8,0.316591,0.326753,0,No
4,4,16,4,4,8,4,4,8,8,0.33143,0.342269,0,No
1,1,1,1,1,2,1,1,2,8,0.310033,0.318684,0,No
1,1,1,1,1,2,1,1,2,8,0.265147,0.271193,0,No
2,2,4,2,2,4,2,2,4,8,0.284265,0.291367,0,No
1,1,1,1,1,2,1,1,2,8,0.310033,0.318684,0,No
5,5,25,4,5,9,5,5,10,7,0.361957,0.377953,0,No
4,4,16,3,2,5,4,4,8,8,0.327291,0.338676,0,No
1,1,1,1,1,2,1,1,2,8,0.331571,0.343073,0,No
1,1,1,1,1,2,1,1,2,8,0.27455,0.283664,0,No
1,1,1,1,1,2,1,1,2,8,0.278743,0.288253,0,No
1,1,1,1,1,2,1,1,2,8,0.32342,0.334424,0,No
6,6,36,3,6,9,6,6,12,8,0.343957,0.356917,0,No
1,1,1,1,1,2,1,1,2,8,0.268345,0.275546,0,No
3,3,9,2,2,4,3,3,6,7,0.326846,0.336921,0,No
2,2,4,2,2,4,2,2,4,8,0.349637,0.363925,0,No
2,2,4,2,2,4,2,2,4,7,0.352621,0.366966,0,No
1,1,1,1,1,2,1,1,2,8,0.331571,0.343073,0,No
1,1,1,1,1,2,1,1,2,8,0.268219,0.275191,0,No
6,6,36,2,6,8,6,6,12,8,0.355709,0.370823,0,No
1,1,1,1,1,2,1,1,2,8,0.233292,0.236867,0,No
1,1,1,1,1,2,1,1,2,8,0.278743,0.288253,0,No
3,3,9,2,3,5,3,3,6,8,0.33827,0.351551,0,No
2,2,4,1,1,2,2,2,4,9,0.258632,0.264272,0,No
2,2,4,2,2,4,2,2,4,8,0.320643,0.327758,0,No
3,3,9,2,2,4,3,3,6,8,0.323942,0.335016,0,No
2,2,4,1,2,3,2,2,4,8,0.317599,0.327618,0,No
3,3,9,3,3,6,3,3,6,8,0.320336,0.330453,0,No
2,1,2,2,2,4,2,2,4,7,0.320113,0.327375,0,No
1,1,1,1,1,2,1,1,2,8,0.339934,0.352194,0,No
2,2,4,2,2,4,2,2,4,8,0.32828,0.340062,0,No
1,1,1,1,1,2,1,1,2,8,0.289257,0.299292,0,No
1,1,1,1,1,2,1,1,2,8,0.264457,0.270739,0,No
2,2,4,1,1,2,2,2,4,8,0.315765,0.323492,0,No
1,1,1,1,1,2,1,1,2,8,0.310033,0.318684,0,No
1,1,1,1,1,2,1,1,2,8,0.32342,0.334424,0,No
4,4,16,1,3,4,4,4,8,8,0.325779,0.337235,0,No
2,2,4,1,1,2,2,2,4,7,0.327819,0.338512,0,No
1,1,1,1,1,2,1,1,2,8,0.32342,0.334424,0,No
1,1,1,1,1,2,1,1,2,8,0.303375,0.311466,0,No
1,1,1,1,1,2,1,1,2,8,0.296171,0.303818,0,No
1,1,1,1,1,2,1,1,2,8,0.288163,0.299063,0,No
1,1,1,1,1,2,1,1,2,8,0.288163,0.299063,0,No
1,1,1,1,1,2,1,1,2,8,0.301584,0.314486,0,No
1,1,1,1,1,2,1,1,2,8,0.303375,0.311466,0,No
2,2,4,2,2,4,2,2,4,8,0.339941,0.352224,0,No
2,2,4,1,2,3,2,2,4,8,0.305487,0.311953,0,No
1,1,1,1,1,2,1,1,2,8,0.301584,0.314486,0,No
1,1,1,1,1,2,1,1,2,8,0.288168,0.299068,0,No
1,1,1,1,1,2,1,1,2,8,0.277096,0.285605,0,No
3,2,6,1,3,4,3,3,6,8,0.323488,0.331768,0,No
1,1,1,1,1,2,1,1,2,8,0.281345,0.288421,0,No
2,2,4,2,2,4,2,2,4,8,0.299246,0.308726,0,No
1,1,1,1,1,2,1,1,2,8,0.301589,0.314491,0,No
1,1,1,1,1,2,1,1,2,8,0.339934,0.352194,0,No
1,1,1,1,1,2,1,1,2,9,0.275819,0.282769,0,No
1,1,1,1,1,2,1,1,2,8,0.32342,0.334424,0,No
1,1,1,1,1,2,1,1,2,8,0.301589,0.314491,0,No
2,2,4,2,2,4,2,2,4,8,0.306618,0.313198,0,No
2,2,4,1,2,3,2,2,4,7,0.332236,0.343545,0,No
1,1,1,1,1,2,1,1,2,9,0.253548,0.258764,0,No
1,1,1,1,1,2,1,1,2,8,0.273915,0.280746,0,No
1,1,1,1,1,2,1,1,2,8,0.331571,0.343073,0,No
3,3,9,2,2,4,3,3,6,8,0.312326,0.320781,0,No
1,1,1,1,1,2,1,1,2,8,0.339934,0.352194,0,No
1,1,1,1,1,2,1,1,2,8,0.331571,0.343073,0,No
1,1,1,1,1,2,1,1,2,8,0.339927,0.352185,0,No
3,3,9,2,1,3,3,3,6,8,0.310028,0.318679,0,No
2,2,4,2,2,4,2,2,4,8,0.32147,0.329863,0,No
1,1,1,1,1,2,1,1,2,8,0.310022,0.31867,0,No
2,2,4,2,2,4,2,2,4,8,0.306349,0.314012,0,No
1,1,1,1,1,2,1,1,2,8,0.27122,0.279026,0,No
4,3,12,4,4,8,4,4,8,7,0.3277,0.336539,0,No
2,2,4,2,2,4,2,2,4,8,0.313941,0.323264,0,No
2,2,4,2,2,4,2,2,4,8,0.305083,0.311567,0,No
1,1,1,1,1,2,1,1,2,8,0.313497,0.320213,0,No
1,1,1,1,1,2,1,1,2,9,0.273017,0.280524,0,No
1,1,1,1,1,2,1,1,2,8,0.32342,0.334424,0,No
1,1,1,1,1,2,1,1,2,9,0.303807,0.312038,0,No
1,1,1,1,1,2,1,1,2,8,0.301584,0.314486,0,No
1,1,1,1,1,2,1,1,2,8,0.295965,0.304324,0,No
1,1,1,1,1,2,1,1,2,8,0.317298,0.324393,0,No
1,1,1,1,1,2,1,1,2,9,0.268641,0.276936,0,No
1,1,1,1,1,2,1,1,2,8,0.32342,0.334424,0,No
1,1,1,1,1,2,1,1,2,8,0.30268,0.309675,0,No
2,2,4,2,2,4,2,2,4,8,0.327675,0.33951,0,No
2,1,2,1,2,3,2,2,4,8,0.324065,0.335019,0,No
5,5,25,3,3,6,5,5,10,8,0.324873,0.335756,0,No
2,2,4,2,2,4,2,2,4,8,0.324855,0.335707,0,No
2,2,4,2,2,4,2,2,4,8,0.305296,0.31321,0,No
9,8,72,7,5,12,9,9,18,8,0.344791,0.358602,0,No
1,1,1,1,1,2,1,1,2,8,0.310033,0.318684,0,No
1,1,1,1,1,2,1,1,2,8,0.282257,0.289547,0,No
1,1,1,1,1,2,1,1,2,9,0.244979,0.249046,0,No
2,2,4,1,1,2,2,2,4,8,0.303661,0.312967,0,No
1,1,1,1,1,2,1,1,2,8,0.289252,0.299287,0,No
4,4,16,1,4,5,4,4,8,8,0.34139,0.353897,0,No
1,1,1,1,1,2,1,1,2,8,0.300574,0.307495,0,No
2,2,4,2,2,4,2,2,4,8,0.326765,0.337961,0,No
1,1,1,1,1,2,1,1,2,8,0.303661,0.312967,0,No
1,1,1,1,1,2,1,1,2,8,0.32342,0.334424,0,No
1,1,1,1,1,2,1,1,2,8,0.301589,0.314491,0,No
1,1,1,1,1,2,1,1,2,9,0.266589,0.272988,0,No
2,2,4,1,1,2,2,2,4,8,0.30946,0.31614,0,No
1,1,1,1,1,2,1,1,2,8,0.301584,0.314486,0,No
1,1,1,1,1,2,1,1,2,8,0.301584,0.314486,0,No
2,2,4,1,1,2,2,2,4,8,0.303655,0.312962,0,No
1,1,1,1,1,2,1,1,2,8,0.339934,0.352194,0,No
2,2,4,1,1,2,2,2,4,8,0.305078,0.312168,0,No
2,2,4,2,2,4,2,2,4,8,0.319245,0.32991,0,No
1,1,1,1,1,2,1,1,2,8,0.301589,0.314491,0,No
4,4,16,1,1,2,4,4,8,8,0.30338,0.311471,0,No
2,2,4,1,1,2,2,2,4,8,0.303375,0.311466,0,No
1,1,1,1,1,2,1,1,2,8,0.30359,0.310474,0,No
5,5,25,3,4,7,5,5,10,8,0.318911,0.326699,0,No
1,1,1,1,1,2,1,1,2,7,0.297726,0.304624,0,No
1,1,1,1,1,2,1,1,2,9,0.268721,0.277328,0,No
16,16,256,9,6,15,16,16,32,8,0.357782,0.373801,0,No
1,1,1,1,1,2,1,1,2,8,0.309325,0.317943,0,No
2,2,4,2,2,4,2,2,4,8,0.290345,0.301652,0,No
1,1,1,1,1,2,1,1,2,9,0.272886,0.279757,0,No
3,3,9,2,2,4,3,3,6,7,0.311995,0.320459,0,No
1,1,1,1,1,2,1,1,2,8,0.288778,0.295831,0,No
3,2,6,2,3,5,3,3,6,8,0.305515,0.312814,0,No
2,2,4,1,1,2,2,2,4,8,0.339934,0.352194,0,No
4,4,16,1,4,5,4,4,8,8,0.350319,0.363715,0,No
1,1,1,1,1,2,1,1,2,8,0.278743,0.288253,0,No
8,8,64,5,5,10,8,8,16,8,0.319502,0.328248,0,No
1,1,1,1,1,2,1,1,2,9,0.268637,0.276931,0,No
3,3,9,1,2,3,3,3,6,8,0.308665,0.315759,0,No
1,1,1,1,1,2,1,1,2,8,0.303693,0.310789,0,No
6,6,36,4,4,8,6,6,12,8,0.31485,0.324103,0,No
1,1,1,1,1,2,1,1,2,9,0.258985,0.264497,0,No
2,2,4,1,2,3,2,2,4,7,0.316046,0.325451,0,No
3,3,9,2,2,4,3,3,6,8,0.323255,0.333734,0,No
2,2,4,2,2,4,2,2,4,8,0.304974,0.317538,0,No
3,3,9,1,1,2,3,3,6,9,0.250842,0.255927,0,No
1,1,1,1,1,2,1,1,2,8,0.313497,0.320213,0,No
5,5,25,5,5,10,5,5,10,8,0.323187,0.331952,0,No
1,1,1,1,1,2,1,1,2,8,0.32342,0.334424,0,No
1,1,1,1,1,2,1,1,2,9,0.274926,0.281867,0,No
1,1,1,1,1,2,1,1,2,8,0.27455,0.283664,0,No
4,4,16,2,2,4,4,4,8,8,0.325084,0.336656,0,No
1,1,1,1,1,2,1,1,2,8,0.317445,0.327454,0,No
1,1,1,1,1,2,1,1,2,9,0.268641,0.276936,0,No
2,2,4,2,1,3,2,2,4,8,0.339934,0.352194,0,No
2,2,4,1,1,2,2,2,4,8,0.339934,0.352194,0,No
3,3,9,3,3,6,3,3,6,8,0.334346,0.346645,0,No
1,1,1,1,1,2,1,1,2,8,0.339941,0.352199,0,No
1,1,1,1,1,2,1,1,2,8,0.288168,0.299068,0,No
1,1,1,1,1,2,1,1,2,8,0.289941,0.297462,0,No
1,1,1,1,1,2,1,1,2,8,0.32342,0.334424,0,No
1,1,1,1,1,2,1,1,2,8,0.331571,0.343073,0,No
1,1,1,1,1,2,1,1,2,9,0.255737,0.261999,0,No
1,1,1,1,1,2,1,1,2,8,0.307819,0.314416,0,No
2,2,4,1,1,2,2,2,4,8,0.302589,0.309511,0,No
1,1,1,1,1,2,1,1,2,8,0.30946,0.31614,0,No
1,1,1,1,1,2,1,1,2,8,0.292405,0.299561,0,No
1,1,1,1,1,2,1,1,2,8,0.32342,0.334424,0,No
1,1,1,1,1,2,1,1,2,8,0.339934,0.352194,0,No
1,1,1,1,1,2,1,1,2,8,0.331571,0.343073,0,No
1,1,1,1,1,2,1,1,2,8,0.278739,0.288248,0,No
2,2,4,2,1,3,2,2,4,8,0.288168,0.299068,0,No
1,1,1,1,1,2,1,1,2,8,0.301584,0.314486,0,No
10,10,100,5,3,8,10,10,20,7,0.344415,0.357247,0,No
1,1,1,1,1,2,1,1,2,8,0.323426,0.334429,0,No
5,3,15,3,2,5,5,5,10,8,0.327455,0.338576,0,No
4,4,16,1,1,2,4,4,8,8,0.32342,0.334424,0,No
1,1,1,1,1,2,1,1,2,7,0.327819,0.338512,0,No
1,1,1,1,1,2,1,1,2,8,0.310717,0.317502,0,No
1,1,1,1,1,2,1,1,2,7,0.327819,0.338512,0,No
1,1,1,1,1,2,1,1,2,7,0.327826,0.338517,0,No
2,2,4,2,2,4,2,2,4,7,0.333614,0.345149,0,No
2,2,4,2,2,4,2,2,4,8,0.352003,0.366286,0,No
1,1,1,1,1,2,1,1,2,8,0.288929,0.297713,0,No
2,2,4,1,1,2,2,2,4,8,0.268341,0.275541,0,No
4,4,16,3,2,5,4,4,8,8,0.323481,0.334512,0,No
8,8,64,2,4,6,8,8,16,8,0.33702,0.347955,0,No
4,4,16,3,4,7,4,4,8,8,0.335009,0.345792,0,No
2,2,4,1,2,3,2,2,4,8,0.323893,0.334858,0,No
1,1,1,1,1,2,1,1,2,8,0.286249,0.293453,0,No
2,2,4,1,2,3,2,2,4,8,0.316615,0.325395,0,No
1,1,1,1,1,2,1,1,2,8,0.32342,0.334424,0,No
1,1,1,1,1,2,1,1,2,8,0.27122,0.279026,0,No
1,1,1,1,1,2,1,1,2,9,0.246932,0.250705,0,No
1,1,1,1,1,2,1,1,2,8,0.314583,0.32146,0,No
1,1,1,1,1,2,1,1,2,8,0.339934,0.352194,0,No
1,1,1,1,1,2,1,1,2,8,0.30338,0.311471,0,No
1,1,1,1,1,2,1,1,2,8,0.301589,0.314491,0,No
1,1,1,1,1,2,1,1,2,8,0.2469,0.251301,0,No
1,1,1,1,1,2,1,1,2,8,0.331578,0.343078,0,No
1,1,1,1,1,2,1,1,2,9,0.27248,0.279829,0,No
1,1,1,1,1,2,1,1,2,8,0.268345,0.275546,0,No
1,1,1,1,1,2,1,1,2,7,0.2963,0.30485,0,No
1,1,1,1,1,2,1,1,2,9,0.247789,0.252397,0,No
2,2,4,2,2,4,2,2,4,9,0.268257,0.27526,0,No
1,1,1,1,1,2,1,1,2,7,0.327819,0.338512,0,No
1,1,1,1,1,2,1,1,2,8,0.309466,0.316145,0,No
1,1,1,1,1,2,1,1,2,8,0.310711,0.317493,0,No
1,1,1,1,1,2,1,1,2,8,0.27455,0.283664,0,No
1,1,1,1,1,2,1,1,2,8,0.339934,0.352194,0,No
1,1,1,1,1,2,1,1,2,8,0.32342,0.334424,0,No
3,3,9,2,2,4,3,3,6,7,0.352614,0.366956,0,No
1,1,1,1,1,2,1,1,2,8,0.263998,0.269767,0,No
2,2,4,2,2,4,2,2,4,8,0.29934,0.306217,0,No
2,2,4,1,1,2,2,2,4,9,0.235498,0.238584,0,No
1,1,1,1,1,2,1,1,2,7,0.327819,0.338512,0,No
5,5,25,4,3,7,5,5,10,8,0.333366,0.345078,0,No
1,1,1,1,1,2,1,1,2,9,0.239864,0.24368,0,No
1,1,1,1,1,2,1,1,2,7,0.327819,0.338512,0,No
1,1,1,1,1,2,1,1,2,8,0.331571,0.343073,0,No
1,1,1,1,1,2,1,1,2,9,0.265308,0.271483,0,No
1,1,1,1,1,2,1,1,2,8,0.271899,0.280395,0,No
2,2,4,2,1,3,2,2,4,8,0.331565,0.343064,0,No
1,1,1,1,1,2,1,1,2,8,0.311312,0.322315,0,No
1,1,1,1,1,2,1,1,2,8,0.301578,0.314477,0,No
2,2,4,2,2,4,2,2,4,8,0.336807,0.349008,0,No
1,1,1,1,1,2,1,1,2,8,0.309466,0.316145,0,No
2,2,4,1,2,3,2,2,4,8,0.332185,0.343784,0,No
3,3,9,2,2,4,3,3,6,8,0.345692,0.358823,0,No
1,1,1,1,1,2,1,1,2,8,0.25113,0.255669,0,No
1,1,1,1,1,2,1,1,2,7,0.327819,0.338512,0,No
1,1,1,1,1,2,1,1,2,8,0.299367,0.306897,0,No
4,4,16,1,2,3,4,4,8,8,0.300442,0.307206,0,No
1,1,1,1,1,2,1,1,2,7,0.327819,0.338512,0,No
1,1,1,1,1,2,1,1,2,8,0.275712,0.282592,0,No
3,3,9,2,3,5,3,3,6,8,0.312503,0.320918,0,No
2,2,4,2,2,4,2,2,4,8,0.314682,0.323791,0,No
1,1,1,1,1,2,1,1,2,8,0.299745,0.307615,0,No
2,2,4,1,1,2,2,2,4,8,0.267857,0.275083,0,No
2,2,4,1,2,3,2,2,4,9,0.270742,0.279209,0,No
1,1,1,1,1,2,1,1,2,8,0.288168,0.299068,0,No
1,1,1,1,1,2,1,1,2,8,0.30833,0.31471,0,No
1,1,1,1,1,2,1,1,2,7,0.327813,0.338503,0,No
3,3,9,2,2,4,3,3,6,8,0.319197,0.327819,0,No
1,1,1,1,1,2,1,1,2,7,0.327819,0.338512,0,No
1,1,1,1,1,2,1,1,2,8,0.339934,0.352194,0,No
1,1,1,1,1,2,1,1,2,8,0.28349,0.292904,0,No
1,1,1,1,1,2,1,1,2,9,0.241405,0.244558,0,No
1,1,1,1,1,2,1,1,2,8,0.303585,0.310469,0,No
2,2,4,2,2,4,2,2,4,8,0.323684,0.334728,0,No
2,2,4,1,2,3,2,2,4,8,0.299036,0.307866,0,No
1,1,1,1,1,2,1,1,2,8,0.271894,0.28039,0,No
1,1,1,1,1,2,1,1,2,8,0.339934,0.352194,0,No
2,2,4,1,1,2,2,2,4,8,0.286976,0.294369,0,No
1,1,1,1,1,2,1,1,2,8,0.32342,0.334424,0,No
1,1,1,1,1,2,1,1,2,9,0.253115,0.258182,0,No
1,1,1,1,1,2,1,1,2,9,0.254141,0.258985,0,No
1,1,1,1,1,2,1,1,2,8,0.282224,0.289322,0,No
2,2,4,2,2,4,2,2,4,8,0.305635,0.312758,0,No
1,1,1,1,1,2,1,1,2,8,0.255167,0.259813,0,No
5,4,20,4,3,7,5,5,10,8,0.356378,0.372067,0,No
2,2,4,1,2,3,2,2,4,8,0.30876,0.315663,0,No
4,4,16,2,3,5,4,4,8,8,0.352127,0.366466,0,No
1,1,1,1,1,2,1,1,2,8,0.339941,0.352199,0,No
1,1,1,1,1,2,1,1,2,8,0.331571,0.343073,0,No
1,1,1,1,1,2,1,1,2,9,0.268641,0.276936,0,No
1,1,1,1,1,2,1,1,2,8,0.301584,0.314486,0,No
1,1,1,1,1,2,1,1,2,8,0.28349,0.292904,0,No
2,2,4,2,2,4,2,2,4,8,0.288426,0.297037,0,No
1,1,1,1,1,2,1,1,2,8,0.286662,0.293739,0,No
3,3,9,3,3,6,3,3,6,8,0.349946,0.364557,0,No
1,1,1,1,1,2,1,1,2,8,0.32342,0.334424,0,No
1,1,1,1,1,2,1,1,2,8,0.296444,0.303647,0,No
2,2,4,2,2,4,2,2,4,8,0.339995,0.352287,0,No
2,2,4,1,1,2,2,2,4,8,0.32342,0.334424,0,No
2,2,4,2,2,4,2,2,4,8,0.289847,0.297189,0,No
8,6,48,3,3,6,8,8,16,8,0.356661,0.372224,0,No
1,1,1,1,1,2,1,1,2,8,0.297706,0.304468,0,No
5,5,25,2,3,5,5,5,10,7,0.330269,0.34061,0,No
1,1,1,1,1,2,1,1,2,8,0.259194,0.264322,0,No
3,3,9,1,3,4,3,3,6,8,0.333119,0.344951,0,No
3,3,9,1,3,4,3,3,6,8,0.314531,0.323217,0,No
1,1,1,1,1,2,1,1,2,8,0.331571,0.343073,0,No
4,4,16,2,2,4,4,4,8,8,0.304392,0.313804,0,No
1,1,1,1,1,2,1,1,2,8,0.315759,0.323487,0,No
1,1,1,1,1,2,1,1,2,8,0.310028,0.318679,0,No
1,1,1,1,1,2,1,1,2,8,0.266139,0.272079,0,No
1,1,1,1,1,2,1,1,2,8,0.288158,0.299054,0,No
1,1,1,1,1,2,1,1,2,8,0.310028,0.318679,0,No
1,1,1,1,1,2,1,1,2,8,0.306453,0.313109,0,No
4,4,16,2,1,3,4,4,8,8,0.339934,0.352194,0,No
1,1,1,1,1,2,1,1,2,9,0.268641,0.276936,0,No
1,1,1,1,1,2,1,1,2,8,0.269005,0.275293,0,No
1,1,1,1,1,2,1,1,2,9,0.244309,0.248587,0,No
2,2,4,1,1,2,2,2,4,7,0.327819,0.338512,0,No
2,2,4,2,2,4,2,2,4,8,0.29227,0.301673,0,No
5,5,25,4,2,6,5,5,10,8,0.313198,0.322823,0,No
1,1,1,1,1,2,1,1,2,8,0.301589,0.314491,0,No
1,1,1,1,1,2,1,1,2,8,0.301589,0.314491,0,No
5,5,25,4,3,7,5,5,10,8,0.312303,0.319011,0,No
1,1,1,1,1,2,1,1,2,7,0.296305,0.304855,0,No
1,1,1,1,1,2,1,1,2,9,0.249499,0.253819,0,No
7,7,49,5,5,10,7,7,14,7,0.338558,0.35135,0,No
1,1,1,1,1,2,1,1,2,8,0.27455,0.283664,0,No
1,1,1,1,1,2,1,1,2,8,0.30338,0.311471,0,No
1,1,1,1,1,2,1,1,2,8,0.339934,0.352194,0,No
1,1,1,1,1,2,1,1,2,9,0.235063,0.238923,0,No
1,1,1,1,1,2,1,1,2,8,0.331571,0.343073,0,No
3,3,9,2,1,3,3,3,6,8,0.331578,0.343078,0,No
1,1,1,1,1,2,1,1,2,8,0.302016,0.308681,0,No
1,1,1,1,1,2,1,1,2,8,0.299745,0.307615,0,No
1,1,1,1,1,2,1,1,2,8,0.295294,0.302306,0,No
2,2,4,2,2,4,2,2,4,8,0.270262,0.276552,0,No
1,1,1,1,1,2,1,1,2,7,0.2963,0.30485,0,No
2,2,4,2,2,4,2,2,4,8,0.340328,0.352617,0,No
1,1,1,1,1,2,1,1,2,8,0.296444,0.303647,0,No
1,1,1,1,1,2,1,1,2,8,0.271899,0.280395,0,No
1,1,1,1,1,2,1,1,2,9,0.268641,0.276936,0,No
2,2,4,1,1,2,2,2,4,8,0.281833,0.289891,0,No
2,2,4,1,1,2,2,2,4,8,0.339934,0.352194,0,No
1,1,1,1,1,2,1,1,2,8,0.249971,0.254122,0,No
1,1,1,1,1,2,1,1,2,8,0.339934,0.352194,0,No
1,1,1,1,1,2,1,1,2,8,0.301589,0.314491,0,No
2,2,4,2,2,4,2,2,4,8,0.297343,0.305695,0,No
1,1,1,1,1,2,1,1,2,8,0.286932,0.294207,0,No
1,1,1,1,1,2,1,1,2,7,0.327813,0.338503,0,No
3,3,9,2,1,3,3,3,6,8,0.339934,0.352194,0,No
2,2,4,2,2,4,2,2,4,8,0.288548,0.297729,0,No
1,1,1,1,1,2,1,1,2,8,0.310722,0.317507,0,No
1,1,1,1,1,2,1,1,2,8,0.313497,0.320213,0,No
1,1,1,1,1,2,1,1,2,8,0.323426,0.334429,0,No
1,1,1,1,1,2,1,1,2,7,0.327819,0.338512,0,No
1,1,1,1,1,2,1,1,2,7,0.312584,0.319273,0,No
2,2,4,2,2,4,2,2,4,8,0.315065,0.322475,0,No
1,1,1,1,1,2,1,1,2,8,0.302198,0.308977,0,No
1,1,1,1,1,2,1,1,2,8,0.281833,0.289891,0,No
1,1,1,1,1,2,1,1,2,8,0.295596,0.303244,0,No
1,1,1,1,1,2,1,1,2,8,0.284412,0.29144,0,No
1,1,1,1,1,2,1,1,2,9,0.259399,0.265032,0,No
1,1,1,1,1,2,1,1,2,8,0.32342,0.334424,0,No
3,3,9,2,3,5,3,3,6,7,0.351127,0.365493,0,No
1,1,1,1,1,2,1,1,2,9,0.276051,0.283073,0,No
1,1,1,1,1,2,1,1,2,8,0.331571,0.343073,0,No
4,3,12,4,3,7,4,4,8,7,0.332541,0.343883,0,No
1,1,1,1,1,2,1,1,2,9,0.276056,0.283078,0,No
2,1,2,2,2,4,2,2,4,8,0.293678,0.301302,0,No
2,2,4,1,1,2,2,2,4,8,0.303693,0.310789,0,No
1,1,1,1,1,2,1,1,2,8,0.309331,0.317947,0,No
1,1,1,1,1,2,1,1,2,9,0.284336,0.292278,0,No
3,3,9,1,1,2,3,3,6,8,0.339934,0.352194,0,No
1,1,1,1,1,2,1,1,2,8,0.2876,0.295187,0,No
1,1,1,1,1,2,1,1,2,8,0.32342,0.334424,0,No
1,1,1,1,1,2,1,1,2,8,0.288163,0.299063,0,No
1,1,1,1,1,2,1,1,2,8,0.313497,0.320213,0,No
2,2,4,2,2,4,2,2,4,8,0.317451,0.326332,0,No
1,1,1,1,1,2,1,1,2,8,0.288168,0.299068,0,No
1,1,1,1,1,2,1,1,2,8,0.301589,0.314491,0,No
1,1,1,1,1,2,1,1,2,8,0.271099,0.277563,0,No
1,1,1,1,1,2,1,1,2,8,0.269353,0.275718,0,No
1,1,1,1,1,2,1,1,2,8,0.29037,0.297428,0,No
1,1,1,1,1,2,1,1,2,9,0.244979,0.249046,0,No
4,4,16,4,2,6,4,4,8,7,0.334628,0.346795,0,No
5,5,25,2,3,5,5,5,10,8,0.35311,0.368179,0,No
1,1,1,1,1,2,1,1,2,8,0.301589,0.314491,0,No
1,1,1,1,1,2,1,1,2,8,0.315765,0.323492,0,No
1,1,1,1,1,2,1,1,2,7,0.327819,0.338512,0,No
3,3,9,2,2,4,3,3,6,7,0.332956,0.343312,0,No
1,1,1,1,1,2,1,1,2,7,0.327819,0.338512,0,No
1,1,1,1,1,2,1,1,2,8,0.339934,0.352194,0,No
1,1,1,1,1,2,1,1,2,7,0.327826,0.338517,0,No
8,8,64,4,2,6,8,8,16,8,0.304224,0.317593,0,No
6,6,36,5,6,11,6,6,12,8,0.340368,0.352586,0,No
18,18,324,1,8,9,18,18,36,8,0.331933,0.342773,0,No
7,7,49,5,5,10,7,7,14,7,0.340701,0.35373,0,No
4,3,12,1,4,5,4,4,8,8,0.330601,0.339979,0,No
1,1,1,1,1,2,1,1,2,8,0.264186,0.269955,0,No
1,1,1,1,1,2,1,1,2,8,0.301589,0.314491,0,No
2,2,4,2,2,4,2,2,4,8,0.34128,0.353765,0,No
1,1,1,1,1,2,1,1,2,7,0.327819,0.338512,0,No
1,1,1,1,1,2,1,1,2,8,0.317292,0.324388,0,No
2,1,2,1,2,3,2,2,4,8,0.313941,0.323264,0,No
1,1,1,1,1,2,1,1,2,7,0.327819,0.338512,0,No
4,3,12,3,2,5,4,4,8,8,0.308754,0.316717,0,No
1,1,1,1,1,2,1,1,2,8,0.303375,0.311466,0,No
1,1,1,1,1,2,1,1,2,7,0.327819,0.338512,0,No
1,1,1,1,1,2,1,1,2,8,0.339934,0.352194,0,No
1,1,1,1,1,2,1,1,2,9,0.244305,0.248584,0,No
1,1,1,1,1,2,1,1,2,8,0.301589,0.314491,0,No
1,1,1,1,1,2,1,1,2,8,0.323426,0.334429,0,No
1,1,1,1,1,2,1,1,2,8,0.268219,0.275191,0,No
2,2,4,1,1,2,2,2,4,8,0.32342,0.334424,0,No
1,1,1,1,1,2,1,1,2,8,0.339934,0.352194,0,No
1,1,1,1,1,2,1,1,2,8,0.339934,0.352194,0,No
9,9,81,4,4,8,9,9,18,8,0.328413,0.339042,0,No
4,4,16,3,4,7,4,4,8,8,0.358881,0.374908,0,No
2,2,4,2,2,4,2,2,4,8,0.340429,0.352603,0,No
1,1,1,1,1,2,1,1,2,8,0.331571,0.343073,0,No
12,12,144,5,6,11,12,12,24,8,0.3375,0.349341,0,No
1,1,1,1,1,2,1,1,2,8,0.300521,0.307317,0,No
2,2,4,2,2,4,2,2,4,8,0.333535,0.345157,0,No
2,2,4,1,1,2,2,2,4,8,0.291371,0.298343,0,No
5,5,25,4,3,7,5,5,10,8,0.332632,0.344581,0,No
1,1,1,1,1,2,1,1,2,8,0.323426,0.334429,0,No
8,8,64,5,7,12,8,8,16,8,0.341574,0.354551,0,No
1,1,1,1,1,2,1,1,2,8,0.313497,0.320213,0,No
1,1,1,1,1,2,1,1,2,8,0.331571,0.343073,0,No
19,19,361,1,12,13,19,19,38,8,0.362103,0.378966,0,No
10,10,100,5,7,12,10,10,20,8,0.35669,0.371543,0,No
6,6,36,1,3,4,6,6,12,8,0.328337,0.339331,0,No
1,1,1,1,1,2,1,1,2,8,0.310028,0.318679,0,No
3,3,9,1,2,3,3,3,6,8,0.34361,0.356903,0,No
1,1,1,1,1,2,1,1,2,8,0.303375,0.311466,0,No
2,2,4,1,1,2,2,2,4,9,0.239615,0.243014,0,No
2,2,4,2,2,4,2,2,4,8,0.317327,0.32416,0,No
2,2,4,1,2,3,2,2,4,8,0.317327,0.32416,0,No
2,2,4,2,2,4,2,2,4,8,0.3317,0.34321,0,No
3,3,9,3,3,6,3,3,6,8,0.308481,0.316349,0,No
2,2,4,1,2,3,2,2,4,8,0.320974,0.330933,0,No
5,5,25,4,4,8,5,5,10,7,0.338384,0.350992,0,No
2,2,4,2,2,4,2,2,4,8,0.316368,0.323325,0,No
1,1,1,1,1,2,1,1,2,9,0.252669,0.257322,0,No
2,2,4,2,2,4,2,2,4,7,0.297877,0.306737,0,No
1,1,1,1,1,2,1,1,2,9,0.249499,0.253819,0,No
1,1,1,1,1,2,1,1,2,8,0.339934,0.352194,0,No
1,1,1,1,1,2,1,1,2,9,0.24811,0.252403,0,No
1,1,1,1,1,2,1,1,2,7,0.296305,0.304855,0,No
2,2,4,2,2,4,2,2,4,8,0.313941,0.323264,0,No
1,1,1,1,1,2,1,1,2,8,0.284104,0.291229,0,No
1,1,1,1,1,2,1,1,2,8,0.301589,0.314491,0,No
1,1,1,1,1,2,1,1,2,9,0.268721,0.277328,0,No
1,1,1,1,1,2,1,1,2,9,0.268637,0.276931,0,No
2,2,4,1,2,3,2,2,4,8,0.314967,0.321944,0,No
1,1,1,1,1,2,1,1,2,9,0.268641,0.276936,0,No
1,1,1,1,1,2,1,1,2,8,0.309325,0.317943,0,No
2,2,4,2,2,4,2,2,4,7,0.315549,0.324581,0,No
2,2,4,1,2,3,2,2,4,8,0.310977,0.320722,0,No
20,18,360,4,6,10,20,20,40,8,0.333868,0.344933,0,No
1,1,1,1,1,2,1,1,2,8,0.339941,0.352199,0,No
3,3,9,2,3,5,3,3,6,7,0.35341,0.367672,0,No
1,1,1,1,1,2,1,1,2,8,0.264203,0.270022,0,No
2,2,4,1,1,2,2,2,4,8,0.339934,0.352194,0,No
2,2,4,1,1,2,2,2,4,8,0.28349,0.292904,0,No
1,1,1,1,1,2,1,1,2,9,0.263403,0.271075,0,No
2,2,4,1,2,3,2,2,4,8,0.316409,0.32641,0,No
2,2,4,1,1,2,2,2,4,9,0.249499,0.253819,0,No
1,1,1,1,1,2,1,1,2,7,0.327819,0.338512,0,No
1,1,1,1,1,2,1,1,2,8,0.32342,0.334424,0,No
2,2,4,2,1,3,2,2,4,8,0.339934,0.352194,0,No
1,1,1,1,1,2,1,1,2,8,0.339934,0.352194,0,No
1,1,1,1,1,2,1,1,2,8,0.288168,0.299068,0,No
1,1,1,1,1,2,1,1,2,7,0.327826,0.338517,0,No
1,1,1,1,1,2,1,1,2,8,0.32342,0.334424,0,No
2,2,4,2,2,4,2,2,4,8,0.323451,0.333713,0,No
1,1,1,1,1,2,1,1,2,8,0.310033,0.318684,0,No
3,3,9,1,3,4,3,3,6,7,0.344415,0.357328,0,No
6,5,30,2,4,6,6,6,12,8,0.312618,0.321061,0,No
1,1,1,1,1,2,1,1,2,8,0.303375,0.311466,0,No
1,1,1,1,1,2,1,1,2,8,0.298534,0.305391,0,No
7,7,49,2,7,9,7,7,14,7,0.330518,0.339699,0,No
1,1,1,1,1,2,1,1,2,9,0.26135,0.267206,0,No
2,2,4,1,1,2,2,2,4,9,0.268641,0.276936,0,No
2,2,4,2,2,4,2,2,4,7,0.318571,0.32623,0,No
4,4,16,3,3,6,4,4,8,8,0.345028,0.357928,0,No
4,4,16,3,1,4,4,4,8,7,0.296305,0.304855,0,No
3,3,9,3,3,6,3,3,6,8,0.343451,0.356669,0,No
1,1,1,1,1,2,1,1,2,8,0.339941,0.352199,0,No
1,1,1,1,1,2,1,1,2,8,0.289257,0.299292,0,No
1,1,1,1,1,2,1,1,2,8,0.278743,0.288253,0,No
1,1,1,1,1,2,1,1,2,8,0.289257,0.299292,0,No
2,2,4,1,2,3,2,2,4,8,0.312298,0.326054,0,No
1,1,1,1,1,2,1,1,2,9,0.241027,0.244532,0,No
1,1,1,1,1,2,1,1,2,8,0.27122,0.279026,0,No
2,2,4,2,2,4,2,2,4,7,0.330723,0.342041,0,No
2,2,4,2,2,4,2,2,4,8,0.318708,0.326414,0,No
1,1,1,1,1,2,1,1,2,8,0.317292,0.324388,0,No
1,1,1,1,1,2,1,1,2,8,0.301584,0.314486,0,No
1,1,1,1,1,2,1,1,2,8,0.254478,0.259327,0,No
2,2,4,1,2,3,2,2,4,8,0.288037,0.299923,0,No
1,1,1,1,1,2,1,1,2,8,0.301589,0.314491,0,No
1,1,1,1,1,2,1,1,2,8,0.301584,0.314486,0,No
1,1,1,1,1,2,1,1,2,7,0.2963,0.30485,0,No
2,2,4,2,1,3,2,2,4,7,0.2963,0.30485,0,No
4,4,16,2,3,5,4,4,8,7,0.351156,0.36538,0,No
1,1,1,1,1,2,1,1,2,8,0.339934,0.352194,0,No
1,1,1,1,1,2,1,1,2,7,0.327826,0.338517,0,No
3,2,6,2,2,4,3,3,6,7,0.332431,0.343269,0,No
1,1,1,1,1,2,1,1,2,8,0.286995,0.294302,0,No
1,1,1,1,1,2,1,1,2,8,0.296444,0.303607,0,No
1,1,1,1,1,2,1,1,2,7,0.327819,0.338512,0,No
1,1,1,1,1,2,1,1,2,9,0.213504,0.216649,0,No
2,2,4,1,2,3,2,2,4,8,0.2803,0.287636,0,No
1,1,1,1,1,2,1,1,2,8,0.258883,0.26458,0,No
1,1,1,1,1,2,1,1,2,8,0.305078,0.312168,0,No
1,1,1,1,1,2,1,1,2,8,0.304126,0.310933,0,No
1,1,1,1,1,2,1,1,2,9,0.268573,0.275154,0,No
9,9,81,2,9,11,9,9,18,8,0.355043,0.371565,0,No
17,17,289,1,13,14,17,17,34,7,0.353469,0.369024,0,No
1,1,1,1,1,2,1,1,2,8,0.301589,0.314491,0,No
1,1,1,1,1,2,1,1,2,9,0.268641,0.276936,0,No
1,1,1,1,1,2,1,1,2,8,0.270391,0.276789,0,No
1,1,1,1,1,2,1,1,2,8,0.288431,0.295663,0,No
1,1,1,1,1,2,1,1,2,8,0.331571,0.343073,0,No
1,1,1,1,1,2,1,1,2,8,0.292676,0.300197,0,No
1,1,1,1,1,2,1,1,2,8,0.294256,0.301306,0,No
3,3,9,2,2,4,3,3,6,7,0.330858,0.341164,0,No
2,2,4,2,2,4,2,2,4,8,0.290409,0.2999,0,No
4,4,16,2,4,6,4,4,8,7,0.335443,0.347463,0,No
1,1,1,1,1,2,1,1,2,8,0.310028,0.318679,0,No
1,1,1,1,1,2,1,1,2,8,0.310028,0.318679,0,No
1,1,1,1,1,2,1,1,2,8,0.309331,0.317947,0,No
2,2,4,1,1,2,2,2,4,8,0.331571,0.343073,0,No
2,2,4,1,1,2,2,2,4,8,0.279689,0.286598,0,No
1,1,1,1,1,2,1,1,2,8,0.303688,0.310784,0,No
1,1,1,1,1,2,1,1,2,8,0.299835,0.307302,0,No
2,2,4,2,2,4,2,2,4,7,0.310949,0.319025,0,No
1,1,1,1,1,2,1,1,2,8,0.262274,0.267902,0,No
2,2,4,1,1,2,2,2,4,7,0.2963,0.30485,0,No
1,1,1,1,1,2,1,1,2,7,0.2963,0.30485,0,No
2,2,4,1,1,2,2,2,4,9,0.303807,0.312038,0,No
2,2,4,2,1,3,2,2,4,8,0.32342,0.334424,0,No
1,1,1,1,1,2,1,1,2,8,0.309325,0.317943,0,No
2,2,4,2,2,4,2,2,4,8,0.325195,0.335978,0,No
1,1,1,1,1,2,1,1,2,8,0.313497,0.320213,0,No
1,1,1,1,1,2,1,1,2,8,0.265423,0.271296,0,No
2,2,4,2,2,4,2,2,4,8,0.32417,0.335546,0,No
2,2,4,1,2,3,2,2,4,8,0.298018,0.305326,0,No
2,2,4,1,1,2,2,2,4,8,0.339927,0.352185,0,No
1,1,1,1,1,2,1,1,2,8,0.27189,0.28038,0,No
1,1,1,1,1,2,1,1,2,8,0.291665,0.299217,0,No
3,3,9,1,1,2,3,3,6,8,0.277096,0.285605,0,No
1,1,1,1,1,2,1,1,2,8,0.271903,0.280398,0,No
1,1,1,1,1,2,1,1,2,9,0.268641,0.276936,0,No
1,1,1,1,1,2,1,1,2,9,0.268641,0.276936,0,No
4,4,16,2,3,5,4,4,8,8,0.336343,0.348793,0,No
1,1,1,1,1,2,1,1,2,8,0.315759,0.323487,0,No
3,3,9,1,1,2,3,3,6,8,0.32342,0.334424,0,No
1,1,1,1,1,2,1,1,2,9,0.271022,0.277889,0,No
1,1,1,1,1,2,1,1,2,8,0.32342,0.334424,0,No
2,2,4,2,1,3,2,2,4,8,0.32342,0.334424,0,No
1,1,1,1,1,2,1,1,2,8,0.27303,0.279623,0,No
1,1,1,1,1,2,1,1,2,8,0.28349,0.292904,0,No
3,3,9,2,2,4,3,3,6,8,0.317552,0.324657,0,No
2,1,2,1,2,3,2,2,4,8,0.331829,0.343299,0,No
1,1,1,1,1,2,1,1,2,8,0.339934,0.352194,0,No
1,1,1,1,1,2,1,1,2,9,0.280683,0.28796,0,No
1,1,1,1,1,2,1,1,2,8,0.303693,0.310789,0,No
1,1,1,1,1,2,1,1,2,8,0.287038,0.294237,0,No
1,1,1,1,1,2,1,1,2,8,0.287605,0.295192,0,No
1,1,1,1,1,2,1,1,2,8,0.303655,0.312962,0,No
2,2,4,1,1,2,2,2,4,8,0.317298,0.324393,0,No
1,1,1,1,1,2,1,1,2,9,0.236759,0.240563,0,No
1,1,1,1,1,2,1,1,2,8,0.339934,0.352194,0,No
2,2,4,2,2,4,2,2,4,8,0.280946,0.289687,0,No
2,2,4,2,2,4,2,2,4,8,0.342102,0.354638,0,No
1,1,1,1,1,2,1,1,2,8,0.30338,0.311471,0,No
1,1,1,1,1,2,1,1,2,8,0.331571,0.343073,0,No
3,3,9,3,2,5,3,3,6,7,0.347983,0.361927,0,No
1,1,1,1,1,2,1,1,2,8,0.32342,0.334424,0,No
1,1,1,1,1,2,1,1,2,8,0.301584,0.314486,0,No
1,1,1,1,1,2,1,1,2,9,0.268717,0.277323,0,No
1,1,1,1,1,2,1,1,2,8,0.303845,0.310259,0,No
2,2,4,2,2,4,2,2,4,9,0.287063,0.295501,0,No
4,4,16,3,3,6,4,4,8,8,0.30385,0.311065,0,No
1,1,1,1,1,2,1,1,2,8,0.267857,0.275083,0,No
2,2,4,2,2,4,2,2,4,8,0.314845,0.321585,0,No
7,7,49,4,5,9,7,7,14,8,0.329166,0.338318,0,No
1,1,1,1,1,2,1,1,2,8,0.292345,0.299887,0,No
1,1,1,1,1,2,1,1,2,9,0.266372,0.272714,0,No
1,1,1,1,1,2,1,1,2,8,0.298534,0.305391,0,No
1,1,1,1,1,2,1,1,2,8,0.274607,0.281424,0,No
3,3,9,2,2,4,3,3,6,8,0.327291,0.338676,0,No
2,2,4,2,2,4,2,2,4,8,0.32404,0.33506,0,No
1,1,1,1,1,2,1,1,2,8,0.32342,0.334424,0,No
1,1,1,1,1,2,1,1,2,9,0.268717,0.277323,0,No
1,1,1,1,1,2,1,1,2,8,0.313497,0.320213,0,No
1,1,1,1,1,2,1,1,2,9,0.268641,0.276936,0,No
1,1,1,1,1,2,1,1,2,7,0.296305,0.304855,0,No
1,1,1,1,1,2,1,1,2,8,0.339934,0.352194,0,No
1,1,1,1,1,2,1,1,2,9,0.255852,0.260955,0,No
3,3,9,2,3,5,3,3,6,7,0.344415,0.357247,0,No
1,1,1,1,1,2,1,1,2,8,0.309325,0.317943,0,No
3,3,9,3,2,5,3,3,6,8,0.313198,0.322823,0,No
1,1,1,1,1,2,1,1,2,8,0.268214,0.275186,0,No
2,2,4,1,1,2,2,2,4,8,0.287605,0.295192,0,No
5,5,25,3,4,7,5,5,10,8,0.320727,0.330604,0,No
1,1,1,1,1,2,1,1,2,9,0.244305,0.248584,0,No
3,3,9,2,2,4,3,3,6,8,0.292897,0.301741,0,No
1,1,1,1,1,2,1,1,2,9,0.268721,0.277328,0,No
2,2,4,1,2,3,2,2,4,8,0.338243,0.351497,0,No
1,1,1,1,1,2,1,1,2,8,0.255167,0.259813,0,No
2,2,4,1,2,3,2,2,4,8,0.319072,0.326986,0,No
1,1,1,1,1,2,1,1,2,8,0.339934,0.352194,0,No
1,1,1,1,1,2,1,1,2,8,0.271259,0.277667,0,No
3,3,9,1,2,3,3,3,6,8,0.309163,0.317891,0,No
1,1,1,1,1,2,1,1,2,8,0.26015,0.26574,0,No
1,1,1,1,1,2,1,1,2,8,0.331571,0.343073,0,No
1,1,1,1,1,2,1,1,2,8,0.278743,0.288253,0,No
2,2,4,2,1,3,2,2,4,7,0.327819,0.338512,0,No
3,3,9,2,2,4,3,3,6,8,0.309617,0.31825,0,No
1,1,1,1,1,2,1,1,2,8,0.292405,0.299561,0,No
2,2,4,2,2,4,2,2,4,8,0.302863,0.310215,0,No
2,2,4,2,2,4,2,2,4,8,0.323874,0.33228,0,No
1,1,1,1,1,2,1,1,2,8,0.301589,0.314491,0,No
1,1,1,1,1,2,1,1,2,8,0.289223,0.296402,0,No
1,1,1,1,1,2,1,1,2,8,0.317439,0.327445,0,No
3,3,9,2,3,5,3,3,6,8,0.300622,0.309284,0,No
1,1,1,1,1,2,1,1,2,8,0.339941,0.352199,0,No
1,1,1,1,1,2,1,1,2,8,0.30338,0.311471,0,No
1,1,1,1,1,2,1,1,2,8,0.339934,0.352194,0,No
2,2,4,1,1,2,2,2,4,8,0.296171,0.303818,0,No
1,1,1,1,1,2,1,1,2,8,0.339934,0.352194,0,No
1,1,1,1,1,2,1,1,2,8,0.271899,0.280395,0,No
1,1,1,1,1,2,1,1,2,8,0.281833,0.289891,0,No
3,3,9,1,3,4,3,3,6,8,0.343811,0.357161,0,No
2,2,4,2,2,4,2,2,4,8,0.314022,0.320784,0,No
4,4,16,4,2,6,4,4,8,8,0.341219,0.353853,0,No
1,1,1,1,1,2,1,1,2,8,0.299367,0.306897,0,No
2,2,4,1,2,3,2,2,4,8,0.296954,0.307656,0,No
2,2,4,1,2,3,2,2,4,8,0.319078,0.326587,0,No
1,1,1,1,1,2,1,1,2,8,0.306453,0.313109,0,No
8,8,64,7,6,13,8,8,16,8,0.360146,0.376343,0,No
1,1,1,1,1,2,1,1,2,8,0.302842,0.310166,0,No
1,1,1,1,1,2,1,1,2,8,0.310028,0.318679,0,No
5,5,25,2,2,4,5,5,10,8,0.315462,0.327083,0,No
1,1,1,1,1,2,1,1,2,8,0.277339,0.284521,0,No
1,1,1,1,1,2,1,1,2,8,0.279245,0.286914,0,No
8,8,64,5,4,9,8,8,16,8,0.301706,0.308318,0,No
1,1,1,1,1,2,1,1,2,8,0.313497,0.320213,0,No
1,1,1,1,1,2,1,1,2,8,0.277981,0.285017,0,No
1,1,1,1,1,2,1,1,2,8,0.30833,0.31471,0,No
1,1,1,1,1,2,1,1,2,8,0.309325,0.317943,0,No
1,1,1,1,1,2,1,1,2,7,0.327826,0.338517,0,No
2,2,4,1,2,3,2,2,4,8,0.290192,0.297677,0,No
2,2,4,2,2,4,2,2,4,8,0.331604,0.343137,0,No
3,3,9,2,1,3,3,3,6,7,0.327813,0.338503,0,No
1,1,1,1,1,2,1,1,2,8,0.339934,0.352194,0,No
1,1,1,1,1,2,1,1,2,7,0.327819,0.338512,0,No
1,1,1,1,1,2,1,1,2,8,0.313497,0.320213,0,No
1,1,1,1,1,2,1,1,2,8,0.32342,0.334424,0,No
1,1,1,1,1,2,1,1,2,8,0.289694,0.297055,0,No
8,5,40,7,7,14,8,8,16,8,0.349458,0.363534,0,No
1,1,1,1,1,2,1,1,2,8,0.263119,0.269161,0,No
1,1,1,1,1,2,1,1,2,8,0.301584,0.314486,0,No
1,1,1,1,1,2,1,1,2,7,0.2963,0.30485,0,No
1,1,1,1,1,2,1,1,2,8,0.289145,0.296989,0,No
2,2,4,2,2,4,2,2,4,8,0.312155,0.319091,0,No
2,2,4,2,2,4,2,2,4,8,0.322241,0.329873,0,No
1,1,1,1,1,2,1,1,2,7,0.327813,0.338503,0,No
1,1,1,1,1,2,1,1,2,8,0.32342,0.334424,0,No
1,1,1,1,1,2,1,1,2,8,0.310028,0.318679,0,No
1,1,1,1,1,2,1,1,2,7,0.296305,0.304855,0,No
1,1,1,1,1,2,1,1,2,8,0.27122,0.279026,0,No
1,1,1,1,1,2,1,1,2,8,0.339934,0.352194,0,No
1,1,1,1,1,2,1,1,2,9,0.268721,0.277328,0,No
1,1,1,1,1,2,1,1,2,8,0.323426,0.334429,0,No
1,1,1,1,1,2,1,1,2,8,0.310028,0.318679,0,No
1,1,1,1,1,2,1,1,2,8,0.301589,0.314491,0,No
1,1,1,1,1,2,1,1,2,9,0.268721,0.277328,0,No
4,4,16,3,3,6,4,4,8,7,0.297674,0.306196,0,No
1,1,1,1,1,2,1,1,2,8,0.310028,0.318679,0,No
1,1,1,1,1,2,1,1,2,8,0.317298,0.324393,0,No
1,1,1,1,1,2,1,1,2,8,0.268219,0.275191,0,No
1,1,1,1,1,2,1,1,2,7,0.296305,0.304855,0,No
1,1,1,1,1,2,1,1,2,7,0.296305,0.304855,0,No
3,3,9,2,2,4,3,3,6,8,0.288032,0.299918,0,No
1,1,1,1,1,2,1,1,2,8,0.303585,0.310469,0,No
1,1,1,1,1,2,1,1,2,9,0.271276,0.277863,0,No
1,1,1,1,1,2,1,1,2,9,0.22025,0.224163,0,No
1,1,1,1,1,2,1,1,2,8,0.29974,0.30761,0,No
1,1,1,1,1,2,1,1,2,9,0.238067,0.241926,0,No
2,2,4,2,2,4,2,2,4,8,0.282486,0.291044,0,No
2,2,4,1,2,3,2,2,4,8,0.277276,0.284227,0,No
1,1,1,1,1,2,1,1,2,8,0.28349,0.292904,0,No
3,3,9,2,2,4,3,3,6,8,0.301877,0.308857,0,No
1,1,1,1,1,2,1,1,2,8,0.268341,0.275541,0,No
1,1,1,1,1,2,1,1,2,9,0.247054,0.250762,0,No
5,5,25,4,2,6,5,5,10,8,0.325474,0.336246,0,No
1,1,1,1,1,2,1,1,2,8,0.276813,0.283549,0,No
1,1,1,1,1,2,1,1,2,8,0.270536,0.276998,0,No
2,2,4,1,1,2,2,2,4,9,0.268641,0.276936,0,No
1,1,1,1,1,2,1,1,2,8,0.30338,0.311471,0,No
1,1,1,1,1,2,1,1,2,8,0.30338,0.311471,0,No
2,2,4,2,2,4,2,2,4,8,0.277186,0.284353,0,No
2,2,4,2,2,4,2,2,4,7,0.33181,0.342425,0,No
1,1,1,1,1,2,1,1,2,8,0.290123,0.297326,0,No
1,1,1,1,1,2,1,1,2,9,0.247054,0.250762,0,No
2,2,4,2,1,3,2,2,4,8,0.288163,0.299063,0,No
4,4,16,4,3,7,4,4,8,8,0.329008,0.340186,0,No
3,3,9,3,2,5,3,3,6,7,0.352621,0.366966,0,No
2,2,4,2,2,4,2,2,4,8,0.339982,0.352282,0,No
1,1,1,1,1,2,1,1,2,8,0.32342,0.334424,0,No
1,1,1,1,1,2,1,1,2,8,0.277096,0.285605,0,No
1,1,1,1,1,2,1,1,2,8,0.323426,0.334429,0,No
1,1,1,1,1,2,1,1,2,8,0.331578,0.343078,0,No
1,1,1,1,1,2,1,1,2,7,0.296305,0.304855,0,No
4,4,16,4,3,7,4,4,8,7,0.33839,0.349816,0,No
1,1,1,1,1,2,1,1,2,8,0.30833,0.31471,0,No
1,1,1,1,1,2,1,1,2,7,0.296305,0.304855,0,No
14,14,196,4,7,11,14,14,28,8,0.328596,0.338666,0,No
1,1,1,1,1,2,1,1,2,9,0.240982,0.244751,0,No
3,3,9,3,2,5,3,3,6,8,0.30586,0.31901,0,No
1,1,1,1,1,2,1,1,2,9,0.255733,0.261996,0,No
2,2,4,1,1,2,2,2,4,9,0.281062,0.288127,0,No
1,1,1,1,1,2,1,1,2,8,0.247122,0.251495,0,No
1,1,1,1,1,2,1,1,2,9,0.240812,0.244413,0,No
2,2,4,1,1,2,2,2,4,8,0.272307,0.278975,0,No
1,1,1,1,1,2,1,1,2,8,0.331565,0.343064,0,No
1,1,1,1,1,2,1,1,2,8,0.314583,0.32146,0,No
3,3,9,3,3,6,3,3,6,8,0.336462,0.34784,0,No
1,1,1,1,1,2,1,1,2,8,0.310028,0.318679,0,No
1,1,1,1,1,2,1,1,2,7,0.327819,0.338512,0,No
1,1,1,1,1,2,1,1,2,8,0.301584,0.314486,0,No
2,1,2,2,2,4,2,2,4,8,0.29844,0.30647,0,No
1,1,1,1,1,2,1,1,2,8,0.339934,0.352194,0,No
2,2,4,1,1,2,2,2,4,8,0.274647,0.281458,0,No
2,2,4,2,2,4,2,2,4,8,0.31167,0.32049,0,No
1,1,1,1,1,2,1,1,2,8,0.310033,0.318684,0,No
2,2,4,1,1,2,2,2,4,9,0.270944,0.277793,0,No
2,2,4,1,1,2,2,2,4,8,0.310028,0.318679,0,No
3,3,9,2,2,4,3,3,6,8,0.302027,0.315248,0,No
1,1,1,1,1,2,1,1,2,8,0.339934,0.352194,0,No
1,1,1,1,1,2,1,1,2,8,0.301584,0.314486,0,No
2,2,4,1,1,2,2,2,4,8,0.32342,0.334424,0,No
3,3,9,3,3,6,3,3,6,7,0.330755,0.341909,0,No
1,1,1,1,1,2,1,1,2,8,0.265411,0.271305,0,No
1,1,1,1,1,2,1,1,2,8,0.303585,0.310469,0,No
1,1,1,1,1,2,1,1,2,8,0.279965,0.286903,0,No
1,1,1,1,1,2,1,1,2,8,0.310028,0.318679,0,No
1,1,1,1,1,2,1,1,2,8,0.278008,0.285471,0,No
1,1,1,1,1,2,1,1,2,8,0.315759,0.323487,0,No
1,1,1,1,1,2,1,1,2,7,0.327826,0.338517,0,No
1,1,1,1,1,2,1,1,2,8,0.32342,0.334424,0,No
1,1,1,1,1,2,1,1,2,8,0.296991,0.30415,0,No
1,1,1,1,1,2,1,1,2,9,0.269417,0.275849,0,No
2,2,4,2,2,4,2,2,4,8,0.30669,0.315686,0,No
1,1,1,1,1,2,1,1,2,8,0.297462,0.304358,0,No
1,1,1,1,1,2,1,1,2,8,0.296433,0.30351,0,No
1,1,1,1,1,2,1,1,2,8,0.301584,0.314486,0,No
3,3,9,3,3,6,3,3,6,8,0.344429,0.357468,0,No
10,9,90,5,5,10,10,10,20,7,0.346802,0.359873,0,No
1,1,1,1,1,2,1,1,2,8,0.339934,0.352194,0,No
1,1,1,1,1,2,1,1,2,8,0.289257,0.299292,0,No
2,2,4,2,2,4,2,2,4,8,0.316962,0.323676,0,No
1,1,1,1,1,2,1,1,2,9,0.244305,0.248584,0,No
1,1,1,1,1,2,1,1,2,8,0.339934,0.352194,0,No
1,1,1,1,1,2,1,1,2,8,0.301589,0.314491,0,No
2,2,4,1,1,2,2,2,4,8,0.303839,0.310394,0,No
2,2,4,2,2,4,2,2,4,8,0.28609,0.293432,0,No
1,1,1,1,1,2,1,1,2,8,0.295632,0.302485,0,No
1,1,1,1,1,2,1,1,2,7,0.327819,0.338512,0,No
1,1,1,1,1,2,1,1,2,8,0.309977,0.317107,0,No
1,1,1,1,1,2,1,1,2,8,0.286158,0.293266,0,No
2,2,4,1,2,3,2,2,4,8,0.293214,0.303966,0,No
2,2,4,1,2,3,2,2,4,8,0.341219,0.353853,0,No
2,2,4,2,2,4,2,2,4,8,0.341124,0.35348,0,No
1,1,1,1,1,2,1,1,2,9,0.262237,0.268863,0,No
1,1,1,1,1,2,1,1,2,9,0.243587,0.24716,0,No
2,2,4,2,2,4,2,2,4,7,0.352621,0.366966,0,No
2,2,4,2,2,4,2,2,4,7,0.299972,0.30965,0,No
3,3,9,2,3,5,3,3,6,8,0.340878,0.353261,0,No
1,1,1,1,1,2,1,1,2,8,0.304126,0.310713,0,No
1,1,1,1,1,2,1,1,2,8,0.32342,0.334424,0,No
1,1,1,1,1,2,1,1,2,8,0.293355,0.300441,0,No
1,1,1,1,1,2,1,1,2,9,0.284336,0.292278,0,No
4,4,16,2,4,6,4,4,8,8,0.329803,0.341287,0,No
3,3,9,2,2,4,3,3,6,8,0.349637,0.363925,0,No
1,1,1,1,1,2,1,1,2,8,0.275681,0.282761,0,No
2,2,4,1,2,3,2,2,4,8,0.298905,0.305892,0,No
1,1,1,1,1,2,1,1,2,8,0.339934,0.352194,0,No
2,2,4,2,2,4,2,2,4,8,0.295034,0.305722,0,No
1,1,1,1,1,2,1,1,2,9,0.254965,0.259737,0,No
1,1,1,1,1,2,1,1,2,8,0.306448,0.313104,0,No
2,2,4,2,2,4,2,2,4,8,0.325084,0.336656,0,No
1,1,1,1,1,2,1,1,2,8,0.317292,0.324388,0,No
1,1,1,1,1,2,1,1,2,8,0.32342,0.334424,0,No
2,2,4,2,2,4,2,2,4,8,0.340837,0.35328,0,No
1,1,1,1,1,2,1,1,2,9,0.256857,0.261944,0,No
1,1,1,1,1,2,1,1,2,8,0.331571,0.343073,0,No
1,1,1,1,1,2,1,1,2,8,0.310028,0.318679,0,No
1,1,1,1,1,2,1,1,2,8,0.255786,0.260546,0,No
1,1,1,1,1,2,1,1,2,8,0.302847,0.310171,0,No
3,2,6,1,3,4,3,3,6,8,0.333738,0.345371,0,No
3,3,9,1,1,2,3,3,6,8,0.310717,0.317502,0,No
1,1,1,1,1,2,1,1,2,8,0.315759,0.323487,0,No
2,2,4,1,2,3,2,2,4,8,0.313198,0.322823,0,No
2,1,2,1,2,3,2,2,4,8,0.286942,0.294145,0,No
1,1,1,1,1,2,1,1,2,8,0.314589,0.321465,0,No
1,1,1,1,1,2,1,1,2,8,0.331578,0.343078,0,No
2,2,4,2,2,4,2,2,4,8,0.349637,0.363925,0,No
4,4,16,4,3,7,4,4,8,7,0.298476,0.30708,0,No
4,4,16,1,2,3,4,4,8,8,0.310745,0.31945,0,No
1,1,1,1,1,2,1,1,2,9,0.276056,0.283078,0,No
1,1,1,1,1,2,1,1,2,7,0.296305,0.304855,0,No
1,1,1,1,1,2,1,1,2,8,0.310028,0.318679,0,No
4,3,12,4,2,6,4,4,8,9,0.279983,0.28795,0,No
2,2,4,1,1,2,2,2,4,9,0.276056,0.283078,0,No
5,5,25,3,3,6,5,5,10,7,0.299377,0.307929,0,No
1,1,1,1,1,2,1,1,2,7,0.327819,0.338512,0,No
3,3,9,3,3,6,3,3,6,7,0.316099,0.325534,0,No
1,1,1,1,1,2,1,1,2,8,0.339941,0.352199,0,No
1,1,1,1,1,2,1,1,2,8,0.309331,0.317947,0,No
1,1,1,1,1,2,1,1,2,8,0.284255,0.291831,0,No
2,2,4,2,2,4,2,2,4,8,0.311255,0.318834,0,No
1,1,1,1,1,2,1,1,2,8,0.313497,0.320213,0,No
1,1,1,1,1,2,1,1,2,9,0.266484,0.273045,0,No
1,1,1,1,1,2,1,1,2,8,0.339934,0.352194,0,No
1,1,1,1,1,2,1,1,2,9,0.268641,0.276936,0,No
3,3,9,2,2,4,3,3,6,7,0.332606,0.34272,0,No
4,4,16,4,1,5,4,4,8,8,0.323426,0.334429,0,No
2,2,4,1,1,2,2,2,4,8,0.309977,0.317107,0,No
1,1,1,1,1,2,1,1,2,8,0.32342,0.334424,0,No
1,1,1,1,1,2,1,1,2,8,0.32342,0.334424,0,No
1,1,1,1,1,2,1,1,2,8,0.339934,0.352194,0,No
7,7,49,7,2,9,7,7,14,8,0.312819,0.32166,0,No
2,2,4,2,2,4,2,2,4,8,0.306673,0.320221,0,No
1,1,1,1,1,2,1,1,2,8,0.339934,0.352194,0,No
1,1,1,1,1,2,1,1,2,8,0.294596,0.301832,0,No
1,1,1,1,1,2,1,1,2,8,0.301584,0.314486,0,No
1,1,1,1,1,2,1,1,2,8,0.313497,0.320213,0,No
1,1,1,1,1,2,1,1,2,8,0.275281,0.282162,0,No
1,1,1,1,1,2,1,1,2,8,0.302198,0.308977,0,No
3,3,9,2,2,4,3,3,6,8,0.309068,0.315475,0,No
2,2,4,1,2,3,2,2,4,8,0.341752,0.354359,0,No
1,1,1,1,1,2,1,1,2,8,0.339941,0.352199,0,No
1,1,1,1,1,2,1,1,2,8,0.296166,0.303813,0,No
1,1,1,1,1,2,1,1,2,8,0.309466,0.316145,0,No
1,1,1,1,1,2,1,1,2,8,0.27455,0.283664,0,No
1,1,1,1,1,2,1,1,2,8,0.27455,0.283664,0,No
1,1,1,1,1,2,1,1,2,8,0.278743,0.288253,0,No
3,3,9,2,2,4,3,3,6,7,0.330845,0.341128,0,No
1,1,1,1,1,2,1,1,2,8,0.305116,0.311592,0,No
3,3,9,3,3,6,3,3,6,8,0.351633,0.366222,0,No
2,2,4,2,2,4,2,2,4,8,0.319957,0.327929,0,No
3,3,9,2,2,4,3,3,6,7,0.314479,0.322906,0,No
1,1,1,1,1,2,1,1,2,7,0.327819,0.338512,0,No
1,1,1,1,1,2,1,1,2,7,0.327819,0.338512,0,No
2,2,4,1,1,2,2,2,4,9,0.28776,0.294983,0,No
5,5,25,3,4,7,5,5,10,8,0.321634,0.332611,0,No
4,4,16,2,3,5,4,4,8,8,0.321283,0.329027,0,No
2,2,4,1,2,3,2,2,4,8,0.340192,0.352546,0,No
3,3,9,2,2,4,3,3,6,7,0.332236,0.343545,0,No
1,1,1,1,1,2,1,1,2,7,0.327819,0.338512,0,No
2,2,4,1,2,3,2,2,4,8,0.309157,0.321667,0,No
3,3,9,2,2,4,3,3,6,8,0.319066,0.329734,0,No
1,1,1,1,1,2,1,1,2,9,0.268721,0.277328,0,No
1,1,1,1,1,2,1,1,2,8,0.29983,0.307297,0,No
2,2,4,2,1,3,2,2,4,8,0.30338,0.311471,0,No
1,1,1,1,1,2,1,1,2,8,0.339934,0.352194,0,No
1,1,1,1,1,2,1,1,2,9,0.260083,0.265757,0,No
1,1,1,1,1,2,1,1,2,8,0.32342,0.334424,0,No
2,1,2,1,1,2,2,2,4,8,0.301589,0.314491,0,No
1,1,1,1,1,2,1,1,2,9,0.250845,0.25593,0,No
1,1,1,1,1,2,1,1,2,8,0.323426,0.334429,0,No
1,1,1,1,1,2,1,1,2,9,0.268637,0.276931,0,No
2,2,4,1,2,3,2,2,4,8,0.340043,0.352326,0,No
1,1,1,1,1,2,1,1,2,8,0.310028,0.318679,0,No
1,1,1,1,1,2,1,1,2,9,0.268717,0.277323,0,No
1,1,1,1,1,2,1,1,2,8,0.339927,0.352185,0,No
1,1,1,1,1,2,1,1,2,8,0.323426,0.334429,0,No
1,1,1,1,1,2,1,1,2,8,0.27122,0.279026,0,No
6,6,36,5,1,6,6,6,12,7,0.2963,0.30485,0,No
1,1,1,1,1,2,1,1,2,9,0.26137,0.267227,0,No
1,1,1,1,1,2,1,1,2,8,0.288168,0.299068,0,No
1,1,1,1,1,2,1,1,2,8,0.30223,0.308783,0,No
1,1,1,1,1,2,1,1,2,8,0.288163,0.299063,0,No
2,2,4,2,1,3,2,2,4,8,0.303375,0.311466,0,No
1,1,1,1,1,2,1,1,2,8,0.317292,0.324388,0,No
1,1,1,1,1,2,1,1,2,7,0.2963,0.30485,0,No
1,1,1,1,1,2,1,1,2,7,0.296305,0.304855,0,No
4,4,16,3,1,4,4,4,8,7,0.296305,0.304855,0,No
4,4,16,2,2,4,4,4,8,7,0.308375,0.316065,0,No
5,4,20,4,5,9,5,5,10,8,0.332794,0.344039,0,No
2,2,4,2,2,4,2,2,4,8,0.318435,0.327389,0,No
7,7,49,4,5,9,7,7,14,8,0.336376,0.349044,0,No
1,1,1,1,1,2,1,1,2,8,0.306448,0.313104,0,No
1,1,1,1,1,2,1,1,2,7,0.327819,0.338512,0,No
3,3,9,2,3,5,3,3,6,8,0.315561,0.330468,0,No
1,1,1,1,1,2,1,1,2,8,0.263155,0.269091,0,No
1,1,1,1,1,2,1,1,2,8,0.278743,0.288253,0,No
1,1,1,1,1,2,1,1,2,7,0.327819,0.338512,0,No
2,2,4,2,2,4,2,2,4,7,0.339306,0.352082,0,No
2,2,4,1,1,2,2,2,4,8,0.295294,0.302306,0,No
1,1,1,1,1,2,1,1,2,8,0.301594,0.314494,0,No
1,1,1,1,1,2,1,1,2,8,0.297462,0.304358,0,No
2,2,4,1,2,3,2,2,4,8,0.352403,0.367741,0,No
1,1,1,1,1,2,1,1,2,10,0.235066,0.238708,0,No
1,1,1,1,1,2,1,1,2,8,0.310722,0.317507,0,No
2,2,4,1,1,2,2,2,4,8,0.27122,0.279026,0,No
3,3,9,1,1,2,3,3,6,8,0.323426,0.334429,0,No
4,4,16,3,3,6,4,4,8,8,0.309387,0.318215,0,No
2,2,4,2,2,4,2,2,4,8,0.325115,0.336276,0,No
3,3,9,2,2,4,3,3,6,8,0.32709,0.337909,0,No
2,2,4,1,1,2,2,2,4,8,0.288929,0.297713,0,No
1,1,1,1,1,2,1,1,2,8,0.32342,0.334424,0,No
2,2,4,2,2,4,2,2,4,7,0.332249,0.34279,0,No
4,4,16,3,4,7,4,4,8,8,0.330665,0.342183,0,No
2,2,4,2,2,4,2,2,4,8,0.332573,0.344483,0,No
2,2,4,2,2,4,2,2,4,8,0.339995,0.352287,0,No
2,2,4,2,2,4,2,2,4,8,0.29221,0.302983,0,No
3,3,9,3,2,5,3,3,6,8,0.330961,0.343854,0,No
1,1,1,1,1,2,1,1,2,8,0.288163,0.299063,0,No
1,1,1,1,1,2,1,1,2,7,0.327819,0.338512,0,No
1,1,1,1,1,2,1,1,2,9,0.28078,0.287919,0,No
2,2,4,1,1,2,2,2,4,9,0.268641,0.276936,0,No
2,2,4,2,2,4,2,2,4,8,0.330961,0.343854,0,No
1,1,1,1,1,2,1,1,2,8,0.310033,0.318684,0,No
7,7,49,3,4,7,7,7,14,8,0.324262,0.334229,0,No
3,2,6,2,2,4,3,3,6,8,0.316486,0.324623,0,No
1,1,1,1,1,2,1,1,2,8,0.271899,0.280395,0,No
1,1,1,1,1,2,1,1,2,8,0.306448,0.313104,0,No
1,1,1,1,1,2,1,1,2,9,0.268641,0.276936,0,No
1,1,1,1,1,2,1,1,2,8,0.339934,0.352194,0,No
1,1,1,1,1,2,1,1,2,8,0.291905,0.299149,0,No
11,10,110,3,6,9,11,11,22,7,0.333314,0.343965,0,No
1,1,1,1,1,2,1,1,2,8,0.271899,0.280395,0,No
1,1,1,1,1,2,1,1,2,9,0.268645,0.276939,0,No
2,2,4,1,1,2,2,2,4,9,0.241405,0.244558,0,No
2,2,4,2,2,4,2,2,4,8,0.345692,0.358823,0,No
1,1,1,1,1,2,1,1,2,8,0.331571,0.343073,0,No
1,1,1,1,1,2,1,1,2,8,0.299835,0.307302,0,No
2,2,4,1,1,2,2,2,4,8,0.277096,0.285605,0,No
1,1,1,1,1,2,1,1,2,9,0.265403,0.271611,0,No
1,1,1,1,1,2,1,1,2,8,0.32342,0.334424,0,No
3,3,9,1,3,4,3,3,6,8,0.320534,0.329289,0,No
1,1,1,1,1,2,1,1,2,8,0.289257,0.299292,0,No
2,2,4,1,2,3,2,2,4,8,0.306905,0.313894,0,No
2,2,4,1,2,3,2,2,4,8,0.283401,0.293711,0,No
3,3,9,3,3,6,3,3,6,8,0.313854,0.326241,0,No
2,2,4,1,2,3,2,2,4,8,0.311051,0.3191,0,No
1,1,1,1,1,2,1,1,2,8,0.331571,0.343073,0,No
2,2,4,1,2,3,2,2,4,7,0.347983,0.361927,0,No
1,1,1,1,1,2,1,1,2,8,0.301589,0.314491,0,No
2,2,4,2,2,4,2,2,4,7,0.347983,0.361927,0,No
1,1,1,1,1,2,1,1,2,8,0.287125,0.294179,0,No
4,4,16,4,3,7,4,4,8,8,0.342376,0.356151,0,No
1,1,1,1,1,2,1,1,2,7,0.327819,0.338512,0,No
1,1,1,1,1,2,1,1,2,7,0.327826,0.338517,0,No
1,1,1,1,1,2,1,1,2,8,0.309331,0.317947,0,No
3,3,9,2,2,4,3,3,6,8,0.328425,0.33907,0,No
2,2,4,2,2,4,2,2,4,8,0.338243,0.351497,0,No
1,1,1,1,1,2,1,1,2,8,0.255308,0.260071,0,No
1,1,1,1,1,2,1,1,2,9,0.25919,0.264959,0,No
1,1,1,1,1,2,1,1,2,8,0.339934,0.352194,0,No
1,1,1,1,1,2,1,1,2,8,0.27455,0.283664,0,No
2,2,4,1,1,2,2,2,4,9,0.265704,0.272578,0,No
3,3,9,2,2,4,3,3,6,7,0.328469,0.339091,0,No
1,1,1,1,1,2,1,1,2,8,0.267403,0.273615,0,No
3,3,9,3,2,5,3,3,6,8,0.302417,0.312687,0,No
1,1,1,1,1,2,1,1,2,9,0.239922,0.243252,0,No
1,1,1,1,1,2,1,1,2,9,0.254908,0.260671,0,No
2,2,4,2,1,3,2,2,4,8,0.288163,0.299063,0,No
1,1,1,1,1,2,1,1,2,9,0.268721,0.277328,0,No
1,1,1,1,1,2,1,1,2,8,0.281716,0.289,0,No
2,2,4,2,2,4,2,2,4,8,0.296475,0.308019,0,No
1,1,1,1,1,2,1,1,2,8,0.289355,0.297215,0,No
1,1,1,1,1,2,1,1,2,8,0.271899,0.280395,0,No
1,1,1,1,1,2,1,1,2,8,0.301584,0.314486,0,No
1,1,1,1,1,2,1,1,2,8,0.269005,0.275293,0,No
2,2,4,2,2,4,2,2,4,8,0.309775,0.323433,0,No
1,1,1,1,1,2,1,1,2,8,0.263013,0.269118,0,No
1,1,1,1,1,2,1,1,2,9,0.256151,0.261327,0,No
1,1,1,1,1,2,1,1,2,8,0.32342,0.334424,0,No
1,1,1,1,1,2,1,1,2,8,0.331578,0.343078,0,No
1,1,1,1,1,2,1,1,2,9,0.243834,0.247507,0,No
1,1,1,1,1,2,1,1,2,8,0.339934,0.352194,0,No
5,5,25,2,4,6,5,5,10,8,0.354475,0.369401,0,No
1,1,1,1,1,2,1,1,2,8,0.288168,0.299068,0,No
1,1,1,1,1,2,1,1,2,8,0.301589,0.314491,0,No
1,1,1,1,1,2,1,1,2,8,0.287605,0.295192,0,No
2,2,4,2,2,4,2,2,4,8,0.306019,0.312622,0,No
1,1,1,1,1,2,1,1,2,8,0.323426,0.334429,0,No
5,5,25,3,4,7,5,5,10,8,0.32265,0.332626,0,No
3,3,9,2,1,3,3,3,6,9,0.268641,0.276936,0,No
10,10,100,5,5,10,10,10,20,8,0.329662,0.340937,0,No
3,3,9,3,3,6,3,3,6,8,0.306156,0.318549,0,No
1,1,1,1,1,2,1,1,2,9,0.276056,0.283078,0,No
1,1,1,1,1,2,1,1,2,8,0.310717,0.317502,0,No
4,4,16,4,2,6,4,4,8,8,0.295571,0.304762,0,No
1,1,1,1,1,2,1,1,2,8,0.303655,0.312962,0,No
1,1,1,1,1,2,1,1,2,9,0.268641,0.276936,0,No
3,3,9,2,2,4,3,3,6,8,0.275441,0.282131,0,No
2,2,4,1,1,2,2,2,4,8,0.313497,0.320213,0,No
2,2,4,2,2,4,2,2,4,8,0.342335,0.354877,0,No
2,2,4,2,2,4,2,2,4,8,0.316609,0.32539,0,No
1,1,1,1,1,2,1,1,2,8,0.313497,0.320213,0,No
1,1,1,1,1,2,1,1,2,8,0.317445,0.327454,0,No
1,1,1,1,1,2,1,1,2,8,0.2924,0.299556,0,No
1,1,1,1,1,2,1,1,2,8,0.304132,0.310718,0,No
1,1,1,1,1,2,1,1,2,9,0.259988,0.266702,0,No
1,1,1,1,1,2,1,1,2,9,0.254911,0.260674,0,No
1,1,1,1,1,2,1,1,2,8,0.309331,0.317947,0,No
1,1,1,1,1,2,1,1,2,8,0.339934,0.352194,0,No
1,1,1,1,1,2,1,1,2,8,0.303655,0.312962,0,No
2,2,4,2,2,4,2,2,4,8,0.316227,0.323765,0,No
1,1,1,1,1,2,1,1,2,7,0.327819,0.338512,0,No
2,2,4,2,2,4,2,2,4,8,0.341069,0.353752,0,No
1,1,1,1,1,2,1,1,2,8,0.267852,0.275078,0,No
1,1,1,1,1,2,1,1,2,8,0.288163,0.299063,0,No
1,1,1,1,1,2,1,1,2,8,0.291655,0.298837,0,No
1,1,1,1,1,2,1,1,2,9,0.243834,0.247507,0,No
1,1,1,1,1,2,1,1,2,8,0.274545,0.283659,0,No
1,1,1,1,1,2,1,1,2,8,0.287605,0.295192,0,No
2,2,4,1,1,2,2,2,4,8,0.301589,0.314491,0,No
2,2,4,1,1,2,2,2,4,8,0.310033,0.318684,0,No
1,1,1,1,1,2,1,1,2,8,0.296166,0.303813,0,No
1,1,1,1,1,2,1,1,2,9,0.27242,0.279222,0,No
1,1,1,1,1,2,1,1,2,8,0.278743,0.288253,0,No
2,2,4,1,2,3,2,2,4,8,0.287174,0.297346,0,No
1,1,1,1,1,2,1,1,2,8,0.290014,0.297093,0,No
3,3,9,3,2,5,3,3,6,8,0.3347,0.34661,0,No
1,1,1,1,1,2,1,1,2,7,0.296294,0.30484,0,No
1,1,1,1,1,2,1,1,2,8,0.30338,0.311471,0,No
1,1,1,1,1,2,1,1,2,7,0.327819,0.338512,0,No
2,2,4,1,2,3,2,2,4,9,0.2876,0.29621,0,No
1,1,1,1,1,2,1,1,2,7,0.327819,0.338512,0,No
3,3,9,2,2,4,3,3,6,8,0.294012,0.302983,0,No
2,2,4,2,2,4,2,2,4,8,0.352396,0.367736,0,No
1,1,1,1,1,2,1,1,2,9,0.234437,0.239796,0,No
5,4,20,3,2,5,5,5,10,8,0.308754,0.316717,0,No
1,1,1,1,1,2,1,1,2,8,0.301589,0.314491,0,No
1,1,1,1,1,2,1,1,2,9,0.249499,0.253819,0,No
1,1,1,1,1,2,1,1,2,8,0.32342,0.334424,0,No
2,2,4,1,2,3,2,2,4,8,0.315444,0.325104,0,No
3,3,9,1,1,2,3,3,6,8,0.32342,0.334424,0,No
1,1,1,1,1,2,1,1,2,8,0.268345,0.275546,0,No
1,1,1,1,1,2,1,1,2,8,0.268345,0.275546,0,No
2,2,4,2,2,4,2,2,4,8,0.328995,0.340857,0,No
4,4,16,2,2,4,4,4,8,7,0.32816,0.33883,0,No
1,1,1,1,1,2,1,1,2,8,0.296444,0.303607,0,No
1,1,1,1,1,2,1,1,2,8,0.339927,0.352185,0,No
9,9,81,1,2,3,9,9,18,7,0.352614,0.366956,0,No
2,2,4,2,2,4,2,2,4,8,0.311926,0.319167,0,No
3,3,9,3,3,6,3,3,6,8,0.319161,0.325969,0,No
1,1,1,1,1,2,1,1,2,8,0.301589,0.314491,0,No
3,3,9,3,3,6,3,3,6,8,0.310389,0.318244,0,No
1,1,1,1,1,2,1,1,2,8,0.284208,0.291543,0,No
1,1,1,1,1,2,1,1,2,8,0.286898,0.294153,0,No
1,1,1,1,1,2,1,1,2,8,0.282678,0.289714,0,No
1,1,1,1,1,2,1,1,2,8,0.265102,0.271101,0,No
3,3,9,2,3,5,3,3,6,8,0.318304,0.326168,0,No
5,5,25,4,2,6,5,5,10,8,0.315083,0.329711,0,No
1,1,1,1,1,2,1,1,2,8,0.301584,0.314486,0,No
1,1,1,1,1,2,1,1,2,8,0.331571,0.343073,0,No
2,1,2,2,2,4,2,2,4,8,0.315089,0.329716,0,No
1,1,1,1,1,2,1,1,2,9,0.250842,0.255927,0,No
2,2,4,2,2,4,2,2,4,8,0.305756,0.314245,0,No
1,1,1,1,1,2,1,1,2,8,0.339934,0.352194,0,No
2,2,4,1,1,2,2,2,4,7,0.327819,0.338512,0,No
6,6,36,2,5,7,6,6,12,8,0.328387,0.336841,0,No
1,1,1,1,1,2,1,1,2,8,0.286995,0.295346,0,No
2,2,4,1,1,2,2,2,4,9,0.272337,0.279216,0,No
1,1,1,1,1,2,1,1,2,8,0.28349,0.292904,0,No
3,3,9,2,1,3,3,3,6,9,0.254908,0.259913,0,No
3,3,9,2,2,4,3,3,6,8,0.345692,0.358823,0,No
1,1,1,1,1,2,1,1,2,8,0.339934,0.352194,0,No
1,1,1,1,1,2,1,1,2,9,0.303807,0.312038,0,No
2,2,4,1,1,2,2,2,4,8,0.313497,0.320213,0,No
2,2,4,1,1,2,2,2,4,8,0.291361,0.298432,0,No
1,1,1,1,1,2,1,1,2,8,0.299367,0.306897,0,No
1,1,1,1,1,2,1,1,2,8,0.294479,0.3016,0,No
1,1,1,1,1,2,1,1,2,9,0.268641,0.276936,0,No
1,1,1,1,1,2,1,1,2,7,0.327813,0.338503,0,No
3,3,9,2,3,5,3,3,6,8,0.343825,0.356973,0,No
2,2,4,2,2,4,2,2,4,8,0.340205,0.352517,0,No
1,1,1,1,1,2,1,1,2,8,0.317298,0.324393,0,No
1,1,1,1,1,2,1,1,2,8,0.29596,0.304319,0,No
1,1,1,1,1,2,1,1,2,8,0.273858,0.280724,0,No
4,4,16,4,4,8,4,4,8,8,0.345146,0.358202,0,No
6,5,30,6,5,11,6,6,12,8,0.331121,0.341821,0,No
1,1,1,1,1,2,1,1,2,9,0.265932,0.272147,0,No
2,2,4,2,1,3,2,2,4,8,0.261907,0.26787,0,No
1,1,1,1,1,2,1,1,2,9,0.279309,0.28665,0,No
3,3,9,3,2,5,3,3,6,7,0.313837,0.320688,0,No
1,1,1,1,1,2,1,1,2,9,0.25908,0.264482,0,No
1,1,1,1,1,2,1,1,2,8,0.247987,0.252548,0,No
2,2,4,1,1,2,2,2,4,8,0.339934,0.352194,0,No
2,2,4,2,2,4,2,2,4,8,0.314699,0.321595,0,No
1,1,1,1,1,2,1,1,2,8,0.303375,0.311466,0,No
1,1,1,1,1,2,1,1,2,8,0.306651,0.31538,0,No
1,1,1,1,1,2,1,1,2,7,0.327819,0.338512,0,No
1,1,1,1,1,2,1,1,2,8,0.287338,0.294477,0,No
1,1,1,1,1,2,1,1,2,8,0.339934,0.352194,0,No
1,1,1,1,1,2,1,1,2,8,0.271899,0.280395,0,No
7,7,49,2,1,3,7,7,14,7,0.327813,0.338503,0,No
5,5,25,5,3,8,5,5,10,8,0.319873,0.331168,0,No
1,1,1,1,1,2,1,1,2,8,0.303661,0.312967,0,No
1,1,1,1,1,2,1,1,2,8,0.311306,0.32231,0,No
1,1,1,1,1,2,1,1,2,8,0.317451,0.327459,0,No
4,4,16,1,4,5,4,4,8,8,0.342163,0.35501,0,No
1,1,1,1,1,2,1,1,2,8,0.339934,0.352194,0,No
3,3,9,3,2,5,3,3,6,8,0.349637,0.363925,0,No
1,1,1,1,1,2,1,1,2,8,0.295596,0.303244,0,No
1,1,1,1,1,2,1,1,2,9,0.25189,0.256782,0,No
1,1,1,1,1,2,1,1,2,8,0.281637,0.288585,0,No
1,1,1,1,1,2,1,1,2,8,0.280056,0.287563,0,No
1,1,1,1,1,2,1,1,2,9,0.303807,0.312038,0,No
1,1,1,1,1,2,1,1,2,8,0.339941,0.352199,0,No
1,1,1,1,1,2,1,1,2,8,0.303585,0.310469,0,No
1,1,1,1,1,2,1,1,2,8,0.296444,0.303607,0,No
1,1,1,1,1,2,1,1,2,8,0.277096,0.285605,0,No
1,1,1,1,1,2,1,1,2,8,0.289434,0.296701,0,No
3,3,9,3,3,6,3,3,6,8,0.310954,0.317631,0,No
3,3,9,3,3,6,3,3,6,8,0.321398,0.329484,0,No
2,2,4,2,2,4,2,2,4,8,0.304056,0.31151,0,No
2,2,4,2,2,4,2,2,4,8,0.316609,0.32539,0,No
1,1,1,1,1,2,1,1,2,8,0.307813,0.314411,0,No
1,1,1,1,1,2,1,1,2,7,0.327826,0.338517,0,No
1,1,1,1,1,2,1,1,2,8,0.309325,0.317943,0,No
1,1,1,1,1,2,1,1,2,8,0.317292,0.324388,0,No
1,1,1,1,1,2,1,1,2,8,0.317445,0.327454,0,No
3,3,9,2,3,5,3,3,6,7,0.322162,0.330062,0,No
1,1,1,1,1,2,1,1,2,8,0.28349,0.292904,0,No
2,2,4,1,1,2,2,2,4,8,0.288168,0.299068,0,No
2,2,4,1,2,3,2,2,4,8,0.317345,0.324166,0,No
2,2,4,2,2,4,2,2,4,8,0.323911,0.334929,0,No
1,1,1,1,1,2,1,1,2,8,0.323426,0.334429,0,No
1,1,1,1,1,2,1,1,2,8,0.310722,0.317507,0,No
1,1,1,1,1,2,1,1,2,8,0.310033,0.318684,0,No
2,2,4,1,2,3,2,2,4,8,0.331649,0.343191,0,No
2,2,4,1,1,2,2,2,4,8,0.293133,0.30075,0,No
1,1,1,1,1,2,1,1,2,8,0.284184,0.291154,0,No
1,1,1,1,1,2,1,1,2,7,0.296305,0.304855,0,No
1,1,1,1,1,2,1,1,2,8,0.293355,0.300441,0,No
1,1,1,1,1,2,1,1,2,8,0.301589,0.314491,0,No
1,1,1,1,1,2,1,1,2,8,0.304653,0.311376,0,No
1,1,1,1,1,2,1,1,2,7,0.296305,0.304855,0,No
1,1,1,1,1,2,1,1,2,8,0.301584,0.314486,0,No
3,3,9,3,2,5,3,3,6,8,0.304735,0.317312,0,No
1,1,1,1,1,2,1,1,2,7,0.2963,0.30485,0,No
1,1,1,1,1,2,1,1,2,9,0.268641,0.276936,0,No
1,1,1,1,1,2,1,1,2,8,0.301584,0.314486,0,No
6,6,36,3,4,7,6,6,12,8,0.315112,0.322616,0,No
1,1,1,1,1,2,1,1,2,9,0.27606,0.283081,0,No
1,1,1,1,1,2,1,1,2,8,0.323426,0.334429,0,No
1,1,1,1,1,2,1,1,2,8,0.304626,0.311242,0,No
1,1,1,1,1,2,1,1,2,9,0.253119,0.258185,0,No
1,1,1,1,1,2,1,1,2,8,0.303412,0.309915,0,No
1,1,1,1,1,2,1,1,2,8,0.301584,0.314486,0,No
1,1,1,1,1,2,1,1,2,8,0.278739,0.288248,0,No
3,3,9,2,3,5,3,3,6,8,0.341438,0.354416,0,No
2,2,4,1,1,2,2,2,4,9,0.280683,0.28796,0,No
1,1,1,1,1,2,1,1,2,9,0.268645,0.276939,0,No
3,3,9,3,3,6,3,3,6,8,0.306877,0.31923,0,No
2,2,4,2,1,3,2,2,4,8,0.339934,0.352194,0,No
2,2,4,2,2,4,2,2,4,8,0.29205,0.302928,0,No
1,1,1,1,1,2,1,1,2,8,0.292245,0.299248,0,No
1,1,1,1,1,2,1,1,2,8,0.27189,0.28038,0,No
1,1,1,1,1,2,1,1,2,8,0.32342,0.334424,0,No
1,1,1,1,1,2,1,1,2,8,0.32342,0.334424,0,No
2,2,4,1,1,2,2,2,4,8,0.301584,0.314486,0,No
1,1,1,1,1,2,1,1,2,8,0.323426,0.334429,0,No
1,1,1,1,1,2,1,1,2,9,0.244979,0.249046,0,No
2,2,4,2,1,3,2,2,4,8,0.32342,0.334424,0,No
1,1,1,1,1,2,1,1,2,8,0.301589,0.314491,0,No
1,1,1,1,1,2,1,1,2,8,0.310722,0.317507,0,No
1,1,1,1,1,2,1,1,2,8,0.288163,0.299063,0,No
1,1,1,1,1,2,1,1,2,8,0.32342,0.334424,0,No
1,1,1,1,1,2,1,1,2,8,0.28103,0.28802,0,No
3,3,9,2,3,5,3,3,6,8,0.342782,0.355429,0,No
1,1,1,1,1,2,1,1,2,9,0.272825,0.279527,0,No
3,3,9,2,2,4,3,3,6,8,0.321059,0.329667,0,No
1,1,1,1,1,2,1,1,2,7,0.327819,0.338512,0,No
1,1,1,1,1,2,1,1,2,8,0.289257,0.299292,0,No
1,1,1,1,1,2,1,1,2,8,0.289252,0.299287,0,No
3,3,9,1,1,2,3,3,6,8,0.309325,0.317943,0,No
1,1,1,1,1,2,1,1,2,9,0.268641,0.276936,0,No
3,3,9,3,3,6,3,3,6,7,0.333666,0.344931,0,No
2,2,4,1,1,2,2,2,4,8,0.301589,0.314491,0,No
2,2,4,1,1,2,2,2,4,8,0.28349,0.292904,0,No
1,1,1,1,1,2,1,1,2,8,0.297084,0.304216,0,No
1,1,1,1,1,2,1,1,2,8,0.303693,0.310789,0,No
1,1,1,1,1,2,1,1,2,8,0.339941,0.352199,0,No
1,1,1,1,1,2,1,1,2,8,0.309331,0.317947,0,No
5,5,25,3,2,5,5,5,10,8,0.29574,0.304815,0,No
1,1,1,1,1,2,1,1,2,9,0.269426,0.276263,0,No
1,1,1,1,1,2,1,1,2,8,0.306453,0.313109,0,No
1,1,1,1,1,2,1,1,2,8,0.32342,0.334424,0,No
2,2,4,2,2,4,2,2,4,8,0.315176,0.322066,0,No
1,1,1,1,1,2,1,1,2,8,0.2828,0.289824,0,No
1,1,1,1,1,2,1,1,2,7,0.327819,0.338512,0,No
1,1,1,1,1,2,1,1,2,8,0.310028,0.318679,0,No
1,1,1,1,1,2,1,1,2,8,0.32342,0.334424,0,No
1,1,1,1,1,2,1,1,2,7,0.327819,0.338512,0,No
6,6,36,1,1,2,6,6,12,8,0.295136,0.302087,0,No
2,2,4,2,2,4,2,2,4,8,0.319789,0.327203,0,No
2,2,4,2,2,4,2,2,4,8,0.322808,0.330199,0,No
1,1,1,1,1,2,1,1,2,8,0.278739,0.288248,0,No
3,3,9,1,1,2,3,3,6,8,0.339934,0.352194,0,No
2,2,4,2,2,4,2,2,4,7,0.29697,0.30568,0,No
1,1,1,1,1,2,1,1,2,8,0.268219,0.275191,0,No
5,5,25,2,3,5,5,5,10,8,0.311107,0.319395,0,No
1,1,1,1,1,2,1,1,2,8,0.268219,0.275191,0,No
5,5,25,3,3,6,5,5,10,9,0.275734,0.285484,0,No
7,7,49,3,4,7,7,7,14,8,0.329784,0.341587,0,No
3,3,9,1,1,2,3,3,6,9,0.244302,0.248579,0,No
3,3,9,1,3,4,3,3,6,8,0.298602,0.306625,0,No
1,1,1,1,1,2,1,1,2,8,0.339934,0.352194,0,No
1,1,1,1,1,2,1,1,2,8,0.303834,0.31039,0,No
1,1,1,1,1,2,1,1,2,8,0.303375,0.311466,0,No
2,2,4,1,1,2,2,2,4,8,0.303375,0.311466,0,No
5,5,25,4,2,6,5,5,10,8,0.327455,0.338576,0,No
1,1,1,1,1,2,1,1,2,7,0.296305,0.304855,0,No
4,4,16,3,3,6,4,4,8,8,0.319442,0.326985,0,No
1,1,1,1,1,2,1,1,2,8,0.301589,0.314491,0,No
1,1,1,1,1,2,1,1,2,9,0.263403,0.271075,0,No
1,1,1,1,1,2,1,1,2,8,0.339934,0.352194,0,No
1,1,1,1,1,2,1,1,2,8,0.32342,0.334424,0,No
2,2,4,1,1,2,2,2,4,8,0.339927,0.352185,0,No
3,3,9,2,2,4,3,3,6,8,0.323899,0.334023,0,No
3,3,9,1,2,3,3,3,6,8,0.340341,0.352751,0,No
2,2,4,2,2,4,2,2,4,8,0.327461,0.338581,0,No
1,1,1,1,1,2,1,1,2,9,0.241409,0.244561,0,No
2,2,4,1,1,2,2,2,4,8,0.301584,0.314486,0,No
1,1,1,1,1,2,1,1,2,8,0.301584,0.314486,0,No
2,2,4,1,1,2,2,2,4,8,0.339934,0.352194,0,No
1,1,1,1,1,2,1,1,2,9,0.244312,0.248642,0,No
1,1,1,1,1,2,1,1,2,8,0.273862,0.280729,0,No
2,2,4,1,2,3,2,2,4,8,0.278525,0.287764,0,No
2,2,4,2,2,4,2,2,4,8,0.315543,0.326978,0,No
1,1,1,1,1,2,1,1,2,8,0.323426,0.334429,0,No
1,1,1,1,1,2,1,1,2,8,0.323426,0.334429,0,No
1,1,1,1,1,2,1,1,2,8,0.27925,0.286916,0,No
1,1,1,1,1,2,1,1,2,8,0.301584,0.314486,0,No
1,1,1,1,1,2,1,1,2,8,0.274545,0.283659,0,No
1,1,1,1,1,2,1,1,2,8,0.284042,0.291117,0,No
1,1,1,1,1,2,1,1,2,8,0.301584,0.308533,0,No
1,1,1,1,1,2,1,1,2,9,0.259988,0.266702,0,No
1,1,1,1,1,2,1,1,2,8,0.287605,0.295192,0,No
3,3,9,1,2,3,3,3,6,8,0.313595,0.321963,0,No
1,1,1,1,1,2,1,1,2,7,0.2963,0.30485,0,No
1,1,1,1,1,2,1,1,2,8,0.278734,0.288238,0,No
2,2,4,1,2,3,2,2,4,8,0.343127,0.355994,0,No
1,1,1,1,1,2,1,1,2,9,0.250842,0.255927,0,No
1,1,1,1,1,2,1,1,2,8,0.262217,0.268378,0,No
1,1,1,1,1,2,1,1,2,9,0.268641,0.276936,0,No
6,6,36,5,4,9,6,6,12,8,0.341424,0.354606,0,No
1,1,1,1,1,2,1,1,2,8,0.288168,0.299068,0,No
4,4,16,3,2,5,4,4,8,8,0.3347,0.34661,0,No
8,8,64,3,3,6,8,8,16,8,0.328191,0.339204,0,No
20,16,320,5,10,15,20,20,40,7,0.358723,0.373871,0,No
3,3,9,2,2,4,3,3,6,8,0.288148,0.297061,0,No
2,2,4,2,2,4,2,2,4,8,0.297213,0.31,0,No
1,1,1,1,1,2,1,1,2,9,0.257477,0.262636,0,No
1,1,1,1,1,2,1,1,2,8,0.339934,0.352194,0,No
2,2,4,2,2,4,2,2,4,8,0.333764,0.345268,0,No
2,2,4,2,2,4,2,2,4,8,0.332178,0.343701,0,No
2,2,4,2,2,4,2,2,4,7,0.315549,0.324581,0,No
1,1,1,1,1,2,1,1,2,8,0.271899,0.280395,0,No
2,2,4,2,2,4,2,2,4,8,0.324429,0.333684,0,No
1,1,1,1,1,2,1,1,2,8,0.289257,0.299292,0,No
1,1,1,1,1,2,1,1,2,8,0.331578,0.343078,0,No
2,2,4,2,2,4,2,2,4,8,0.295473,0.303911,0,No
1,1,1,1,1,2,1,1,2,8,0.32342,0.334424,0,No
1,1,1,1,1,2,1,1,2,9,0.268641,0.276936,0,No
2,2,4,1,2,3,2,2,4,8,0.314033,0.321007,0,No
2,2,4,2,1,3,2,2,4,8,0.274545,0.283659,0,No
2,2,4,2,2,4,2,2,4,8,0.313566,0.320316,0,No
1,1,1,1,1,2,1,1,2,8,0.339941,0.352199,0,No
1,1,1,1,1,2,1,1,2,9,0.254417,0.260027,0,No
2,2,4,2,2,4,2,2,4,8,0.304751,0.312924,0,No
1,1,1,1,1,2,1,1,2,8,0.294479,0.3016,0,No
2,2,4,2,1,3,2,2,4,9,0.268641,0.276936,0,No
1,1,1,1,1,2,1,1,2,8,0.331578,0.343078,0,No
1,1,1,1,1,2,1,1,2,9,0.242793,0.246514,0,No
1,1,1,1,1,2,1,1,2,8,0.271886,0.278708,0,No
1,1,1,1,1,2,1,1,2,8,0.262641,0.268503,0,No
1,1,1,1,1,2,1,1,2,8,0.285396,0.292412,0,No
4,4,16,4,3,7,4,4,8,8,0.321452,0.328645,0,No
6,6,36,3,5,8,6,6,12,8,0.325773,0.334214,0,No
2,2,4,1,1,2,2,2,4,8,0.339934,0.352194,0,No
2,2,4,1,1,2,2,2,4,8,0.315765,0.323492,0,No
1,1,1,1,1,2,1,1,2,8,0.288168,0.299068,0,No
2,2,4,1,1,2,2,2,4,8,0.32342,0.334424,0,No
3,3,9,3,3,6,3,3,6,8,0.326796,0.338214,0,No
1,1,1,1,1,2,1,1,2,8,0.288168,0.299068,0,No
1,1,1,1,1,2,1,1,2,8,0.301584,0.314486,0,No
1,1,1,1,1,2,1,1,2,8,0.323426,0.334429,0,No
1,1,1,1,1,2,1,1,2,8,0.279104,0.286806,0,No
1,1,1,1,1,2,1,1,2,8,0.306657,0.315385,0,No
2,2,4,1,1,2,2,2,4,8,0.339934,0.352194,0,No
2,2,4,2,2,4,2,2,4,8,0.320161,0.330383,0,No
1,1,1,1,1,2,1,1,2,8,0.323426,0.334429,0,No
2,2,4,1,1,2,2,2,4,8,0.309325,0.317943,0,No
1,1,1,1,1,2,1,1,2,8,0.309325,0.317943,0,No
1,1,1,1,1,2,1,1,2,8,0.339934,0.352194,0,No
1,1,1,1,1,2,1,1,2,9,0.268641,0.276936,0,No
1,1,1,1,1,2,1,1,2,8,0.278743,0.288253,0,No
4,4,16,2,3,5,4,4,8,8,0.339117,0.3522,0,No
1,1,1,1,1,2,1,1,2,7,0.327826,0.338517,0,No
1,1,1,1,1,2,1,1,2,9,0.260735,0.266425,0,No
2,2,4,2,2,4,2,2,4,8,0.346281,0.360278,0,No
2,2,4,1,2,3,2,2,4,8,0.331642,0.342486,0,No
1,1,1,1,1,2,1,1,2,8,0.277096,0.285605,0,No
1,1,1,1,1,2,1,1,2,8,0.331571,0.343073,0,No
1,1,1,1,1,2,1,1,2,9,0.250525,0.255288,0,No
2,2,4,1,2,3,2,2,4,8,0.28444,0.292957,0,No
1,1,1,1,1,2,1,1,2,8,0.339934,0.352194,0,No
4,4,16,2,2,4,4,4,8,8,0.305007,0.313861,0,No
2,2,4,2,2,4,2,2,4,8,0.296867,0.304842,0,No
3,3,9,2,2,4,3,3,6,8,0.305143,0.315411,0,No
1,1,1,1,1,2,1,1,2,8,0.282636,0.289754,0,No
1,1,1,1,1,2,1,1,2,7,0.312584,0.319273,0,No
1,1,1,1,1,2,1,1,2,8,0.308542,0.315798,0,No
3,3,9,2,2,4,3,3,6,8,0.339982,0.352277,0,No
3,3,9,1,2,3,3,3,6,8,0.315537,0.324889,0,No
2,2,4,1,1,2,2,2,4,8,0.271899,0.280395,0,No
1,1,1,1,1,2,1,1,2,9,0.267332,0.273854,0,No
1,1,1,1,1,2,1,1,2,8,0.310033,0.318684,0,No
1,1,1,1,1,2,1,1,2,8,0.303834,0.31039,0,No
4,4,16,3,3,6,4,4,8,8,0.323426,0.331537,0,No
1,1,1,1,1,2,1,1,2,7,0.296305,0.304855,0,No
3,3,9,1,2,3,3,3,6,8,0.342617,0.356522,0,No
1,1,1,1,1,2,1,1,2,8,0.309331,0.317947,0,No
2,2,4,2,2,4,2,2,4,8,0.290469,0.297845,0,No
1,1,1,1,1,2,1,1,2,8,0.305083,0.312173,0,No
1,1,1,1,1,2,1,1,2,8,0.309331,0.317947,0,No
1,1,1,1,1,2,1,1,2,8,0.32342,0.334424,0,No
1,1,1,1,1,2,1,1,2,8,0.30338,0.311471,0,No
1,1,1,1,1,2,1,1,2,8,0.30359,0.310474,0,No
1,1,1,1,1,2,1,1,2,8,0.310722,0.317507,0,No
3,3,9,2,2,4,3,3,6,8,0.341096,0.353516,0,No
1,1,1,1,1,2,1,1,2,8,0.27122,0.279026,0,No
1,1,1,1,1,2,1,1,2,8,0.32342,0.334424,0,No
2,2,4,2,2,4,2,2,4,8,0.333418,0.344856,0,No
2,2,4,2,2,4,2,2,4,8,0.300898,0.308063,0,No
1,1,1,1,1,2,1,1,2,8,0.26821,0.275176,0,No
5,5,25,4,4,8,5,5,10,8,0.32042,0.328032,0,No
1,1,1,1,1,2,1,1,2,8,0.339934,0.352194,0,No
1,1,1,1,1,2,1,1,2,8,0.275494,0.282231,0,No
3,3,9,1,2,3,3,3,6,8,0.343203,0.35581,0,No
1,1,1,1,1,2,1,1,2,8,0.339934,0.352194,0,No
3,3,9,2,2,4,3,3,6,8,0.301153,0.308294,0,No
1,1,1,1,1,2,1,1,2,7,0.296305,0.304855,0,No
3,3,9,2,2,4,3,3,6,8,0.29222,0.30113,0,No
4,4,16,2,4,6,4,4,8,8,0.342369,0.35544,0,No
2,2,4,1,1,2,2,2,4,7,0.327819,0.338512,0,No
1,1,1,1,1,2,1,1,2,8,0.292405,0.299561,0,No
1,1,1,1,1,2,1,1,2,9,0.261342,0.267038,0,No
5,5,25,4,2,6,5,5,10,8,0.335569,0.348254,0,No
3,3,9,2,2,4,3,3,6,7,0.331224,0.342603,0,No
1,1,1,1,1,2,1,1,2,8,0.331578,0.343078,0,No
2,2,4,2,2,4,2,2,4,8,0.346281,0.360278,0,No
1,1,1,1,1,2,1,1,2,9,0.303807,0.312038,0,No
1,1,1,1,1,2,1,1,2,8,0.29741,0.304429,0,No
4,4,16,3,4,7,4,4,8,8,0.343285,0.357316,0,No
1,1,1,1,1,2,1,1,2,8,0.303655,0.312962,0,No
4,4,16,3,4,7,4,4,8,8,0.310219,0.318991,0,No
1,1,1,1,1,2,1,1,2,8,0.301589,0.314491,0,No
2,2,4,2,2,4,2,2,4,8,0.310451,0.316971,0,No
1,1,1,1,1,2,1,1,2,8,0.301584,0.314486,0,No
1,1,1,1,1,2,1,1,2,8,0.331578,0.343078,0,No
3,3,9,3,3,6,3,3,6,8,0.325723,0.334694,0,No
4,4,16,4,3,7,4,4,8,7,0.335272,0.34728,0,No
1,1,1,1,1,2,1,1,2,8,0.339934,0.352194,0,No
1,1,1,1,1,2,1,1,2,8,0.274594,0.281518,0,No
1,1,1,1,1,2,1,1,2,8,0.274545,0.283659,0,No
1,1,1,1,1,2,1,1,2,8,0.246266,0.250335,0,No
1,1,1,1,1,2,1,1,2,8,0.313502,0.320218,0,No
4,4,16,2,2,4,4,4,8,8,0.331959,0.342516,0,No
1,1,1,1,1,2,1,1,2,8,0.301584,0.314486,0,No
1,1,1,1,1,2,1,1,2,8,0.331571,0.343073,0,No
1,1,1,1,1,2,1,1,2,9,0.249029,0.25372,0,No
1,1,1,1,1,2,1,1,2,9,0.255737,0.261999,0,No
3,3,9,2,2,4,3,3,6,7,0.329014,0.339935,0,No
1,1,1,1,1,2,1,1,2,9,0.241627,0.244757,0,No
8,4,32,2,1,3,8,8,16,8,0.309325,0.317943,0,No
1,1,1,1,1,2,1,1,2,8,0.29933,0.305989,0,No
1,1,1,1,1,2,1,1,2,8,0.301584,0.314486,0,No
1,1,1,1,1,2,1,1,2,8,0.339934,0.352194,0,No
1,1,1,1,1,2,1,1,2,8,0.29252,0.30008,0,No
1,1,1,1,1,2,1,1,2,8,0.303375,0.311466,0,No
1,1,1,1,1,2,1,1,2,8,0.304132,0.310938,0,No
2,2,4,2,1,3,2,2,4,8,0.308542,0.315798,0,No
1,1,1,1,1,2,1,1,2,8,0.303585,0.310469,0,No
1,1,1,1,1,2,1,1,2,8,0.308542,0.315798,0,No
1,1,1,1,1,2,1,1,2,8,0.301589,0.314491,0,No
2,2,4,2,2,4,2,2,4,8,0.324558,0.335306,0,No
1,1,1,1,1,2,1,1,2,8,0.29974,0.30761,0,No
1,1,1,1,1,2,1,1,2,8,0.299835,0.307302,0,No
1,1,1,1,1,2,1,1,2,8,0.281452,0.288543,0,No
1,1,1,1,1,2,1,1,2,8,0.261835,0.267518,0,No
1,1,1,1,1,2,1,1,2,8,0.30359,0.310474,0,No
2,2,4,1,2,3,2,2,4,8,0.313203,0.322828,0,No
2,2,4,1,1,2,2,2,4,9,0.246932,0.250705,0,No
1,1,1,1,1,2,1,1,2,8,0.301589,0.314491,0,No
1,1,1,1,1,2,1,1,2,8,0.288168,0.299068,0,No
2,2,4,2,2,4,2,2,4,8,0.289694,0.30061,0,No
2,2,4,1,1,2,2,2,4,9,0.268717,0.277323,0,No
2,2,4,2,2,4,2,2,4,8,0.297716,0.306414,0,No
1,1,1,1,1,2,1,1,2,8,0.277096,0.285605,0,No
1,1,1,1,1,2,1,1,2,8,0.301584,0.314486,0,No
1,1,1,1,1,2,1,1,2,8,0.323426,0.334429,0,No
1,1,1,1,1,2,1,1,2,8,0.301584,0.314486,0,No
1,1,1,1,1,2,1,1,2,8,0.301589,0.314491,0,No
1,1,1,1,1,2,1,1,2,8,0.32342,0.334424,0,No
1,1,1,1,1,2,1,1,2,8,0.301584,0.314486,0,No
1,1,1,1,1,2,1,1,2,8,0.287605,0.295192,0,No
2,2,4,2,2,4,2,2,4,8,0.310062,0.31649,0,No
1,1,1,1,1,2,1,1,2,9,0.268641,0.276936,0,No
1,1,1,1,1,2,1,1,2,8,0.313502,0.320218,0,No
1,1,1,1,1,2,1,1,2,9,0.273621,0.280743,0,No
3,3,9,2,2,4,3,3,6,8,0.323961,0.334992,0,No
1,1,1,1,1,2,1,1,2,9,0.269103,0.277072,0,No
2,2,4,2,2,4,2,2,4,8,0.309775,0.323433,0,No
2,2,4,1,2,3,2,2,4,8,0.323451,0.334488,0,No
1,1,1,1,1,2,1,1,2,8,0.288168,0.299068,0,No
18,18,324,5,3,8,18,18,36,8,0.333438,0.345109,0,No
3,3,9,2,2,4,3,3,6,8,0.315193,0.327617,0,No
1,1,1,1,1,2,1,1,2,8,0.283486,0.292899,0,No
1,1,1,1,1,2,1,1,2,8,0.303375,0.311466,0,No
1,1,1,1,1,2,1,1,2,7,0.327819,0.338512,0,No
2,2,4,2,1,3,2,2,4,7,0.327826,0.338517,0,No
1,1,1,1,1,2,1,1,2,8,0.309325,0.317943,0,No
1,1,1,1,1,2,1,1,2,8,0.301589,0.314491,0,No
4,4,16,3,4,7,4,4,8,8,0.312962,0.320665,0,No
1,1,1,1,1,2,1,1,2,8,0.331571,0.343073,0,No
1,1,1,1,1,2,1,1,2,8,0.331571,0.343073,0,No
1,1,1,1,1,2,1,1,2,8,0.32342,0.334424,0,No
4,4,16,1,2,3,4,4,8,8,0.318488,0.327558,0,No
2,2,4,2,2,4,2,2,4,8,0.311068,0.319489,0,No
1,1,1,1,1,2,1,1,2,8,0.339941,0.352199,0,No
1,1,1,1,1,2,1,1,2,8,0.315759,0.323487,0,No
1,1,1,1,1,2,1,1,2,9,0.244302,0.248579,0,No
1,1,1,1,1,2,1,1,2,8,0.339941,0.352199,0,No
1,1,1,1,1,2,1,1,2,8,0.339934,0.352194,0,No
1,1,1,1,1,2,1,1,2,8,0.315765,0.323492,0,No
1,1,1,1,1,2,1,1,2,8,0.279245,0.286914,0,No
2,2,4,2,2,4,2,2,4,8,0.311573,0.31972,0,No
1,1,1,1,1,2,1,1,2,8,0.288168,0.299068,0,No
4,4,16,3,1,4,4,4,8,9,0.268721,0.277328,0,No
6,6,36,4,5,9,6,6,12,8,0.343562,0.356707,0,No
1,1,1,1,1,2,1,1,2,8,0.30338,0.311471,0,No
1,1,1,1,1,2,1,1,2,8,0.27455,0.283664,0,No
1,1,1,1,1,2,1,1,2,8,0.339941,0.352199,0,No
1,1,1,1,1,2,1,1,2,8,0.268219,0.275191,0,No
1,1,1,1,1,2,1,1,2,8,0.30338,0.311471,0,No
1,1,1,1,1,2,1,1,2,7,0.327826,0.338517,0,No
1,1,1,1,1,2,1,1,2,8,0.306448,0.313104,0,No
1,1,1,1,1,2,1,1,2,8,0.301589,0.314491,0,No
1,1,1,1,1,2,1,1,2,8,0.278739,0.288248,0,No
3,3,9,3,3,6,3,3,6,8,0.318625,0.326239,0,No
1,1,1,1,1,2,1,1,2,9,0.259628,0.265175,0,No
1,1,1,1,1,2,1,1,2,8,0.310033,0.318684,0,No
4,4,16,2,4,6,4,4,8,8,0.335285,0.347253,0,No
2,2,4,1,2,3,2,2,4,8,0.308019,0.314624,0,No
1,1,1,1,1,2,1,1,2,8,0.302589,0.309511,0,No
1,1,1,1,1,2,1,1,2,8,0.296438,0.303643,0,No
1,1,1,1,1,2,1,1,2,8,0.323426,0.334429,0,No
1,1,1,1,1,2,1,1,2,8,0.310033,0.318684,0,No
1,1,1,1,1,2,1,1,2,8,0.323426,0.334429,0,No
1,1,1,1,1,2,1,1,2,8,0.288163,0.299063,0,No
3,3,9,2,1,3,3,3,6,9,0.255733,0.261996,0,No
1,1,1,1,1,2,1,1,2,8,0.339934,0.352194,0,No
1,1,1,1,1,2,1,1,2,7,0.327819,0.338512,0,No
1,1,1,1,1,2,1,1,2,7,0.296305,0.304855,0,No
1,1,1,1,1,2,1,1,2,9,0.303801,0.312033,0,No
2,2,4,1,1,2,2,2,4,9,0.268721,0.277328,0,No
3,3,9,3,3,6,3,3,6,8,0.329943,0.341716,0,No
3,3,9,1,1,2,3,3,6,8,0.331571,0.343073,0,No
2,2,4,2,1,3,2,2,4,7,0.296305,0.304855,0,No
1,1,1,1,1,2,1,1,2,7,0.296305,0.304855,0,No
1,1,1,1,1,2,1,1,2,7,0.296305,0.304855,0,No
1,1,1,1,1,2,1,1,2,8,0.291705,0.298878,0,No
1,1,1,1,1,2,1,1,2,9,0.268721,0.277328,0,No
6,6,36,5,2,7,6,6,12,8,0.346274,0.360268,0,No
1,1,1,1,1,2,1,1,2,9,0.269103,0.277072,0,No
1,1,1,1,1,2,1,1,2,8,0.310028,0.318679,0,No
1,1,1,1,1,2,1,1,2,8,0.310033,0.318684,0,No
1,1,1,1,1,2,1,1,2,8,0.317445,0.327454,0,No
1,1,1,1,1,2,1,1,2,8,0.32342,0.334424,0,No
4,4,16,4,1,5,4,4,8,8,0.323414,0.334415,0,No
1,1,1,1,1,2,1,1,2,8,0.305001,0.311358,0,No
2,2,4,2,2,4,2,2,4,8,0.338243,0.351497,0,No
2,2,4,2,1,3,2,2,4,8,0.278739,0.288248,0,No
2,2,4,1,2,3,2,2,4,8,0.307946,0.32196,0,No
1,1,1,1,1,2,1,1,2,7,0.327819,0.338512,0,No
1,1,1,1,1,2,1,1,2,7,0.327819,0.338512,0,No
2,2,4,2,1,3,2,2,4,7,0.327819,0.338512,0,No
1,1,1,1,1,2,1,1,2,7,0.327819,0.338512,0,No
1,1,1,1,1,2,1,1,2,8,0.261106,0.266905,0,No
1,1,1,1,1,2,1,1,2,8,0.288163,0.299063,0,No
1,1,1,1,1,2,1,1,2,8,0.303375,0.311466,0,No
2,2,4,1,1,2,2,2,4,8,0.310722,0.317507,0,No
4,4,16,1,2,3,4,4,8,7,0.347983,0.361927,0,No
1,1,1,1,1,2,1,1,2,8,0.288163,0.299063,0,No
1,1,1,1,1,2,1,1,2,7,0.327819,0.338512,0,No
1,1,1,1,1,2,1,1,2,8,0.310722,0.317507,0,No
2,2,4,2,1,3,2,2,4,8,0.271899,0.280395,0,No
1,1,1,1,1,2,1,1,2,7,0.327826,0.338517,0,No
2,2,4,1,2,3,2,2,4,8,0.29795,0.305392,0,No
1,1,1,1,1,2,1,1,2,8,0.289527,0.296931,0,No
1,1,1,1,1,2,1,1,2,7,0.327819,0.338512,0,No
4,4,16,2,2,4,4,4,8,7,0.339306,0.352082,0,No
1,1,1,1,1,2,1,1,2,8,0.281712,0.288655,0,No
3,3,9,2,2,4,3,3,6,8,0.332191,0.343757,0,No
2,2,4,2,2,4,2,2,4,7,0.327914,0.338639,0,No
1,1,1,1,1,2,1,1,2,8,0.331571,0.343073,0,No
4,3,12,3,3,6,4,4,8,8,0.313267,0.320721,0,No
5,5,25,2,4,6,5,5,10,8,0.352301,0.367502,0,No
1,1,1,1,1,2,1,1,2,8,0.288929,0.297713,0,No
1,1,1,1,1,2,1,1,2,8,0.303375,0.311466,0,No
1,1,1,1,1,2,1,1,2,8,0.278203,0.285439,0,No
2,2,4,2,1,3,2,2,4,8,0.32342,0.334424,0,No
2,2,4,1,1,2,2,2,4,8,0.301584,0.314486,0,No
2,2,4,2,1,3,2,2,4,8,0.323426,0.334429,0,No
8,8,64,3,5,8,8,8,16,8,0.347381,0.362116,0,No
1,1,1,1,1,2,1,1,2,7,0.327819,0.338512,0,No
11,11,121,9,4,13,11,11,22,8,0.339346,0.352701,0,No
4,4,16,2,3,5,4,4,8,8,0.335226,0.345919,0,No
2,2,4,2,2,4,2,2,4,8,0.298049,0.309803,0,No
1,1,1,1,1,2,1,1,2,9,0.249499,0.253819,0,No
1,1,1,1,1,2,1,1,2,8,0.288934,0.297717,0,No
2,2,4,2,2,4,2,2,4,8,0.291217,0.300762,0,No
2,2,4,1,1,2,2,2,4,8,0.274545,0.283659,0,No
3,3,9,3,3,6,3,3,6,8,0.303585,0.312306,0,No
4,4,16,1,4,5,4,4,8,8,0.344603,0.357215,0,No
3,3,9,3,1,4,3,3,6,8,0.331571,0.343073,0,No
2,2,4,1,1,2,2,2,4,8,0.26052,0.265893,0,No
1,1,1,1,1,2,1,1,2,8,0.28214,0.289603,0,No
2,2,4,1,1,2,2,2,4,8,0.331571,0.343073,0,No
3,3,9,2,2,4,3,3,6,8,0.276835,0.28448,0,No
2,2,4,2,2,4,2,2,4,8,0.333999,0.345746,0,No
2,2,4,2,2,4,2,2,4,8,0.298482,0.305884,0,No
1,1,1,1,1,2,1,1,2,8,0.339941,0.352199,0,No
2,2,4,1,2,3,2,2,4,8,0.299514,0.308673,0,No
3,3,9,2,2,4,3,3,6,8,0.303456,0.311578,0,No
1,1,1,1,1,2,1,1,2,7,0.312589,0.319278,0,No
2,2,4,1,2,3,2,2,4,8,0.342617,0.356522,0,No
1,1,1,1,1,2,1,1,2,8,0.288168,0.299068,0,No
1,1,1,1,1,2,1,1,2,8,0.301584,0.314486,0,No
1,1,1,1,1,2,1,1,2,8,0.281805,0.28952,0,No
1,1,1,1,1,2,1,1,2,8,0.268219,0.275191,0,No
1,1,1,1,1,2,1,1,2,9,0.268641,0.276936,0,No
1,1,1,1,1,2,1,1,2,8,0.268219,0.275191,0,No
1,1,1,1,1,2,1,1,2,8,0.310028,0.318679,0,No
1,1,1,1,1,2,1,1,2,7,0.296305,0.304855,0,No
1,1,1,1,1,2,1,1,2,7,0.327826,0.338517,0,No
1,1,1,1,1,2,1,1,2,7,0.296305,0.304855,0,No
1,1,1,1,1,2,1,1,2,9,0.263925,0.269976,0,No
1,1,1,1,1,2,1,1,2,8,0.339934,0.352194,0,No
3,3,9,3,3,6,3,3,6,8,0.310756,0.318525,0,No
1,1,1,1,1,2,1,1,2,9,0.253115,0.258182,0,No
1,1,1,1,1,2,1,1,2,9,0.263403,0.271075,0,No
1,1,1,1,1,2,1,1,2,8,0.339934,0.352194,0,No
1,1,1,1,1,2,1,1,2,9,0.269103,0.277072,0,No
1,1,1,1,1,2,1,1,2,8,0.272873,0.280386,0,No
1,1,1,1,1,2,1,1,2,8,0.274545,0.283659,0,No
4,4,16,2,3,5,4,4,8,8,0.317847,0.325076,0,No
5,5,25,3,5,8,5,5,10,8,0.31329,0.320502,0,No
10,10,100,3,8,11,10,10,20,7,0.365453,0.381881,0,No
2,2,4,1,1,2,2,2,4,8,0.301589,0.314491,0,No
1,1,1,1,1,2,1,1,2,8,0.309331,0.317947,0,No
2,2,4,1,1,2,2,2,4,8,0.282884,0.29009,0,No
3,3,9,2,3,5,3,3,6,8,0.318233,0.325424,0,No
1,1,1,1,1,2,1,1,2,8,0.339934,0.352194,0,No
2,2,4,2,2,4,2,2,4,8,0.324392,0.333694,0,No
4,4,16,3,3,6,4,4,8,8,0.326265,0.335704,0,No
1,1,1,1,1,2,1,1,2,8,0.310033,0.318684,0,No
8,8,64,7,6,13,8,8,16,8,0.348694,0.362484,0,No
1,1,1,1,1,2,1,1,2,8,0.30932,0.317933,0,No
1,1,1,1,1,2,1,1,2,8,0.310028,0.318679,0,No
1,1,1,1,1,2,1,1,2,8,0.29667,0.303664,0,No
4,4,16,2,2,4,4,4,8,8,0.321464,0.329859,0,No
1,1,1,1,1,2,1,1,2,7,0.327819,0.338512,0,No
1,1,1,1,1,2,1,1,2,8,0.278743,0.288253,0,No
1,1,1,1,1,2,1,1,2,8,0.339934,0.352194,0,No
1,1,1,1,1,2,1,1,2,8,0.310028,0.318679,0,No
1,1,1,1,1,2,1,1,2,8,0.303655,0.312962,0,No
2,2,4,1,1,2,2,2,4,8,0.273608,0.280526,0,No
3,3,9,2,2,4,3,3,6,8,0.341219,0.353853,0,No
1,1,1,1,1,2,1,1,2,8,0.277389,0.284283,0,No
1,1,1,1,1,2,1,1,2,8,0.339941,0.352199,0,No
6,6,36,2,2,4,6,6,12,8,0.312303,0.321222,0,No
1,1,1,1,1,2,1,1,2,8,0.310028,0.318679,0,No
1,1,1,1,1,2,1,1,2,8,0.317292,0.324388,0,No
1,1,1,1,1,2,1,1,2,9,0.271596,0.278866,0,No
4,4,16,1,3,4,4,4,8,8,0.320372,0.328624,0,No
2,2,4,2,2,4,2,2,4,8,0.303839,0.313164,0,No
1,1,1,1,1,2,1,1,2,8,0.278743,0.288253,0,No
1,1,1,1,1,2,1,1,2,8,0.296991,0.30415,0,No
1,1,1,1,1,2,1,1,2,8,0.288929,0.297713,0,No
6,6,36,3,4,7,6,6,12,7,0.316615,0.325026,0,No
1,1,1,1,1,2,1,1,2,8,0.288168,0.299068,0,No
1,1,1,1,1,2,1,1,2,8,0.271899,0.280395,0,No
2,2,4,1,2,3,2,2,4,8,0.340151,0.352463,0,No
1,1,1,1,1,2,1,1,2,8,0.30359,0.310474,0,No
1,1,1,1,1,2,1,1,2,8,0.32342,0.334424,0,No
2,2,4,1,2,3,2,2,4,8,0.338008,0.350304,0,No
2,2,4,1,2,3,2,2,4,8,0.288027,0.299908,0,No
1,1,1,1,1,2,1,1,2,8,0.267857,0.275083,0,No
1,1,1,1,1,2,1,1,2,8,0.339941,0.352199,0,No
2,2,4,1,1,2,2,2,4,8,0.258848,0.264107,0,No
1,1,1,1,1,2,1,1,2,9,0.265089,0.271681,0,No
2,2,4,1,1,2,2,2,4,9,0.268641,0.276936,0,No
1,1,1,1,1,2,1,1,2,8,0.323414,0.334415,0,No
2,2,4,1,1,2,2,2,4,9,0.269103,0.277072,0,No
1,1,1,1,1,2,1,1,2,8,0.313502,0.320218,0,No
4,4,16,4,4,8,4,4,8,8,0.352505,0.367892,0,No
1,1,1,1,1,2,1,1,2,8,0.305083,0.312173,0,No
2,1,2,1,2,3,2,2,4,8,0.319963,0.330551,0,No
1,1,1,1,1,2,1,1,2,8,0.32342,0.334424,0,No
1,1,1,1,1,2,1,1,2,9,0.269103,0.277072,0,No
1,1,1,1,1,2,1,1,2,8,0.308548,0.315803,0,No
2,2,4,1,1,2,2,2,4,8,0.32342,0.334424,0,No
1,1,1,1,1,2,1,1,2,8,0.313497,0.320213,0,No
1,1,1,1,1,2,1,1,2,8,0.30338,0.311471,0,No
1,1,1,1,1,2,1,1,2,8,0.288163,0.299063,0,No
1,1,1,1,1,2,1,1,2,8,0.339934,0.352194,0,No
2,2,4,2,2,4,2,2,4,8,0.340016,0.352312,0,No
1,1,1,1,1,2,1,1,2,9,0.255637,0.260829,0,No
1,1,1,1,1,2,1,1,2,9,0.244634,0.248099,0,No
3,3,9,2,1,3,3,3,6,8,0.274435,0.281259,0,No
1,1,1,1,1,2,1,1,2,8,0.339927,0.352185,0,No
1,1,1,1,1,2,1,1,2,9,0.256934,0.262277,0,No
1,1,1,1,1,2,1,1,2,8,0.339941,0.352199,0,No
1,1,1,1,1,2,1,1,2,7,0.327819,0.338512,0,No
3,3,9,3,3,6,3,3,6,8,0.344637,0.357634,0,No
1,1,1,1,1,2,1,1,2,8,0.269681,0.276427,0,No
1,1,1,1,1,2,1,1,2,8,0.309325,0.317943,0,No
2,2,4,1,1,2,2,2,4,8,0.310028,0.318679,0,No
1,1,1,1,1,2,1,1,2,8,0.32342,0.334424,0,No
1,1,1,1,1,2,1,1,2,9,0.25212,0.257194,0,No
1,1,1,1,1,2,1,1,2,8,0.331571,0.343073,0,No
2,2,4,2,2,4,2,2,4,8,0.332573,0.344483,0,No
1,1,1,1,1,2,1,1,2,8,0.276512,0.283298,0,No
1,1,1,1,1,2,1,1,2,8,0.279104,0.286806,0,No
3,3,9,1,1,2,3,3,6,8,0.301584,0.314486,0,No
3,3,9,2,2,4,3,3,6,8,0.325394,0.336176,0,No
1,1,1,1,1,2,1,1,2,8,0.283486,0.292899,0,No
2,2,4,2,2,4,2,2,4,7,0.33161,0.341859,0,No
10,10,100,6,3,9,10,10,20,8,0.340144,0.353535,0,No
3,3,9,2,1,3,3,3,6,8,0.301584,0.314486,0,No
5,5,25,1,1,2,5,5,10,9,0.268721,0.277328,0,No
1,1,1,1,1,2,1,1,2,8,0.301589,0.314491,0,No
1,1,1,1,1,2,1,1,2,9,0.249033,0.253725,0,No
1,1,1,1,1,2,1,1,2,8,0.339934,0.352194,0,No
1,1,1,1,1,2,1,1,2,9,0.262787,0.268743,0,No
1,1,1,1,1,2,1,1,2,8,0.264387,0.270156,0,No
1,1,1,1,1,2,1,1,2,8,0.27529,0.28217,0,No
2,2,4,1,2,3,2,2,4,8,0.314734,0.322225,0,No
1,1,1,1,1,2,1,1,2,8,0.278853,0.285926,0,No
1,1,1,1,1,2,1,1,2,8,0.310028,0.318679,0,No
21,21,441,4,6,10,21,21,42,7,0.353586,0.369049,0,No
1,1,1,1,1,2,1,1,2,8,0.32342,0.334424,0,No
2,2,4,2,2,4,2,2,4,7,0.328381,0.339013,0,No
2,2,4,1,1,2,2,2,4,8,0.282795,0.289819,0,No
1,1,1,1,1,2,1,1,2,9,0.268637,0.276931,0,No
1,1,1,1,1,2,1,1,2,9,0.264719,0.270503,0,No
2,2,4,2,2,4,2,2,4,8,0.302503,0.315889,0,No
2,2,4,2,2,4,2,2,4,9,0.27255,0.281592,0,No
1,1,1,1,1,2,1,1,2,9,0.268641,0.276936,0,No
2,2,4,1,1,2,2,2,4,8,0.297711,0.304473,0,No
1,1,1,1,1,2,1,1,2,8,0.271899,0.280395,0,No
2,2,4,2,2,4,2,2,4,8,0.308074,0.315615,0,No
1,1,1,1,1,2,1,1,2,8,0.299745,0.307615,0,No
16,16,256,2,11,13,16,16,32,8,0.361213,0.37726,0,No
2,2,4,2,2,4,2,2,4,8,0.340334,0.35252,0,No
3,3,9,2,2,4,3,3,6,8,0.316491,0.324744,0,No
2,2,4,1,1,2,2,2,4,8,0.31386,0.320867,0,No
1,1,1,1,1,2,1,1,2,8,0.331578,0.343078,0,No
1,1,1,1,1,2,1,1,2,8,0.310717,0.317502,0,No
1,1,1,1,1,2,1,1,2,8,0.277091,0.2856,0,No
1,1,1,1,1,2,1,1,2,7,0.327819,0.338512,0,No
1,1,1,1,1,2,1,1,2,8,0.258198,0.263633,0,No
1,1,1,1,1,2,1,1,2,8,0.269852,0.27628,0,No
2,2,4,1,2,3,2,2,4,8,0.339941,0.352224,0,No
1,1,1,1,1,2,1,1,2,8,0.29741,0.304429,0,No
1,1,1,1,1,2,1,1,2,9,0.259988,0.266702,0,No
4,4,16,4,2,6,4,4,8,7,0.327933,0.338654,0,No
1,1,1,1,1,2,1,1,2,9,0.268717,0.277323,0,No
2,2,4,1,2,3,2,2,4,8,0.343065,0.355599,0,No
2,2,4,2,2,4,2,2,4,8,0.345153,0.358795,0,No
1,1,1,1,1,2,1,1,2,8,0.303375,0.311466,0,No
3,3,9,3,2,5,3,3,6,8,0.273494,0.281636,0,No
1,1,1,1,1,2,1,1,2,9,0.254046,0.259134,0,No
1,1,1,1,1,2,1,1,2,9,0.276056,0.283078,0,No
1,1,1,1,1,2,1,1,2,7,0.2963,0.30485,0,No
1,1,1,1,1,2,1,1,2,9,0.276056,0.283078,0,No
6,6,36,3,2,5,6,6,12,8,0.320944,0.330591,0,No
1,1,1,1,1,2,1,1,2,9,0.247785,0.252394,0,No
1,1,1,1,1,2,1,1,2,8,0.296444,0.303647,0,No
1,1,1,1,1,2,1,1,2,8,0.301589,0.314491,0,No
1,1,1,1,1,2,1,1,2,8,0.301589,0.314491,0,No
1,1,1,1,1,2,1,1,2,8,0.32342,0.334424,0,No
1,1,1,1,1,2,1,1,2,8,0.306453,0.313109,0,No
3,3,9,3,3,6,3,3,6,8,0.305838,0.314451,0,No
4,4,16,2,3,5,4,4,8,8,0.314218,0.322608,0,No
1,1,1,1,1,2,1,1,2,8,0.285702,0.293456,0,No
2,2,4,1,1,2,2,2,4,8,0.30338,0.311471,0,No
3,3,9,1,2,3,3,3,6,8,0.341663,0.354514,0,No
5,5,25,1,3,4,5,5,10,8,0.34799,0.362318,0,No
1,1,1,1,1,2,1,1,2,7,0.327819,0.338512,0,No
1,1,1,1,1,2,1,1,2,8,0.310033,0.318684,0,No
5,5,25,2,4,6,5,5,10,8,0.308141,0.314766,0,No
4,4,16,2,2,4,4,4,8,8,0.340416,0.352769,0,No
6,6,36,3,5,8,6,6,12,7,0.326971,0.335719,0,No
2,2,4,1,2,3,2,2,4,8,0.31053,0.319152,0,No
5,5,25,4,3,7,5,5,10,7,0.355168,0.36971,0,No
7,7,49,1,1,2,7,7,14,8,0.289857,0.296927,0,No
1,1,1,1,1,2,1,1,2,8,0.317445,0.327454,0,No
1,1,1,1,1,2,1,1,2,8,0.32342,0.334424,0,No
2,2,4,2,2,4,2,2,4,8,0.296851,0.308998,0,No
1,1,1,1,1,2,1,1,2,8,0.309331,0.317947,0,No
1,1,1,1,1,2,1,1,2,8,0.289257,0.299292,0,No
1,1,1,1,1,2,1,1,2,8,0.309331,0.317947,0,No
1,1,1,1,1,2,1,1,2,8,0.309325,0.317943,0,No
2,2,4,1,1,2,2,2,4,7,0.327819,0.338512,0,No
2,2,4,2,2,4,2,2,4,8,0.318488,0.327558,0,No
2,2,4,1,2,3,2,2,4,8,0.342143,0.35478,0,No
2,2,4,2,2,4,2,2,4,8,0.306519,0.314058,0,No
3,1,3,1,1,2,3,3,6,8,0.306651,0.31538,0,No
3,3,9,2,1,3,3,3,6,8,0.274545,0.283659,0,No
1,1,1,1,1,2,1,1,2,8,0.292285,0.300565,0,No
3,3,9,2,2,4,3,3,6,8,0.305756,0.314245,0,No
1,1,1,1,1,2,1,1,2,7,0.327826,0.338517,0,No
1,1,1,1,1,2,1,1,2,8,0.310033,0.318684,0,No
1,1,1,1,1,2,1,1,2,8,0.30359,0.310474,0,No
1,1,1,1,1,2,1,1,2,9,0.217175,0.220483,0,No
2,2,4,1,1,2,2,2,4,7,0.327819,0.338512,0,No
1,1,1,1,1,2,1,1,2,9,0.266389,0.272368,0,No
1,1,1,1,1,2,1,1,2,9,0.259308,0.264995,0,No
1,1,1,1,1,2,1,1,2,7,0.327819,0.338512,0,No
1,1,1,1,1,2,1,1,2,8,0.339934,0.352194,0,No
2,2,4,2,2,4,2,2,4,8,0.311266,0.320085,0,No
3,3,9,2,3,5,3,3,6,8,0.324176,0.332037,0,No
1,1,1,1,1,2,1,1,2,8,0.309331,0.317947,0,No
2,1,2,1,1,2,2,2,4,9,0.268717,0.277323,0,No
2,2,4,2,2,4,2,2,4,8,0.324935,0.333327,0,No
1,1,1,1,1,2,1,1,2,8,0.288934,0.297717,0,No
1,1,1,1,1,2,1,1,2,7,0.2963,0.30485,0,No
1,1,1,1,1,2,1,1,2,9,0.253111,0.258177,0,No
1,1,1,1,1,2,1,1,2,8,0.32342,0.334424,0,No
1,1,1,1,1,2,1,1,2,8,0.301584,0.308533,0,No
1,1,1,1,1,2,1,1,2,8,0.272694,0.27943,0,No
2,2,4,1,2,3,2,2,4,8,0.342342,0.354886,0,No
1,1,1,1,1,2,1,1,2,9,0.268721,0.277328,0,No
4,4,16,3,2,5,4,4,8,8,0.308754,0.316717,0,No
4,4,16,3,2,5,4,4,8,8,0.30876,0.316722,0,No
2,2,4,2,2,4,2,2,4,8,0.273494,0.281636,0,No
2,2,4,1,1,2,2,2,4,8,0.268219,0.275191,0,No
4,4,16,1,2,3,4,4,8,8,0.328615,0.339272,0,No
2,2,4,1,1,2,2,2,4,7,0.327826,0.338517,0,No
2,2,4,1,1,2,2,2,4,7,0.327826,0.338517,0,No
1,1,1,1,1,2,1,1,2,7,0.327819,0.338512,0,No
2,2,4,1,1,2,2,2,4,8,0.29984,0.307305,0,No
8,7,56,7,3,10,8,8,16,7,0.332917,0.344038,0,No
1,1,1,1,1,2,1,1,2,8,0.339934,0.352194,0,No
1,1,1,1,1,2,1,1,2,7,0.327819,0.338512,0,No
1,1,1,1,1,2,1,1,2,8,0.278743,0.288253,0,No
1,1,1,1,1,2,1,1,2,8,0.278743,0.288253,0,No
2,2,4,2,2,4,2,2,4,7,0.333659,0.344622,0,No
11,11,121,4,5,9,11,11,22,7,0.33545,0.346951,0,No
1,1,1,1,1,2,1,1,2,8,0.339934,0.352194,0,No
1,1,1,1,1,2,1,1,2,7,0.327819,0.338512,0,No
3,3,9,2,3,5,3,3,6,8,0.313808,0.321553,0,No
1,1,1,1,1,2,1,1,2,7,0.327826,0.338517,0,No
1,1,1,1,1,2,1,1,2,8,0.310717,0.317502,0,No
1,1,1,1,1,2,1,1,2,8,0.27455,0.283664,0,No
1,1,1,1,1,2,1,1,2,8,0.293138,0.300755,0,No
1,1,1,1,1,2,1,1,2,8,0.302193,0.308972,0,No
1,1,1,1,1,2,1,1,2,8,0.331571,0.343073,0,No
1,1,1,1,1,2,1,1,2,9,0.268721,0.277328,0,No
3,3,9,2,1,3,3,3,6,8,0.301584,0.314486,0,No
1,1,1,1,1,2,1,1,2,8,0.288163,0.299063,0,No
1,1,1,1,1,2,1,1,2,9,0.269035,0.275503,0,No
1,1,1,1,1,2,1,1,2,9,0.240531,0.243654,0,No
3,3,9,2,1,3,3,3,6,8,0.339934,0.352194,0,No
4,4,16,4,3,7,4,4,8,8,0.339204,0.352644,0,No
3,3,9,2,3,5,3,3,6,8,0.361359,0.37701,0,No
1,1,1,1,1,2,1,1,2,8,0.301589,0.314491,0,No
1,1,1,1,1,2,1,1,2,8,0.301584,0.314486,0,No
1,1,1,1,1,2,1,1,2,8,0.323426,0.334429,0,No
2,2,4,1,1,2,2,2,4,9,0.247462,0.251403,0,No
1,1,1,1,1,2,1,1,2,8,0.301584,0.314486,0,No
8,8,64,2,1,3,8,8,16,8,0.323414,0.334415,0,No
5,5,25,5,2,7,5,5,10,8,0.351996,0.366276,0,No
1,1,1,1,1,2,1,1,2,8,0.32342,0.334424,0,No
3,3,9,3,2,5,3,3,6,7,0.297659,0.306496,0,No
6,6,36,4,4,8,6,6,12,7,0.32609,0.335089,0,No
1,1,1,1,1,2,1,1,2,8,0.308325,0.314705,0,No
1,1,1,1,1,2,1,1,2,9,0.268751,0.275147,0,No
2,2,4,1,1,2,2,2,4,8,0.339934,0.352194,0,No
2,2,4,1,1,2,2,2,4,8,0.314583,0.32146,0,No
1,1,1,1,1,2,1,1,2,8,0.339934,0.352194,0,No
2,2,4,2,2,4,2,2,4,7,0.352621,0.366966,0,No
1,1,1,1,1,2,1,1,2,8,0.339934,0.352194,0,No
1,1,1,1,1,2,1,1,2,8,0.301589,0.314491,0,No
2,2,4,1,2,3,2,2,4,8,0.333132,0.344886,0,No
3,3,9,1,3,4,3,3,6,8,0.355058,0.370648,0,No
3,3,9,3,3,6,3,3,6,8,0.32897,0.339459,0,No
1,1,1,1,1,2,1,1,2,8,0.310722,0.317507,0,No
1,1,1,1,1,2,1,1,2,8,0.289257,0.299292,0,No
1,1,1,1,1,2,1,1,2,8,0.339934,0.352194,0,No
2,2,4,2,1,3,2,2,4,7,0.327819,0.338512,0,No
3,3,9,3,2,5,3,3,6,8,0.349637,0.363925,0,No
2,2,4,2,2,4,2,2,4,8,0.275148,0.283961,0,No
1,1,1,1,1,2,1,1,2,8,0.301584,0.314486,0,No
1,1,1,1,1,2,1,1,2,8,0.253081,0.258078,0,No
6,6,36,3,3,6,6,6,12,8,0.291227,0.299919,0,No
1,1,1,1,1,2,1,1,2,8,0.303375,0.311466,0,No
1,1,1,1,1,2,1,1,2,8,0.277361,0.284118,0,No
1,1,1,1,1,2,1,1,2,8,0.286894,0.294746,0,No
2,2,4,2,2,4,2,2,4,8,0.304963,0.315122,0,No
3,3,9,3,2,5,3,3,6,8,0.327122,0.337593,0,No
1,1,1,1,1,2,1,1,2,8,0.303655,0.312962,0,No
1,1,1,1,1,2,1,1,2,8,0.303412,0.309915,0,No
1,1,1,1,1,2,1,1,2,8,0.29037,0.297428,0,No
1,1,1,1,1,2,1,1,2,8,0.255955,0.260644,0,No
1,1,1,1,1,2,1,1,2,8,0.294484,0.301605,0,No
2,2,4,2,2,4,2,2,4,8,0.314682,0.322568,0,No
1,1,1,1,1,2,1,1,2,8,0.306448,0.313104,0,No
1,1,1,1,1,2,1,1,2,9,0.269103,0.277072,0,No
1,1,1,1,1,2,1,1,2,8,0.30068,0.307389,0,No
1,1,1,1,1,2,1,1,2,7,0.327819,0.338512,0,No
6,6,36,5,4,9,6,6,12,8,0.35463,0.370366,0,No
3,3,9,3,2,5,3,3,6,8,0.346281,0.360278,0,No
3,3,9,2,2,4,3,3,6,8,0.315071,0.322089,0,No
1,1,1,1,1,2,1,1,2,8,0.27455,0.283664,0,No
1,1,1,1,1,2,1,1,2,8,0.266326,0.272624,0,No
2,2,4,1,1,2,2,2,4,8,0.32342,0.334424,0,No
6,6,36,6,5,11,6,6,12,8,0.313976,0.324348,0,No
1,1,1,1,1,2,1,1,2,8,0.278743,0.288253,0,No
3,3,9,3,3,6,3,3,6,8,0.327517,0.339073,0,No
1,1,1,1,1,2,1,1,2,8,0.301584,0.314486,0,No
2,2,4,2,2,4,2,2,4,8,0.300304,0.307769,0,No
3,3,9,3,3,6,3,3,6,8,0.315777,0.326752,0,No
2,2,4,1,2,3,2,2,4,9,0.272637,0.281412,0,No
3,3,9,3,3,6,3,3,6,7,0.31853,0.327583,0,No
1,1,1,1,1,2,1,1,2,8,0.309325,0.317943,0,No
1,1,1,1,1,2,1,1,2,8,0.317901,0.325044,0,No
1,1,1,1,1,2,1,1,2,8,0.249971,0.254122,0,No
1,1,1,1,1,2,1,1,2,8,0.323414,0.334415,0,No
2,2,4,2,2,4,2,2,4,9,0.260986,0.266842,0,No
4,4,16,3,4,7,4,4,8,8,0.326115,0.334924,0,No
3,3,9,3,3,6,3,3,6,8,0.346929,0.361835,0,No
1,1,1,1,1,2,1,1,2,8,0.298534,0.305391,0,No
1,1,1,1,1,2,1,1,2,8,0.284047,0.29112,0,No
1,1,1,1,1,2,1,1,2,8,0.28464,0.291662,0,No
1,1,1,1,1,2,1,1,2,8,0.285592,0.293068,0,No
1,1,1,1,1,2,1,1,2,8,0.27455,0.283664,0,No
1,1,1,1,1,2,1,1,2,8,0.317445,0.327454,0,No
3,3,9,1,2,3,3,3,6,7,0.3352,0.346745,0,No
1,1,1,1,1,2,1,1,2,7,0.327819,0.338512,0,No
1,1,1,1,1,2,1,1,2,7,0.327819,0.338512,0,No
2,2,4,1,2,3,2,2,4,8,0.308425,0.314837,0,No
4,4,16,1,2,3,4,4,8,8,0.318411,0.328618,0,No
2,2,4,2,2,4,2,2,4,8,0.346281,0.360278,0,No
2,2,4,2,1,3,2,2,4,8,0.278734,0.288238,0,No
2,2,4,2,1,3,2,2,4,8,0.27122,0.279026,0,No
1,1,1,1,1,2,1,1,2,8,0.323426,0.334429,0,No
1,1,1,1,1,2,1,1,2,8,0.339927,0.352185,0,No
2,2,4,1,2,3,2,2,4,8,0.34664,0.360933,0,No
5,5,25,4,3,7,5,5,10,7,0.339819,0.351149,0,No
1,1,1,1,1,2,1,1,2,9,0.268641,0.276936,0,No
2,2,4,1,1,2,2,2,4,8,0.282795,0.289819,0,No
4,4,16,1,1,2,4,4,8,8,0.317439,0.327445,0,No
2,2,4,1,1,2,2,2,4,8,0.317439,0.327445,0,No
1,1,1,1,1,2,1,1,2,8,0.308542,0.315798,0,No
1,1,1,1,1,2,1,1,2,8,0.317439,0.327445,0,No
2,2,4,2,2,4,2,2,4,8,0.319981,0.327528,0,No
1,1,1,1,1,2,1,1,2,8,0.317451,0.327459,0,No
16,16,256,5,6,11,16,16,32,7,0.345657,0.359232,0,No
2,2,4,1,2,3,2,2,4,8,0.306993,0.314834,0,No
2,2,4,1,1,2,2,2,4,9,0.260591,0.266539,0,No
1,1,1,1,1,2,1,1,2,8,0.301578,0.314477,0,No
1,1,1,1,1,2,1,1,2,8,0.27455,0.283664,0,No
1,1,1,1,1,2,1,1,2,8,0.294464,0.301547,0,No
1,1,1,1,1,2,1,1,2,8,0.282374,0.289343,0,No
1,1,1,1,1,2,1,1,2,7,0.327819,0.338512,0,No
8,8,64,2,2,4,8,8,16,8,0.31474,0.32258,0,No
1,1,1,1,1,2,1,1,2,8,0.296763,0.303644,0,No
2,2,4,2,2,4,2,2,4,7,0.30391,0.313994,0,No
3,3,9,2,2,4,3,3,6,8,0.314775,0.324643,0,No
1,1,1,1,1,2,1,1,2,8,0.30338,0.311471,0,No
5,5,25,5,3,8,5,5,10,8,0.3004,0.309222,0,No
2,2,4,1,1,2,2,2,4,8,0.27455,0.283664,0,No
1,1,1,1,1,2,1,1,2,8,0.311306,0.32231,0,No
1,1,1,1,1,2,1,1,2,8,0.280231,0.287508,0,No
3,3,9,2,3,5,3,3,6,8,0.315234,0.324231,0,No
2,2,4,2,2,4,2,2,4,8,0.30798,0.315191,0,No
1,1,1,1,1,2,1,1,2,8,0.296438,0.303643,0,No
1,1,1,1,1,2,1,1,2,9,0.25277,0.258067,0,No
7,7,49,5,2,7,7,7,14,8,0.316409,0.32641,0,No
2,2,4,2,1,3,2,2,4,8,0.310028,0.318679,0,No
1,1,1,1,1,2,1,1,2,8,0.274545,0.283659,0,No
2,2,4,2,2,4,2,2,4,7,0.329008,0.339549,0,No
3,3,9,2,2,4,3,3,6,8,0.289955,0.299334,0,No
1,1,1,1,1,2,1,1,2,8,0.310028,0.318679,0,No
5,5,25,4,5,9,5,5,10,8,0.343576,0.357582,0,No
1,1,1,1,1,2,1,1,2,7,0.327826,0.338517,0,No
1,1,1,1,1,2,1,1,2,8,0.301584,0.314486,0,No
2,2,4,1,1,2,2,2,4,8,0.276261,0.283173,0,No
1,1,1,1,1,2,1,1,2,8,0.296171,0.303818,0,No
1,1,1,1,1,2,1,1,2,9,0.268721,0.277328,0,No
2,2,4,2,2,4,2,2,4,8,0.340117,0.352391,0,No
1,1,1,1,1,2,1,1,2,9,0.260659,0.266396,0,No
1,1,1,1,1,2,1,1,2,8,0.303693,0.310789,0,No
1,1,1,1,1,2,1,1,2,8,0.339934,0.352194,0,No
1,1,1,1,1,2,1,1,2,8,0.274545,0.283659,0,No
2,2,4,1,1,2,2,2,4,8,0.32342,0.334424,0,No
2,2,4,1,2,3,2,2,4,8,0.317764,0.325165,0,No
3,3,9,3,3,6,3,3,6,8,0.342376,0.356151,0,No
3,3,9,2,1,3,3,3,6,8,0.323414,0.334415,0,No
1,1,1,1,1,2,1,1,2,8,0.32342,0.334424,0,No
2,2,4,2,2,4,2,2,4,8,0.320631,0.333027,0,No
1,1,1,1,1,2,1,1,2,9,0.25212,0.257194,0,No
1,1,1,1,1,2,1,1,2,8,0.331578,0.343078,0,No
6,6,36,3,6,9,6,6,12,8,0.334385,0.344206,0,No
3,3,9,2,1,3,3,3,6,7,0.327819,0.338512,0,No
1,1,1,1,1,2,1,1,2,7,0.296305,0.304855,0,No
1,1,1,1,1,2,1,1,2,8,0.339934,0.352194,0,No
2,2,4,2,2,4,2,2,4,8,0.30094,0.307841,0,No
1,1,1,1,1,2,1,1,2,8,0.278739,0.288248,0,No
1,1,1,1,1,2,1,1,2,8,0.302842,0.310166,0,No
1,1,1,1,1,2,1,1,2,8,0.271899,0.280395,0,No
1,1,1,1,1,2,1,1,2,9,0.303801,0.312033,0,No
1,1,1,1,1,2,1,1,2,8,0.303834,0.31039,0,No
1,1,1,1,1,2,1,1,2,8,0.249393,0.253981,0,No
1,1,1,1,1,2,1,1,2,8,0.288163,0.299063,0,No
1,1,1,1,1,2,1,1,2,9,0.276056,0.283078,0,No
1,1,1,1,1,2,1,1,2,8,0.301584,0.314486,0,No
1,1,1,1,1,2,1,1,2,8,0.323426,0.334429,0,No
2,2,4,1,1,2,2,2,4,8,0.296166,0.303813,0,No
1,1,1,1,1,2,1,1,2,8,0.339934,0.352194,0,No
1,1,1,1,1,2,1,1,2,7,0.327819,0.338512,0,No
4,4,16,1,2,3,4,4,8,8,0.314688,0.323796,0,No
2,2,4,1,2,3,2,2,4,8,0.300162,0.310852,0,No
1,1,1,1,1,2,1,1,2,8,0.30359,0.310474,0,No
2,2,4,2,2,4,2,2,4,8,0.30462,0.3177,0,No
2,2,4,2,2,4,2,2,4,8,0.305165,0.3184,0,No
1,1,1,1,1,2,1,1,2,8,0.303375,0.311466,0,No
1,1,1,1,1,2,1,1,2,8,0.288934,0.297717,0,No
1,1,1,1,1,2,1,1,2,8,0.301589,0.314491,0,No
2,2,4,1,1,2,2,2,4,8,0.309068,0.315818,0,No
2,2,4,1,1,2,2,2,4,9,0.263403,0.271075,0,No
2,2,4,1,1,2,2,2,4,9,0.259742,0.266039,0,No
2,2,4,1,1,2,2,2,4,9,0.27242,0.279222,0,No
1,1,1,1,1,2,1,1,2,9,0.261274,0.266741,0,No
1,1,1,1,1,2,1,1,2,8,0.280471,0.287424,0,No
1,1,1,1,1,2,1,1,2,8,0.292596,0.299539,0,No
1,1,1,1,1,2,1,1,2,8,0.276925,0.283798,0,No
1,1,1,1,1,2,1,1,2,8,0.310033,0.318684,0,No
1,1,1,1,1,2,1,1,2,9,0.259482,0.2648,0,No
1,1,1,1,1,2,1,1,2,8,0.303655,0.312962,0,No
1,1,1,1,1,2,1,1,2,9,0.256702,0.262351,0,No
1,1,1,1,1,2,1,1,2,8,0.261907,0.26787,0,No
1,1,1,1,1,2,1,1,2,8,0.280047,0.287083,0,No
1,1,1,1,1,2,1,1,2,9,0.246818,0.251324,0,No
1,1,1,1,1,2,1,1,2,8,0.331571,0.343073,0,No
1,1,1,1,1,2,1,1,2,8,0.306453,0.313109,0,No
2,2,4,1,1,2,2,2,4,8,0.303655,0.312962,0,No
1,1,1,1,1,2,1,1,2,8,0.283486,0.292899,0,No
2,2,4,2,2,4,2,2,4,7,0.30391,0.313994,0,No
1,1,1,1,1,2,1,1,2,9,0.244638,0.248102,0,No
4,4,16,2,2,4,4,4,8,8,0.34167,0.354519,0,No
2,2,4,1,1,2,2,2,4,8,0.315759,0.323487,0,No
1,1,1,1,1,2,1,1,2,8,0.302847,0.310171,0,No
1,1,1,1,1,2,1,1,2,8,0.291665,0.299217,0,No
1,1,1,1,1,2,1,1,2,8,0.296166,0.303813,0,No
8,8,64,5,4,9,8,8,16,7,0.319185,0.32934,0,No
1,1,1,1,1,2,1,1,2,8,0.339934,0.352194,0,No
1,1,1,1,1,2,1,1,2,9,0.268641,0.276936,0,No
2,2,4,2,1,3,2,2,4,9,0.280683,0.28796,0,No
5,5,25,2,1,3,5,5,10,7,0.327819,0.338512,0,No
2,2,4,1,2,3,2,2,4,7,0.326777,0.338298,0,No
2,2,4,2,2,4,2,2,4,7,0.347983,0.361927,0,No
1,1,1,1,1,2,1,1,2,8,0.277375,0.28464,0,No
1,1,1,1,1,2,1,1,2,8,0.317298,0.324393,0,No
1,1,1,1,1,2,1,1,2,8,0.314583,0.32146,0,No
3,3,9,2,1,3,3,3,6,8,0.339934,0.352194,0,No
2,2,4,1,1,2,2,2,4,8,0.339934,0.352194,0,No
2,2,4,2,1,3,2,2,4,8,0.339934,0.352194,0,No
1,1,1,1,1,2,1,1,2,9,0.24172,0.245961,0,No
22,22,484,2,3,5,22,22,44,8,0.329701,0.340327,0,No
2,2,4,2,1,3,2,2,4,8,0.303655,0.312962,0,No
1,1,1,1,1,2,1,1,2,8,0.303375,0.311466,0,No
4,4,16,2,4,6,4,4,8,7,0.368898,0.385507,0,No
3,3,9,3,3,6,3,3,6,8,0.329363,0.341727,0,No
1,1,1,1,1,2,1,1,2,8,0.288778,0.295831,0,No
2,2,4,1,1,2,2,2,4,8,0.32342,0.334424,0,No
1,1,1,1,1,2,1,1,2,8,0.301584,0.314486,0,No
7,7,49,2,1,3,7,7,14,8,0.32342,0.334424,0,No
1,1,1,1,1,2,1,1,2,9,0.269103,0.277072,0,No
35,32,1120,12,2,14,35,35,70,8,0.330954,0.343844,0,No
1,1,1,1,1,2,1,1,2,8,0.288168,0.299068,0,No
1,1,1,1,1,2,1,1,2,8,0.339934,0.352194,0,No
4,4,16,3,1,4,4,4,8,8,0.32342,0.334424,0,No
1,1,1,1,1,2,1,1,2,9,0.249503,0.253822,0,No
3,3,9,2,2,4,3,3,6,8,0.325115,0.336276,0,No
1,1,1,1,1,2,1,1,2,8,0.317292,0.324388,0,No
1,1,1,1,1,2,1,1,2,8,0.32342,0.334424,0,No
1,1,1,1,1,2,1,1,2,8,0.32342,0.334424,0,No
1,1,1,1,1,2,1,1,2,8,0.339934,0.352194,0,No
1,1,1,1,1,2,1,1,2,8,0.310717,0.317502,0,No
1,1,1,1,1,2,1,1,2,9,0.268641,0.276936,0,No
5,5,25,1,2,3,5,5,10,8,0.269141,0.276055,0,No
9,7,63,1,6,7,9,9,18,8,0.342823,0.355363,0,No
1,1,1,1,1,2,1,1,2,8,0.261911,0.267873,0,No
2,2,4,1,1,2,2,2,4,8,0.295945,0.304705,0,No
1,1,1,1,1,2,1,1,2,8,0.295945,0.304705,0,No
2,2,4,1,1,2,2,2,4,8,0.29595,0.30471,0,No
4,3,12,1,3,4,4,4,8,8,0.315432,0.322412,0,No
1,1,1,1,1,2,1,1,2,8,0.317445,0.327454,0,No
2,2,4,1,2,3,2,2,4,8,0.320986,0.32815,0,No
3,3,9,1,1,2,3,3,6,8,0.310033,0.318684,0,No
6,6,36,1,6,7,6,6,12,7,0.347834,0.361693,0,No
6,6,36,3,5,8,6,6,12,8,0.325543,0.334358,0,No
2,2,4,1,1,2,2,2,4,8,0.301584,0.314486,0,No
1,1,1,1,1,2,1,1,2,8,0.280508,0.28759,0,No
1,1,1,1,1,2,1,1,2,8,0.309325,0.317943,0,No
1,1,1,1,1,2,1,1,2,8,0.339934,0.352194,0,No
1,1,1,1,1,2,1,1,2,8,0.300569,0.30749,0,No
1,1,1,1,1,2,1,1,2,8,0.281805,0.28952,0,No
3,3,9,1,2,3,3,3,6,8,0.287092,0.29424,0,No
1,1,1,1,1,2,1,1,2,8,0.310717,0.317502,0,No
1,1,1,1,1,2,1,1,2,8,0.309325,0.317943,0,No
1,1,1,1,1,2,1,1,2,8,0.289145,0.296989,0,No
1,1,1,1,1,2,1,1,2,8,0.280056,0.287563,0,No
1,1,1,1,1,2,1,1,2,8,0.339941,0.352199,0,No
2,2,4,1,1,2,2,2,4,9,0.27313,0.280176,0,No
1,1,1,1,1,2,1,1,2,8,0.339927,0.352185,0,No
1,1,1,1,1,2,1,1,2,8,0.317298,0.324393,0,No
1,1,1,1,1,2,1,1,2,8,0.253427,0.258516,0,No
1,1,1,1,1,2,1,1,2,8,0.323426,0.334429,0,No
1,1,1,1,1,2,1,1,2,8,0.301589,0.314491,0,No
4,4,16,4,3,7,4,4,8,8,0.309135,0.316486,0,No
1,1,1,1,1,2,1,1,2,7,0.296305,0.304855,0,No
2,2,4,1,2,3,2,2,4,9,0.258828,0.264593,0,No
1,1,1,1,1,2,1,1,2,8,0.309325,0.317943,0,No
1,1,1,1,1,2,1,1,2,7,0.312589,0.319278,0,No
2,2,4,1,1,2,2,2,4,8,0.284255,0.291831,0,No
2,2,4,2,2,4,2,2,4,8,0.29199,0.299132,0,No
1,1,1,1,1,2,1,1,2,8,0.271899,0.280395,0,No
3,3,9,1,3,4,3,3,6,8,0.314932,0.321649,0,No
4,3,12,4,4,8,4,4,8,7,0.352352,0.367039,0,No
1,1,1,1,1,2,1,1,2,8,0.303375,0.311466,0,No
1,1,1,1,1,2,1,1,2,9,0.268641,0.276936,0,No
3,3,9,1,1,2,3,3,6,8,0.323426,0.334429,0,No
1,1,1,1,1,2,1,1,2,9,0.264921,0.271156,0,No
1,1,1,1,1,2,1,1,2,8,0.323426,0.334429,0,No
1,1,1,1,1,2,1,1,2,8,0.301584,0.314486,0,No
1,1,1,1,1,2,1,1,2,8,0.310033,0.318684,0,No
1,1,1,1,1,2,1,1,2,8,0.317292,0.324388,0,No
2,2,4,1,1,2,2,2,4,8,0.339934,0.352194,0,No
2,2,4,1,2,3,2,2,4,8,0.303499,0.310089,0,No
1,1,1,1,1,2,1,1,2,8,0.301589,0.314491,0,No
1,1,1,1,1,2,1,1,2,8,0.301589,0.314491,0,No
1,1,1,1,1,2,1,1,2,8,0.339934,0.352194,0,No
1,1,1,1,1,2,1,1,2,8,0.288168,0.299068,0,No
1,1,1,1,1,2,1,1,2,8,0.292345,0.299887,0,No
2,2,4,2,2,4,2,2,4,8,0.333294,0.344918,0,No
1,1,1,1,1,2,1,1,2,8,0.32342,0.334424,0,No
1,1,1,1,1,2,1,1,2,8,0.292285,0.300565,0,No
1,1,1,1,1,2,1,1,2,9,0.262169,0.267836,0,No
1,1,1,1,1,2,1,1,2,9,0.269035,0.275503,0,No
1,1,1,1,1,2,1,1,2,9,0.27946,0.286689,0,No
1,1,1,1,1,2,1,1,2,8,0.265386,0.271491,0,No
1,1,1,1,1,2,1,1,2,7,0.327826,0.338517,0,No
1,1,1,1,1,2,1,1,2,8,0.310028,0.318679,0,No
1,1,1,1,1,2,1,1,2,8,0.289248,0.299277,0,No
1,1,1,1,1,2,1,1,2,8,0.323426,0.334429,0,No
1,1,1,1,1,2,1,1,2,9,0.244298,0.248569,0,No
4,4,16,1,2,3,4,4,8,8,0.339941,0.352224,0,No
1,1,1,1,1,2,1,1,2,8,0.293018,0.299928,0,No
1,1,1,1,1,2,1,1,2,9,0.268717,0.277323,0,No
2,2,4,1,1,2,2,2,4,9,0.268721,0.277328,0,No
1,1,1,1,1,2,1,1,2,7,0.327819,0.338512,0,No
1,1,1,1,1,2,1,1,2,8,0.32342,0.334424,0,No
5,5,25,3,2,5,5,5,10,8,0.330961,0.343854,0,No
2,2,4,2,2,4,2,2,4,8,0.338243,0.351497,0,No
1,1,1,1,1,2,1,1,2,8,0.288163,0.299063,0,No
2,2,4,1,1,2,2,2,4,7,0.312584,0.319273,0,No
2,2,4,2,1,3,2,2,4,8,0.288934,0.297717,0,No
4,4,16,3,2,5,4,4,8,8,0.330961,0.343854,0,No
2,2,4,2,2,4,2,2,4,8,0.291655,0.302488,0,No
1,1,1,1,1,2,1,1,2,7,0.2963,0.30485,0,No
9,9,81,4,3,7,9,9,18,8,0.317262,0.324512,0,No
2,2,4,2,1,3,2,2,4,8,0.30946,0.31614,0,No
1,1,1,1,1,2,1,1,2,8,0.273437,0.280423,0,No
1,1,1,1,1,2,1,1,2,8,0.301589,0.314491,0,No
13,13,169,9,7,16,13,13,26,7,0.351184,0.365827,0,No
3,3,9,2,2,4,3,3,6,8,0.309012,0.316671,0,No
1,1,1,1,1,2,1,1,2,8,0.339941,0.352199,0,No
2,2,4,1,2,3,2,2,4,7,0.33362,0.345154,0,No
2,2,4,2,2,4,2,2,4,8,0.305564,0.312801,0,No
1,1,1,1,1,2,1,1,2,8,0.288163,0.299063,0,No
2,2,4,2,2,4,2,2,4,8,0.338236,0.351488,0,No
1,1,1,1,1,2,1,1,2,8,0.288163,0.299063,0,No
1,1,1,1,1,2,1,1,2,8,0.288168,0.299068,0,No
1,1,1,1,1,2,1,1,2,8,0.30338,0.311471,0,No
1,1,1,1,1,2,1,1,2,7,0.312584,0.319273,0,No
1,1,1,1,1,2,1,1,2,9,0.242066,0.245229,0,No
2,2,4,2,2,4,2,2,4,7,0.311585,0.31906,0,No
1,1,1,1,1,2,1,1,2,8,0.331571,0.343073,0,No
1,1,1,1,1,2,1,1,2,8,0.303661,0.312967,0,No
1,1,1,1,1,2,1,1,2,8,0.310717,0.317502,0,No
1,1,1,1,1,2,1,1,2,8,0.287721,0.294876,0,No
3,3,9,3,3,6,3,3,6,7,0.306988,0.314812,0,No
2,2,4,1,1,2,2,2,4,8,0.303375,0.311466,0,No
1,1,1,1,1,2,1,1,2,8,0.278739,0.288248,0,No
2,2,4,1,1,2,2,2,4,9,0.260416,0.266109,0,No
1,1,1,1,1,2,1,1,2,8,0.331578,0.343078,0,No
1,1,1,1,1,2,1,1,2,8,0.306453,0.313109,0,No
2,2,4,2,2,4,2,2,4,7,0.302011,0.310355,0,No
3,3,9,2,2,4,3,3,6,8,0.291287,0.29843,0,No
1,1,1,1,1,2,1,1,2,8,0.288934,0.297717,0,No
4,4,16,2,2,4,4,4,8,8,0.310253,0.317541,0,No
2,2,4,2,2,4,2,2,4,8,0.289434,0.29688,0,No
2,2,4,1,1,2,2,2,4,8,0.294469,0.301552,0,No
1,1,1,1,1,2,1,1,2,8,0.315759,0.323487,0,No
1,1,1,1,1,2,1,1,2,8,0.271216,0.279021,0,No
1,1,1,1,1,2,1,1,2,8,0.303655,0.312962,0,No
1,1,1,1,1,2,1,1,2,8,0.271899,0.280395,0,No
6,4,24,4,4,8,6,6,12,8,0.327618,0.336355,0,No
1,1,1,1,1,2,1,1,2,8,0.295965,0.304324,0,No
1,1,1,1,1,2,1,1,2,8,0.299745,0.307615,0,No
1,1,1,1,1,2,1,1,2,8,0.309325,0.317943,0,No
1,1,1,1,1,2,1,1,2,8,0.29974,0.30761,0,No
2,2,4,2,1,3,2,2,4,8,0.309325,0.317943,0,No
1,1,1,1,1,2,1,1,2,8,0.270502,0.276956,0,No
1,1,1,1,1,2,1,1,2,8,0.30359,0.310474,0,No
1,1,1,1,1,2,1,1,2,8,0.29983,0.307297,0,No
1,1,1,1,1,2,1,1,2,7,0.296305,0.304855,0,No
1,1,1,1,1,2,1,1,2,8,0.267857,0.275083,0,No
1,1,1,1,1,2,1,1,2,8,0.315759,0.323487,0,No
1,1,1,1,1,2,1,1,2,8,0.301589,0.308538,0,No
4,4,16,3,4,7,4,4,8,8,0.335886,0.347178,0,No
2,2,4,2,2,4,2,2,4,8,0.342342,0.354886,0,No
3,3,9,2,2,4,3,3,6,8,0.302251,0.309102,0,No
1,1,1,1,1,2,1,1,2,8,0.339934,0.352194,0,No
1,1,1,1,1,2,1,1,2,8,0.302193,0.308972,0,No
4,4,16,3,3,6,4,4,8,7,0.342314,0.355356,0,No
2,2,4,2,2,4,2,2,4,8,0.313825,0.321217,0,No
2,2,4,2,2,4,2,2,4,8,0.302944,0.311208,0,No
1,1,1,1,1,2,1,1,2,9,0.254235,0.259114,0,No
10,10,100,5,7,12,10,10,20,7,0.354666,0.369029,0,No
1,1,1,1,1,2,1,1,2,9,0.268645,0.276939,0,No
6,6,36,3,5,8,6,6,12,8,0.320938,0.330133,0,No
1,1,1,1,1,2,1,1,2,7,0.327819,0.338512,0,No
1,1,1,1,1,2,1,1,2,8,0.296763,0.303644,0,No
1,1,1,1,1,2,1,1,2,8,0.339934,0.352194,0,No
2,2,4,1,2,3,2,2,4,8,0.340518,0.352976,0,No
4,4,16,4,1,5,4,4,8,7,0.327819,0.338512,0,No
3,3,9,2,2,4,3,3,6,8,0.352396,0.367736,0,No
3,3,9,2,2,4,3,3,6,8,0.326771,0.337971,0,No
2,2,4,1,1,2,2,2,4,8,0.247358,0.251461,0,No
1,1,1,1,1,2,1,1,2,8,0.228586,0.232456,0,No
1,1,1,1,1,2,1,1,2,8,0.323426,0.334429,0,No
1,1,1,1,1,2,1,1,2,8,0.303693,0.310789,0,No
1,1,1,1,1,2,1,1,2,9,0.263407,0.269134,0,No
1,1,1,1,1,2,1,1,2,8,0.292345,0.299887,0,No
1,1,1,1,1,2,1,1,2,7,0.327826,0.338517,0,No
5,5,25,1,1,2,5,5,10,8,0.278743,0.288253,0,No
1,1,1,1,1,2,1,1,2,7,0.327826,0.338517,0,No
2,2,4,1,2,3,2,2,4,8,0.330493,0.34092,0,No
1,1,1,1,1,2,1,1,2,8,0.30359,0.310474,0,No
1,1,1,1,1,2,1,1,2,8,0.339934,0.352194,0,No
2,2,4,2,2,4,2,2,4,8,0.317522,0.327565,0,No
3,3,9,3,3,6,3,3,6,8,0.341444,0.353772,0,No
3,3,9,1,3,4,3,3,6,8,0.317203,0.324157,0,No
1,1,1,1,1,2,1,1,2,8,0.296171,0.303818,0,No
1,1,1,1,1,2,1,1,2,8,0.32342,0.334424,0,No
1,1,1,1,1,2,1,1,2,8,0.253179,0.257838,0,No
8,8,64,5,5,10,8,8,16,7,0.349458,0.36332,0,No
8,8,64,3,3,6,8,8,16,8,0.316011,0.331047,0,No
1,1,1,1,1,2,1,1,2,8,0.288163,0.299063,0,No
1,1,1,1,1,2,1,1,2,8,0.294606,0.302082,0,No
1,1,1,1,1,2,1,1,2,8,0.278739,0.288248,0,No
1,1,1,1,1,2,1,1,2,8,0.27455,0.283664,0,No
1,1,1,1,1,2,1,1,2,8,0.310028,0.318679,0,No
4,4,16,3,3,6,4,4,8,7,0.342796,0.356272,0,No
3,3,9,2,1,3,3,3,6,8,0.288163,0.299063,0,No
1,1,1,1,1,2,1,1,2,8,0.32342,0.334424,0,No
1,1,1,1,1,2,1,1,2,8,0.309466,0.316145,0,No
1,1,1,1,1,2,1,1,2,9,0.250842,0.255927,0,No
1,1,1,1,1,2,1,1,2,8,0.32342,0.334424,0,No
3,3,9,3,3,6,3,3,6,8,0.300956,0.308535,0,No
1,1,1,1,1,2,1,1,2,9,0.286499,0.293568,0,No
1,1,1,1,1,2,1,1,2,8,0.331571,0.343073,0,No
1,1,1,1,1,2,1,1,2,8,0.286537,0.29367,0,No
3,3,9,3,3,6,3,3,6,8,0.323022,0.331094,0,No
4,4,16,3,3,6,4,4,8,8,0.304539,0.312689,0,No
1,1,1,1,1,2,1,1,2,8,0.301584,0.314486,0,No
1,1,1,1,1,2,1,1,2,8,0.287261,0.294347,0,No
2,2,4,2,2,4,2,2,4,8,0.328995,0.340857,0,No
1,1,1,1,1,2,1,1,2,8,0.288163,0.299063,0,No
1,1,1,1,1,2,1,1,2,8,0.27455,0.283664,0,No
1,1,1,1,1,2,1,1,2,9,0.266659,0.272921,0,No
2,2,4,2,2,4,2,2,4,7,0.329911,0.340912,0,No
1,1,1,1,1,2,1,1,2,8,0.331571,0.343073,0,No
1,1,1,1,1,2,1,1,2,8,0.26539,0.271496,0,No
1,1,1,1,1,2,1,1,2,8,0.301589,0.314491,0,No
2,2,4,1,1,2,2,2,4,9,0.257995,0.263247,0,No
1,1,1,1,1,2,1,1,2,8,0.331571,0.343073,0,No
5,5,25,5,5,10,5,5,10,8,0.352418,0.367786,0,No
1,1,1,1,1,2,1,1,2,9,0.243205,0.246417,0,No
1,1,1,1,1,2,1,1,2,9,0.268641,0.276936,0,No
1,1,1,1,1,2,1,1,2,8,0.264452,0.270734,0,No
1,1,1,1,1,2,1,1,2,9,0.241146,0.244222,0,No
2,2,4,2,2,4,2,2,4,8,0.315089,0.329716,0,No
1,1,1,1,1,2,1,1,2,8,0.339934,0.352194,0,No
1,1,1,1,1,2,1,1,2,8,0.323426,0.334429,0,No
1,1,1,1,1,2,1,1,2,8,0.303655,0.312962,0,No
1,1,1,1,1,2,1,1,2,8,0.288285,0.295451,0,No
2,2,4,2,1,3,2,2,4,8,0.279099,0.286801,0,No
2,2,4,2,2,4,2,2,4,8,0.324293,0.332402,0,No
1,1,1,1,1,2,1,1,2,8,0.310033,0.318684,0,No
2,1,2,2,2,4,2,2,4,8,0.315351,0.322115,0,No
2,2,4,2,1,3,2,2,4,8,0.278739,0.288248,0,No
1,1,1,1,1,2,1,1,2,8,0.311312,0.322315,0,No
1,1,1,1,1,2,1,1,2,9,0.263407,0.271078,0,No
2,2,4,1,1,2,2,2,4,8,0.301584,0.314486,0,No
1,1,1,1,1,2,1,1,2,8,0.288163,0.299063,0,No
6,6,36,3,3,6,6,6,12,8,0.333353,0.344217,0,No
1,1,1,1,1,2,1,1,2,8,0.2924,0.299556,0,No
2,2,4,2,1,3,2,2,4,8,0.309325,0.317943,0,No
1,1,1,1,1,2,1,1,2,9,0.268637,0.276931,0,No
1,1,1,1,1,2,1,1,2,8,0.309325,0.317943,0,No
2,1,2,2,2,4,2,2,4,8,0.349637,0.363925,0,No
5,4,20,3,3,6,5,5,10,8,0.325841,0.334814,0,No
1,1,1,1,1,2,1,1,2,8,0.30338,0.311471,0,No
1,1,1,1,1,2,1,1,2,9,0.258299,0.263857,0,No
1,1,1,1,1,2,1,1,2,8,0.290014,0.297093,0,No
1,1,1,1,1,2,1,1,2,8,0.308542,0.315798,0,No
2,2,4,2,2,4,2,2,4,8,0.331597,0.343132,0,No
1,1,1,1,1,2,1,1,2,7,0.327819,0.338512,0,No
1,1,1,1,1,2,1,1,2,8,0.28349,0.292904,0,No
1,1,1,1,1,2,1,1,2,7,0.327819,0.338512,0,No
2,2,4,2,2,4,2,2,4,8,0.308565,0.315406,0,No
11,9,99,3,2,5,11,11,22,8,0.322241,0.329873,0,No
1,1,1,1,1,2,1,1,2,8,0.30338,0.311471,0,No
2,2,4,2,2,4,2,2,4,7,0.303202,0.313323,0,No
3,3,9,3,3,6,3,3,6,7,0.334005,0.345692,0,No
1,1,1,1,1,2,1,1,2,8,0.30338,0.311471,0,No
1,1,1,1,1,2,1,1,2,8,0.301589,0.314491,0,No
1,1,1,1,1,2,1,1,2,8,0.27985,0.28677,0,No
1,1,1,1,1,2,1,1,2,8,0.285621,0.292772,0,No
2,2,4,1,1,2,2,2,4,9,0.27509,0.282006,0,No
2,2,4,1,1,2,2,2,4,9,0.244309,0.248587,0,No
3,3,9,2,2,4,3,3,6,8,0.324188,0.335221,0,No
1,1,1,1,1,2,1,1,2,8,0.301584,0.314486,0,No
1,1,1,1,1,2,1,1,2,8,0.296438,0.303643,0,No
1,1,1,1,1,2,1,1,2,8,0.306145,0.312643,0,No
1,1,1,1,1,2,1,1,2,8,0.306145,0.312643,0,No
1,1,1,1,1,2,1,1,2,8,0.306145,0.312643,0,No
3,3,9,2,2,4,3,3,6,8,0.287871,0.299119,0,No
1,1,1,1,1,2,1,1,2,8,0.277267,0.284196,0,No
2,2,4,2,2,4,2,2,4,8,0.309247,0.32129,0,No
2,2,4,1,1,2,2,2,4,8,0.277831,0.285019,0,No
3,3,9,2,3,5,3,3,6,7,0.315351,0.323639,0,No
5,5,25,4,4,8,5,5,10,8,0.351735,0.366221,0,No
1,1,1,1,1,2,1,1,2,9,0.257948,0.263511,0,No
1,1,1,1,1,2,1,1,2,9,0.264338,0.272092,0,No
1,1,1,1,1,2,1,1,2,8,0.29902,0.30606,0,No
1,1,1,1,1,2,1,1,2,8,0.296171,0.303818,0,No
3,3,9,2,2,4,3,3,6,8,0.323432,0.334464,0,No
1,1,1,1,1,2,1,1,2,9,0.268641,0.276936,0,No
1,1,1,1,1,2,1,1,2,8,0.309325,0.317943,0,No
1,1,1,1,1,2,1,1,2,8,0.274545,0.283659,0,No
1,1,1,1,1,2,1,1,2,8,0.249153,0.253561,0,No
1,1,1,1,1,2,1,1,2,8,0.278039,0.285094,0,No
1,1,1,1,1,2,1,1,2,8,0.288168,0.299068,0,No
1,1,1,1,1,2,1,1,2,9,0.268637,0.276931,0,No
2,1,2,1,2,3,2,2,4,8,0.332515,0.344037,0,No
1,1,1,1,1,2,1,1,2,7,0.327826,0.338517,0,No
2,2,4,2,1,3,2,2,4,8,0.339934,0.352194,0,No
3,3,9,1,3,4,3,3,6,8,0.316005,0.327143,0,No
1,1,1,1,1,2,1,1,2,8,0.339927,0.352185,0,No
1,1,1,1,1,2,1,1,2,8,0.313497,0.320213,0,No
1,1,1,1,1,2,1,1,2,8,0.32342,0.334424,0,No
1,1,1,1,1,2,1,1,2,8,0.323426,0.334429,0,No
2,2,4,2,2,4,2,2,4,8,0.327128,0.337598,0,No
1,1,1,1,1,2,1,1,2,8,0.301584,0.314486,0,No
1,1,1,1,1,2,1,1,2,9,0.272424,0.279226,0,No
3,3,9,3,1,4,3,3,6,8,0.303375,0.311466,0,No
1,1,1,1,1,2,1,1,2,9,0.265233,0.271483,0,No
8,8,64,5,6,11,8,8,16,7,0.341267,0.354266,0,No
1,1,1,1,1,2,1,1,2,8,0.301589,0.314491,0,No
1,1,1,1,1,2,1,1,2,8,0.292862,0.300033,0,No
1,1,1,1,1,2,1,1,2,8,0.32342,0.334424,0,No
1,1,1,1,1,2,1,1,2,8,0.301584,0.314486,0,No
1,1,1,1,1,2,1,1,2,7,0.312584,0.319273,0,No
1,1,1,1,1,2,1,1,2,9,0.268721,0.277328,0,No
1,1,1,1,1,2,1,1,2,8,0.32342,0.334424,0,No
1,1,1,1,1,2,1,1,2,8,0.272376,0.279138,0,No
2,2,4,1,1,2,2,2,4,7,0.327819,0.338512,0,No
1,1,1,1,1,2,1,1,2,8,0.317298,0.324393,0,No
2,2,4,1,2,3,2,2,4,8,0.294672,0.301598,0,No
2,2,4,2,2,4,2,2,4,8,0.314978,0.324429,0,No
1,1,1,1,1,2,1,1,2,8,0.275414,0.282153,0,No
2,2,4,1,1,2,2,2,4,8,0.32342,0.334424,0,No
4,4,16,3,3,6,4,4,8,8,0.337014,0.349684,0,No
4,4,16,3,3,6,4,4,8,8,0.333568,0.346132,0,No
1,1,1,1,1,2,1,1,2,8,0.317292,0.324388,0,No
2,2,4,1,1,2,2,2,4,9,0.276454,0.28342,0,No
2,2,4,2,2,4,2,2,4,8,0.322534,0.330251,0,No
1,1,1,1,1,2,1,1,2,8,0.271899,0.280395,0,No
1,1,1,1,1,2,1,1,2,8,0.278739,0.288248,0,No
1,1,1,1,1,2,1,1,2,8,0.294723,0.301702,0,No
1,1,1,1,1,2,1,1,2,8,0.313497,0.320213,0,No
1,1,1,1,1,2,1,1,2,8,0.339934,0.352194,0,No
1,1,1,1,1,2,1,1,2,9,0.256981,0.262361,0,No
1,1,1,1,1,2,1,1,2,8,0.32342,0.334424,0,No
1,1,1,1,1,2,1,1,2,8,0.271903,0.280398,0,No
1,1,1,1,1,2,1,1,2,7,0.296305,0.304855,0,No
1,1,1,1,1,2,1,1,2,8,0.303693,0.310789,0,No
2,2,4,2,2,4,2,2,4,8,0.305127,0.313165,0,No
1,1,1,1,1,2,1,1,2,9,0.271173,0.278263,0,No
4,4,16,3,3,6,4,4,8,8,0.315829,0.325539,0,No
1,1,1,1,1,2,1,1,2,8,0.28349,0.292904,0,No
1,1,1,1,1,2,1,1,2,8,0.311306,0.32231,0,No
1,1,1,1,1,2,1,1,2,9,0.268726,0.277331,0,No
5,5,25,3,4,7,5,5,10,7,0.353711,0.369331,0,No
1,1,1,1,1,2,1,1,2,8,0.288168,0.299068,0,No
3,3,9,1,3,4,3,3,6,7,0.331733,0.342754,0,No
2,2,4,1,1,2,2,2,4,8,0.339934,0.352194,0,No
1,1,1,1,1,2,1,1,2,8,0.274647,0.281458,0,No
2,2,4,2,2,4,2,2,4,8,0.304822,0.317517,0,No
1,1,1,1,1,2,1,1,2,8,0.29902,0.30606,0,No
3,3,9,2,2,4,3,3,6,8,0.338243,0.351497,0,No
1,1,1,1,1,2,1,1,2,8,0.251348,0.25611,0,No
4,4,16,2,1,3,4,4,8,8,0.32342,0.334424,0,No
4,4,16,4,3,7,4,4,8,8,0.32845,0.340217,0,No
1,1,1,1,1,2,1,1,2,8,0.301584,0.314486,0,No
8,8,64,3,4,7,8,8,16,8,0.333333,0.345009,0,No
1,1,1,1,1,2,1,1,2,8,0.294611,0.302087,0,No
4,4,16,4,3,7,4,4,8,7,0.34098,0.354504,0,No
1,1,1,1,1,2,1,1,2,8,0.309983,0.317112,0,No
1,1,1,1,1,2,1,1,2,8,0.339934,0.352194,0,No
1,1,1,1,1,2,1,1,2,8,0.301578,0.314477,0,No
1,1,1,1,1,2,1,1,2,9,0.268641,0.276936,0,No
3,3,9,2,3,5,3,3,6,8,0.333262,0.345122,0,No
3,3,9,2,2,4,3,3,6,8,0.313037,0.32459,0,No
1,1,1,1,1,2,1,1,2,8,0.331578,0.343078,0,No
1,1,1,1,1,2,1,1,2,8,0.301589,0.314491,0,No
2,1,2,2,2,4,2,2,4,8,0.34963,0.363916,0,No
1,1,1,1,1,2,1,1,2,9,0.244169,0.24849,0,No
2,2,4,2,2,4,2,2,4,8,0.318138,0.325939,0,No
1,1,1,1,1,2,1,1,2,7,0.312589,0.319278,0,No
1,1,1,1,1,2,1,1,2,8,0.323426,0.334429,0,No
1,1,1,1,1,2,1,1,2,8,0.30359,0.310474,0,No
1,1,1,1,1,2,1,1,2,9,0.264346,0.272107,0,No
1,1,1,1,1,2,1,1,2,8,0.288168,0.299068,0,No
1,1,1,1,1,2,1,1,2,8,0.30833,0.31471,0,No
2,2,4,2,2,4,2,2,4,8,0.317221,0.325469,0,No
1,1,1,1,1,2,1,1,2,8,0.303693,0.310789,0,No
8,8,64,2,5,7,8,8,16,8,0.343113,0.356861,0,No
1,1,1,1,1,2,1,1,2,8,0.301584,0.314486,0,No
1,1,1,1,1,2,1,1,2,8,0.288168,0.299068,0,No
2,2,4,2,2,4,2,2,4,8,0.330961,0.343854,0,No
1,1,1,1,1,2,1,1,2,9,0.253115,0.258182,0,No
1,1,1,1,1,2,1,1,2,9,0.303807,0.312038,0,No
4,4,16,3,2,5,4,4,8,8,0.326771,0.337971,0,No
1,1,1,1,1,2,1,1,2,8,0.323426,0.334429,0,No
1,1,1,1,1,2,1,1,2,7,0.327819,0.338512,0,No
1,1,1,1,1,2,1,1,2,8,0.287726,0.294881,0,No
1,1,1,1,1,2,1,1,2,8,0.323426,0.334429,0,No
1,1,1,1,1,2,1,1,2,8,0.288934,0.297717,0,No
2,2,4,1,1,2,2,2,4,8,0.258879,0.264575,0,No
1,1,1,1,1,2,1,1,2,9,0.268721,0.277328,0,No
1,1,1,1,1,2,1,1,2,8,0.30338,0.311471,0,No
2,2,4,1,2,3,2,2,4,8,0.310932,0.317586,0,No
1,1,1,1,1,2,1,1,2,8,0.310722,0.317507,0,No
1,1,1,1,1,2,1,1,2,8,0.301589,0.308538,0,No
1,1,1,1,1,2,1,1,2,8,0.274545,0.283659,0,No
1,1,1,1,1,2,1,1,2,9,0.268726,0.277331,0,No
2,2,4,1,1,2,2,2,4,9,0.254417,0.260027,0,No
1,1,1,1,1,2,1,1,2,9,0.268721,0.277328,0,No
1,1,1,1,1,2,1,1,2,8,0.323426,0.334429,0,No
1,1,1,1,1,2,1,1,2,9,0.268721,0.277328,0,No
1,1,1,1,1,2,1,1,2,8,0.32342,0.334424,0,No
2,2,4,2,2,4,2,2,4,8,0.323684,0.334732,0,No
1,1,1,1,1,2,1,1,2,8,0.303375,0.311466,0,No
1,1,1,1,1,2,1,1,2,8,0.32342,0.334424,0,No
2,2,4,1,2,3,2,2,4,8,0.317889,0.326166,0,No
1,1,1,1,1,2,1,1,2,8,0.258167,0.263601,0,No
1,1,1,1,1,2,1,1,2,8,0.339934,0.352194,0,No
2,2,4,2,2,4,2,2,4,8,0.34461,0.357406,0,No
1,1,1,1,1,2,1,1,2,8,0.287726,0.294881,0,No
1,1,1,1,1,2,1,1,2,8,0.309331,0.317947,0,No
5,5,25,3,5,8,5,5,10,7,0.329847,0.338547,0,No
1,1,1,1,1,2,1,1,2,7,0.2963,0.30485,0,No
2,2,4,1,1,2,2,2,4,8,0.283486,0.292899,0,No
1,1,1,1,1,2,1,1,2,9,0.242403,0.246231,0,No
14,13,182,4,2,6,14,14,28,8,0.292005,0.299035,0,No
2,2,4,2,1,3,2,2,4,8,0.32342,0.334424,0,No
2,2,4,1,1,2,2,2,4,8,0.274541,0.28365,0,No
5,5,25,3,2,5,5,5,10,8,0.287512,0.298106,0,No
2,2,4,2,2,4,2,2,4,9,0.306888,0.315484,0,No
1,1,1,1,1,2,1,1,2,8,0.278739,0.288248,0,No
2,2,4,1,1,2,2,2,4,9,0.255733,0.261996,0,No
1,1,1,1,1,2,1,1,2,9,0.258887,0.26472,0,No
1,1,1,1,1,2,1,1,2,9,0.284331,0.292273,0,No
1,1,1,1,1,2,1,1,2,8,0.288168,0.299068,0,No
1,1,1,1,1,2,1,1,2,9,0.268721,0.277328,0,No
4,4,16,2,3,5,4,4,8,8,0.349709,0.364639,0,No
6,6,36,2,3,5,6,6,12,7,0.336045,0.347082,0,No
5,5,25,2,5,7,5,5,10,7,0.344047,0.356333,0,No
2,2,4,2,2,4,2,2,4,8,0.340395,0.352718,0,No
1,1,1,1,1,2,1,1,2,8,0.331571,0.343073,0,No
1,1,1,1,1,2,1,1,2,8,0.266139,0.272079,0,No
2,2,4,2,2,4,2,2,4,8,0.331855,0.343488,0,No
2,2,4,2,2,4,2,2,4,8,0.315095,0.322797,0,No
1,1,1,1,1,2,1,1,2,7,0.327819,0.338512,0,No
2,2,4,2,1,3,2,2,4,8,0.32342,0.334424,0,No
7,7,49,3,4,7,7,7,14,7,0.342328,0.354974,0,No
1,1,1,1,1,2,1,1,2,8,0.299745,0.307615,0,No
1,1,1,1,1,2,1,1,2,7,0.327826,0.338517,0,No
1,1,1,1,1,2,1,1,2,8,0.301584,0.314486,0,No
2,2,4,1,1,2,2,2,4,8,0.278743,0.288253,0,No
2,2,4,1,2,3,2,2,4,7,0.328059,0.338772,0,No
2,2,4,2,2,4,2,2,4,8,0.332411,0.34394,0,No
1,1,1,1,1,2,1,1,2,8,0.301584,0.314486,0,No
7,7,49,2,5,7,7,7,14,7,0.340002,0.351097,0,No
1,1,1,1,1,2,1,1,2,9,0.250842,0.255927,0,No
2,2,4,1,1,2,2,2,4,9,0.250842,0.255927,0,No
2,2,4,1,1,2,2,2,4,8,0.317298,0.324393,0,No
1,1,1,1,1,2,1,1,2,8,0.283274,0.290435,0,No
1,1,1,1,1,2,1,1,2,8,0.309325,0.317943,0,No
2,2,4,1,1,2,2,2,4,8,0.339941,0.352199,0,No
1,1,1,1,1,2,1,1,2,7,0.327819,0.338512,0,No
1,1,1,1,1,2,1,1,2,8,0.301589,0.314491,0,No
2,2,4,1,1,2,2,2,4,8,0.271899,0.280395,0,No
1,1,1,1,1,2,1,1,2,8,0.310717,0.317502,0,No
2,1,2,2,2,4,2,2,4,8,0.341219,0.353853,0,No
3,3,9,2,2,4,3,3,6,8,0.328274,0.340053,0,No
2,2,4,1,2,3,2,2,4,8,0.324213,0.335095,0,No
2,2,4,2,2,4,2,2,4,8,0.331662,0.343191,0,No
1,1,1,1,1,2,1,1,2,7,0.327826,0.338517,0,No
2,2,4,2,2,4,2,2,4,8,0.318435,0.327389,0,No
1,1,1,1,1,2,1,1,2,8,0.303661,0.312967,0,No
2,2,4,2,2,4,2,2,4,8,0.278112,0.28581,0,No
1,1,1,1,1,2,1,1,2,8,0.279108,0.286245,0,No
1,1,1,1,1,2,1,1,2,8,0.301589,0.314491,0,No
1,1,1,1,1,2,1,1,2,9,0.268641,0.276936,0,No
1,1,1,1,1,2,1,1,2,8,0.303661,0.312967,0,No
1,1,1,1,1,2,1,1,2,8,0.297156,0.304596,0,No
1,1,1,1,1,2,1,1,2,8,0.285889,0.292952,0,No
1,1,1,1,1,2,1,1,2,8,0.331571,0.343073,0,No
3,3,9,3,3,6,3,3,6,8,0.329128,0.341476,0,No
1,1,1,1,1,2,1,1,2,8,0.301584,0.314486,0,No
2,2,4,1,1,2,2,2,4,8,0.291043,0.298137,0,No
1,1,1,1,1,2,1,1,2,8,0.323426,0.334429,0,No
3,3,9,3,3,6,3,3,6,8,0.313209,0.321367,0,No
3,3,9,2,1,3,3,3,6,8,0.309325,0.317943,0,No
1,1,1,1,1,2,1,1,2,8,0.309325,0.317943,0,No
1,1,1,1,1,2,1,1,2,8,0.303688,0.310784,0,No
1,1,1,1,1,2,1,1,2,8,0.315759,0.323487,0,No
2,2,4,1,1,2,2,2,4,8,0.308336,0.314713,0,No
1,1,1,1,1,2,1,1,2,8,0.27818,0.285585,0,No
1,1,1,1,1,2,1,1,2,8,0.2924,0.299556,0,No
3,3,9,2,2,4,3,3,6,8,0.311653,0.321121,0,No
2,2,4,2,2,4,2,2,4,8,0.309331,0.317972,0,No
3,3,9,3,3,6,3,3,6,8,0.308085,0.316392,0,No
1,1,1,1,1,2,1,1,2,8,0.274687,0.281604,0,No
1,1,1,1,1,2,1,1,2,8,0.274687,0.281604,0,No
1,1,1,1,1,2,1,1,2,8,0.279245,0.286914,0,No
6,6,36,3,6,9,6,6,12,8,0.348424,0.361919,0,No
1,1,1,1,1,2,1,1,2,8,0.301589,0.314491,0,No
3,3,9,2,2,4,3,3,6,8,0.305487,0.31357,0,No
5,5,25,3,4,7,5,5,10,8,0.327134,0.335585,0,No
1,1,1,1,1,2,1,1,2,8,0.268219,0.275191,0,No
2,1,2,2,2,4,2,2,4,8,0.296614,0.304306,0,No
2,2,4,2,2,4,2,2,4,9,0.261887,0.267687,0,No
1,1,1,1,1,2,1,1,2,8,0.265423,0.271296,0,No
1,1,1,1,1,2,1,1,2,9,0.263403,0.271075,0,No
2,2,4,2,2,4,2,2,4,8,0.295024,0.302283,0,No
2,2,4,1,1,2,2,2,4,8,0.282136,0.289598,0,No
1,1,1,1,1,2,1,1,2,8,0.288163,0.299063,0,No
1,1,1,1,1,2,1,1,2,8,0.288163,0.299063,0,No
2,2,4,2,2,4,2,2,4,8,0.318488,0.325905,0,No
1,1,1,1,1,2,1,1,2,8,0.310033,0.318684,0,No
4,4,16,1,3,4,4,4,8,9,0.269664,0.277364,0,No
1,1,1,1,1,2,1,1,2,9,0.268637,0.276931,0,No
1,1,1,1,1,2,1,1,2,8,0.288168,0.299068,0,No
4,4,16,1,2,3,4,4,8,8,0.327455,0.338576,0,No
1,1,1,1,1,2,1,1,2,8,0.339934,0.352194,0,No
2,2,4,1,1,2,2,2,4,8,0.309325,0.317943,0,No
2,2,4,1,1,2,2,2,4,8,0.289439,0.296706,0,No
1,1,1,1,1,2,1,1,2,9,0.253936,0.25877,0,No
2,2,4,1,1,2,2,2,4,8,0.303655,0.312962,0,No
7,7,49,1,4,5,7,7,14,7,0.334175,0.345948,0,No
1,1,1,1,1,2,1,1,2,8,0.274607,0.281424,0,No
3,3,9,1,3,4,3,3,6,8,0.33625,0.347827,0,No
1,1,1,1,1,2,1,1,2,8,0.293972,0.300915,0,No
8,8,64,3,3,6,8,8,16,8,0.318708,0.326782,0,No
14,14,196,1,5,6,14,14,28,8,0.329274,0.339077,0,No
5,5,25,1,2,3,5,5,10,8,0.310705,0.31938,0,No
4,4,16,2,2,4,4,4,8,8,0.315701,0.32448,0,No
1,1,1,1,1,2,1,1,2,9,0.253721,0.258609,0,No
7,7,49,1,4,5,7,7,14,8,0.316345,0.325222,0,No
2,2,4,2,2,4,2,2,4,8,0.34361,0.356903,0,No
1,1,1,1,1,2,1,1,2,8,0.287726,0.294881,0,No
2,2,4,1,2,3,2,2,4,8,0.311978,0.32049,0,No
1,1,1,1,1,2,1,1,2,8,0.317445,0.327454,0,No
1,1,1,1,1,2,1,1,2,8,0.339934,0.352194,0,No
2,2,4,1,1,2,2,2,4,8,0.294474,0.301555,0,No
1,1,1,1,1,2,1,1,2,7,0.327819,0.338512,0,No
7,7,49,6,6,12,7,7,14,7,0.349946,0.363654,0,No
3,3,9,3,2,5,3,3,6,8,0.329542,0.340471,0,No
2,2,4,1,1,2,2,2,4,8,0.288168,0.299068,0,No
3,3,9,1,1,2,3,3,6,8,0.32342,0.334424,0,No
4,3,12,4,4,8,4,4,8,8,0.320751,0.328102,0,No
2,2,4,2,1,3,2,2,4,7,0.296305,0.304855,0,No
1,1,1,1,1,2,1,1,2,9,0.268637,0.276931,0,No
1,1,1,1,1,2,1,1,2,8,0.26539,0.271496,0,No
2,2,4,1,1,2,2,2,4,8,0.323426,0.334429,0,No
1,1,1,1,1,2,1,1,2,7,0.296305,0.304855,0,No
1,1,1,1,1,2,1,1,2,8,0.314583,0.32146,0,No
3,3,9,2,3,5,3,3,6,7,0.352818,0.367184,0,No
1,1,1,1,1,2,1,1,2,7,0.327819,0.338512,0,No
1,1,1,1,1,2,1,1,2,8,0.271899,0.280395,0,No
2,2,4,2,2,4,2,2,4,8,0.34461,0.357406,0,No
5,5,25,5,4,9,5,5,10,8,0.352745,0.368156,0,No
4,4,16,4,4,8,4,4,8,8,0.318435,0.327851,0,No
2,2,4,2,2,4,2,2,4,8,0.320011,0.329872,0,No
1,1,1,1,1,2,1,1,2,8,0.310028,0.318679,0,No
1,1,1,1,1,2,1,1,2,8,0.32342,0.334424,0,No
5,5,25,2,4,6,5,5,10,8,0.32669,0.33621,0,No
2,2,4,1,1,2,2,2,4,9,0.261875,0.267717,0,No
1,1,1,1,1,2,1,1,2,8,0.30359,0.310474,0,No
1,1,1,1,1,2,1,1,2,8,0.299367,0.306897,0,No
2,2,4,2,1,3,2,2,4,9,0.268721,0.277328,0,No
1,1,1,1,1,2,1,1,2,8,0.339934,0.352194,0,No
2,2,4,1,1,2,2,2,4,9,0.269396,0.275731,0,No
1,1,1,1,1,2,1,1,2,8,0.30223,0.308783,0,No
2,2,4,2,2,4,2,2,4,8,0.326934,0.337437,0,No
3,3,9,2,2,4,3,3,6,8,0.271496,0.279131,0,No
1,1,1,1,1,2,1,1,2,8,0.269617,0.276137,0,No
1,1,1,1,1,2,1,1,2,8,0.32342,0.334424,0,No
2,2,4,1,2,3,2,2,4,8,0.336469,0.349263,0,No
1,1,1,1,1,2,1,1,2,8,0.317298,0.324393,0,No
1,1,1,1,1,2,1,1,2,8,0.296444,0.303647,0,No
4,4,16,2,2,4,4,4,8,8,0.344603,0.357396,0,No
2,2,4,1,2,3,2,2,4,8,0.300114,0.30703,0,No
1,1,1,1,1,2,1,1,2,8,0.32342,0.334424,0,No
1,1,1,1,1,2,1,1,2,9,0.268721,0.277328,0,No
1,1,1,1,1,2,1,1,2,8,0.283486,0.292899,0,No
1,1,1,1,1,2,1,1,2,9,0.261875,0.267717,0,No
3,3,9,1,2,3,3,3,6,9,0.262479,0.268449,0,No
1,1,1,1,1,2,1,1,2,7,0.327819,0.338512,0,No
1,1,1,1,1,2,1,1,2,8,0.30946,0.31614,0,No
1,1,1,1,1,2,1,1,2,8,0.288934,0.297717,0,No
1,1,1,1,1,2,1,1,2,8,0.301589,0.314491,0,No
1,1,1,1,1,2,1,1,2,8,0.288168,0.299068,0,No
1,1,1,1,1,2,1,1,2,8,0.295945,0.304705,0,No
4,4,16,2,3,5,4,4,8,8,0.317883,0.328879,0,No
1,1,1,1,1,2,1,1,2,8,0.28418,0.291149,0,No
1,1,1,1,1,2,1,1,2,8,0.301584,0.314486,0,No
1,1,1,1,1,2,1,1,2,8,0.323426,0.334429,0,No
1,1,1,1,1,2,1,1,2,8,0.302589,0.309511,0,No
1,1,1,1,1,2,1,1,2,8,0.274435,0.281017,0,No
1,1,1,1,1,2,1,1,2,8,0.299367,0.306897,0,No
1,1,1,1,1,2,1,1,2,8,0.30068,0.307389,0,No
1,1,1,1,1,2,1,1,2,8,0.2828,0.289824,0,No
2,2,4,1,2,3,2,2,4,7,0.328558,0.339133,0,No
1,1,1,1,1,2,1,1,2,8,0.278743,0.288253,0,No
2,2,4,2,2,4,2,2,4,8,0.331578,0.343103,0,No
1,1,1,1,1,2,1,1,2,9,0.254417,0.260027,0,No
1,1,1,1,1,2,1,1,2,8,0.30833,0.31471,0,No
1,1,1,1,1,2,1,1,2,8,0.301584,0.314486,0,No
1,1,1,1,1,2,1,1,2,8,0.271903,0.280398,0,No
2,2,4,1,2,3,2,2,4,8,0.31138,0.318786,0,No
2,2,4,2,2,4,2,2,4,8,0.34079,0.353006,0,No
1,1,1,1,1,2,1,1,2,9,0.255733,0.261996,0,No
2,2,4,2,2,4,2,2,4,8,0.319472,0.32736,0,No
1,1,1,1,1,2,1,1,2,8,0.274545,0.283659,0,No
2,2,4,2,2,4,2,2,4,8,0.319951,0.330445,0,No
1,1,1,1,1,2,1,1,2,9,0.255733,0.261996,0,No
2,2,4,2,2,4,2,2,4,8,0.306778,0.31571,0,No
1,1,1,1,1,2,1,1,2,8,0.278743,0.288253,0,No
1,1,1,1,1,2,1,1,2,8,0.310028,0.318679,0,No
1,1,1,1,1,2,1,1,2,8,0.311306,0.32231,0,No
1,1,1,1,1,2,1,1,2,9,0.26673,0.273132,0,No
3,3,9,3,2,5,3,3,6,8,0.304963,0.315122,0,No
1,1,1,1,1,2,1,1,2,8,0.317895,0.325039,0,No
1,1,1,1,1,2,1,1,2,9,0.239242,0.242391,0,No
2,2,4,1,1,2,2,2,4,8,0.306453,0.313109,0,No
2,2,4,2,2,4,2,2,4,9,0.286398,0.293562,0,No
2,2,4,2,2,4,2,2,4,8,0.324886,0.33473,0,No
1,1,1,1,1,2,1,1,2,8,0.339934,0.352194,0,No
1,1,1,1,1,2,1,1,2,8,0.303688,0.310784,0,No
1,1,1,1,1,2,1,1,2,8,0.339934,0.352194,0,No
1,1,1,1,1,2,1,1,2,10,0.211815,0.215838,0,No
1,1,1,1,1,2,1,1,2,9,0.285015,0.29245,0,No
1,1,1,1,1,2,1,1,2,8,0.309325,0.317943,0,No
1,1,1,1,1,2,1,1,2,8,0.32342,0.334424,0,No
1,1,1,1,1,2,1,1,2,9,0.271173,0.278263,0,No
4,4,16,3,4,7,4,4,8,8,0.334018,0.346812,0,No
1,1,1,1,1,2,1,1,2,8,0.309325,0.317943,0,No
2,2,4,1,2,3,2,2,4,8,0.309308,0.316576,0,No
2,2,4,2,1,3,2,2,4,7,0.327819,0.338512,0,No
1,1,1,1,1,2,1,1,2,8,0.288124,0.295298,0,No
1,1,1,1,1,2,1,1,2,8,0.339934,0.352194,0,No
1,1,1,1,1,2,1,1,2,7,0.296305,0.304855,0,No
1,1,1,1,1,2,1,1,2,8,0.339941,0.352199,0,No
1,1,1,1,1,2,1,1,2,8,0.296676,0.303668,0,No
1,1,1,1,1,2,1,1,2,8,0.331578,0.343078,0,No
1,1,1,1,1,2,1,1,2,8,0.339934,0.352194,0,No
1,1,1,1,1,2,1,1,2,8,0.339934,0.352194,0,No
1,1,1,1,1,2,1,1,2,7,0.327819,0.338512,0,No
2,2,4,2,2,4,2,2,4,8,0.301936,0.314961,0,No
3,3,9,1,3,4,3,3,6,8,0.342006,0.35472,0,No
2,2,4,2,1,3,2,2,4,9,0.253115,0.258182,0,No
1,1,1,1,1,2,1,1,2,8,0.28565,0.292652,0,No
2,1,2,2,2,4,2,2,4,8,0.313382,0.320829,0,No
1,1,1,1,1,2,1,1,2,8,0.313848,0.32086,0,No
2,2,4,2,2,4,2,2,4,8,0.318947,0.326211,0,No
1,1,1,1,1,2,1,1,2,8,0.32342,0.334424,0,No
1,1,1,1,1,2,1,1,2,8,0.301589,0.314491,0,No
1,1,1,1,1,2,1,1,2,8,0.317445,0.327454,0,No
2,2,4,2,2,4,2,2,4,8,0.314456,0.321242,0,No
2,2,4,1,1,2,2,2,4,8,0.271899,0.280395,0,No
1,1,1,1,1,2,1,1,2,7,0.296305,0.304855,0,No
2,2,4,2,2,4,2,2,4,7,0.30391,0.313994,0,No
1,1,1,1,1,2,1,1,2,7,0.296305,0.304855,0,No
1,1,1,1,1,2,1,1,2,8,0.264502,0.270851,0,No
2,2,4,1,1,2,2,2,4,8,0.309325,0.317943,0,No
1,1,1,1,1,2,1,1,2,8,0.273915,0.280746,0,No
1,1,1,1,1,2,1,1,2,7,0.327819,0.338512,0,No
1,1,1,1,1,2,1,1,2,8,0.272663,0.279351,0,No
1,1,1,1,1,2,1,1,2,7,0.296305,0.304855,0,No
1,1,1,1,1,2,1,1,2,8,0.27122,0.279026,0,No
2,2,4,2,2,4,2,2,4,8,0.308821,0.317584,0,No
1,1,1,1,1,2,1,1,2,8,0.32342,0.334424,0,No
3,3,9,3,3,6,3,3,6,8,0.314897,0.324512,0,No
1,1,1,1,1,2,1,1,2,8,0.303655,0.312962,0,No
2,2,4,2,2,4,2,2,4,8,0.293008,0.301802,0,No
5,5,25,3,1,4,5,5,10,8,0.288168,0.299068,0,No
1,1,1,1,1,2,1,1,2,8,0.310028,0.318679,0,No
1,1,1,1,1,2,1,1,2,8,0.308325,0.314705,0,No
3,3,9,3,2,5,3,3,6,7,0.298795,0.307211,0,No
1,1,1,1,1,2,1,1,2,8,0.274647,0.281458,0,No
1,1,1,1,1,2,1,1,2,8,0.323426,0.334429,0,No
4,4,16,3,3,6,4,4,8,8,0.316615,0.325259,0,No
1,1,1,1,1,2,1,1,2,9,0.26388,0.270162,0,No
2,2,4,1,2,3,2,2,4,7,0.329911,0.340912,0,No
2,2,4,1,2,3,2,2,4,8,0.306927,0.314222,0,No
1,1,1,1,1,2,1,1,2,8,0.27455,0.283664,0,No
2,2,4,1,1,2,2,2,4,8,0.313497,0.320213,0,No
3,3,9,1,2,3,3,3,6,8,0.314265,0.321367,0,No
1,1,1,1,1,2,1,1,2,8,0.313497,0.320213,0,No
1,1,1,1,1,2,1,1,2,8,0.309325,0.317943,0,No
2,2,4,2,2,4,2,2,4,8,0.304381,0.311336,0,No
1,1,1,1,1,2,1,1,2,8,0.26706,0.273524,0,No
1,1,1,1,1,2,1,1,2,8,0.29667,0.303664,0,No
3,3,9,2,3,5,3,3,6,8,0.346936,0.361183,0,No
1,1,1,1,1,2,1,1,2,8,0.313848,0.32086,0,No
1,1,1,1,1,2,1,1,2,8,0.339934,0.352194,0,No
1,1,1,1,1,2,1,1,2,8,0.323426,0.334429,0,No
1,1,1,1,1,2,1,1,2,8,0.271899,0.280395,0,No
2,2,4,1,1,2,2,2,4,7,0.296305,0.304855,0,No
1,1,1,1,1,2,1,1,2,8,0.27455,0.283664,0,No
2,1,2,1,2,3,2,2,4,8,0.31401,0.320777,0,No
2,2,4,2,2,4,2,2,4,7,0.297208,0.305743,0,No
2,2,4,1,2,3,2,2,4,8,0.317357,0.324211,0,No
1,1,1,1,1,2,1,1,2,8,0.339934,0.352194,0,No
2,2,4,2,2,4,2,2,4,8,0.3104,0.319047,0,No
1,1,1,1,1,2,1,1,2,8,0.331571,0.343073,0,No
1,1,1,1,1,2,1,1,2,8,0.271899,0.280395,0,No
1,1,1,1,1,2,1,1,2,8,0.288778,0.295831,0,No
2,2,4,1,2,3,2,2,4,9,0.286052,0.294983,0,No
1,1,1,1,1,2,1,1,2,8,0.269277,0.275694,0,No
2,2,4,2,2,4,2,2,4,8,0.323353,0.334111,0,No
3,3,9,2,3,5,3,3,6,8,0.304256,0.313281,0,No
1,1,1,1,1,2,1,1,2,8,0.288929,0.297713,0,No
3,3,9,2,2,4,3,3,6,8,0.33825,0.351502,0,No
1,1,1,1,1,2,1,1,2,9,0.268721,0.277328,0,No
1,1,1,1,1,2,1,1,2,8,0.32342,0.334424,0,No
2,2,4,2,2,4,2,2,4,8,0.295243,0.303287,0,No
7,6,42,4,4,8,7,7,14,8,0.328008,0.340468,0,No
1,1,1,1,1,2,1,1,2,8,0.32342,0.334424,0,No
2,2,4,2,2,4,2,2,4,8,0.322601,0.332841,0,No
3,3,9,3,3,6,3,3,6,8,0.311738,0.321313,0,No
2,2,4,2,2,4,2,2,4,8,0.307336,0.315565,0,No
1,1,1,1,1,2,1,1,2,8,0.317292,0.324388,0,No
2,2,4,2,2,4,2,2,4,8,0.339941,0.352224,0,No
1,1,1,1,1,2,1,1,2,9,0.268637,0.276931,0,No
3,3,9,3,3,6,3,3,6,8,0.304593,0.314208,0,No
1,1,1,1,1,2,1,1,2,8,0.339934,0.352194,0,No
2,2,4,2,2,4,2,2,4,8,0.313993,0.322074,0,No
1,1,1,1,1,2,1,1,2,9,0.268645,0.276939,0,No
3,3,9,2,2,4,3,3,6,8,0.325307,0.337114,0,No
1,1,1,1,1,2,1,1,2,8,0.271894,0.28039,0,No
4,4,16,3,2,5,4,4,8,8,0.291605,0.298712,0,No
1,1,1,1,1,2,1,1,2,9,0.268641,0.276936,0,No
6,6,36,2,2,4,6,6,12,8,0.287517,0.298111,0,No
1,1,1,1,1,2,1,1,2,9,0.268641,0.276936,0,No
1,1,1,1,1,2,1,1,2,8,0.28349,0.292904,0,No
2,2,4,2,2,4,2,2,4,8,0.302476,0.309227,0,No
3,3,9,3,3,6,3,3,6,8,0.303569,0.312089,0,No
1,1,1,1,1,2,1,1,2,8,0.314583,0.32146,0,No
1,1,1,1,1,2,1,1,2,8,0.289941,0.297462,0,No
1,1,1,1,1,2,1,1,2,8,0.32342,0.334424,0,No
1,1,1,1,1,2,1,1,2,9,0.24959,0.254279,0,No
2,2,4,1,1,2,2,2,4,8,0.288163,0.299063,0,No
1,1,1,1,1,2,1,1,2,8,0.268633,0.275095,0,No
6,6,36,3,6,9,6,6,12,8,0.323359,0.333559,0,No
2,2,4,2,2,4,2,2,4,8,0.323261,0.333744,0,No
1,1,1,1,1,2,1,1,2,8,0.301589,0.314491,0,No
3,3,9,1,2,3,3,3,6,8,0.323758,0.33471,0,No
6,6,36,5,5,10,6,6,12,8,0.343569,0.357491,0,No
2,2,4,2,1,3,2,2,4,8,0.317292,0.324388,0,No
6,6,36,2,4,6,6,6,12,8,0.344213,0.358238,0,No
9,9,81,6,6,12,9,9,18,8,0.362341,0.378722,0,No
1,1,1,1,1,2,1,1,2,8,0.323426,0.334429,0,No
2,2,4,2,2,4,2,2,4,8,0.307885,0.316493,0,No
6,6,36,3,4,7,6,6,12,8,0.361443,0.377127,0,No
1,1,1,1,1,2,1,1,2,8,0.339934,0.352194,0,No
6,6,36,3,4,7,6,6,12,8,0.343714,0.357698,0,No
1,1,1,1,1,2,1,1,2,8,0.294484,0.301605,0,No
1,1,1,1,1,2,1,1,2,8,0.296171,0.303818,0,No
2,2,4,2,2,4,2,2,4,8,0.309881,0.317358,0,No
1,1,1,1,1,2,1,1,2,8,0.28349,0.292904,0,No
1,1,1,1,1,2,1,1,2,8,0.323426,0.334429,0,No
4,4,16,4,4,8,4,4,8,8,0.338673,0.350748,0,No
1,1,1,1,1,2,1,1,2,8,0.306437,0.313195,0,No
2,2,4,2,2,4,2,2,4,8,0.338243,0.351497,0,No
4,4,16,1,3,4,4,4,8,8,0.323586,0.334686,0,No
2,2,4,2,2,4,2,2,4,8,0.25771,0.263709,0,No
2,2,4,2,2,4,2,2,4,8,0.311539,0.32007,0,No
1,1,1,1,1,2,1,1,2,9,0.242793,0.246514,0,No
2,2,4,2,2,4,2,2,4,8,0.341178,0.353519,0,No
1,1,1,1,1,2,1,1,2,9,0.271721,0.278269,0,No
2,2,4,1,2,3,2,2,4,8,0.320005,0.33016,0,No
2,2,4,2,2,4,2,2,4,8,0.335193,0.345963,0,No
2,2,4,2,2,4,2,2,4,8,0.338243,0.351497,0,No
1,1,1,1,1,2,1,1,2,8,0.295965,0.304324,0,No
2,2,4,2,2,4,2,2,4,8,0.307358,0.314275,0,No
2,1,2,1,2,3,2,2,4,8,0.312149,0.323114,0,No
1,1,1,1,1,2,1,1,2,8,0.289145,0.296989,0,No
1,1,1,1,1,2,1,1,2,7,0.296305,0.304855,0,No
1,1,1,1,1,2,1,1,2,8,0.339934,0.352194,0,No
1,1,1,1,1,2,1,1,2,8,0.286995,0.295346,0,No
2,2,4,1,1,2,2,2,4,9,0.263277,0.269553,0,No
1,1,1,1,1,2,1,1,2,8,0.301589,0.314491,0,No
2,2,4,2,2,4,2,2,4,8,0.309252,0.321299,0,No
1,1,1,1,1,2,1,1,2,8,0.268219,0.275191,0,No
1,1,1,1,1,2,1,1,2,8,0.259715,0.265244,0,No
1,1,1,1,1,2,1,1,2,8,0.301584,0.314486,0,No
2,2,4,2,2,4,2,2,4,8,0.29385,0.301315,0,No
1,1,1,1,1,2,1,1,2,9,0.250161,0.254822,0,No
2,2,4,2,2,4,2,2,4,8,0.306041,0.318526,0,No
4,4,16,1,2,3,4,4,8,8,0.279136,0.289197,0,No
1,1,1,1,1,2,1,1,2,8,0.313497,0.320213,0,No
1,1,1,1,1,2,1,1,2,8,0.323426,0.334429,0,No
8,8,64,2,4,6,8,8,16,7,0.333711,0.345681,0,No
4,4,16,2,4,6,4,4,8,7,0.334012,0.344894,0,No
1,1,1,1,1,2,1,1,2,9,0.253115,0.258182,0,No
4,4,16,2,2,4,4,4,8,8,0.32709,0.337909,0,No
1,1,1,1,1,2,1,1,2,8,0.288168,0.299068,0,No
2,2,4,2,2,4,2,2,4,7,0.317948,0.325389,0,No
1,1,1,1,1,2,1,1,2,8,0.288168,0.299068,0,No
2,2,4,1,1,2,2,2,4,8,0.339934,0.352194,0,No
5,5,25,4,5,9,5,5,10,8,0.347133,0.360799,0,No
1,1,1,1,1,2,1,1,2,8,0.303375,0.311466,0,No
3,3,9,2,1,3,3,3,6,8,0.339934,0.352194,0,No
1,1,1,1,1,2,1,1,2,8,0.317292,0.324388,0,No
1,1,1,1,1,2,1,1,2,8,0.309325,0.317943,0,No
1,1,1,1,1,2,1,1,2,9,0.246932,0.250705,0,No
3,3,9,2,3,5,3,3,6,8,0.279666,0.28774,0,No
2,2,4,2,2,4,2,2,4,8,0.311187,0.318063,0,No
2,2,4,1,1,2,2,2,4,8,0.288934,0.297717,0,No
2,2,4,1,1,2,2,2,4,8,0.301589,0.314491,0,No
4,4,16,2,2,4,4,4,8,8,0.306211,0.318624,0,No
3,3,9,3,3,6,3,3,6,8,0.310683,0.318538,0,No
1,1,1,1,1,2,1,1,2,9,0.269103,0.277072,0,No
1,1,1,1,1,2,1,1,2,8,0.271899,0.280395,0,No
1,1,1,1,1,2,1,1,2,8,0.32342,0.334424,0,No
1,1,1,1,1,2,1,1,2,8,0.32342,0.334424,0,No
1,1,1,1,1,2,1,1,2,9,0.267018,0.273383,0,No
1,1,1,1,1,2,1,1,2,8,0.32342,0.334424,0,No
1,1,1,1,1,2,1,1,2,8,0.27455,0.283664,0,No
1,1,1,1,1,2,1,1,2,8,0.265155,0.271381,0,No
1,1,1,1,1,2,1,1,2,8,0.310028,0.318679,0,No
1,1,1,1,1,2,1,1,2,9,0.268641,0.276936,0,No
1,1,1,1,1,2,1,1,2,8,0.310717,0.317502,0,No
1,1,1,1,1,2,1,1,2,8,0.264457,0.270739,0,No
2,2,4,2,1,3,2,2,4,7,0.327813,0.338503,0,No
1,1,1,1,1,2,1,1,2,8,0.317298,0.324393,0,No
1,1,1,1,1,2,1,1,2,9,0.261871,0.267712,0,No
1,1,1,1,1,2,1,1,2,8,0.331571,0.343073,0,No
1,1,1,1,1,2,1,1,2,8,0.288163,0.299063,0,No
1,1,1,1,1,2,1,1,2,8,0.288168,0.299068,0,No
1,1,1,1,1,2,1,1,2,8,0.310033,0.318684,0,No
1,1,1,1,1,2,1,1,2,8,0.296166,0.303813,0,No
3,3,9,1,1,2,3,3,6,8,0.301584,0.314486,0,No
4,4,16,2,3,5,4,4,8,8,0.286364,0.296132,0,No
1,1,1,1,1,2,1,1,2,8,0.301589,0.314491,0,No
4,4,16,2,2,4,4,4,8,8,0.305056,0.317696,0,No
1,1,1,1,1,2,1,1,2,8,0.301584,0.314486,0,No
3,3,9,1,1,2,3,3,6,9,0.268721,0.277328,0,No
1,1,1,1,1,2,1,1,2,9,0.268721,0.277328,0,No
1,1,1,1,1,2,1,1,2,9,0.268721,0.277328,0,No
1,1,1,1,1,2,1,1,2,8,0.301589,0.314491,0,No
1,1,1,1,1,2,1,1,2,8,0.339934,0.352194,0,No
1,1,1,1,1,2,1,1,2,9,0.263399,0.271071,0,No
1,1,1,1,1,2,1,1,2,8,0.331571,0.343073,0,No
1,1,1,1,1,2,1,1,2,8,0.317451,0.327459,0,No
1,1,1,1,1,2,1,1,2,8,0.339934,0.352194,0,No
2,2,4,1,1,2,2,2,4,8,0.32342,0.334424,0,No
1,1,1,1,1,2,1,1,2,8,0.273858,0.280724,0,No
1,1,1,1,1,2,1,1,2,8,0.258887,0.264583,0,No
2,2,4,2,2,4,2,2,4,8,0.278189,0.285391,0,No
2,2,4,2,2,4,2,2,4,8,0.340402,0.352739,0,No
1,1,1,1,1,2,1,1,2,8,0.313502,0.320218,0,No
1,1,1,1,1,2,1,1,2,9,0.250842,0.255927,0,No
1,1,1,1,1,2,1,1,2,8,0.289941,0.297462,0,No
1,1,1,1,1,2,1,1,2,8,0.279259,0.286305,0,No
1,1,1,1,1,2,1,1,2,9,0.247642,0.251713,0,No
1,1,1,1,1,2,1,1,2,8,0.283486,0.292899,0,No
2,2,4,2,2,4,2,2,4,7,0.304159,0.312183,0,No
1,1,1,1,1,2,1,1,2,8,0.28349,0.292904,0,No
1,1,1,1,1,2,1,1,2,8,0.297322,0.304241,0,No
3,3,9,2,3,5,3,3,6,8,0.33016,0.339908,0,No
1,1,1,1,1,2,1,1,2,8,0.317451,0.327459,0,No
1,1,1,1,1,2,1,1,2,8,0.331571,0.343073,0,No
1,1,1,1,1,2,1,1,2,7,0.327819,0.338512,0,No
1,1,1,1,1,2,1,1,2,7,0.2963,0.30485,0,No
4,4,16,4,2,6,4,4,8,7,0.339306,0.352082,0,No
1,1,1,1,1,2,1,1,2,8,0.299761,0.306442,0,No
1,1,1,1,1,2,1,1,2,8,0.301589,0.314491,0,No
3,3,9,2,2,4,3,3,6,8,0.342665,0.355544,0,No
3,3,9,3,1,4,3,3,6,8,0.323426,0.334429,0,No
2,2,4,1,1,2,2,2,4,8,0.278743,0.288253,0,No
2,2,4,2,1,3,2,2,4,7,0.327819,0.338512,0,No
1,1,1,1,1,2,1,1,2,9,0.268641,0.276936,0,No
1,1,1,1,1,2,1,1,2,7,0.327819,0.338512,0,No
1,1,1,1,1,2,1,1,2,8,0.274545,0.283659,0,No
1,1,1,1,1,2,1,1,2,7,0.327819,0.338512,0,No
1,1,1,1,1,2,1,1,2,9,0.254908,0.260671,0,No
1,1,1,1,1,2,1,1,2,8,0.301584,0.314486,0,No
5,5,25,4,3,7,5,5,10,9,0.293128,0.302224,0,No
1,1,1,1,1,2,1,1,2,9,0.268721,0.277328,0,No
2,2,4,1,1,2,2,2,4,8,0.264457,0.270739,0,No
6,6,36,3,3,6,6,6,12,8,0.327687,0.339549,0,No
2,2,4,1,1,2,2,2,4,7,0.296305,0.304855,0,No
1,1,1,1,1,2,1,1,2,8,0.310028,0.318679,0,No
2,2,4,2,2,4,2,2,4,8,0.29633,0.305184,0,No
1,1,1,1,1,2,1,1,2,8,0.339934,0.352194,0,No
1,1,1,1,1,2,1,1,2,8,0.288934,0.297717,0,No
2,2,4,1,2,3,2,2,4,8,0.303763,0.31212,0,No
1,1,1,1,1,2,1,1,2,8,0.281452,0.288543,0,No
1,1,1,1,1,2,1,1,2,8,0.288168,0.299068,0,No
1,1,1,1,1,2,1,1,2,8,0.268219,0.275191,0,No
1,1,1,1,1,2,1,1,2,7,0.327819,0.338512,0,No
1,1,1,1,1,2,1,1,2,8,0.29001,0.297088,0,No
1,1,1,1,1,2,1,1,2,9,0.266505,0.273076,0,No
2,2,4,1,1,2,2,2,4,8,0.282257,0.289547,0,No
1,1,1,1,1,2,1,1,2,8,0.265787,0.271974,0,No
2,2,4,1,2,3,2,2,4,8,0.325319,0.3366,0,No
1,1,1,1,1,2,1,1,2,8,0.283081,0.290002,0,No
1,1,1,1,1,2,1,1,2,9,0.284336,0.292278,0,No
2,2,4,1,1,2,2,2,4,8,0.32342,0.334424,0,No
1,1,1,1,1,2,1,1,2,9,0.268641,0.276936,0,No
2,2,4,1,2,3,2,2,4,8,0.305767,0.31226,0,No
1,1,1,1,1,2,1,1,2,9,0.243548,0.247573,0,No
1,1,1,1,1,2,1,1,2,8,0.299367,0.306897,0,No
1,1,1,1,1,2,1,1,2,9,0.250842,0.255927,0,No
1,1,1,1,1,2,1,1,2,8,0.303375,0.311466,0,No
1,1,1,1,1,2,1,1,2,9,0.250842,0.255927,0,No
1,1,1,1,1,2,1,1,2,8,0.303375,0.311466,0,No
1,1,1,1,1,2,1,1,2,8,0.303375,0.311466,0,No
2,2,4,1,2,3,2,2,4,8,0.316609,0.32539,0,No
5,5,25,2,4,6,5,5,10,8,0.320492,0.330364,0,No
2,2,4,1,1,2,2,2,4,8,0.310028,0.318679,0,No
1,1,1,1,1,2,1,1,2,8,0.310028,0.318679,0,No
3,3,9,1,2,3,3,3,6,8,0.341417,0.354268,0,No
4,4,16,3,2,5,4,4,8,8,0.290069,0.297148,0,No
2,2,4,1,1,2,2,2,4,8,0.315759,0.323487,0,No
1,1,1,1,1,2,1,1,2,8,0.264457,0.270739,0,No
2,2,4,2,2,4,2,2,4,8,0.28968,0.299061,0,No
2,2,4,1,2,3,2,2,4,8,0.338243,0.351497,0,No
1,1,1,1,1,2,1,1,2,8,0.271899,0.280395,0,No
1,1,1,1,1,2,1,1,2,8,0.27455,0.283664,0,No
1,1,1,1,1,2,1,1,2,9,0.242293,0.245444,0,No
1,1,1,1,1,2,1,1,2,9,0.258734,0.264338,0,No
1,1,1,1,1,2,1,1,2,7,0.296305,0.304855,0,No
1,1,1,1,1,2,1,1,2,7,0.327819,0.338512,0,No
1,1,1,1,1,2,1,1,2,7,0.296305,0.304855,0,No
1,1,1,1,1,2,1,1,2,8,0.279245,0.286914,0,No
1,1,1,1,1,2,1,1,2,8,0.317292,0.324388,0,No
1,1,1,1,1,2,1,1,2,8,0.302193,0.308972,0,No
1,1,1,1,1,2,1,1,2,8,0.32342,0.334424,0,No
1,1,1,1,1,2,1,1,2,8,0.28565,0.292652,0,No
1,1,1,1,1,2,1,1,2,8,0.301584,0.314486,0,No
1,1,1,1,1,2,1,1,2,8,0.309325,0.317943,0,No
1,1,1,1,1,2,1,1,2,9,0.264707,0.271034,0,No
3,3,9,2,3,5,3,3,6,8,0.345419,0.358362,0,No
2,2,4,2,2,4,2,2,4,8,0.335754,0.347754,0,No
1,1,1,1,1,2,1,1,2,8,0.280641,0.287963,0,No
1,1,1,1,1,2,1,1,2,8,0.282257,0.289547,0,No
1,1,1,1,1,2,1,1,2,8,0.303375,0.311466,0,No
1,1,1,1,1,2,1,1,2,8,0.288168,0.299068,0,No
1,1,1,1,1,2,1,1,2,8,0.264457,0.270739,0,No
3,3,9,2,2,4,3,3,6,8,0.319066,0.329734,0,No
1,1,1,1,1,2,1,1,2,8,0.28349,0.292904,0,No
2,2,4,1,1,2,2,2,4,8,0.309977,0.317107,0,No
1,1,1,1,1,2,1,1,2,8,0.301589,0.314491,0,No
1,1,1,1,1,2,1,1,2,9,0.268721,0.277328,0,No
1,1,1,1,1,2,1,1,2,7,0.2963,0.30485,0,No
1,1,1,1,1,2,1,1,2,8,0.278958,0.286026,0,No
1,1,1,1,1,2,1,1,2,9,0.250842,0.255927,0,No
3,3,9,2,3,5,3,3,6,8,0.33,0.340132,0,No
4,4,16,2,2,4,4,4,8,8,0.316339,0.325302,0,No
2,2,4,2,2,4,2,2,4,8,0.338243,0.351497,0,No
2,1,2,2,1,3,2,2,4,8,0.339934,0.352194,0,No
1,1,1,1,1,2,1,1,2,8,0.303358,0.310126,0,No
1,1,1,1,1,2,1,1,2,9,0.268717,0.277323,0,No
1,1,1,1,1,2,1,1,2,8,0.299761,0.306442,0,No
1,1,1,1,1,2,1,1,2,8,0.32342,0.334424,0,No
3,3,9,3,3,6,3,3,6,8,0.29781,0.308138,0,No
1,1,1,1,1,2,1,1,2,8,0.309325,0.317943,0,No
1,1,1,1,1,2,1,1,2,8,0.310033,0.318684,0,No
6,6,36,1,3,4,6,6,12,8,0.284877,0.295026,0,No
2,2,4,1,2,3,2,2,4,8,0.280614,0.290015,0,No
1,1,1,1,1,2,1,1,2,8,0.339934,0.352194,0,No
1,1,1,1,1,2,1,1,2,8,0.339934,0.352194,0,No
1,1,1,1,1,2,1,1,2,8,0.310028,0.318679,0,No
3,3,9,1,2,3,3,3,6,8,0.339955,0.352243,0,No
2,2,4,1,1,2,2,2,4,8,0.339934,0.352194,0,No
2,2,4,2,2,4,2,2,4,8,0.342342,0.354886,0,No
1,1,1,1,1,2,1,1,2,9,0.250938,0.255202,0,No
1,1,1,1,1,2,1,1,2,8,0.303375,0.311466,0,No
1,1,1,1,1,2,1,1,2,8,0.309331,0.317947,0,No
1,1,1,1,1,2,1,1,2,8,0.331578,0.343078,0,No
1,1,1,1,1,2,1,1,2,8,0.272929,0.279555,0,No
1,1,1,1,1,2,1,1,2,8,0.288168,0.299068,0,No
1,1,1,1,1,2,1,1,2,8,0.277096,0.285605,0,No
1,1,1,1,1,2,1,1,2,8,0.291905,0.299149,0,No
1,1,1,1,1,2,1,1,2,8,0.297415,0.304434,0,No
1,1,1,1,1,2,1,1,2,8,0.301584,0.314486,0,No
1,1,1,1,1,2,1,1,2,8,0.266964,0.273196,0,No
2,2,4,2,2,4,2,2,4,8,0.323844,0.33373,0,No
1,1,1,1,1,2,1,1,2,8,0.271899,0.280395,0,No
1,1,1,1,1,2,1,1,2,9,0.268641,0.276936,0,No
2,2,4,1,2,3,2,2,4,8,0.337353,0.349544,0,No
2,2,4,1,2,3,2,2,4,7,0.322199,0.329935,0,No
1,1,1,1,1,2,1,1,2,9,0.268641,0.276936,0,No
2,2,4,2,2,4,2,2,4,7,0.331514,0.343058,0,No
1,1,1,1,1,2,1,1,2,8,0.339934,0.352194,0,No
2,2,4,1,1,2,2,2,4,8,0.28565,0.292652,0,No
1,1,1,1,1,2,1,1,2,8,0.339934,0.352194,0,No
1,1,1,1,1,2,1,1,2,8,0.32342,0.334424,0,No
5,5,25,3,3,6,5,5,10,8,0.350499,0.364742,0,No
1,1,1,1,1,2,1,1,2,8,0.274554,0.281188,0,No
3,3,9,1,1,2,3,3,6,8,0.258883,0.26458,0,No
5,5,25,3,4,7,5,5,10,8,0.319933,0.326999,0,No
1,1,1,1,1,2,1,1,2,9,0.249989,0.254629,0,No
1,1,1,1,1,2,1,1,2,8,0.313497,0.320213,0,No
2,2,4,2,2,4,2,2,4,8,0.305772,0.314837,0,No
1,1,1,1,1,2,1,1,2,8,0.27296,0.279655,0,No
4,4,16,1,3,4,4,4,8,8,0.324219,0.333097,0,No
1,1,1,1,1,2,1,1,2,8,0.288934,0.297717,0,No
1,1,1,1,1,2,1,1,2,9,0.250842,0.255927,0,No
2,2,4,2,2,4,2,2,4,8,0.282772,0.29232,0,No
2,2,4,2,2,4,2,2,4,7,0.299493,0.30636,0,No
2,2,4,2,2,4,2,2,4,8,0.320643,0.327758,0,No
1,1,1,1,1,2,1,1,2,8,0.295402,0.302692,0,No
1,1,1,1,1,2,1,1,2,8,0.296171,0.303818,0,No
3,3,9,1,1,2,3,3,6,9,0.264379,0.270521,0,No
1,1,1,1,1,2,1,1,2,8,0.270811,0.277278,0,No
1,1,1,1,1,2,1,1,2,8,0.303655,0.312962,0,No
4,4,16,2,2,4,4,4,8,8,0.292285,0.299353,0,No
3,3,9,1,1,2,3,3,6,7,0.327819,0.338512,0,No
2,2,4,2,1,3,2,2,4,8,0.298471,0.305386,0,No
1,1,1,1,1,2,1,1,2,8,0.339934,0.352194,0,No
2,2,4,1,1,2,2,2,4,8,0.303661,0.312967,0,No
1,1,1,1,1,2,1,1,2,8,0.247193,0.251569,0,No
1,1,1,1,1,2,1,1,2,8,0.314583,0.32146,0,No
1,1,1,1,1,2,1,1,2,8,0.317439,0.327445,0,No
4,4,16,3,4,7,4,4,8,7,0.341294,0.353413,0,No
2,2,4,1,1,2,2,2,4,8,0.301589,0.314491,0,No
2,2,4,2,2,4,2,2,4,8,0.305904,0.313294,0,No
1,1,1,1,1,2,1,1,2,8,0.32342,0.334424,0,No
1,1,1,1,1,2,1,1,2,9,0.269468,0.276174,0,No
5,5,25,3,3,6,5,5,10,8,0.329943,0.341716,0,No
1,1,1,1,1,2,1,1,2,8,0.299835,0.307302,0,No
1,1,1,1,1,2,1,1,2,8,0.290622,0.298005,0,No
5,4,20,4,2,6,5,5,10,8,0.311255,0.319813,0,No
7,7,49,3,4,7,7,7,14,8,0.345049,0.358115,0,No
1,1,1,1,1,2,1,1,2,9,0.260567,0.266141,0,No
1,1,1,1,1,2,1,1,2,8,0.323426,0.334429,0,No
1,1,1,1,1,2,1,1,2,8,0.277096,0.285605,0,No
3,3,9,2,2,4,3,3,6,8,0.272385,0.280945,0,No
1,1,1,1,1,2,1,1,2,8,0.309331,0.317947,0,No
1,1,1,1,1,2,1,1,2,8,0.309325,0.317943,0,No
1,1,1,1,1,2,1,1,2,8,0.278812,0.285798,0,No
4,4,16,2,3,5,4,4,8,7,0.319867,0.327136,0,No
1,1,1,1,1,2,1,1,2,8,0.265857,0.272089,0,No
3,3,9,3,3,6,3,3,6,8,0.317138,0.325241,0,No
1,1,1,1,1,2,1,1,2,9,0.227658,0.231869,0,No
1,1,1,1,1,2,1,1,2,7,0.327819,0.338512,0,No
1,1,1,1,1,2,1,1,2,7,0.327819,0.338512,0,No
1,1,1,1,1,2,1,1,2,9,0.268721,0.277328,0,No
2,2,4,1,1,2,2,2,4,9,0.268641,0.276936,0,No
1,1,1,1,1,2,1,1,2,8,0.280572,0.287568,0,No
6,6,36,5,5,10,6,6,12,8,0.338625,0.350233,0,No
1,1,1,1,1,2,1,1,2,8,0.339934,0.352194,0,No
2,1,2,2,2,4,2,2,4,7,0.327819,0.338512,0,No
1,1,1,1,1,2,1,1,2,8,0.27122,0.279026,0,No
2,2,4,1,1,2,2,2,4,8,0.32342,0.334424,0,No
1,1,1,1,1,2,1,1,2,9,0.259889,0.265422,0,No
1,1,1,1,1,2,1,1,2,8,0.288163,0.299063,0,No
2,2,4,1,1,2,2,2,4,8,0.28349,0.292904,0,No
1,1,1,1,1,2,1,1,2,8,0.301589,0.314491,0,No
3,3,9,1,1,2,3,3,6,8,0.295678,0.302736,0,No
1,1,1,1,1,2,1,1,2,8,0.314589,0.321465,0,No
2,2,4,1,2,3,2,2,4,8,0.309107,0.31589,0,No
1,1,1,1,1,2,1,1,2,8,0.309983,0.317112,0,No
1,1,1,1,1,2,1,1,2,8,0.301589,0.314491,0,No
1,1,1,1,1,2,1,1,2,9,0.268721,0.277328,0,No
2,2,4,1,1,2,2,2,4,8,0.32342,0.334424,0,No
1,1,1,1,1,2,1,1,2,8,0.2876,0.295187,0,No
2,2,4,2,2,4,2,2,4,8,0.273494,0.281636,0,No
1,1,1,1,1,2,1,1,2,8,0.278216,0.285471,0,No
3,3,9,2,2,4,3,3,6,8,0.308754,0.316717,0,No
5,5,25,2,3,5,5,5,10,8,0.329472,0.340707,0,No
1,1,1,1,1,2,1,1,2,8,0.310717,0.317502,0,No
2,2,4,2,2,4,2,2,4,8,0.323549,0.334639,0,No
1,1,1,1,1,2,1,1,2,8,0.301589,0.314491,0,No
2,1,2,2,2,4,2,2,4,8,0.340341,0.352708,0,No
2,2,4,1,1,2,2,2,4,8,0.310033,0.318684,0,No
1,1,1,1,1,2,1,1,2,8,0.293138,0.300755,0,No
1,1,1,1,1,2,1,1,2,8,0.292345,0.299887,0,No
1,1,1,1,1,2,1,1,2,8,0.301589,0.314491,0,No
1,1,1,1,1,2,1,1,2,8,0.29229,0.30057,0,No
1,1,1,1,1,2,1,1,2,8,0.288168,0.299068,0,No
3,3,9,2,2,4,3,3,6,7,0.32944,0.340164,0,No
1,1,1,1,1,2,1,1,2,9,0.280683,0.28796,0,No
1,1,1,1,1,2,1,1,2,8,0.339934,0.352194,0,No
1,1,1,1,1,2,1,1,2,8,0.278743,0.288253,0,No
3,3,9,1,2,3,3,3,6,8,0.34126,0.353609,0,No
2,2,4,2,2,4,2,2,4,7,0.303931,0.31217,0,No
1,1,1,1,1,2,1,1,2,8,0.295637,0.302489,0,No
2,2,4,2,2,4,2,2,4,8,0.2687,0.27596,0,No
1,1,1,1,1,2,1,1,2,8,0.27122,0.279026,0,No
5,5,25,2,3,5,5,5,10,8,0.333849,0.345869,0,No
2,2,4,1,1,2,2,2,4,8,0.282795,0.289819,0,No
1,1,1,1,1,2,1,1,2,9,0.268717,0.277323,0,No
2,2,4,1,1,2,2,2,4,8,0.303666,0.31297,0,No
2,2,4,2,2,4,2,2,4,8,0.327675,0.33951,0,No
1,1,1,1,1,2,1,1,2,8,0.264457,0.270739,0,No
1,1,1,1,1,2,1,1,2,8,0.301584,0.314486,0,No
2,2,4,1,1,2,2,2,4,8,0.278743,0.288253,0,No
3,3,9,1,2,3,3,3,6,8,0.312338,0.321488,0,No
2,2,4,1,2,3,2,2,4,8,0.320637,0.330847,0,No
15,14,210,1,7,8,15,15,30,7,0.347933,0.361516,0,No
1,1,1,1,1,2,1,1,2,9,0.242641,0.24633,0,No
4,3,12,1,1,2,4,4,8,8,0.278743,0.288253,0,No
1,1,1,1,1,2,1,1,2,8,0.339934,0.352194,0,No
1,1,1,1,1,2,1,1,2,8,0.339941,0.352199,0,No
1,1,1,1,1,2,1,1,2,8,0.292285,0.300565,0,No
2,2,4,2,2,4,2,2,4,8,0.292295,0.300604,0,No
2,2,4,2,2,4,2,2,4,8,0.327675,0.33951,0,No
2,2,4,2,2,4,2,2,4,8,0.309477,0.318116,0,No
6,6,36,5,4,9,6,6,12,8,0.317699,0.325702,0,No
1,1,1,1,1,2,1,1,2,8,0.288163,0.299063,0,No
4,4,16,2,2,4,4,4,8,8,0.29596,0.308371,0,No
1,1,1,1,1,2,1,1,2,8,0.288163,0.299063,0,No
2,2,4,2,2,4,2,2,4,8,0.307453,0.319722,0,No
1,1,1,1,1,2,1,1,2,8,0.339934,0.352194,0,No
3,2,6,2,2,4,3,3,6,7,0.311989,0.320454,0,No
2,2,4,2,2,4,2,2,4,8,0.311955,0.320274,0,No
2,2,4,1,1,2,2,2,4,9,0.303801,0.312033,0,No
1,1,1,1,1,2,1,1,2,8,0.289223,0.296402,0,No
4,4,16,3,3,6,4,4,8,8,0.34404,0.357143,0,No
2,2,4,1,1,2,2,2,4,9,0.262241,0.268868,0,No
3,3,9,2,2,4,3,3,6,8,0.30267,0.309333,0,No
3,3,9,1,2,3,3,3,6,8,0.307392,0.314984,0,No
1,1,1,1,1,2,1,1,2,8,0.281712,0.288655,0,No
1,1,1,1,1,2,1,1,2,7,0.327819,0.338512,0,No
2,2,4,2,2,4,2,2,4,8,0.315001,0.324771,0,No
1,1,1,1,1,2,1,1,2,8,0.297721,0.304393,0,No
1,1,1,1,1,2,1,1,2,8,0.280471,0.287424,0,No
1,1,1,1,1,2,1,1,2,8,0.323426,0.334429,0,No
2,2,4,1,1,2,2,2,4,8,0.331571,0.343073,0,No
1,1,1,1,1,2,1,1,2,8,0.294591,0.301827,0,No
1,1,1,1,1,2,1,1,2,8,0.289248,0.299277,0,No
1,1,1,1,1,2,1,1,2,8,0.331578,0.343078,0,No
2,2,4,1,1,2,2,2,4,8,0.288168,0.299068,0,No
1,1,1,1,1,2,1,1,2,8,0.288168,0.299068,0,No
1,1,1,1,1,2,1,1,2,7,0.327819,0.338512,0,No
1,1,1,1,1,2,1,1,2,8,0.317298,0.324393,0,No
1,1,1,1,1,2,1,1,2,9,0.255737,0.261999,0,No
1,1,1,1,1,2,1,1,2,8,0.339934,0.352194,0,No
1,1,1,1,1,2,1,1,2,9,0.25463,0.259566,0,No
1,1,1,1,1,2,1,1,2,8,0.309325,0.317943,0,No
1,1,1,1,1,2,1,1,2,9,0.266115,0.272326,0,No
1,1,1,1,1,2,1,1,2,8,0.309977,0.317107,0,No
1,1,1,1,1,2,1,1,2,8,0.315759,0.323487,0,No
5,5,25,2,2,4,5,5,10,8,0.338243,0.351497,0,No
5,5,25,1,2,3,5,5,10,8,0.289498,0.300189,0,No
1,1,1,1,1,2,1,1,2,8,0.28214,0.289603,0,No
1,1,1,1,1,2,1,1,2,9,0.253793,0.258648,0,No
1,1,1,1,1,2,1,1,2,8,0.32342,0.334424,0,No
1,1,1,1,1,2,1,1,2,8,0.292887,0.299995,0,No
2,2,4,2,2,4,2,2,4,7,0.326846,0.336921,0,No
27,27,729,7,4,11,27,27,54,7,0.335476,0.346582,0,No
3,3,9,3,2,5,3,3,6,7,0.339306,0.352082,0,No
7,7,49,5,4,9,7,7,14,8,0.347862,0.361692,0,No
1,1,1,1,1,2,1,1,2,9,0.303801,0.312033,0,No
1,1,1,1,1,2,1,1,2,9,0.250842,0.255927,0,No
1,1,1,1,1,2,1,1,2,8,0.274775,0.281585,0,No
1,1,1,1,1,2,1,1,2,9,0.268726,0.277331,0,No
2,2,4,2,2,4,2,2,4,8,0.327675,0.33951,0,No
3,3,9,1,1,2,3,3,6,9,0.268721,0.277328,0,No
1,1,1,1,1,2,1,1,2,8,0.32342,0.334424,0,No
2,2,4,2,2,4,2,2,4,8,0.327675,0.33951,0,No
1,1,1,1,1,2,1,1,2,8,0.32342,0.334424,0,No
1,1,1,1,1,2,1,1,2,7,0.327819,0.338512,0,No
1,1,1,1,1,2,1,1,2,8,0.310028,0.318679,0,No
1,1,1,1,1,2,1,1,2,8,0.301584,0.314486,0,No
1,1,1,1,1,2,1,1,2,7,0.327819,0.338512,0,No
2,2,4,1,1,2,2,2,4,8,0.32342,0.334424,0,No
1,1,1,1,1,2,1,1,2,8,0.296171,0.303818,0,No
1,1,1,1,1,2,1,1,2,7,0.296305,0.304855,0,No
15,15,225,3,8,11,15,15,30,7,0.358625,0.373686,0,No
1,1,1,1,1,2,1,1,2,8,0.287605,0.295192,0,No
1,1,1,1,1,2,1,1,2,8,0.2828,0.289824,0,No
1,1,1,1,1,2,1,1,2,8,0.303375,0.311466,0,No
1,1,1,1,1,2,1,1,2,9,0.268717,0.277323,0,No
1,1,1,1,1,2,1,1,2,8,0.301589,0.314491,0,No
2,2,4,1,1,2,2,2,4,8,0.280231,0.287508,0,No
1,1,1,1,1,2,1,1,2,8,0.301589,0.314491,0,No
3,3,9,3,3,6,3,3,6,7,0.333288,0.344842,0,No
1,1,1,1,1,2,1,1,2,8,0.30338,0.311471,0,No
5,5,25,2,4,6,5,5,10,8,0.309701,0.317715,0,No
1,1,1,1,1,2,1,1,2,8,0.301589,0.314491,0,No
1,1,1,1,1,2,1,1,2,9,0.278702,0.285801,0,No
1,1,1,1,1,2,1,1,2,8,0.301584,0.314486,0,No
3,3,9,2,2,4,3,3,6,8,0.315083,0.329711,0,No
1,1,1,1,1,2,1,1,2,8,0.301584,0.314486,0,No
1,1,1,1,1,2,1,1,2,9,0.243208,0.24642,0,No
1,1,1,1,1,2,1,1,2,8,0.310717,0.317502,0,No
1,1,1,1,1,2,1,1,2,8,0.307819,0.314416,0,No
2,2,4,2,2,4,2,2,4,8,0.314375,0.325572,0,No
7,7,49,3,5,8,7,7,14,8,0.342527,0.356506,0,No
2,2,4,1,1,2,2,2,4,8,0.303655,0.312962,0,No
1,1,1,1,1,2,1,1,2,8,0.301589,0.314491,0,No
1,1,1,1,1,2,1,1,2,9,0.270588,0.277371,0,No
2,2,4,2,1,3,2,2,4,8,0.30338,0.311471,0,No
3,3,9,2,3,5,3,3,6,8,0.340151,0.353548,0,No
3,3,9,2,2,4,3,3,6,8,0.334326,0.344905,0,No
1,1,1,1,1,2,1,1,2,8,0.32342,0.334424,0,No
1,1,1,1,1,2,1,1,2,7,0.312589,0.319278,0,No
8,8,64,3,4,7,8,8,16,8,0.35292,0.368987,0,No
1,1,1,1,1,2,1,1,2,8,0.32342,0.334424,0,No
1,1,1,1,1,2,1,1,2,8,0.313497,0.320213,0,No
8,8,64,1,4,5,8,8,16,8,0.339948,0.354341,0,No
4,4,16,4,4,8,4,4,8,8,0.348587,0.36272,0,No
1,1,1,1,1,2,1,1,2,8,0.27455,0.283664,0,No
1,1,1,1,1,2,1,1,2,8,0.295678,0.302736,0,No
2,2,4,2,1,3,2,2,4,8,0.288168,0.299068,0,No
1,1,1,1,1,2,1,1,2,8,0.32342,0.334424,0,No
1,1,1,1,1,2,1,1,2,8,0.301589,0.314491,0,No
2,2,4,2,2,4,2,2,4,8,0.34361,0.356903,0,No
1,1,1,1,1,2,1,1,2,8,0.313502,0.320218,0,No
3,3,9,3,3,6,3,3,6,8,0.315048,0.329449,0,No
1,1,1,1,1,2,1,1,2,9,0.268641,0.276936,0,No
4,4,16,3,3,6,4,4,8,8,0.344047,0.357469,0,No
1,1,1,1,1,2,1,1,2,8,0.282795,0.289819,0,No
1,1,1,1,1,2,1,1,2,7,0.327819,0.338512,0,No
1,1,1,1,1,2,1,1,2,8,0.281619,0.289092,0,No
3,3,9,1,3,4,3,3,6,8,0.301339,0.311294,0,No
5,5,25,4,2,6,5,5,10,8,0.334097,0.345984,0,No
1,1,1,1,1,2,1,1,2,8,0.331571,0.343073,0,No
1,1,1,1,1,2,1,1,2,9,0.284336,0.292278,0,No
3,3,9,2,3,5,3,3,6,8,0.312115,0.320922,0,No
1,1,1,1,1,2,1,1,2,8,0.281712,0.288655,0,No
4,4,16,2,2,4,4,4,8,7,0.331597,0.34297,0,No
1,1,1,1,1,2,1,1,2,8,0.339934,0.352194,0,No
1,1,1,1,1,2,1,1,2,8,0.310033,0.318684,0,No
1,1,1,1,1,2,1,1,2,9,0.284336,0.292278,0,No
1,1,1,1,1,2,1,1,2,8,0.259715,0.265244,0,No
1,1,1,1,1,2,1,1,2,9,0.244305,0.248584,0,No
1,1,1,1,1,2,1,1,2,8,0.317292,0.324388,0,No
3,2,6,2,2,4,3,3,6,7,0.326846,0.336921,0,No
1,1,1,1,1,2,1,1,2,8,0.291705,0.29867,0,No
2,2,4,1,1,2,2,2,4,8,0.313497,0.320213,0,No
8,8,64,2,3,5,8,8,16,7,0.341752,0.355124,0,No
1,1,1,1,1,2,1,1,2,8,0.303358,0.310126,0,No
1,1,1,1,1,2,1,1,2,8,0.339927,0.352185,0,No
1,1,1,1,1,2,1,1,2,7,0.312589,0.319278,0,No
1,1,1,1,1,2,1,1,2,8,0.288163,0.299063,0,No
4,4,16,2,3,5,4,4,8,8,0.32089,0.32806,0,No
3,3,9,2,1,3,3,3,6,9,0.268717,0.277323,0,No
1,1,1,1,1,2,1,1,2,9,0.268641,0.276936,0,No
1,1,1,1,1,2,1,1,2,8,0.291905,0.299149,0,No
1,1,1,1,1,2,1,1,2,8,0.32342,0.334424,0,No
1,1,1,1,1,2,1,1,2,8,0.32342,0.334424,0,No
2,2,4,1,1,2,2,2,4,8,0.276857,0.283757,0,No
2,2,4,1,2,3,2,2,4,7,0.313745,0.320469,0,No
1,1,1,1,1,2,1,1,2,8,0.29595,0.30471,0,No
1,1,1,1,1,2,1,1,2,8,0.295945,0.304705,0,No
1,1,1,1,1,2,1,1,2,8,0.246312,0.251061,0,No
1,1,1,1,1,2,1,1,2,8,0.270309,0.276579,0,No
1,1,1,1,1,2,1,1,2,8,0.292857,0.300028,0,No
2,2,4,2,2,4,2,2,4,8,0.285301,0.294783,0,No
1,1,1,1,1,2,1,1,2,8,0.308325,0.314705,0,No
1,1,1,1,1,2,1,1,2,8,0.286532,0.293667,0,No
4,4,16,2,2,4,4,4,8,8,0.342342,0.354886,0,No
1,1,1,1,1,2,1,1,2,8,0.301589,0.314491,0,No
1,1,1,1,1,2,1,1,2,8,0.32342,0.334424,0,No
1,1,1,1,1,2,1,1,2,8,0.252781,0.25735,0,No
1,1,1,1,1,2,1,1,2,8,0.284199,0.291467,0,No
2,2,4,2,2,4,2,2,4,8,0.341485,0.35377,0,No
1,1,1,1,1,2,1,1,2,8,0.256903,0.262046,0,No
3,3,9,2,3,5,3,3,6,8,0.342074,0.354965,0,No
1,1,1,1,1,2,1,1,2,8,0.302198,0.308977,0,No
1,1,1,1,1,2,1,1,2,8,0.294469,0.301552,0,No
1,1,1,1,1,2,1,1,2,8,0.26165,0.26719,0,No
1,1,1,1,1,2,1,1,2,8,0.331571,0.343073,0,No
1,1,1,1,1,2,1,1,2,8,0.339934,0.352194,0,No
1,1,1,1,1,2,1,1,2,9,0.255733,0.261996,0,No
1,1,1,1,1,2,1,1,2,8,0.301589,0.314491,0,No
1,1,1,1,1,2,1,1,2,8,0.314583,0.32146,0,No
1,1,1,1,1,2,1,1,2,8,0.27455,0.283664,0,No
2,2,4,1,2,3,2,2,4,8,0.298513,0.305329,0,No
2,2,4,2,2,4,2,2,4,8,0.318947,0.326124,0,No
2,2,4,1,1,2,2,2,4,8,0.310033,0.318684,0,No
1,1,1,1,1,2,1,1,2,8,0.301589,0.314491,0,No
2,2,4,1,2,3,2,2,4,8,0.323432,0.334464,0,No
7,7,49,4,5,9,7,7,14,7,0.349946,0.36358,0,No
1,1,1,1,1,2,1,1,2,8,0.299367,0.306897,0,No
3,3,9,3,3,6,3,3,6,8,0.345209,0.359841,0,No
1,1,1,1,1,2,1,1,2,8,0.331571,0.343073,0,No
6,6,36,5,3,8,6,6,12,8,0.328154,0.339407,0,No
2,2,4,2,2,4,2,2,4,8,0.324997,0.33581,0,No
3,3,9,3,3,6,3,3,6,8,0.332508,0.344273,0,No
1,1,1,1,1,2,1,1,2,8,0.300569,0.30749,0,No
1,1,1,1,1,2,1,1,2,9,0.259822,0.265922,0,No
2,2,4,1,1,2,2,2,4,8,0.287609,0.295194,0,No
2,2,4,2,2,4,2,2,4,8,0.29933,0.306296,0,No
1,1,1,1,1,2,1,1,2,8,0.331571,0.343073,0,No
5,5,25,3,4,7,5,5,10,8,0.320564,0.328896,0,No
1,1,1,1,1,2,1,1,2,8,0.331571,0.343073,0,No
1,1,1,1,1,2,1,1,2,8,0.27455,0.283664,0,No
1,1,1,1,1,2,1,1,2,8,0.277096,0.285605,0,No
1,1,1,1,1,2,1,1,2,7,0.327819,0.338512,0,No
1,1,1,1,1,2,1,1,2,8,0.303585,0.310469,0,No
1,1,1,1,1,2,1,1,2,8,0.310028,0.318679,0,No
1,1,1,1,1,2,1,1,2,8,0.27455,0.283664,0,No
2,2,4,2,2,4,2,2,4,8,0.299199,0.311964,0,No
1,1,1,1,1,2,1,1,2,9,0.260659,0.266396,0,No
1,1,1,1,1,2,1,1,2,9,0.268721,0.277328,0,No
3,3,9,1,3,4,3,3,6,8,0.323481,0.333084,0,No
3,3,9,1,2,3,3,3,6,8,0.288037,0.299923,0,No
3,3,9,3,3,6,3,3,6,8,0.313491,0.322297,0,No
1,1,1,1,1,2,1,1,2,8,0.292405,0.299561,0,No
1,1,1,1,1,2,1,1,2,8,0.309331,0.317947,0,No
1,1,1,1,1,2,1,1,2,9,0.266764,0.273228,0,No
1,1,1,1,1,2,1,1,2,9,0.259742,0.266039,0,No
1,1,1,1,1,2,1,1,2,8,0.304631,0.311247,0,No
1,1,1,1,1,2,1,1,2,8,0.339934,0.352194,0,No
1,1,1,1,1,2,1,1,2,8,0.310722,0.317507,0,No
1,1,1,1,1,2,1,1,2,8,0.306448,0.313104,0,No
2,2,4,2,2,4,2,2,4,8,0.308108,0.315609,0,No
1,1,1,1,1,2,1,1,2,8,0.277389,0.284283,0,No
2,2,4,1,1,2,2,2,4,8,0.278748,0.288256,0,No
1,1,1,1,1,2,1,1,2,8,0.259569,0.265135,0,No
3,3,9,2,3,5,3,3,6,8,0.318019,0.332354,0,No
2,2,4,2,2,4,2,2,4,8,0.312052,0.319863,0,No
1,1,1,1,1,2,1,1,2,9,0.268726,0.277331,0,No
1,1,1,1,1,2,1,1,2,8,0.284308,0.291246,0,No
1,1,1,1,1,2,1,1,2,8,0.317445,0.327454,0,No
3,3,9,3,3,6,3,3,6,8,0.312001,0.323798,0,No
1,1,1,1,1,2,1,1,2,8,0.32342,0.334424,0,No
1,1,1,1,1,2,1,1,2,8,0.323426,0.334429,0,No
1,1,1,1,1,2,1,1,2,8,0.288934,0.297717,0,No
2,2,4,2,2,4,2,2,4,8,0.289306,0.297629,0,No
2,2,4,2,2,4,2,2,4,7,0.331224,0.342603,0,No
2,2,4,2,2,4,2,2,4,8,0.324985,0.335768,0,No
1,1,1,1,1,2,1,1,2,8,0.331571,0.343073,0,No
1,1,1,1,1,2,1,1,2,8,0.32342,0.334424,0,No
1,1,1,1,1,2,1,1,2,8,0.331571,0.343073,0,No
5,5,25,4,4,8,5,5,10,8,0.338209,0.349182,0,No
3,3,9,1,2,3,3,3,6,8,0.310784,0.320993,0,No
4,4,16,2,3,5,4,4,8,8,0.312023,0.321963,0,No
1,1,1,1,1,2,1,1,2,8,0.301584,0.314486,0,No
1,1,1,1,1,2,1,1,2,8,0.32342,0.334424,0,No
3,3,9,2,3,5,3,3,6,7,0.346105,0.36018,0,No
1,1,1,1,1,2,1,1,2,8,0.268219,0.275191,0,No
1,1,1,1,1,2,1,1,2,8,0.278743,0.288253,0,No
1,1,1,1,1,2,1,1,2,8,0.331578,0.343078,0,No
2,2,4,2,1,3,2,2,4,8,0.288163,0.299063,0,No
1,1,1,1,1,2,1,1,2,9,0.268721,0.277328,0,No
2,2,4,1,1,2,2,2,4,8,0.301584,0.314486,0,No
1,1,1,1,1,2,1,1,2,8,0.288168,0.299068,0,No
1,1,1,1,1,2,1,1,2,9,0.262237,0.268863,0,No
4,4,16,3,3,6,4,4,8,8,0.320944,0.331904,0,No
4,4,16,2,1,3,4,4,8,8,0.32342,0.334424,0,No
1,1,1,1,1,2,1,1,2,8,0.32342,0.334424,0,No
4,4,16,4,3,7,4,4,8,8,0.35257,0.367637,0,No
1,1,1,1,1,2,1,1,2,8,0.32342,0.334424,0,No
1,1,1,1,1,2,1,1,2,8,0.30338,0.311471,0,No
1,1,1,1,1,2,1,1,2,8,0.310033,0.318684,0,No
1,1,1,1,1,2,1,1,2,8,0.301584,0.314486,0,No
1,1,1,1,1,2,1,1,2,8,0.278748,0.288256,0,No
2,2,4,2,2,4,2,2,4,8,0.317711,0.328607,0,No
1,1,1,1,1,2,1,1,2,9,0.2716,0.278869,0,No
1,1,1,1,1,2,1,1,2,9,0.260381,0.265905,0,No
5,5,25,2,2,4,5,5,10,8,0.300813,0.309748,0,No
2,2,4,2,2,4,2,2,4,8,0.342342,0.354886,0,No
1,1,1,1,1,2,1,1,2,8,0.339934,0.352194,0,No
1,1,1,1,1,2,1,1,2,8,0.274545,0.283659,0,No
2,2,4,2,2,4,2,2,4,8,0.30153,0.310915,0,No
3,3,9,2,2,4,3,3,6,8,0.338243,0.351497,0,No
2,2,4,2,2,4,2,2,4,8,0.324478,0.335324,0,No
1,1,1,1,1,2,1,1,2,8,0.289936,0.297457,0,No
1,1,1,1,1,2,1,1,2,8,0.288168,0.299068,0,No
3,3,9,2,2,4,3,3,6,8,0.309904,0.317286,0,No
1,1,1,1,1,2,1,1,2,8,0.323426,0.334429,0,No
1,1,1,1,1,2,1,1,2,8,0.301584,0.314486,0,No
3,3,9,1,1,2,3,3,6,9,0.24785,0.251769,0,No
1,1,1,1,1,2,1,1,2,8,0.303655,0.312962,0,No
1,1,1,1,1,2,1,1,2,8,0.339927,0.352185,0,No
4,4,16,1,3,4,4,4,8,7,0.353023,0.367439,0,No
1,1,1,1,1,2,1,1,2,7,0.327819,0.338512,0,No
1,1,1,1,1,2,1,1,2,9,0.268721,0.277328,0,No
2,2,4,1,1,2,2,2,4,9,0.272424,0.279226,0,No
2,2,4,1,1,2,2,2,4,8,0.317298,0.324393,0,No
2,1,2,2,1,3,2,2,4,9,0.268721,0.277328,0,No
1,1,1,1,1,2,1,1,2,9,0.268721,0.277328,0,No
2,2,4,1,1,2,2,2,4,7,0.327819,0.338512,0,No
1,1,1,1,1,2,1,1,2,8,0.32342,0.334424,0,No
3,3,9,3,3,6,3,3,6,8,0.343957,0.357188,0,No
1,1,1,1,1,2,1,1,2,8,0.331578,0.343078,0,No
1,1,1,1,1,2,1,1,2,8,0.301589,0.314491,0,No
2,2,4,2,2,4,2,2,4,8,0.312183,0.319461,0,No
2,2,4,2,2,4,2,2,4,8,0.317457,0.327493,0,No
7,7,49,3,4,7,7,7,14,8,0.328255,0.336877,0,No
2,2,4,2,2,4,2,2,4,8,0.340769,0.353218,0,No
6,6,36,1,6,7,6,6,12,8,0.343389,0.356639,0,No
1,1,1,1,1,2,1,1,2,9,0.253714,0.258585,0,No
1,1,1,1,1,2,1,1,2,8,0.32342,0.334424,0,No
1,1,1,1,1,2,1,1,2,8,0.26504,0.270989,0,No
4,4,16,2,2,4,4,4,8,8,0.323881,0.335064,0,No
1,1,1,1,1,2,1,1,2,9,0.254417,0.260027,0,No
7,7,49,5,3,8,7,7,14,8,0.328292,0.339828,0,No
1,1,1,1,1,2,1,1,2,8,0.32342,0.334424,0,No
1,1,1,1,1,2,1,1,2,8,0.32342,0.334424,0,No
1,1,1,1,1,2,1,1,2,9,0.242745,0.245859,0,No
1,1,1,1,1,2,1,1,2,8,0.32342,0.334424,0,No
4,4,16,4,2,6,4,4,8,8,0.282392,0.291569,0,No
1,1,1,1,1,2,1,1,2,8,0.30833,0.31471,0,No
1,1,1,1,1,2,1,1,2,8,0.271216,0.279021,0,No
2,2,4,1,1,2,2,2,4,8,0.288934,0.297717,0,No
1,1,1,1,1,2,1,1,2,9,0.249503,0.253822,0,No
1,1,1,1,1,2,1,1,2,8,0.289699,0.29706,0,No
3,3,9,2,2,4,3,3,6,8,0.340776,0.35304,0,No
2,2,4,1,1,2,2,2,4,8,0.27122,0.279026,0,No
1,1,1,1,1,2,1,1,2,8,0.27455,0.283664,0,No
2,2,4,1,1,2,2,2,4,9,0.268721,0.277328,0,No
1,1,1,1,1,2,1,1,2,8,0.271899,0.280395,0,No
1,1,1,1,1,2,1,1,2,8,0.274334,0.282192,0,No
2,2,4,2,2,4,2,2,4,8,0.341205,0.353536,0,No
1,1,1,1,1,2,1,1,2,8,0.28036,0.287381,0,No
1,1,1,1,1,2,1,1,2,8,0.317451,0.327459,0,No
2,2,4,2,2,4,2,2,4,8,0.315543,0.324894,0,No
1,1,1,1,1,2,1,1,2,8,0.339934,0.352194,0,No
1,1,1,1,1,2,1,1,2,8,0.339934,0.352194,0,No
1,1,1,1,1,2,1,1,2,8,0.339934,0.352194,0,No
2,2,4,1,1,2,2,2,4,8,0.269426,0.275746,0,No
2,2,4,1,2,3,2,2,4,7,0.332379,0.343252,0,No
1,1,1,1,1,2,1,1,2,8,0.292962,0.300182,0,No
2,2,4,1,1,2,2,2,4,7,0.327819,0.338512,0,No
1,1,1,1,1,2,1,1,2,8,0.313848,0.32086,0,No
3,3,9,1,3,4,3,3,6,8,0.30184,0.309131,0,No
2,2,4,1,1,2,2,2,4,7,0.327819,0.338512,0,No
1,1,1,1,1,2,1,1,2,7,0.327819,0.338512,0,No
1,1,1,1,1,2,1,1,2,7,0.327819,0.338512,0,No
4,4,16,3,2,5,4,4,8,7,0.331224,0.342603,0,No
4,4,16,1,1,2,4,4,8,7,0.327819,0.338512,0,No
3,3,9,2,3,5,3,3,6,7,0.331127,0.342393,0,No
1,1,1,1,1,2,1,1,2,9,0.265262,0.2712,0,No
1,1,1,1,1,2,1,1,2,7,0.327819,0.338512,0,No
1,1,1,1,1,2,1,1,2,7,0.296305,0.304855,0,No
1,1,1,1,1,2,1,1,2,8,0.297099,0.303912,0,No
2,2,4,2,2,4,2,2,4,8,0.26986,0.276421,0,No
2,1,2,1,2,3,2,2,4,8,0.324299,0.332863,0,No
1,1,1,1,1,2,1,1,2,8,0.295591,0.303239,0,No
1,1,1,1,1,2,1,1,2,8,0.323426,0.334429,0,No
1,1,1,1,1,2,1,1,2,8,0.339934,0.352194,0,No
2,2,4,1,1,2,2,2,4,9,0.265304,0.271478,0,No
1,1,1,1,1,2,1,1,2,8,0.313502,0.320218,0,No
3,3,9,1,1,2,3,3,6,7,0.327819,0.338512,0,No
1,1,1,1,1,2,1,1,2,8,0.288163,0.299063,0,No
2,2,4,1,1,2,2,2,4,8,0.309325,0.317943,0,No
1,1,1,1,1,2,1,1,2,8,0.303655,0.312962,0,No
2,2,4,1,1,2,2,2,4,8,0.277096,0.285605,0,No
1,1,1,1,1,2,1,1,2,8,0.32342,0.334424,0,No
4,4,16,2,2,4,4,4,8,7,0.331243,0.342587,0,No
2,2,4,2,2,4,2,2,4,7,0.330723,0.342041,0,No
1,1,1,1,1,2,1,1,2,8,0.296438,0.303643,0,No
1,1,1,1,1,2,1,1,2,8,0.30338,0.311471,0,No
1,1,1,1,1,2,1,1,2,8,0.27122,0.279026,0,No
1,1,1,1,1,2,1,1,2,7,0.327826,0.338517,0,No
1,1,1,1,1,2,1,1,2,8,0.310033,0.318684,0,No
1,1,1,1,1,2,1,1,2,8,0.313497,0.320213,0,No
1,1,1,1,1,2,1,1,2,8,0.303661,0.312967,0,No
2,2,4,2,2,4,2,2,4,7,0.328533,0.339251,0,No
2,2,4,1,1,2,2,2,4,8,0.288061,0.295135,0,No
2,2,4,2,2,4,2,2,4,8,0.30077,0.307605,0,No
2,2,4,2,2,4,2,2,4,8,0.293547,0.302389,0,No
1,1,1,1,1,2,1,1,2,9,0.260611,0.266583,0,No
1,1,1,1,1,2,1,1,2,8,0.286528,0.293662,0,No
1,1,1,1,1,2,1,1,2,8,0.289257,0.299292,0,No
1,1,1,1,1,2,1,1,2,8,0.278739,0.288248,0,No
1,1,1,1,1,2,1,1,2,8,0.309325,0.317943,0,No
2,2,4,2,2,4,2,2,4,8,0.314688,0.323796,0,No
1,1,1,1,1,2,1,1,2,8,0.278743,0.288253,0,No
1,1,1,1,1,2,1,1,2,8,0.288163,0.299063,0,No
1,1,1,1,1,2,1,1,2,8,0.287605,0.295192,0,No
2,2,4,1,1,2,2,2,4,8,0.339934,0.352194,0,No
1,1,1,1,1,2,1,1,2,8,0.276284,0.283503,0,No
1,1,1,1,1,2,1,1,2,8,0.258848,0.264107,0,No
1,1,1,1,1,2,1,1,2,9,0.244417,0.249015,0,No
1,1,1,1,1,2,1,1,2,8,0.309325,0.317943,0,No
2,2,4,1,1,2,2,2,4,8,0.315759,0.323487,0,No
1,1,1,1,1,2,1,1,2,8,0.339934,0.352194,0,No
1,1,1,1,1,2,1,1,2,8,0.310028,0.318679,0,No
1,1,1,1,1,2,1,1,2,8,0.306437,0.313195,0,No
1,1,1,1,1,2,1,1,2,8,0.299835,0.307302,0,No
1,1,1,1,1,2,1,1,2,8,0.32342,0.334424,0,No
1,1,1,1,1,2,1,1,2,8,0.29595,0.30471,0,No
4,4,16,3,3,6,4,4,8,7,0.32377,0.331877,0,No
1,1,1,1,1,2,1,1,2,8,0.339934,0.352194,0,No
1,1,1,1,1,2,1,1,2,8,0.339941,0.352199,0,No
2,2,4,2,2,4,2,2,4,8,0.296645,0.303586,0,No
1,1,1,1,1,2,1,1,2,8,0.331578,0.343078,0,No
1,1,1,1,1,2,1,1,2,8,0.271099,0.277488,0,No
4,4,16,4,3,7,4,4,8,8,0.319897,0.329772,0,No
2,2,4,1,2,3,2,2,4,9,0.30569,0.313782,0,No
1,1,1,1,1,2,1,1,2,8,0.299835,0.307302,0,No
2,2,4,2,2,4,2,2,4,8,0.327455,0.338576,0,No
3,3,9,3,3,6,3,3,6,8,0.304822,0.31366,0,No
2,2,4,1,2,3,2,2,4,8,0.340294,0.352652,0,No
1,1,1,1,1,2,1,1,2,8,0.291905,0.299149,0,No
1,1,1,1,1,2,1,1,2,8,0.309331,0.317947,0,No
2,2,4,1,1,2,2,2,4,8,0.271899,0.280395,0,No
4,4,16,3,3,6,4,4,8,8,0.312635,0.322564,0,No
1,1,1,1,1,2,1,1,2,8,0.26636,0.272552,0,No
1,1,1,1,1,2,1,1,2,9,0.271272,0.277859,0,No
3,3,9,3,3,6,3,3,6,8,0.32816,0.338786,0,No
3,3,9,1,2,3,3,3,6,8,0.315258,0.327725,0,No
1,1,1,1,1,2,1,1,2,8,0.303655,0.312962,0,No
4,4,16,3,3,6,4,4,8,8,0.336045,0.347017,0,No
1,1,1,1,1,2,1,1,2,8,0.301584,0.314486,0,No
1,1,1,1,1,2,1,1,2,8,0.273862,0.280729,0,No
5,5,25,1,2,3,5,5,10,8,0.344408,0.357419,0,No
1,1,1,1,1,2,1,1,2,8,0.297706,0.304468,0,No
1,1,1,1,1,2,1,1,2,7,0.296305,0.304855,0,No
1,1,1,1,1,2,1,1,2,8,0.32342,0.334424,0,No
4,4,16,3,3,6,4,4,8,8,0.321591,0.33345,0,No
2,2,4,1,2,3,2,2,4,8,0.327675,0.33951,0,No
2,2,4,2,2,4,2,2,4,8,0.325966,0.336758,0,No
1,1,1,1,1,2,1,1,2,8,0.289936,0.297457,0,No
1,1,1,1,1,2,1,1,2,8,0.339934,0.352194,0,No
2,2,4,2,2,4,2,2,4,8,0.307408,0.316361,0,No
1,1,1,1,1,2,1,1,2,8,0.286995,0.295346,0,No
1,1,1,1,1,2,1,1,2,9,0.268721,0.277328,0,No
1,1,1,1,1,2,1,1,2,8,0.309977,0.317107,0,No
2,2,4,2,1,3,2,2,4,8,0.331571,0.343073,0,No
1,1,1,1,1,2,1,1,2,8,0.27455,0.283664,0,No
2,2,4,2,2,4,2,2,4,8,0.340036,0.352318,0,No
2,2,4,2,2,4,2,2,4,9,0.259754,0.265182,0,No
2,2,4,1,1,2,2,2,4,8,0.30946,0.31614,0,No
2,2,4,2,2,4,2,2,4,8,0.346281,0.360278,0,No
1,1,1,1,1,2,1,1,2,8,0.331571,0.343073,0,No
2,2,4,2,2,4,2,2,4,8,0.346281,0.360278,0,No
1,1,1,1,1,2,1,1,2,8,0.278361,0.285482,0,No
2,2,4,2,2,4,2,2,4,8,0.323967,0.335063,0,No
1,1,1,1,1,2,1,1,2,9,0.25212,0.257194,0,No
2,2,4,2,2,4,2,2,4,8,0.299651,0.308832,0,No
1,1,1,1,1,2,1,1,2,8,0.27455,0.283664,0,No
4,4,16,2,2,4,4,4,8,8,0.322607,0.330646,0,No
3,3,9,3,3,6,3,3,6,7,0.330582,0.341565,0,No
1,1,1,1,1,2,1,1,2,8,0.310028,0.318679,0,No
1,1,1,1,1,2,1,1,2,8,0.317298,0.324393,0,No
2,2,4,1,1,2,2,2,4,8,0.296444,0.303647,0,No
1,1,1,1,1,2,1,1,2,8,0.278743,0.288253,0,No
1,1,1,1,1,2,1,1,2,7,0.327826,0.338517,0,No
1,1,1,1,1,2,1,1,2,8,0.301584,0.314486,0,No
1,1,1,1,1,2,1,1,2,8,0.323426,0.334429,0,No
1,1,1,1,1,2,1,1,2,7,0.327819,0.338512,0,No
5,4,20,3,3,6,5,5,10,8,0.311147,0.320413,0,No
2,2,4,2,2,4,2,2,4,8,0.344283,0.357109,0,No
1,1,1,1,1,2,1,1,2,9,0.268721,0.277328,0,No
1,1,1,1,1,2,1,1,2,8,0.309466,0.316145,0,No
2,2,4,2,2,4,2,2,4,8,0.323696,0.334192,0,No
1,1,1,1,1,2,1,1,2,9,0.268641,0.276936,0,No
1,1,1,1,1,2,1,1,2,8,0.287605,0.295192,0,No
1,1,1,1,1,2,1,1,2,9,0.268641,0.276936,0,No
3,3,9,3,3,6,3,3,6,8,0.309398,0.3183,0,No
2,2,4,1,2,3,2,2,4,9,0.277001,0.283882,0,No
1,1,1,1,1,2,1,1,2,8,0.268219,0.275191,0,No
3,3,9,3,2,5,3,3,6,8,0.309775,0.323433,0,No
1,1,1,1,1,2,1,1,2,9,0.235251,0.238502,0,No
2,2,4,1,1,2,2,2,4,8,0.258801,0.263753,0,No
1,1,1,1,1,2,1,1,2,8,0.305116,0.311592,0,No
1,1,1,1,1,2,1,1,2,8,0.299026,0.306063,0,No
1,1,1,1,1,2,1,1,2,8,0.30946,0.31614,0,No
1,1,1,1,1,2,1,1,2,9,0.274087,0.281098,0,No
1,1,1,1,1,2,1,1,2,8,0.339934,0.352194,0,No
2,2,4,1,1,2,2,2,4,8,0.331571,0.343073,0,No
1,1,1,1,1,2,1,1,2,9,0.255971,0.261481,0,No
3,3,9,2,2,4,3,3,6,7,0.32254,0.333404,0,No
1,1,1,1,1,2,1,1,2,9,0.268641,0.276936,0,No
1,1,1,1,1,2,1,1,2,9,0.27242,0.279222,0,No
2,2,4,2,2,4,2,2,4,7,0.296629,0.305205,0,No
2,2,4,2,2,4,2,2,4,8,0.319783,0.327467,0,No
1,1,1,1,1,2,1,1,2,8,0.339934,0.352194,0,No
1,1,1,1,1,2,1,1,2,9,0.303807,0.312038,0,No
2,2,4,1,2,3,2,2,4,8,0.28357,0.290721,0,No
1,1,1,1,1,2,1,1,2,8,0.296171,0.303818,0,No
2,2,4,1,1,2,2,2,4,8,0.339934,0.352194,0,No
1,1,1,1,1,2,1,1,2,8,0.296171,0.303818,0,No
4,4,16,1,2,3,4,4,8,7,0.31611,0.323313,0,No
1,1,1,1,1,2,1,1,2,8,0.292666,0.299788,0,No
1,1,1,1,1,2,1,1,2,7,0.296305,0.304855,0,No
2,2,4,1,2,3,2,2,4,8,0.322607,0.330139,0,No
1,1,1,1,1,2,1,1,2,7,0.2963,0.30485,0,No
2,2,4,2,2,4,2,2,4,8,0.317368,0.325996,0,No
4,3,12,2,2,4,4,4,8,8,0.315083,0.329711,0,No
1,1,1,1,1,2,1,1,2,9,0.303807,0.312038,0,No
1,1,1,1,1,2,1,1,2,8,0.29191,0.299154,0,No
1,1,1,1,1,2,1,1,2,8,0.32342,0.334424,0,No
1,1,1,1,1,2,1,1,2,8,0.32342,0.334424,0,No
1,1,1,1,1,2,1,1,2,8,0.32342,0.334424,0,No
1,1,1,1,1,2,1,1,2,8,0.292405,0.299561,0,No
1,1,1,1,1,2,1,1,2,8,0.310033,0.318684,0,No
2,2,4,2,2,4,2,2,4,7,0.31163,0.320022,0,No
1,1,1,1,1,2,1,1,2,8,0.339934,0.352194,0,No
1,1,1,1,1,2,1,1,2,8,0.287605,0.295192,0,No
2,2,4,2,2,4,2,2,4,8,0.34493,0.357689,0,No
1,1,1,1,1,2,1,1,2,8,0.309325,0.317943,0,No
2,2,4,2,2,4,2,2,4,8,0.303628,0.3141,0,No
2,2,4,2,2,4,2,2,4,8,0.29596,0.308371,0,No
1,1,1,1,1,2,1,1,2,8,0.301584,0.314486,0,No
1,1,1,1,1,2,1,1,2,8,0.313497,0.320213,0,No
1,1,1,1,1,2,1,1,2,8,0.301589,0.314491,0,No
3,3,9,1,3,4,3,3,6,8,0.321228,0.329125,0,No
1,1,1,1,1,2,1,1,2,8,0.288163,0.299063,0,No
1,1,1,1,1,2,1,1,2,8,0.301589,0.314491,0,No
1,1,1,1,1,2,1,1,2,8,0.301589,0.314491,0,No
3,3,9,2,2,4,3,3,6,8,0.314891,0.321775,0,No
1,1,1,1,1,2,1,1,2,8,0.282856,0.289962,0,No
1,1,1,1,1,2,1,1,2,8,0.288168,0.299068,0,No
1,1,1,1,1,2,1,1,2,7,0.296305,0.304855,0,No
1,1,1,1,1,2,1,1,2,8,0.32342,0.334424,0,No
1,1,1,1,1,2,1,1,2,8,0.290994,0.298009,0,No
1,1,1,1,1,2,1,1,2,8,0.287605,0.295192,0,No
1,1,1,1,1,2,1,1,2,8,0.292601,0.299544,0,No
1,1,1,1,1,2,1,1,2,8,0.271899,0.280395,0,No
1,1,1,1,1,2,1,1,2,9,0.269099,0.277068,0,No
3,3,9,2,1,3,3,3,6,8,0.2876,0.295187,0,No
1,1,1,1,1,2,1,1,2,8,0.301589,0.314491,0,No
1,1,1,1,1,2,1,1,2,8,0.287605,0.295192,0,No
1,1,1,1,1,2,1,1,2,8,0.277091,0.2856,0,No
4,4,16,2,3,5,4,4,8,8,0.293587,0.300926,0,No
1,1,1,1,1,2,1,1,2,8,0.274545,0.283659,0,No
2,2,4,2,2,4,2,2,4,8,0.331746,0.343347,0,No
1,1,1,1,1,2,1,1,2,9,0.255423,0.260924,0,No
1,1,1,1,1,2,1,1,2,8,0.303375,0.311466,0,No
1,1,1,1,1,2,1,1,2,8,0.331578,0.343078,0,No
1,1,1,1,1,2,1,1,2,8,0.323426,0.334429,0,No
1,1,1,1,1,2,1,1,2,8,0.339934,0.352194,0,No
1,1,1,1,1,2,1,1,2,8,0.286927,0.294202,0,No
1,1,1,1,1,2,1,1,2,8,0.306145,0.312643,0,No
1,1,1,1,1,2,1,1,2,8,0.306145,0.312643,0,No
1,1,1,1,1,2,1,1,2,8,0.288773,0.295826,0,No
1,1,1,1,1,2,1,1,2,8,0.261907,0.26787,0,No
1,1,1,1,1,2,1,1,2,8,0.27455,0.283664,0,No
1,1,1,1,1,2,1,1,2,7,0.327819,0.338512,0,No
3,3,9,2,3,5,3,3,6,7,0.333431,0.34495,0,No
1,1,1,1,1,2,1,1,2,9,0.267014,0.27338,0,No
8,8,64,5,4,9,8,8,16,7,0.345615,0.359604,0,No
1,1,1,1,1,2,1,1,2,9,0.245204,0.249428,0,No
1,1,1,1,1,2,1,1,2,7,0.296305,0.304855,0,No
9,8,72,1,8,9,9,9,18,7,0.360146,0.375934,0,No
1,1,1,1,1,2,1,1,2,8,0.281861,0.289104,0,No
1,1,1,1,1,2,1,1,2,9,0.261875,0.267717,0,No
1,1,1,1,1,2,1,1,2,9,0.268721,0.277328,0,No
2,1,2,2,2,4,2,2,4,8,0.309107,0.317962,0,No
1,1,1,1,1,2,1,1,2,8,0.278743,0.288253,0,No
2,2,4,1,2,3,2,2,4,8,0.312338,0.321488,0,No
1,1,1,1,1,2,1,1,2,8,0.301584,0.314486,0,No
6,6,36,1,2,3,6,6,12,8,0.315701,0.32448,0,No
2,2,4,2,2,4,2,2,4,8,0.312423,0.320968,0,No
3,3,9,3,2,5,3,3,6,8,0.326771,0.337971,0,No
1,1,1,1,1,2,1,1,2,8,0.313497,0.320213,0,No
4,4,16,3,3,6,4,4,8,8,0.344241,0.357741,0,No
1,1,1,1,1,2,1,1,2,8,0.286532,0.293667,0,No
1,1,1,1,1,2,1,1,2,8,0.303693,0.310789,0,No
2,2,4,2,2,4,2,2,4,8,0.321561,0.329642,0,No
2,2,4,1,1,2,2,2,4,8,0.300521,0.307317,0,No
1,1,1,1,1,2,1,1,2,9,0.267014,0.27338,0,No
1,1,1,1,1,2,1,1,2,8,0.32342,0.334424,0,No
1,1,1,1,1,2,1,1,2,8,0.317445,0.327454,0,No
2,2,4,2,2,4,2,2,4,8,0.319382,0.327029,0,No
1,1,1,1,1,2,1,1,2,8,0.306145,0.312643,0,No
1,1,1,1,1,2,1,1,2,9,0.250842,0.255927,0,No
1,1,1,1,1,2,1,1,2,8,0.30338,0.311471,0,No
5,5,25,4,4,8,5,5,10,8,0.318696,0.329503,0,No
1,1,1,1,1,2,1,1,2,8,0.294825,0.301721,0,No
1,1,1,1,1,2,1,1,2,8,0.288168,0.299068,0,No
1,1,1,1,1,2,1,1,2,8,0.301589,0.314491,0,No
1,1,1,1,1,2,1,1,2,8,0.310028,0.318679,0,No
1,1,1,1,1,2,1,1,2,8,0.30338,0.311471,0,No
1,1,1,1,1,2,1,1,2,8,0.302198,0.308977,0,No
1,1,1,1,1,2,1,1,2,8,0.29167,0.29922,0,No
1,1,1,1,1,2,1,1,2,8,0.310028,0.318679,0,No
3,3,9,2,2,4,3,3,6,8,0.346274,0.360268,0,No
3,3,9,2,2,4,3,3,6,8,0.283636,0.290831,0,No
1,1,1,1,1,2,1,1,2,8,0.331571,0.343073,0,No
3,3,9,2,3,5,3,3,6,7,0.341164,0.354064,0,No
2,2,4,2,2,4,2,2,4,7,0.331597,0.34297,0,No
5,5,25,3,3,6,5,5,10,7,0.348915,0.363011,0,No
3,3,9,2,2,4,3,3,6,8,0.334097,0.345984,0,No
5,5,25,3,3,6,5,5,10,7,0.330281,0.340745,0,No
2,2,4,2,2,4,2,2,4,7,0.328526,0.339124,0,No
2,2,4,2,2,4,2,2,4,7,0.328723,0.33929,0,No
1,1,1,1,1,2,1,1,2,8,0.28349,0.292904,0,No
1,1,1,1,1,2,1,1,2,8,0.2876,0.295187,0,No
1,1,1,1,1,2,1,1,2,9,0.261354,0.267211,0,No
1,1,1,1,1,2,1,1,2,8,0.27144,0.277823,0,No
1,1,1,1,1,2,1,1,2,8,0.291361,0.298432,0,No
1,1,1,1,1,2,1,1,2,8,0.339934,0.352194,0,No
1,1,1,1,1,2,1,1,2,9,0.255182,0.259955,0,No
1,1,1,1,1,2,1,1,2,9,0.266659,0.272921,0,No
1,1,1,1,1,2,1,1,2,8,0.291361,0.298432,0,No
1,1,1,1,1,2,1,1,2,8,0.309331,0.317947,0,No
1,1,1,1,1,2,1,1,2,8,0.271899,0.280395,0,No
2,2,4,2,2,4,2,2,4,8,0.301413,0.308422,0,No
1,1,1,1,1,2,1,1,2,9,0.255737,0.261999,0,No
1,1,1,1,1,2,1,1,2,8,0.290014,0.297093,0,No
1,1,1,1,1,2,1,1,2,8,0.309062,0.315813,0,No
1,1,1,1,1,2,1,1,2,8,0.282187,0.289103,0,No
1,1,1,1,1,2,1,1,2,8,0.301584,0.314486,0,No
1,1,1,1,1,2,1,1,2,8,0.301589,0.314491,0,No
1,1,1,1,1,2,1,1,2,8,0.309331,0.317947,0,No
1,1,1,1,1,2,1,1,2,9,0.249503,0.253822,0,No
1,1,1,1,1,2,1,1,2,8,0.276678,0.28406,0,No
1,1,1,1,1,2,1,1,2,8,0.331571,0.343073,0,No
6,6,36,2,1,3,6,6,12,8,0.317292,0.324388,0,No
2,2,4,2,2,4,2,2,4,8,0.280609,0.29001,0,No
1,1,1,1,1,2,1,1,2,8,0.281861,0.289104,0,No
1,1,1,1,1,2,1,1,2,8,0.309752,0.316287,0,No
1,1,1,1,1,2,1,1,2,8,0.301584,0.314486,0,No
3,3,9,2,2,4,3,3,6,8,0.330961,0.343854,0,No
1,1,1,1,1,2,1,1,2,8,0.301589,0.314491,0,No
1,1,1,1,1,2,1,1,2,8,0.32342,0.334424,0,No
3,3,9,3,3,6,3,3,6,8,0.327838,0.340356,0,No
1,1,1,1,1,2,1,1,2,9,0.268721,0.277328,0,No
1,1,1,1,1,2,1,1,2,8,0.290014,0.297093,0,No
1,1,1,1,1,2,1,1,2,8,0.32342,0.334424,0,No
3,3,9,2,2,4,3,3,6,8,0.326902,0.337513,0,No
2,2,4,2,2,4,2,2,4,8,0.323961,0.334992,0,No
3,3,9,2,2,4,3,3,6,9,0.276074,0.286084,0,No
1,1,1,1,1,2,1,1,2,8,0.32342,0.334424,0,No
3,3,9,1,2,3,3,3,6,8,0.352003,0.366286,0,No
1,1,1,1,1,2,1,1,2,8,0.303375,0.311466,0,No
1,1,1,1,1,2,1,1,2,8,0.339934,0.352194,0,No
2,2,4,2,1,3,2,2,4,8,0.32342,0.334424,0,No
9,7,63,4,2,6,9,9,18,8,0.327832,0.339198,0,No
2,2,4,1,1,2,2,2,4,8,0.32342,0.334424,0,No
2,2,4,2,2,4,2,2,4,8,0.342816,0.355495,0,No
3,3,9,2,3,5,3,3,6,7,0.331346,0.341633,0,No
1,1,1,1,1,2,1,1,2,7,0.327826,0.338517,0,No
1,1,1,1,1,2,1,1,2,8,0.281861,0.289104,0,No
1,1,1,1,1,2,1,1,2,8,0.276284,0.283503,0,No
1,1,1,1,1,2,1,1,2,9,0.260902,0.266721,0,No
1,1,1,1,1,2,1,1,2,9,0.273783,0.28069,0,No
1,1,1,1,1,2,1,1,2,8,0.288163,0.299063,0,No
1,1,1,1,1,2,1,1,2,7,0.296305,0.304855,0,No
2,2,4,1,1,2,2,2,4,8,0.307813,0.314411,0,No
2,2,4,1,2,3,2,2,4,8,0.341219,0.353853,0,No
1,1,1,1,1,2,1,1,2,8,0.331571,0.343073,0,No
4,4,16,2,3,5,4,4,8,7,0.352745,0.367098,0,No
1,1,1,1,1,2,1,1,2,9,0.268717,0.277323,0,No
1,1,1,1,1,2,1,1,2,8,0.317292,0.324388,0,No
2,2,4,2,2,4,2,2,4,8,0.335193,0.347351,0,No
3,3,9,1,1,2,3,3,6,9,0.254417,0.260027,0,No
2,2,4,2,2,4,2,2,4,8,0.28792,0.295031,0,No
1,1,1,1,1,2,1,1,2,8,0.278739,0.288248,0,No
2,2,4,1,1,2,2,2,4,9,0.263713,0.26981,0,No
1,1,1,1,1,2,1,1,2,8,0.263038,0.269168,0,No
2,2,4,2,2,4,2,2,4,8,0.305362,0.317969,0,No
4,4,16,4,3,7,4,4,8,8,0.322808,0.33096,0,No
2,2,4,1,2,3,2,2,4,8,0.324985,0.336203,0,No
22,22,484,8,3,11,22,22,44,8,0.30345,0.310149,0,No
4,4,16,2,4,6,4,4,8,8,0.313313,0.320093,0,No
1,1,1,1,1,2,1,1,2,9,0.267106,0.273804,0,No
2,2,4,1,1,2,2,2,4,8,0.301589,0.314491,0,No
2,2,4,2,2,4,2,2,4,9,0.276257,0.283132,0,No
1,1,1,1,1,2,1,1,2,8,0.323426,0.334429,0,No
1,1,1,1,1,2,1,1,2,8,0.32342,0.334424,0,No
1,1,1,1,1,2,1,1,2,8,0.294479,0.3016,0,No
6,6,36,3,4,7,6,6,12,8,0.338062,0.351537,0,No
1,1,1,1,1,2,1,1,2,8,0.272172,0.278813,0,No
1,1,1,1,1,2,1,1,2,8,0.303693,0.310789,0,No
1,1,1,1,1,2,1,1,2,9,0.26388,0.270162,0,No
2,2,4,1,1,2,2,2,4,9,0.303801,0.312033,0,No
7,7,49,3,2,5,7,7,14,7,0.318096,0.330234,0,No
3,3,9,2,1,3,3,3,6,7,0.296305,0.304855,0,No
2,2,4,1,1,2,2,2,4,9,0.303801,0.312033,0,No
1,1,1,1,1,2,1,1,2,8,0.275077,0.282123,0,No
1,1,1,1,1,2,1,1,2,7,0.2963,0.30485,0,No
3,3,9,1,3,4,3,3,6,8,0.311989,0.31846,0,No
2,2,4,1,2,3,2,2,4,7,0.306839,0.314471,0,No
1,1,1,1,1,2,1,1,2,8,0.271899,0.280395,0,No
2,2,4,1,1,2,2,2,4,8,0.339934,0.352194,0,No
1,1,1,1,1,2,1,1,2,7,0.327819,0.338512,0,No
3,3,9,2,2,4,3,3,6,8,0.30768,0.320103,0,No
1,1,1,1,1,2,1,1,2,8,0.331571,0.343073,0,No
2,2,4,2,2,4,2,2,4,8,0.316938,0.327224,0,No
1,1,1,1,1,2,1,1,2,8,0.331571,0.343073,0,No
1,1,1,1,1,2,1,1,2,7,0.327826,0.338517,0,No
2,2,4,1,2,3,2,2,4,8,0.301658,0.308635,0,No
1,1,1,1,1,2,1,1,2,8,0.279653,0.286498,0,No
3,3,9,2,1,3,3,3,6,8,0.286889,0.294049,0,No
2,2,4,1,1,2,2,2,4,8,0.305078,0.312168,0,No
1,1,1,1,1,2,1,1,2,8,0.317292,0.324388,0,No
1,1,1,1,1,2,1,1,2,8,0.310033,0.318684,0,No
2,2,4,1,1,2,2,2,4,8,0.278743,0.288253,0,No
1,1,1,1,1,2,1,1,2,8,0.277096,0.285605,0,No
1,1,1,1,1,2,1,1,2,8,0.281712,0.288655,0,No
6,6,36,2,1,3,6,6,12,8,0.27122,0.279026,0,No
3,3,9,1,2,3,3,3,6,8,0.34461,0.357406,0,No
1,1,1,1,1,2,1,1,2,9,0.244979,0.249046,0,No
1,1,1,1,1,2,1,1,2,8,0.289252,0.299287,0,No
3,3,9,2,2,4,3,3,6,7,0.331514,0.343058,0,No
1,1,1,1,1,2,1,1,2,8,0.331571,0.343073,0,No
2,2,4,1,2,3,2,2,4,8,0.286364,0.293542,0,No
1,1,1,1,1,2,1,1,2,9,0.244396,0.24898,0,No
2,2,4,1,1,2,2,2,4,7,0.2963,0.30485,0,No
2,2,4,1,2,3,2,2,4,8,0.317575,0.327599,0,No
3,3,9,3,3,6,3,3,6,8,0.326396,0.337087,0,No
1,1,1,1,1,2,1,1,2,8,0.303375,0.311466,0,No
1,1,1,1,1,2,1,1,2,8,0.32342,0.334424,0,No
1,1,1,1,1,2,1,1,2,9,0.263403,0.271075,0,No
1,1,1,1,1,2,1,1,2,8,0.309325,0.317943,0,No
2,2,4,2,2,4,2,2,4,8,0.29912,0.310478,0,No
3,3,9,1,2,3,3,3,6,8,0.340382,0.352564,0,No
3,3,9,3,2,5,3,3,6,8,0.325078,0.336647,0,No
1,1,1,1,1,2,1,1,2,8,0.317445,0.327454,0,No
1,1,1,1,1,2,1,1,2,7,0.296305,0.304855,0,No
2,2,4,2,1,3,2,2,4,8,0.288168,0.299068,0,No
1,1,1,1,1,2,1,1,2,8,0.339934,0.352194,0,No
1,1,1,1,1,2,1,1,2,8,0.288168,0.299068,0,No
2,2,4,1,2,3,2,2,4,8,0.315824,0.32712,0,No
7,7,49,5,6,11,7,7,14,8,0.317298,0.32493,0,No
3,3,9,3,3,6,3,3,6,7,0.329478,0.340375,0,No
1,1,1,1,1,2,1,1,2,8,0.32342,0.334424,0,No
1,1,1,1,1,2,1,1,2,8,0.310028,0.318679,0,No
5,5,25,1,2,3,5,5,10,8,0.315176,0.324499,0,No
2,2,4,2,2,4,2,2,4,8,0.328368,0.339723,0,No
2,2,4,1,1,2,2,2,4,8,0.267857,0.275083,0,No
1,1,1,1,1,2,1,1,2,8,0.32342,0.334424,0,No
1,1,1,1,1,2,1,1,2,8,0.317445,0.327454,0,No
4,4,16,3,3,6,4,4,8,8,0.29234,0.302782,0,No
1,1,1,1,1,2,1,1,2,8,0.291945,0.299044,0,No
3,3,9,2,2,4,3,3,6,8,0.289086,0.300254,0,No
1,1,1,1,1,2,1,1,2,8,0.32342,0.334424,0,No
7,6,42,2,5,7,7,7,14,8,0.355575,0.370693,0,No
4,4,16,2,2,4,4,4,8,8,0.301089,0.31191,0,No
1,1,1,1,1,2,1,1,2,9,0.251663,0.256354,0,No
4,4,16,2,1,3,4,4,8,9,0.244305,0.248584,0,No
1,1,1,1,1,2,1,1,2,8,0.283081,0.290002,0,No
1,1,1,1,1,2,1,1,2,8,0.273862,0.280729,0,No
1,1,1,1,1,2,1,1,2,8,0.309752,0.316287,0,No
1,1,1,1,1,2,1,1,2,7,0.327819,0.338512,0,No
3,3,9,3,2,5,3,3,6,8,0.31216,0.322349,0,No
6,6,36,6,3,9,6,6,12,8,0.327147,0.337647,0,No
1,1,1,1,1,2,1,1,2,8,0.299745,0.307615,0,No
1,1,1,1,1,2,1,1,2,8,0.306448,0.313104,0,No
3,3,9,2,3,5,3,3,6,8,0.318732,0.325841,0,No
1,1,1,1,1,2,1,1,2,8,0.278739,0.288248,0,No
1,1,1,1,1,2,1,1,2,8,0.339934,0.352194,0,No
1,1,1,1,1,2,1,1,2,8,0.32342,0.334424,0,No
3,3,9,2,2,4,3,3,6,8,0.338243,0.351497,0,No
1,1,1,1,1,2,1,1,2,9,0.263403,0.269344,0,No
1,1,1,1,1,2,1,1,2,8,0.339934,0.352194,0,No
3,2,6,2,2,4,3,3,6,8,0.293881,0.304916,0,No
1,1,1,1,1,2,1,1,2,9,0.268721,0.277328,0,No
1,1,1,1,1,2,1,1,2,9,0.268721,0.277328,0,No
2,2,4,2,2,4,2,2,4,8,0.318488,0.325905,0,No
5,3,15,3,3,6,5,5,10,8,0.33362,0.344527,0,No
2,2,4,2,2,4,2,2,4,8,0.314317,0.323273,0,No
1,1,1,1,1,2,1,1,2,8,0.258487,0.263799,0,No
1,1,1,1,1,2,1,1,2,8,0.305116,0.311592,0,No
2,2,4,2,2,4,2,2,4,7,0.330096,0.341269,0,No
2,2,4,2,2,4,2,2,4,8,0.303051,0.31152,0,No
1,1,1,1,1,2,1,1,2,9,0.255733,0.261996,0,No
1,1,1,1,1,2,1,1,2,7,0.327819,0.338512,0,No
1,1,1,1,1,2,1,1,2,8,0.263155,0.269091,0,No
6,6,36,3,3,6,6,6,12,7,0.333138,0.343371,0,No
1,1,1,1,1,2,1,1,2,8,0.277096,0.285605,0,No
1,1,1,1,1,2,1,1,2,8,0.278739,0.288248,0,No
3,2,6,3,2,5,3,3,6,7,0.33293,0.343007,0,No
2,2,4,2,1,3,2,2,4,7,0.327819,0.338512,0,No
1,1,1,1,1,2,1,1,2,8,0.278743,0.288253,0,No
1,1,1,1,1,2,1,1,2,8,0.309331,0.317947,0,No
1,1,1,1,1,2,1,1,2,8,0.289145,0.296989,0,No
1,1,1,1,1,2,1,1,2,8,0.317292,0.324388,0,No
1,1,1,1,1,2,1,1,2,8,0.339927,0.352185,0,No
1,1,1,1,1,2,1,1,2,8,0.331578,0.343078,0,No
1,1,1,1,1,2,1,1,2,8,0.331571,0.343073,0,No
1,1,1,1,1,2,1,1,2,7,0.296305,0.304855,0,No
1,1,1,1,1,2,1,1,2,8,0.288168,0.299068,0,No
1,1,1,1,1,2,1,1,2,8,0.313497,0.320213,0,No
7,7,49,4,5,9,7,7,14,8,0.354858,0.370439,0,No
1,1,1,1,1,2,1,1,2,9,0.303807,0.312038,0,No
1,1,1,1,1,2,1,1,2,9,0.265308,0.271483,0,No
1,1,1,1,1,2,1,1,2,8,0.339941,0.352199,0,No
1,1,1,1,1,2,1,1,2,8,0.317451,0.327459,0,No
1,1,1,1,1,2,1,1,2,8,0.309325,0.317943,0,No
3,3,9,2,3,5,3,3,6,8,0.326309,0.338007,0,No
1,1,1,1,1,2,1,1,2,8,0.314589,0.321465,0,No
1,1,1,1,1,2,1,1,2,8,0.288168,0.299068,0,No
2,2,4,1,1,2,2,2,4,8,0.301584,0.314486,0,No
2,2,4,2,2,4,2,2,4,8,0.320643,0.327758,0,No
1,1,1,1,1,2,1,1,2,8,0.310028,0.318679,0,No
1,1,1,1,1,2,1,1,2,8,0.301584,0.314486,0,No
1,1,1,1,1,2,1,1,2,8,0.301584,0.314486,0,No
2,2,4,1,1,2,2,2,4,8,0.339934,0.352194,0,No
1,1,1,1,1,2,1,1,2,8,0.295596,0.303244,0,No
1,1,1,1,1,2,1,1,2,8,0.29974,0.30761,0,No
1,1,1,1,1,2,1,1,2,7,0.327819,0.338512,0,No
1,1,1,1,1,2,1,1,2,8,0.339934,0.352194,0,No
1,1,1,1,1,2,1,1,2,9,0.266659,0.272921,0,No
1,1,1,1,1,2,1,1,2,8,0.287169,0.294456,0,No
1,1,1,1,1,2,1,1,2,8,0.27455,0.283664,0,No
2,2,4,1,1,2,2,2,4,8,0.268997,0.275184,0,No
2,2,4,2,2,4,2,2,4,8,0.303207,0.31136,0,No
2,2,4,2,2,4,2,2,4,8,0.322436,0.330248,0,No
2,2,4,1,1,2,2,2,4,8,0.310028,0.318679,0,No
4,4,16,1,2,3,4,4,8,8,0.340022,0.352312,0,No
3,3,9,2,2,4,3,3,6,8,0.311272,0.319792,0,No
1,1,1,1,1,2,1,1,2,8,0.303655,0.312962,0,No
1,1,1,1,1,2,1,1,2,8,0.303661,0.312967,0,No
1,1,1,1,1,2,1,1,2,8,0.289223,0.296402,0,No
4,4,16,3,3,6,4,4,8,7,0.314961,0.3253,0,No
3,3,9,1,1,2,3,3,6,8,0.309325,0.317943,0,No
15,13,195,4,5,9,15,15,30,8,0.330832,0.342892,0,No
1,1,1,1,1,2,1,1,2,8,0.310028,0.318679,0,No
1,1,1,1,1,2,1,1,2,8,0.309325,0.317943,0,No
4,4,16,4,3,7,4,4,8,8,0.32377,0.333938,0,No
4,4,16,3,4,7,4,4,8,8,0.32218,0.330159,0,No
1,1,1,1,1,2,1,1,2,8,0.263574,0.26993,0,No
1,1,1,1,1,2,1,1,2,8,0.258022,0.26326,0,No
1,1,1,1,1,2,1,1,2,8,0.256903,0.262046,0,No
3,3,9,3,2,5,3,3,6,8,0.328995,0.340857,0,No
2,2,4,2,2,4,2,2,4,8,0.313198,0.322823,0,No
2,2,4,2,2,4,2,2,4,8,0.310751,0.319541,0,No
1,1,1,1,1,2,1,1,2,8,0.309331,0.317947,0,No
1,1,1,1,1,2,1,1,2,8,0.2828,0.289824,0,No
1,1,1,1,1,2,1,1,2,8,0.26636,0.272552,0,No
3,3,9,2,2,4,3,3,6,7,0.342218,0.354868,0,No
8,8,64,5,6,11,8,8,16,7,0.343756,0.356458,0,No
2,2,4,2,2,4,2,2,4,8,0.312109,0.320358,0,No
4,4,16,4,4,8,4,4,8,8,0.339137,0.351765,0,No
2,2,4,2,2,4,2,2,4,8,0.331578,0.343103,0,No
1,1,1,1,1,2,1,1,2,8,0.339934,0.352194,0,No
1,1,1,1,1,2,1,1,2,8,0.303655,0.312962,0,No
4,4,16,4,2,6,4,4,8,8,0.318762,0.32578,0,No
1,1,1,1,1,2,1,1,2,8,0.291043,0.298137,0,No
1,1,1,1,1,2,1,1,2,8,0.28349,0.292904,0,No
1,1,1,1,1,2,1,1,2,9,0.244127,0.247285,0,No
1,1,1,1,1,2,1,1,2,8,0.339934,0.352194,0,No
1,1,1,1,1,2,1,1,2,9,0.254125,0.259272,0,No
1,1,1,1,1,2,1,1,2,8,0.310028,0.318679,0,No
1,1,1,1,1,2,1,1,2,8,0.323426,0.334429,0,No
1,1,1,1,1,2,1,1,2,8,0.301584,0.314486,0,No
1,1,1,1,1,2,1,1,2,8,0.271899,0.280395,0,No
1,1,1,1,1,2,1,1,2,8,0.28102,0.288099,0,No
3,3,9,3,2,5,3,3,6,7,0.332236,0.343545,0,No
1,1,1,1,1,2,1,1,2,8,0.315759,0.323487,0,No
3,3,9,1,1,2,3,3,6,7,0.327819,0.338512,0,No
1,1,1,1,1,2,1,1,2,8,0.32342,0.334424,0,No
4,4,16,1,2,3,4,4,8,8,0.343666,0.35637,0,No
3,3,9,1,1,2,3,3,6,8,0.278739,0.288248,0,No
1,1,1,1,1,2,1,1,2,8,0.283486,0.292899,0,No
1,1,1,1,1,2,1,1,2,8,0.274545,0.283659,0,No
2,2,4,1,2,3,2,2,4,7,0.329268,0.340023,0,No
3,3,9,1,3,4,3,3,6,8,0.331733,0.343282,0,No
1,1,1,1,1,2,1,1,2,8,0.310033,0.318684,0,No
4,4,16,2,3,5,4,4,8,7,0.351691,0.366011,0,No
1,1,1,1,1,2,1,1,2,8,0.272007,0.278365,0,No
1,1,1,1,1,2,1,1,2,8,0.303661,0.312967,0,No
1,1,1,1,1,2,1,1,2,8,0.339934,0.352194,0,No
1,1,1,1,1,2,1,1,2,8,0.26966,0.276146,0,No
2,2,4,2,2,4,2,2,4,8,0.323967,0.334906,0,No
2,2,4,2,2,4,2,2,4,8,0.332573,0.344483,0,No
3,3,9,2,2,4,3,3,6,8,0.318947,0.326124,0,No
2,2,4,1,1,2,2,2,4,8,0.313497,0.320213,0,No
1,1,1,1,1,2,1,1,2,8,0.271899,0.280395,0,No
1,1,1,1,1,2,1,1,2,8,0.271899,0.280395,0,No
1,1,1,1,1,2,1,1,2,8,0.268219,0.275191,0,No
1,1,1,1,1,2,1,1,2,8,0.32342,0.334424,0,No
3,3,9,3,3,6,3,3,6,8,0.345132,0.357968,0,No
1,1,1,1,1,2,1,1,2,8,0.296991,0.30415,0,No
1,1,1,1,1,2,1,1,2,9,0.284336,0.292278,0,No
1,1,1,1,1,2,1,1,2,8,0.302842,0.310166,0,No
1,1,1,1,1,2,1,1,2,8,0.301584,0.314486,0,No
1,1,1,1,1,2,1,1,2,9,0.268717,0.277323,0,No
1,1,1,1,1,2,1,1,2,8,0.301584,0.314486,0,No
1,1,1,1,1,2,1,1,2,8,0.267357,0.273769,0,No
2,2,4,1,2,3,2,2,4,8,0.309505,0.317379,0,No
6,6,36,3,5,8,6,6,12,8,0.328413,0.337341,0,No
1,1,1,1,1,2,1,1,2,8,0.288929,0.297713,0,No
2,2,4,2,2,4,2,2,4,8,0.341827,0.354496,0,No
1,1,1,1,1,2,1,1,2,8,0.296438,0.303515,0,No
3,3,9,2,2,4,3,3,6,8,0.314242,0.322739,0,No
1,1,1,1,1,2,1,1,2,8,0.275285,0.282167,0,No
2,2,4,2,2,4,2,2,4,8,0.317056,0.323986,0,No
1,1,1,1,1,2,1,1,2,8,0.288934,0.297717,0,No
2,2,4,1,1,2,2,2,4,8,0.288934,0.297717,0,No
1,1,1,1,1,2,1,1,2,8,0.295514,0.302439,0,No
2,2,4,2,2,4,2,2,4,8,0.311778,0.320297,0,No
4,4,16,2,3,5,4,4,8,8,0.328292,0.339828,0,No
1,1,1,1,1,2,1,1,2,8,0.288934,0.297717,0,No
1,1,1,1,1,2,1,1,2,8,0.274545,0.283659,0,No
1,1,1,1,1,2,1,1,2,8,0.310028,0.318679,0,No
2,2,4,2,2,4,2,2,4,8,0.275303,0.284343,0,No
3,3,9,3,3,6,3,3,6,8,0.340239,0.3526,0,No
2,2,4,2,1,3,2,2,4,8,0.301589,0.314491,0,No
1,1,1,1,1,2,1,1,2,7,0.2963,0.30485,0,No
1,1,1,1,1,2,1,1,2,8,0.301589,0.308538,0,No
1,1,1,1,1,2,1,1,2,8,0.317298,0.324393,0,No
1,1,1,1,1,2,1,1,2,8,0.29229,0.30057,0,No
1,1,1,1,1,2,1,1,2,8,0.301584,0.314486,0,No
2,2,4,1,2,3,2,2,4,7,0.329332,0.339854,0,No
2,2,4,2,2,4,2,2,4,7,0.339306,0.352082,0,No
1,1,1,1,1,2,1,1,2,8,0.273678,0.280436,0,No
3,3,9,3,3,6,3,3,6,8,0.3425,0.355653,0,No
1,1,1,1,1,2,1,1,2,8,0.27455,0.283664,0,No
1,1,1,1,1,2,1,1,2,8,0.309977,0.317107,0,No
1,1,1,1,1,2,1,1,2,8,0.304446,0.311255,0,No
2,2,4,1,1,2,2,2,4,8,0.255813,0.260526,0,No
1,1,1,1,1,2,1,1,2,8,0.288929,0.297713,0,No
3,3,9,3,2,5,3,3,6,8,0.345153,0.358795,0,No
2,2,4,2,1,3,2,2,4,8,0.289459,0.296639,0,No
1,1,1,1,1,2,1,1,2,8,0.339941,0.352199,0,No
1,1,1,1,1,2,1,1,2,8,0.288168,0.299068,0,No
1,1,1,1,1,2,1,1,2,8,0.323426,0.334429,0,No
1,1,1,1,1,2,1,1,2,8,0.27455,0.283664,0,No
1,1,1,1,1,2,1,1,2,8,0.27455,0.283664,0,No
1,1,1,1,1,2,1,1,2,9,0.253751,0.258633,0,No
1,1,1,1,1,2,1,1,2,9,0.268721,0.277328,0,No
1,1,1,1,1,2,1,1,2,7,0.2963,0.30485,0,No
1,1,1,1,1,2,1,1,2,8,0.310033,0.318684,0,No
2,2,4,1,1,2,2,2,4,7,0.2963,0.30485,0,No
1,1,1,1,1,2,1,1,2,8,0.296444,0.303647,0,No
1,1,1,1,1,2,1,1,2,8,0.27818,0.285585,0,No
2,2,4,1,1,2,2,2,4,7,0.296305,0.304855,0,No
5,5,25,3,1,4,5,5,10,7,0.2963,0.30485,0,No
1,1,1,1,1,2,1,1,2,8,0.259241,0.264516,0,No
2,2,4,2,2,4,2,2,4,7,0.342218,0.354868,0,No
2,2,4,2,2,4,2,2,4,8,0.29333,0.30197,0,No
1,1,1,1,1,2,1,1,2,8,0.339934,0.352194,0,No
2,2,4,1,1,2,2,2,4,8,0.310028,0.318679,0,No
2,2,4,2,2,4,2,2,4,8,0.294301,0.303639,0,No
1,1,1,1,1,2,1,1,2,8,0.32342,0.334424,0,No
1,1,1,1,1,2,1,1,2,8,0.301584,0.314486,0,No
2,2,4,1,1,2,2,2,4,8,0.310033,0.318684,0,No
1,1,1,1,1,2,1,1,2,8,0.229015,0.232866,0,No
2,2,4,1,1,2,2,2,4,7,0.2963,0.30485,0,No
5,4,20,5,4,9,5,5,10,7,0.342349,0.355073,0,No
1,1,1,1,1,2,1,1,2,9,0.238944,0.24297,0,No
2,2,4,2,2,4,2,2,4,7,0.32902,0.339709,0,No
1,1,1,1,1,2,1,1,2,9,0.259822,0.265922,0,No
3,3,9,3,3,6,3,3,6,8,0.310762,0.317353,0,No
5,5,25,5,4,9,5,5,10,7,0.322924,0.332202,0,No
2,2,4,2,2,4,2,2,4,8,0.328609,0.339267,0,No
4,4,16,2,2,4,4,4,8,8,0.317723,0.326062,0,No
2,2,4,2,2,4,2,2,4,8,0.295351,0.303883,0,No
1,1,1,1,1,2,1,1,2,8,0.249474,0.253632,0,No
2,2,4,2,2,4,2,2,4,8,0.313883,0.32347,0,No
2,2,4,1,2,3,2,2,4,8,0.302954,0.309793,0,No
1,1,1,1,1,2,1,1,2,7,0.327819,0.338512,0,No
1,1,1,1,1,2,1,1,2,8,0.309331,0.317947,0,No
2,2,4,1,2,3,2,2,4,8,0.324305,0.335748,0,No
2,2,4,1,2,3,2,2,4,8,0.343127,0.355994,0,No
2,2,4,1,2,3,2,2,4,8,0.294139,0.303418,0,No
2,2,4,1,2,3,2,2,4,8,0.34516,0.358804,0,No
1,1,1,1,1,2,1,1,2,8,0.310028,0.318679,0,No
4,4,16,3,1,4,4,4,8,7,0.296305,0.304855,0,No
1,1,1,1,1,2,1,1,2,7,0.2963,0.30485,0,No
2,2,4,2,2,4,2,2,4,7,0.29631,0.304889,0,No
3,3,9,2,1,3,3,3,6,7,0.296305,0.304855,0,No
9,9,81,7,1,8,9,9,18,7,0.2963,0.30485,0,No
1,1,1,1,1,2,1,1,2,8,0.339934,0.352194,0,No
4,4,16,2,1,3,4,4,8,7,0.2963,0.30485,0,No
2,2,4,1,1,2,2,2,4,7,0.2963,0.30485,0,No
1,1,1,1,1,2,1,1,2,8,0.308542,0.315798,0,No
3,3,9,2,2,4,3,3,6,8,0.319472,0.32736,0,No
7,7,49,4,2,6,7,7,14,7,0.303926,0.312165,0,No
1,1,1,1,1,2,1,1,2,7,0.2963,0.30485,0,No
1,1,1,1,1,2,1,1,2,8,0.288163,0.299063,0,No
3,3,9,2,2,4,3,3,6,8,0.315083,0.329711,0,No
1,1,1,1,1,2,1,1,2,8,0.278743,0.288253,0,No
4,4,16,1,1,2,4,4,8,8,0.302842,0.310166,0,No
2,2,4,2,2,4,2,2,4,7,0.30546,0.312118,0,No
3,3,9,2,2,4,3,3,6,8,0.304121,0.313414,0,No
1,1,1,1,1,2,1,1,2,8,0.288934,0.297717,0,No
1,1,1,1,1,2,1,1,2,9,0.279465,0.286694,0,No
1,1,1,1,1,2,1,1,2,8,0.301584,0.314486,0,No
1,1,1,1,1,2,1,1,2,8,0.287605,0.295192,0,No
1,1,1,1,1,2,1,1,2,9,0.268721,0.277328,0,No
1,1,1,1,1,2,1,1,2,8,0.301584,0.314486,0,No
2,2,4,1,1,2,2,2,4,9,0.253793,0.258648,0,No
1,1,1,1,1,2,1,1,2,9,0.26388,0.270162,0,No
1,1,1,1,1,2,1,1,2,9,0.250842,0.255927,0,No
5,5,25,3,3,6,5,5,10,8,0.310265,0.318402,0,No
1,1,1,1,1,2,1,1,2,9,0.250842,0.255927,0,No
1,1,1,1,1,2,1,1,2,8,0.310033,0.318684,0,No
1,1,1,1,1,2,1,1,2,9,0.244309,0.248587,0,No
1,1,1,1,1,2,1,1,2,8,0.310028,0.318679,0,No
1,1,1,1,1,2,1,1,2,8,0.310028,0.318679,0,No
7,7,49,7,1,8,7,7,14,8,0.310028,0.318679,0,No
1,1,1,1,1,2,1,1,2,8,0.310033,0.318684,0,No
11,11,121,7,1,8,11,11,22,8,0.310028,0.318679,0,No
1,1,1,1,1,2,1,1,2,8,0.32342,0.334424,0,No
1,1,1,1,1,2,1,1,2,8,0.294007,0.301287,0,No
1,1,1,1,1,2,1,1,2,8,0.288168,0.299068,0,No
1,1,1,1,1,2,1,1,2,8,0.32342,0.334424,0,No
1,1,1,1,1,2,1,1,2,8,0.303585,0.310469,0,No
2,2,4,2,2,4,2,2,4,8,0.315941,0.327166,0,No
1,1,1,1,1,2,1,1,2,7,0.296305,0.304855,0,No
1,1,1,1,1,2,1,1,2,8,0.32342,0.334424,0,No
1,1,1,1,1,2,1,1,2,8,0.32342,0.334424,0,No
3,3,9,2,1,3,3,3,6,8,0.32342,0.334424,0,No
1,1,1,1,1,2,1,1,2,8,0.251093,0.256375,0,No
1,1,1,1,1,2,1,1,2,8,0.27455,0.283664,0,No
5,5,25,4,2,6,5,5,10,8,0.324793,0.335623,0,No
2,2,4,1,1,2,2,2,4,8,0.32342,0.334424,0,No
3,3,9,2,1,3,3,3,6,8,0.32342,0.334424,0,No
4,4,16,4,1,5,4,4,8,8,0.32342,0.334424,0,No
1,1,1,1,1,2,1,1,2,9,0.268641,0.276936,0,No
2,2,4,2,2,4,2,2,4,8,0.282453,0.289451,0,No
1,1,1,1,1,2,1,1,2,9,0.268641,0.276936,0,No
5,5,25,5,2,7,5,5,10,8,0.323616,0.334633,0,No
2,2,4,2,2,4,2,2,4,8,0.334326,0.344905,0,No
1,1,1,1,1,2,1,1,2,8,0.309331,0.317947,0,No
1,1,1,1,1,2,1,1,2,8,0.288168,0.299068,0,No
1,1,1,1,1,2,1,1,2,8,0.32342,0.334424,0,No
1,1,1,1,1,2,1,1,2,8,0.294469,0.301552,0,No
2,2,4,2,2,4,2,2,4,8,0.311085,0.31989,0,No
1,1,1,1,1,2,1,1,2,8,0.309325,0.317943,0,No
1,1,1,1,1,2,1,1,2,7,0.296305,0.304855,0,No
1,1,1,1,1,2,1,1,2,7,0.296305,0.304855,0,No
1,1,1,1,1,2,1,1,2,7,0.296305,0.304855,0,No
1,1,1,1,1,2,1,1,2,8,0.278794,0.285756,0,No
2,2,4,1,2,3,2,2,4,8,0.315089,0.329716,0,No
1,1,1,1,1,2,1,1,2,8,0.291705,0.29867,0,No
1,1,1,1,1,2,1,1,2,8,0.32342,0.334424,0,No
1,1,1,1,1,2,1,1,2,9,0.268721,0.277328,0,No
6,6,36,2,4,6,6,6,12,8,0.331089,0.341706,0,No
1,1,1,1,1,2,1,1,2,8,0.291401,0.298476,0,No
2,2,4,2,2,4,2,2,4,8,0.315882,0.327011,0,No
1,1,1,1,1,2,1,1,2,9,0.268726,0.277331,0,No
4,4,16,1,2,3,4,4,8,8,0.330537,0.341041,0,No
1,1,1,1,1,2,1,1,2,8,0.294469,0.301552,0,No
1,1,1,1,1,2,1,1,2,8,0.310028,0.318679,0,No
2,2,4,1,1,2,2,2,4,8,0.294469,0.301552,0,No
1,1,1,1,1,2,1,1,2,8,0.27122,0.279026,0,No
1,1,1,1,1,2,1,1,2,8,0.32342,0.334424,0,No
2,2,4,2,2,4,2,2,4,9,0.265679,0.273555,0,No
3,3,9,2,3,5,3,3,6,8,0.311107,0.319395,0,No
1,1,1,1,1,2,1,1,2,9,0.272825,0.279527,0,No
1,1,1,1,1,2,1,1,2,9,0.280683,0.28796,0,No
3,3,9,3,3,6,3,3,6,8,0.318061,0.325864,0,No
1,1,1,1,1,2,1,1,2,8,0.314583,0.32146,0,No
1,1,1,1,1,2,1,1,2,8,0.311306,0.32231,0,No
2,2,4,1,2,3,2,2,4,8,0.303704,0.310828,0,No
1,1,1,1,1,2,1,1,2,9,0.268641,0.276936,0,No
1,1,1,1,1,2,1,1,2,8,0.277096,0.285605,0,No
3,3,9,2,3,5,3,3,6,8,0.349022,0.363503,0,No
3,3,9,3,2,5,3,3,6,8,0.292095,0.299708,0,No
1,1,1,1,1,2,1,1,2,8,0.30338,0.311471,0,No
1,1,1,1,1,2,1,1,2,9,0.250842,0.255927,0,No
1,1,1,1,1,2,1,1,2,7,0.327826,0.338517,0,No
2,2,4,1,2,3,2,2,4,8,0.330961,0.343854,0,No
2,2,4,2,2,4,2,2,4,7,0.298372,0.307366,0,No
1,1,1,1,1,2,1,1,2,8,0.331571,0.343073,0,No
4,4,16,1,1,2,4,4,8,9,0.250842,0.255927,0,No
1,1,1,1,1,2,1,1,2,8,0.307813,0.314411,0,No
1,1,1,1,1,2,1,1,2,9,0.265733,0.271724,0,No
1,1,1,1,1,2,1,1,2,9,0.271134,0.278029,0,No
1,1,1,1,1,2,1,1,2,8,0.306453,0.313109,0,No
1,1,1,1,1,2,1,1,2,8,0.323426,0.334429,0,No
1,1,1,1,1,2,1,1,2,9,0.254417,0.260027,0,No
4,3,12,4,3,7,4,4,8,8,0.318577,0.328413,0,No
1,1,1,1,1,2,1,1,2,8,0.303661,0.312967,0,No
1,1,1,1,1,2,1,1,2,8,0.339934,0.352194,0,No
2,2,4,2,2,4,2,2,4,7,0.305422,0.31691,0,No
1,1,1,1,1,2,1,1,2,8,0.303375,0.311466,0,No
2,2,4,2,2,4,2,2,4,8,0.323481,0.33452,0,No
7,7,49,3,1,4,7,7,14,8,0.303375,0.311466,0,No
1,1,1,1,1,2,1,1,2,8,0.32342,0.334424,0,No
2,2,4,1,1,2,2,2,4,8,0.339941,0.352199,0,No
1,1,1,1,1,2,1,1,2,8,0.28349,0.292904,0,No
1,1,1,1,1,2,1,1,2,8,0.30338,0.311471,0,No
1,1,1,1,1,2,1,1,2,8,0.323426,0.334429,0,No
1,1,1,1,1,2,1,1,2,8,0.28349,0.292904,0,No
3,3,9,2,1,3,3,3,6,8,0.288168,0.299068,0,No
1,1,1,1,1,2,1,1,2,8,0.339934,0.352194,0,No
1,1,1,1,1,2,1,1,2,8,0.317901,0.325044,0,No
1,1,1,1,1,2,1,1,2,8,0.296996,0.304154,0,No
2,2,4,2,2,4,2,2,4,8,0.322802,0.330195,0,No
1,1,1,1,1,2,1,1,2,8,0.30338,0.311471,0,No
1,1,1,1,1,2,1,1,2,8,0.32342,0.334424,0,No
1,1,1,1,1,2,1,1,2,8,0.301589,0.314491,0,No
2,2,4,2,2,4,2,2,4,8,0.309707,0.31773,0,No
1,1,1,1,1,2,1,1,2,8,0.310033,0.318684,0,No
1,1,1,1,1,2,1,1,2,8,0.331571,0.343073,0,No
2,2,4,1,2,3,2,2,4,7,0.298466,0.307041,0,No
2,2,4,1,1,2,2,2,4,8,0.339941,0.352199,0,No
2,2,4,2,1,3,2,2,4,8,0.301589,0.314491,0,No
1,1,1,1,1,2,1,1,2,8,0.339934,0.352194,0,No
2,2,4,1,1,2,2,2,4,8,0.339934,0.352194,0,No
1,1,1,1,1,2,1,1,2,8,0.339934,0.352194,0,No
1,1,1,1,1,2,1,1,2,8,0.306448,0.313104,0,No
2,2,4,1,1,2,2,2,4,8,0.26357,0.269925,0,No
2,1,2,2,2,4,2,2,4,8,0.301589,0.314491,0,No
2,2,4,2,2,4,2,2,4,8,0.324305,0.335748,0,No
3,3,9,1,2,3,3,3,6,8,0.294078,0.301062,0,No
4,4,16,4,4,8,4,4,8,7,0.349752,0.364051,0,No
1,1,1,1,1,2,1,1,2,9,0.303807,0.312038,0,No
1,1,1,1,1,2,1,1,2,8,0.303688,0.310784,0,No
1,1,1,1,1,2,1,1,2,8,0.29171,0.298881,0,No
3,3,9,2,2,4,3,3,6,8,0.313941,0.323264,0,No
2,2,4,1,2,3,2,2,4,8,0.281935,0.291429,0,No
1,1,1,1,1,2,1,1,2,8,0.281549,0.288506,0,No
1,1,1,1,1,2,1,1,2,8,0.255442,0.260358,0,No
2,2,4,2,2,4,2,2,4,8,0.2924,0.299975,0,No
1,1,1,1,1,2,1,1,2,8,0.303661,0.312967,0,No
2,2,4,1,1,2,2,2,4,9,0.243208,0.24642,0,No
1,1,1,1,1,2,1,1,2,8,0.268912,0.275375,0,No
8,8,64,6,5,11,8,8,16,7,0.311193,0.320093,0,No
1,1,1,1,1,2,1,1,2,9,0.268637,0.276931,0,No
2,2,4,2,2,4,2,2,4,8,0.312515,0.31994,0,No
1,1,1,1,1,2,1,1,2,8,0.339934,0.352194,0,No
5,5,25,5,4,9,5,5,10,8,0.361566,0.377269,0,No
1,1,1,1,1,2,1,1,2,7,0.296305,0.304855,0,No
2,2,4,2,2,4,2,2,4,8,0.328609,0.339267,0,No
6,6,36,2,3,5,6,6,12,8,0.314218,0.327237,0,No
2,2,4,1,2,3,2,2,4,8,0.312727,0.319553,0,No
1,1,1,1,1,2,1,1,2,8,0.313502,0.320218,0,No
1,1,1,1,1,2,1,1,2,9,0.273696,0.280287,0,No
1,1,1,1,1,2,1,1,2,8,0.270309,0.276579,0,No
1,1,1,1,1,2,1,1,2,9,0.271121,0.277521,0,No
5,5,25,3,5,8,5,5,10,8,0.313768,0.321218,0,No
1,1,1,1,1,2,1,1,2,8,0.272172,0.278813,0,No
6,6,36,4,4,8,6,6,12,8,0.307835,0.314514,0,No
4,4,16,4,3,7,4,4,8,7,0.334496,0.346751,0,No
1,1,1,1,1,2,1,1,2,9,0.255733,0.261996,0,No
1,1,1,1,1,2,1,1,2,7,0.296305,0.304855,0,No
1,1,1,1,1,2,1,1,2,8,0.29229,0.30057,0,No
2,2,4,1,2,3,2,2,4,8,0.327832,0.339198,0,No
1,1,1,1,1,2,1,1,2,8,0.339941,0.352199,0,No
1,1,1,1,1,2,1,1,2,9,0.268721,0.277328,0,No
1,1,1,1,1,2,1,1,2,9,0.256074,0.261307,0,No
1,1,1,1,1,2,1,1,2,9,0.268721,0.277328,0,No
1,1,1,1,1,2,1,1,2,8,0.323426,0.334429,0,No
1,1,1,1,1,2,1,1,2,8,0.301589,0.314491,0,No
3,3,9,2,2,4,3,3,6,8,0.29081,0.301974,0,No
1,1,1,1,1,2,1,1,2,8,0.309062,0.315813,0,No
1,1,1,1,1,2,1,1,2,8,0.32342,0.334424,0,No
1,1,1,1,1,2,1,1,2,9,0.271596,0.278866,0,No
1,1,1,1,1,2,1,1,2,9,0.25212,0.257194,0,No
4,4,16,3,2,5,4,4,8,8,0.308754,0.317985,0,No
3,3,9,3,2,5,3,3,6,8,0.338243,0.351497,0,No
1,1,1,1,1,2,1,1,2,8,0.301584,0.308533,0,No
1,1,1,1,1,2,1,1,2,9,0.271721,0.278269,0,No
1,1,1,1,1,2,1,1,2,8,0.317895,0.325039,0,No
5,5,25,3,3,6,5,5,10,8,0.339839,0.35214,0,No
1,1,1,1,1,2,1,1,2,7,0.327819,0.338512,0,No
2,2,4,2,2,4,2,2,4,7,0.330339,0.340859,0,No
5,5,25,3,2,5,5,5,10,8,0.330961,0.343854,0,No
2,1,2,2,2,4,2,2,4,8,0.311011,0.322877,0,No
1,1,1,1,1,2,1,1,2,8,0.274554,0.283667,0,No
2,2,4,1,2,3,2,2,4,8,0.315958,0.325109,0,No
1,1,1,1,1,2,1,1,2,9,0.242042,0.246616,0,No
1,1,1,1,1,2,1,1,2,8,0.29234,0.299883,0,No
2,2,4,1,1,2,2,2,4,8,0.32342,0.334424,0,No
1,1,1,1,1,2,1,1,2,8,0.32342,0.334424,0,No
1,1,1,1,1,2,1,1,2,7,0.296305,0.304855,0,No
1,1,1,1,1,2,1,1,2,9,0.271173,0.278263,0,No
1,1,1,1,1,2,1,1,2,8,0.301578,0.314477,0,No
1,1,1,1,1,2,1,1,2,8,0.30338,0.311471,0,No
1,1,1,1,1,2,1,1,2,9,0.303801,0.312033,0,No
1,1,1,1,1,2,1,1,2,7,0.2963,0.30485,0,No
1,1,1,1,1,2,1,1,2,8,0.323426,0.334429,0,No
1,1,1,1,1,2,1,1,2,8,0.309325,0.317943,0,No
4,4,16,2,1,3,4,4,8,7,0.296305,0.304855,0,No
1,1,1,1,1,2,1,1,2,8,0.313497,0.320213,0,No
1,1,1,1,1,2,1,1,2,8,0.317439,0.327445,0,No
5,5,25,2,2,4,5,5,10,7,0.342218,0.354868,0,No
3,3,9,3,3,6,3,3,6,7,0.338578,0.349904,0,No
6,6,36,5,4,9,6,6,12,8,0.346534,0.360393,0,No
1,1,1,1,1,2,1,1,2,8,0.317445,0.327454,0,No
1,1,1,1,1,2,1,1,2,8,0.301589,0.314491,0,No
1,1,1,1,1,2,1,1,2,8,0.331578,0.343078,0,No
2,2,4,1,1,2,2,2,4,9,0.263403,0.271075,0,No
1,1,1,1,1,2,1,1,2,8,0.30946,0.31614,0,No
1,1,1,1,1,2,1,1,2,9,0.268721,0.277328,0,No
1,1,1,1,1,2,1,1,2,8,0.323426,0.334429,0,No
2,2,4,1,1,2,2,2,4,8,0.30338,0.311471,0,No
3,3,9,3,2,5,3,3,6,8,0.342335,0.354877,0,No
1,1,1,1,1,2,1,1,2,9,0.242032,0.245374,0,No
10,9,90,6,3,9,10,10,20,8,0.332917,0.345108,0,No
5,5,25,4,3,7,5,5,10,8,0.310411,0.321568,0,No
1,1,1,1,1,2,1,1,2,8,0.309325,0.317943,0,No
1,1,1,1,1,2,1,1,2,8,0.301589,0.314491,0,No
5,5,25,4,3,7,5,5,10,8,0.317363,0.326355,0,No
2,2,4,2,2,4,2,2,4,8,0.339948,0.352234,0,No
16,16,256,5,6,11,16,16,32,7,0.346056,0.360092,0,No
1,1,1,1,1,2,1,1,2,9,0.252449,0.257201,0,No
3,3,9,2,3,5,3,3,6,8,0.287125,0.296386,0,No
1,1,1,1,1,2,1,1,2,9,0.259988,0.266702,0,No
1,1,1,1,1,2,1,1,2,8,0.339934,0.352194,0,No
2,2,4,2,2,4,2,2,4,8,0.308224,0.316774,0,No
1,1,1,1,1,2,1,1,2,9,0.269099,0.277068,0,No
4,4,16,4,3,7,4,4,8,8,0.299756,0.312378,0,No
1,1,1,1,1,2,1,1,2,8,0.282879,0.290085,0,No
3,3,9,2,2,4,3,3,6,8,0.289052,0.299973,0,No
4,4,16,2,2,4,4,4,8,8,0.318334,0.327434,0,No
1,1,1,1,1,2,1,1,2,9,0.263403,0.271075,0,No
1,1,1,1,1,2,1,1,2,8,0.288163,0.299063,0,No
1,1,1,1,1,2,1,1,2,8,0.303655,0.312962,0,No
1,1,1,1,1,2,1,1,2,8,0.268214,0.275186,0,No
1,1,1,1,1,2,1,1,2,8,0.296438,0.303643,0,No
1,1,1,1,1,2,1,1,2,8,0.303375,0.311466,0,No
1,1,1,1,1,2,1,1,2,8,0.301589,0.314491,0,No
1,1,1,1,1,2,1,1,2,8,0.323426,0.334429,0,No
2,2,4,1,1,2,2,2,4,8,0.268219,0.275191,0,No
5,5,25,5,3,8,5,5,10,8,0.325935,0.337051,0,No
1,1,1,1,1,2,1,1,2,9,0.236009,0.239115,0,No
4,4,16,4,4,8,4,4,8,8,0.334195,0.345354,0,No
1,1,1,1,1,2,1,1,2,8,0.303375,0.311466,0,No
1,1,1,1,1,2,1,1,2,8,0.3113,0.3223,0,No
1,1,1,1,1,2,1,1,2,8,0.27122,0.279026,0,No
1,1,1,1,1,2,1,1,2,9,0.242606,0.248365,0,No
1,1,1,1,1,2,1,1,2,8,0.30833,0.31471,0,No
1,1,1,1,1,2,1,1,2,8,0.30068,0.307389,0,No
1,1,1,1,1,2,1,1,2,8,0.30833,0.31471,0,No
1,1,1,1,1,2,1,1,2,7,0.327819,0.338512,0,No
1,1,1,1,1,2,1,1,2,8,0.300516,0.307312,0,No
1,1,1,1,1,2,1,1,2,8,0.301589,0.314491,0,No
1,1,1,1,1,2,1,1,2,8,0.32342,0.334424,0,No
4,4,16,3,4,7,4,4,8,7,0.34079,0.353376,0,No
1,1,1,1,1,2,1,1,2,8,0.277096,0.285605,0,No
2,2,4,1,1,2,2,2,4,8,0.32342,0.334424,0,No
3,3,9,2,2,4,3,3,6,8,0.309336,0.317982,0,No
1,1,1,1,1,2,1,1,2,8,0.331571,0.343073,0,No
2,2,4,1,1,2,2,2,4,8,0.309331,0.317947,0,No
1,1,1,1,1,2,1,1,2,7,0.296305,0.304855,0,No
1,1,1,1,1,2,1,1,2,8,0.339934,0.352194,0,No
1,1,1,1,1,2,1,1,2,8,0.309325,0.317943,0,No
2,2,4,2,2,4,2,2,4,8,0.338015,0.350314,0,No
3,3,9,3,3,6,3,3,6,7,0.323666,0.332983,0,No
1,1,1,1,1,2,1,1,2,9,0.252172,0.257216,0,No
4,4,16,2,3,5,4,4,8,8,0.344081,0.358034,0,No
12,12,144,3,2,5,12,12,24,8,0.333294,0.344918,0,No
1,1,1,1,1,2,1,1,2,8,0.278184,0.28559,0,No
2,2,4,2,2,4,2,2,4,8,0.346281,0.360278,0,No
1,1,1,1,1,2,1,1,2,7,0.327826,0.338517,0,No
3,3,9,2,2,4,3,3,6,8,0.289498,0.300189,0,No
1,1,1,1,1,2,1,1,2,8,0.339934,0.352194,0,No
3,3,9,2,3,5,3,3,6,7,0.344881,0.357992,0,No
1,1,1,1,1,2,1,1,2,8,0.276503,0.2834,0,No
3,3,9,1,3,4,3,3,6,8,0.317788,0.328022,0,No
2,2,4,1,2,3,2,2,4,8,0.310253,0.317791,0,No
1,1,1,1,1,2,1,1,2,8,0.309325,0.317943,0,No
2,2,4,1,1,2,2,2,4,8,0.309325,0.317943,0,No
1,1,1,1,1,2,1,1,2,8,0.306448,0.313104,0,No
2,2,4,1,2,3,2,2,4,8,0.310394,0.319213,0,No
1,1,1,1,1,2,1,1,2,8,0.271899,0.280395,0,No
2,2,4,2,2,4,2,2,4,8,0.296892,0.306594,0,No
1,1,1,1,1,2,1,1,2,8,0.309331,0.317947,0,No
1,1,1,1,1,2,1,1,2,8,0.309325,0.317943,0,No
3,3,9,1,3,4,3,3,6,8,0.316603,0.325491,0,No
1,1,1,1,1,2,1,1,2,9,0.267027,0.273411,0,No
1,1,1,1,1,2,1,1,2,8,0.32342,0.334424,0,No
8,7,56,6,7,13,8,8,16,7,0.342253,0.355126,0,No
1,1,1,1,1,2,1,1,2,8,0.339934,0.352194,0,No
2,2,4,2,2,4,2,2,4,8,0.338243,0.351497,0,No
5,5,25,3,4,7,5,5,10,8,0.350312,0.36533,0,No
1,1,1,1,1,2,1,1,2,8,0.323426,0.334429,0,No
1,1,1,1,1,2,1,1,2,8,0.261823,0.267414,0,No
2,2,4,2,1,3,2,2,4,9,0.268641,0.276936,0,No
4,4,16,3,4,7,4,4,8,8,0.348239,0.361857,0,No
1,1,1,1,1,2,1,1,2,8,0.283486,0.292899,0,No
1,1,1,1,1,2,1,1,2,8,0.303655,0.312962,0,No
1,1,1,1,1,2,1,1,2,9,0.261775,0.267501,0,No
1,1,1,1,1,2,1,1,2,8,0.30833,0.31471,0,No
1,1,1,1,1,2,1,1,2,8,0.303364,0.310131,0,No
2,2,4,2,2,4,2,2,4,7,0.352614,0.366956,0,No
1,1,1,1,1,2,1,1,2,8,0.331578,0.343078,0,No
1,1,1,1,1,2,1,1,2,8,0.32342,0.334424,0,No
1,1,1,1,1,2,1,1,2,9,0.268713,0.277313,0,No
2,2,4,2,2,4,2,2,4,8,0.338243,0.351497,0,No
4,3,12,3,3,6,4,4,8,7,0.317298,0.325022,0,No
1,1,1,1,1,2,1,1,2,8,0.288934,0.297717,0,No
1,1,1,1,1,2,1,1,2,8,0.323426,0.334429,0,No
1,1,1,1,1,2,1,1,2,8,0.301589,0.314491,0,No
1,1,1,1,1,2,1,1,2,9,0.303801,0.312033,0,No
1,1,1,1,1,2,1,1,2,8,0.323426,0.334429,0,No
1,1,1,1,1,2,1,1,2,7,0.327819,0.338512,0,No
1,1,1,1,1,2,1,1,2,9,0.244982,0.249049,0,No
1,1,1,1,1,2,1,1,2,8,0.27455,0.283664,0,No
1,1,1,1,1,2,1,1,2,8,0.27455,0.283664,0,No
1,1,1,1,1,2,1,1,2,8,0.303375,0.311466,0,No
1,1,1,1,1,2,1,1,2,9,0.266272,0.272882,0,No
2,2,4,1,1,2,2,2,4,8,0.331571,0.343073,0,No
1,1,1,1,1,2,1,1,2,8,0.308548,0.315803,0,No
3,3,9,3,3,6,3,3,6,8,0.322802,0.330745,0,No
1,1,1,1,1,2,1,1,2,8,0.26742,0.273619,0,No
1,1,1,1,1,2,1,1,2,8,0.32342,0.334424,0,No
1,1,1,1,1,2,1,1,2,8,0.32342,0.334424,0,No
2,2,4,1,2,3,2,2,4,7,0.326777,0.338298,0,No
1,1,1,1,1,2,1,1,2,8,0.283279,0.290422,0,No
2,2,4,1,2,3,2,2,4,8,0.323445,0.334473,0,No
1,1,1,1,1,2,1,1,2,8,0.280466,0.287419,0,No
2,2,4,1,2,3,2,2,4,8,0.305416,0.314633,0,No
1,1,1,1,1,2,1,1,2,8,0.317445,0.327454,0,No
2,2,4,1,1,2,2,2,4,7,0.2963,0.30485,0,No
2,2,4,2,2,4,2,2,4,8,0.292646,0.300414,0,No
1,1,1,1,1,2,1,1,2,8,0.32342,0.334424,0,No
1,1,1,1,1,2,1,1,2,8,0.339934,0.352194,0,No
3,3,9,1,2,3,3,3,6,8,0.342617,0.356522,0,No
4,4,16,4,3,7,4,4,8,8,0.34303,0.356879,0,No
1,1,1,1,1,2,1,1,2,8,0.286244,0.293449,0,No
1,1,1,1,1,2,1,1,2,8,0.26052,0.265893,0,No
1,1,1,1,1,2,1,1,2,8,0.307813,0.314411,0,No
2,2,4,2,2,4,2,2,4,8,0.349637,0.363925,0,No
5,5,25,1,5,6,5,5,10,8,0.372083,0.389704,0,No
2,2,4,2,2,4,2,2,4,8,0.27973,0.287499,0,No
5,5,25,3,3,6,5,5,10,8,0.349867,0.364194,0,No
8,8,64,5,6,11,8,8,16,8,0.364415,0.380711,0,No
1,1,1,1,1,2,1,1,2,8,0.286976,0.294369,0,No
1,1,1,1,1,2,1,1,2,8,0.283486,0.292899,0,No
1,1,1,1,1,2,1,1,2,8,0.299745,0.307615,0,No
1,1,1,1,1,2,1,1,2,8,0.309758,0.316292,0,No
5,5,25,2,3,5,5,5,10,8,0.312996,0.322066,0,No
2,2,4,2,2,4,2,2,4,8,0.32425,0.335155,0,No
2,2,4,2,2,4,2,2,4,8,0.314682,0.323791,0,No
1,1,1,1,1,2,1,1,2,8,0.282795,0.289819,0,No
2,2,4,1,1,2,2,2,4,7,0.327819,0.338512,0,No
1,1,1,1,1,2,1,1,2,7,0.327819,0.338512,0,No
2,2,4,1,1,2,2,2,4,8,0.277096,0.285605,0,No
1,1,1,1,1,2,1,1,2,8,0.317292,0.324388,0,No
1,1,1,1,1,2,1,1,2,9,0.268641,0.276936,0,No
1,1,1,1,1,2,1,1,2,8,0.310033,0.318684,0,No
2,2,4,1,1,2,2,2,4,8,0.293138,0.300755,0,No
5,5,25,3,2,5,5,5,10,8,0.305904,0.318342,0,No
5,5,25,3,1,4,5,5,10,8,0.339934,0.352194,0,No
2,2,4,2,2,4,2,2,4,8,0.332573,0.344483,0,No
12,12,144,1,1,2,12,12,24,8,0.32342,0.334424,0,No
1,1,1,1,1,2,1,1,2,8,0.309325,0.317943,0,No
1,1,1,1,1,2,1,1,2,8,0.301584,0.314486,0,No
2,2,4,1,1,2,2,2,4,8,0.303655,0.312962,0,No
2,2,4,1,2,3,2,2,4,8,0.313031,0.322168,0,No
1,1,1,1,1,2,1,1,2,8,0.288168,0.299068,0,No
1,1,1,1,1,2,1,1,2,8,0.303845,0.310259,0,No
1,1,1,1,1,2,1,1,2,8,0.301584,0.314486,0,No
2,2,4,2,2,4,2,2,4,8,0.313048,0.323948,0,No
3,3,9,2,1,3,3,3,6,8,0.305116,0.311592,0,No
1,1,1,1,1,2,1,1,2,8,0.307813,0.314411,0,No
1,1,1,1,1,2,1,1,2,8,0.274329,0.282188,0,No
1,1,1,1,1,2,1,1,2,8,0.303655,0.312962,0,No
1,1,1,1,1,2,1,1,2,8,0.317292,0.324388,0,No
1,1,1,1,1,2,1,1,2,8,0.271899,0.280395,0,No
1,1,1,1,1,2,1,1,2,7,0.2963,0.30485,0,No
2,2,4,2,2,4,2,2,4,7,0.316052,0.325456,0,No
1,1,1,1,1,2,1,1,2,8,0.281712,0.288655,0,No
1,1,1,1,1,2,1,1,2,9,0.276056,0.283078,0,No
1,1,1,1,1,2,1,1,2,9,0.276051,0.283073,0,No
1,1,1,1,1,2,1,1,2,8,0.270768,0.277084,0,No
1,1,1,1,1,2,1,1,2,8,0.32342,0.334424,0,No
1,1,1,1,1,2,1,1,2,8,0.32342,0.334424,0,No
2,2,4,2,2,4,2,2,4,8,0.315083,0.329711,0,No
1,1,1,1,1,2,1,1,2,8,0.309331,0.317947,0,No
1,1,1,1,1,2,1,1,2,7,0.296305,0.304855,0,No
3,3,9,1,2,3,3,3,6,9,0.25127,0.255636,0,No
4,4,16,3,2,5,4,4,8,7,0.342218,0.354868,0,No
1,1,1,1,1,2,1,1,2,8,0.339934,0.352194,0,No
1,1,1,1,1,2,1,1,2,9,0.268641,0.276936,0,No
8,8,64,5,2,7,8,8,16,8,0.324577,0.335516,0,No
1,1,1,1,1,2,1,1,2,8,0.323414,0.334415,0,No
2,2,4,1,1,2,2,2,4,8,0.271899,0.280395,0,No
3,3,9,3,2,5,3,3,6,8,0.279588,0.286633,0,No
2,2,4,1,1,2,2,2,4,9,0.263407,0.269134,0,No
1,1,1,1,1,2,1,1,2,9,0.263407,0.269134,0,No
3,3,9,2,2,4,3,3,6,8,0.323979,0.335279,0,No
1,1,1,1,1,2,1,1,2,8,0.311306,0.32231,0,No
1,1,1,1,1,2,1,1,2,7,0.2963,0.30485,0,No
2,2,4,2,2,4,2,2,4,8,0.301089,0.31191,0,No
2,2,4,1,1,2,2,2,4,8,0.267416,0.274309,0,No
1,1,1,1,1,2,1,1,2,9,0.281057,0.288122,0,No
1,1,1,1,1,2,1,1,2,8,0.288934,0.297717,0,No
5,5,25,1,3,4,5,5,10,8,0.328292,0.339828,0,No
3,3,9,1,1,2,3,3,6,8,0.32342,0.334424,0,No
1,1,1,1,1,2,1,1,2,9,0.252973,0.258264,0,No
3,3,9,2,2,4,3,3,6,8,0.29756,0.304407,0,No
1,1,1,1,1,2,1,1,2,8,0.289852,0.296924,0,No
1,1,1,1,1,2,1,1,2,7,0.327819,0.338512,0,No
1,1,1,1,1,2,1,1,2,8,0.314589,0.321465,0,No
1,1,1,1,1,2,1,1,2,8,0.277096,0.285605,0,No
1,1,1,1,1,2,1,1,2,9,0.250842,0.255927,0,No
2,2,4,1,1,2,2,2,4,9,0.273696,0.280287,0,No
2,2,4,1,1,2,2,2,4,8,0.286528,0.293662,0,No
1,1,1,1,1,2,1,1,2,9,0.240487,0.243945,0,No
3,3,9,3,1,4,3,3,6,7,0.327819,0.338512,0,No
1,1,1,1,1,2,1,1,2,8,0.313497,0.320213,0,No
1,1,1,1,1,2,1,1,2,8,0.339934,0.352194,0,No
2,2,4,2,2,4,2,2,4,8,0.276449,0.283562,0,No
4,4,16,2,3,5,4,4,8,8,0.320366,0.327785,0,No
5,5,25,4,3,7,5,5,10,8,0.331063,0.342991,0,No
1,1,1,1,1,2,1,1,2,8,0.32342,0.334424,0,No
3,3,9,2,2,4,3,3,6,8,0.338243,0.351497,0,No
1,1,1,1,1,2,1,1,2,8,0.32342,0.334424,0,No
2,2,4,2,2,4,2,2,4,8,0.325084,0.336656,0,No
7,7,49,4,4,8,7,7,14,7,0.330653,0.34263,0,No
9,9,81,8,1,9,9,9,18,8,0.32342,0.334424,0,No
5,5,25,3,3,6,5,5,10,8,0.329211,0.33988,0,No
1,1,1,1,1,2,1,1,2,8,0.30385,0.310264,0,No
3,3,9,2,2,4,3,3,6,8,0.309112,0.317972,0,No
1,1,1,1,1,2,1,1,2,9,0.244127,0.247285,0,No
2,2,4,1,1,2,2,2,4,8,0.288168,0.299068,0,No
1,1,1,1,1,2,1,1,2,8,0.303655,0.312962,0,No
1,1,1,1,1,2,1,1,2,9,0.244127,0.247285,0,No
2,2,4,1,2,3,2,2,4,8,0.299068,0.305824,0,No
1,1,1,1,1,2,1,1,2,8,0.278962,0.28591,0,No
1,1,1,1,1,2,1,1,2,8,0.265452,0.271896,0,No
2,2,4,1,1,2,2,2,4,8,0.303655,0.312962,0,No
1,1,1,1,1,2,1,1,2,8,0.295658,0.302666,0,No
2,2,4,1,1,2,2,2,4,8,0.303655,0.312962,0,No
4,4,16,4,3,7,4,4,8,8,0.315153,0.323281,0,No
1,1,1,1,1,2,1,1,2,9,0.244127,0.247285,0,No
8,8,64,1,1,2,8,8,16,8,0.265452,0.271896,0,No
1,1,1,1,1,2,1,1,2,9,0.244127,0.247285,0,No
3,3,9,2,2,4,3,3,6,8,0.345692,0.358823,0,No
3,3,9,2,2,4,3,3,6,7,0.342218,0.354868,0,No
2,2,4,2,2,4,2,2,4,7,0.302782,0.312964,0,No
4,4,16,3,3,6,4,4,8,7,0.309034,0.320583,0,No
2,1,2,2,2,4,2,2,4,8,0.302482,0.309816,0,No
3,3,9,2,2,4,3,3,6,8,0.310253,0.317541,0,No
1,1,1,1,1,2,1,1,2,8,0.305116,0.311592,0,No
2,2,4,2,2,4,2,2,4,8,0.307065,0.313419,0,No
7,7,49,5,4,9,7,7,14,8,0.361397,0.377078,0,No
1,1,1,1,1,2,1,1,2,8,0.307819,0.314416,0,No
2,2,4,2,2,4,2,2,4,9,0.264752,0.272018,0,No
4,4,16,3,3,6,4,4,8,7,0.34341,0.356305,0,No
2,2,4,1,1,2,2,2,4,8,0.339934,0.352194,0,No
2,2,4,1,1,2,2,2,4,8,0.323426,0.334429,0,No
2,2,4,1,1,2,2,2,4,8,0.295402,0.302692,0,No
1,1,1,1,1,2,1,1,2,8,0.27455,0.283664,0,No
1,1,1,1,1,2,1,1,2,8,0.339934,0.352194,0,No
1,1,1,1,1,2,1,1,2,8,0.291905,0.299149,0,No
1,1,1,1,1,2,1,1,2,8,0.301589,0.314491,0,No
2,2,4,2,1,3,2,2,4,8,0.32342,0.334424,0,No
5,5,25,4,3,7,5,5,10,8,0.341608,0.354766,0,No
1,1,1,1,1,2,1,1,2,8,0.301589,0.314491,0,No
1,1,1,1,1,2,1,1,2,7,0.296305,0.304855,0,No
1,1,1,1,1,2,1,1,2,7,0.296305,0.304855,0,No
3,3,9,2,3,5,3,3,6,8,0.307015,0.313618,0,No
5,5,25,4,4,8,5,5,10,7,0.339016,0.350885,0,No
2,2,4,1,1,2,2,2,4,8,0.303375,0.311466,0,No
2,2,4,2,1,3,2,2,4,9,0.259056,0.26452,0,No
2,2,4,2,1,3,2,2,4,7,0.327819,0.338512,0,No
2,2,4,1,1,2,2,2,4,8,0.301584,0.314486,0,No
3,3,9,3,2,5,3,3,6,7,0.352621,0.366966,0,No
2,2,4,1,2,3,2,2,4,8,0.332865,0.344367,0,No
1,1,1,1,1,2,1,1,2,8,0.271899,0.280395,0,No
3,3,9,2,2,4,3,3,6,8,0.325307,0.337114,0,No
1,1,1,1,1,2,1,1,2,9,0.249135,0.253575,0,No
2,2,4,2,2,4,2,2,4,8,0.306178,0.318508,0,No
1,1,1,1,1,2,1,1,2,8,0.2828,0.289824,0,No
4,4,16,3,1,4,4,4,8,8,0.301584,0.314486,0,No
2,2,4,2,2,4,2,2,4,8,0.289459,0.296582,0,No
1,1,1,1,1,2,1,1,2,8,0.301589,0.314491,0,No
1,1,1,1,1,2,1,1,2,8,0.258887,0.264583,0,No
2,2,4,2,1,3,2,2,4,8,0.301584,0.314486,0,No
2,2,4,2,2,4,2,2,4,8,0.328995,0.340857,0,No
3,3,9,2,2,4,3,3,6,8,0.304359,0.31767,0,No
3,3,9,2,3,5,3,3,6,8,0.318845,0.326185,0,No
8,8,64,6,7,13,8,8,16,8,0.321767,0.330377,0,No
1,1,1,1,1,2,1,1,2,8,0.271899,0.280395,0,No
1,1,1,1,1,2,1,1,2,8,0.301584,0.314486,0,No
1,1,1,1,1,2,1,1,2,7,0.327826,0.338517,0,No
6,5,30,2,2,4,6,6,12,8,0.313635,0.32099,0,No
1,1,1,1,1,2,1,1,2,8,0.288163,0.299063,0,No
1,1,1,1,1,2,1,1,2,8,0.277249,0.28473,0,No
2,2,4,1,2,3,2,2,4,8,0.315083,0.329711,0,No
1,1,1,1,1,2,1,1,2,8,0.294484,0.301605,0,No
3,3,9,3,1,4,3,3,6,7,0.327819,0.338512,0,No
3,3,9,1,1,2,3,3,6,8,0.339934,0.352194,0,No
3,3,9,3,3,6,3,3,6,7,0.334496,0.346751,0,No
2,2,4,2,2,4,2,2,4,8,0.331675,0.343195,0,No
1,1,1,1,1,2,1,1,2,8,0.29338,0.300813,0,No
1,1,1,1,1,2,1,1,2,8,0.265382,0.271498,0,No
1,1,1,1,1,2,1,1,2,8,0.265382,0.271498,0,No
1,1,1,1,1,2,1,1,2,8,0.288929,0.297713,0,No
1,1,1,1,1,2,1,1,2,8,0.310028,0.318679,0,No
1,1,1,1,1,2,1,1,2,8,0.310028,0.318679,0,No
1,1,1,1,1,2,1,1,2,7,0.296305,0.304855,0,No
1,1,1,1,1,2,1,1,2,8,0.310022,0.31867,0,No
2,2,4,2,2,4,2,2,4,8,0.315386,0.32508,0,No
3,3,9,3,2,5,3,3,6,8,0.31538,0.325075,0,No
2,2,4,1,2,3,2,2,4,8,0.280503,0.289358,0,No
6,6,36,6,5,11,6,6,12,8,0.366355,0.383401,0,No
1,1,1,1,1,2,1,1,2,8,0.271894,0.28039,0,No
1,1,1,1,1,2,1,1,2,8,0.299745,0.307615,0,No
1,1,1,1,1,2,1,1,2,8,0.331571,0.343073,0,No
1,1,1,1,1,2,1,1,2,8,0.303655,0.312962,0,No
1,1,1,1,1,2,1,1,2,7,0.296305,0.304855,0,No
1,1,1,1,1,2,1,1,2,8,0.271894,0.28039,0,No
1,1,1,1,1,2,1,1,2,8,0.310028,0.318679,0,No
6,5,30,2,1,3,6,6,12,8,0.27455,0.283664,0,No
3,3,9,1,3,4,3,3,6,8,0.352425,0.367794,0,No
1,1,1,1,1,2,1,1,2,8,0.288934,0.297717,0,No
1,1,1,1,1,2,1,1,2,8,0.339934,0.352194,0,No
1,1,1,1,1,2,1,1,2,8,0.271656,0.278056,0,No
1,1,1,1,1,2,1,1,2,9,0.303807,0.312038,0,No
1,1,1,1,1,2,1,1,2,9,0.254322,0.259238,0,No
1,1,1,1,1,2,1,1,2,7,0.296305,0.304855,0,No
1,1,1,1,1,2,1,1,2,9,0.269396,0.275731,0,No
1,1,1,1,1,2,1,1,2,8,0.301594,0.314494,0,No
2,2,4,2,2,4,2,2,4,8,0.327675,0.33951,0,No
2,2,4,1,1,2,2,2,4,8,0.294469,0.301552,0,No
7,7,49,5,6,11,7,7,14,7,0.349946,0.364507,0,No
1,1,1,1,1,2,1,1,2,8,0.301584,0.314486,0,No
2,2,4,2,2,4,2,2,4,7,0.330096,0.341269,0,No
1,1,1,1,1,2,1,1,2,8,0.303375,0.311466,0,No
1,1,1,1,1,2,1,1,2,8,0.30338,0.311471,0,No
19,17,323,6,1,7,19,19,38,7,0.327819,0.338512,0,No
2,2,4,2,1,3,2,2,4,8,0.263155,0.269091,0,No
2,2,4,1,2,3,2,2,4,8,0.330961,0.343854,0,No
2,2,4,2,2,4,2,2,4,8,0.318138,0.325939,0,No
3,3,9,2,3,5,3,3,6,7,0.341342,0.354355,0,No
3,3,9,1,3,4,3,3,6,8,0.353257,0.367803,0,No
2,2,4,2,2,4,2,2,4,8,0.295627,0.302831,0,No
2,2,4,2,2,4,2,2,4,7,0.328236,0.339009,0,No
1,1,1,1,1,2,1,1,2,8,0.313497,0.320213,0,No
1,1,1,1,1,2,1,1,2,8,0.288158,0.299054,0,No
1,1,1,1,1,2,1,1,2,8,0.301584,0.314486,0,No
3,3,9,3,2,5,3,3,6,7,0.333262,0.343731,0,No
1,1,1,1,1,2,1,1,2,9,0.267613,0.274069,0,No
1,1,1,1,1,2,1,1,2,8,0.279241,0.286909,0,No
1,1,1,1,1,2,1,1,2,8,0.339934,0.352194,0,No
1,1,1,1,1,2,1,1,2,8,0.296444,0.303607,0,No
1,1,1,1,1,2,1,1,2,9,0.24989,0.25444,0,No
1,1,1,1,1,2,1,1,2,8,0.32342,0.334424,0,No
1,1,1,1,1,2,1,1,2,8,0.309325,0.317943,0,No
1,1,1,1,1,2,1,1,2,8,0.315765,0.323492,0,No
1,1,1,1,1,2,1,1,2,8,0.282856,0.289962,0,No
1,1,1,1,1,2,1,1,2,8,0.288168,0.299068,0,No
1,1,1,1,1,2,1,1,2,8,0.339934,0.352194,0,No
1,1,1,1,1,2,1,1,2,8,0.308548,0.315803,0,No
7,6,42,4,5,9,7,7,14,7,0.327034,0.336701,0,No
1,1,1,1,1,2,1,1,2,8,0.309331,0.317947,0,No
1,1,1,1,1,2,1,1,2,9,0.244305,0.248584,0,No
1,1,1,1,1,2,1,1,2,8,0.32342,0.334424,0,No
1,1,1,1,1,2,1,1,2,8,0.30338,0.311471,0,No
1,1,1,1,1,2,1,1,2,8,0.296161,0.303803,0,No
1,1,1,1,1,2,1,1,2,8,0.288934,0.297717,0,No
1,1,1,1,1,2,1,1,2,8,0.303375,0.311466,0,No
1,1,1,1,1,2,1,1,2,8,0.323426,0.334429,0,No
2,2,4,2,1,3,2,2,4,8,0.339934,0.352194,0,No
2,2,4,2,2,4,2,2,4,8,0.279213,0.288783,0,No
4,4,16,2,2,4,4,4,8,8,0.319161,0.329088,0,No
1,1,1,1,1,2,1,1,2,8,0.271821,0.278185,0,No
1,1,1,1,1,2,1,1,2,9,0.244979,0.249046,0,No
1,1,1,1,1,2,1,1,2,9,0.269082,0.275579,0,No
1,1,1,1,1,2,1,1,2,8,0.313497,0.320213,0,No
1,1,1,1,1,2,1,1,2,8,0.317451,0.327459,0,No
2,2,4,2,2,4,2,2,4,8,0.300194,0.310673,0,No
1,1,1,1,1,2,1,1,2,8,0.299745,0.307615,0,No
1,1,1,1,1,2,1,1,2,8,0.310722,0.317507,0,No
1,1,1,1,1,2,1,1,2,8,0.301589,0.314491,0,No
2,2,4,1,1,2,2,2,4,8,0.288163,0.299063,0,No
1,1,1,1,1,2,1,1,2,8,0.339941,0.352199,0,No
1,1,1,1,1,2,1,1,2,8,0.32342,0.334424,0,No
1,1,1,1,1,2,1,1,2,9,0.254239,0.259158,0,No
3,3,9,3,2,5,3,3,6,8,0.332185,0.343952,0,No
1,1,1,1,1,2,1,1,2,8,0.280914,0.28788,0,No
1,1,1,1,1,2,1,1,2,8,0.339934,0.352194,0,No
1,1,1,1,1,2,1,1,2,8,0.339941,0.352199,0,No
3,3,9,2,2,4,3,3,6,8,0.340511,0.352966,0,No
1,1,1,1,1,2,1,1,2,8,0.271899,0.280395,0,No
1,1,1,1,1,2,1,1,2,8,0.323426,0.334429,0,No
2,2,4,1,1,2,2,2,4,8,0.313497,0.320213,0,No
1,1,1,1,1,2,1,1,2,9,0.264892,0.270598,0,No
1,1,1,1,1,2,1,1,2,8,0.339941,0.352199,0,No
2,2,4,2,2,4,2,2,4,8,0.339948,0.352234,0,No
1,1,1,1,1,2,1,1,2,7,0.327819,0.338512,0,No
1,1,1,1,1,2,1,1,2,7,0.327826,0.338517,0,No
1,1,1,1,1,2,1,1,2,9,0.237527,0.241056,0,No
2,2,4,2,2,4,2,2,4,8,0.303785,0.310821,0,No
1,1,1,1,1,2,1,1,2,8,0.286894,0.294746,0,No
1,1,1,1,1,2,1,1,2,8,0.331571,0.343073,0,No
4,4,16,1,2,3,4,4,8,8,0.288032,0.299918,0,No
1,1,1,1,1,2,1,1,2,8,0.310722,0.317507,0,No
1,1,1,1,1,2,1,1,2,7,0.312584,0.319273,0,No
1,1,1,1,1,2,1,1,2,8,0.30359,0.310474,0,No
1,1,1,1,1,2,1,1,2,7,0.327826,0.338517,0,No
2,2,4,2,2,4,2,2,4,8,0.307652,0.316606,0,No
2,2,4,2,2,4,2,2,4,8,0.275232,0.284507,0,No
1,1,1,1,1,2,1,1,2,8,0.317439,0.327445,0,No
1,1,1,1,1,2,1,1,2,8,0.299835,0.307302,0,No
1,1,1,1,1,2,1,1,2,8,0.269643,0.276191,0,No
1,1,1,1,1,2,1,1,2,9,0.265932,0.272147,0,No
1,1,1,1,1,2,1,1,2,7,0.2963,0.30485,0,No
2,2,4,1,1,2,2,2,4,7,0.327826,0.338517,0,No
2,2,4,1,2,3,2,2,4,8,0.309264,0.317538,0,No
4,4,16,4,3,7,4,4,8,7,0.345091,0.358125,0,No
3,3,9,3,3,6,3,3,6,8,0.342122,0.35487,0,No
4,4,16,1,4,5,4,4,8,8,0.336263,0.347116,0,No
2,2,4,2,2,4,2,2,4,8,0.31329,0.322999,0,No
1,1,1,1,1,2,1,1,2,8,0.313508,0.320221,0,No
1,1,1,1,1,2,1,1,2,8,0.292405,0.299561,0,No
1,1,1,1,1,2,1,1,2,9,0.268641,0.276936,0,No
3,2,6,2,2,4,3,3,6,7,0.341458,0.354156,0,No
2,2,4,1,1,2,2,2,4,8,0.331571,0.343073,0,No
2,2,4,2,1,3,2,2,4,8,0.331571,0.343073,0,No
1,1,1,1,1,2,1,1,2,8,0.331571,0.343073,0,No
2,2,4,2,1,3,2,2,4,8,0.314583,0.32146,0,No
1,1,1,1,1,2,1,1,2,8,0.314583,0.32146,0,No
1,1,1,1,1,2,1,1,2,9,0.246212,0.250629,0,No
1,1,1,1,1,2,1,1,2,8,0.339934,0.352194,0,No
1,1,1,1,1,2,1,1,2,7,0.327819,0.338512,0,No
1,1,1,1,1,2,1,1,2,8,0.295131,0.302082,0,No
4,4,16,2,3,5,4,4,8,8,0.325543,0.336532,0,No
1,1,1,1,1,2,1,1,2,8,0.32342,0.334424,0,No
3,3,9,1,2,3,3,3,6,8,0.291496,0.300612,0,No
5,5,25,3,4,7,5,5,10,8,0.339934,0.353055,0,No
3,3,9,2,2,4,3,3,6,8,0.313941,0.323264,0,No
4,3,12,4,4,8,4,4,8,8,0.330999,0.342536,0,No
1,1,1,1,1,2,1,1,2,8,0.293224,0.30019,0,No
2,2,4,2,2,4,2,2,4,7,0.31831,0.325849,0,No
4,4,16,4,2,6,4,4,8,8,0.342816,0.355495,0,No
1,1,1,1,1,2,1,1,2,8,0.32342,0.334424,0,No
1,1,1,1,1,2,1,1,2,7,0.296305,0.304855,0,No
4,4,16,3,3,6,4,4,8,8,0.324281,0.335457,0,No
9,9,81,4,7,11,9,9,18,7,0.370556,0.387431,0,No
5,5,25,3,2,5,5,5,10,7,0.331507,0.343048,0,No
4,4,16,1,2,3,4,4,8,7,0.332236,0.343545,0,No
2,2,4,1,1,2,2,2,4,8,0.279108,0.286245,0,No
1,1,1,1,1,2,1,1,2,8,0.339934,0.352194,0,No
1,1,1,1,1,2,1,1,2,9,0.255733,0.261996,0,No
2,2,4,1,1,2,2,2,4,7,0.327819,0.338512,0,No
1,1,1,1,1,2,1,1,2,7,0.327819,0.338512,0,No
6,6,36,2,1,3,6,6,12,7,0.327819,0.338512,0,No
3,3,9,3,3,6,3,3,6,7,0.340626,0.353603,0,No
1,1,1,1,1,2,1,1,2,8,0.288168,0.299068,0,No
1,1,1,1,1,2,1,1,2,8,0.32342,0.334424,0,No
2,2,4,1,1,2,2,2,4,9,0.267756,0.274472,0,No
1,1,1,1,1,2,1,1,2,8,0.29974,0.30761,0,No
1,1,1,1,1,2,1,1,2,8,0.315759,0.323487,0,No
1,1,1,1,1,2,1,1,2,9,0.26776,0.274477,0,No
1,1,1,1,1,2,1,1,2,8,0.276732,0.283742,0,No
1,1,1,1,1,2,1,1,2,9,0.25212,0.257194,0,No
5,5,25,4,5,9,5,5,10,8,0.313906,0.32566,0,No
1,1,1,1,1,2,1,1,2,8,0.310028,0.318679,0,No
1,1,1,1,1,2,1,1,2,8,0.30338,0.311471,0,No
2,1,2,1,2,3,2,2,4,8,0.288032,0.299918,0,No
1,1,1,1,1,2,1,1,2,8,0.265106,0.271106,0,No
1,1,1,1,1,2,1,1,2,7,0.327819,0.338512,0,No
1,1,1,1,1,2,1,1,2,8,0.311312,0.322315,0,No
1,1,1,1,1,2,1,1,2,7,0.327819,0.338512,0,No
2,2,4,1,2,3,2,2,4,9,0.249693,0.255124,0,No
1,1,1,1,1,2,1,1,2,7,0.327819,0.338512,0,No
3,3,9,1,1,2,3,3,6,7,0.327813,0.338503,0,No
1,1,1,1,1,2,1,1,2,8,0.30338,0.311471,0,No
1,1,1,1,1,2,1,1,2,9,0.255733,0.261996,0,No
1,1,1,1,1,2,1,1,2,8,0.303375,0.311466,0,No
3,3,9,1,1,2,3,3,6,7,0.327819,0.338512,0,No
1,1,1,1,1,2,1,1,2,8,0.27455,0.283664,0,No
1,1,1,1,1,2,1,1,2,8,0.299761,0.306442,0,No
2,2,4,2,1,3,2,2,4,8,0.30338,0.311471,0,No
6,5,30,4,3,7,6,6,12,7,0.330186,0.341205,0,No
2,2,4,1,1,2,2,2,4,8,0.310028,0.318679,0,No
1,1,1,1,1,2,1,1,2,8,0.339934,0.352194,0,No
1,1,1,1,1,2,1,1,2,7,0.327813,0.338503,0,No
1,1,1,1,1,2,1,1,2,8,0.27122,0.279026,0,No
1,1,1,1,1,2,1,1,2,7,0.327826,0.338517,0,No
2,2,4,1,1,2,2,2,4,8,0.339934,0.352194,0,No
1,1,1,1,1,2,1,1,2,8,0.310033,0.318684,0,No
8,8,64,3,5,8,8,8,16,8,0.348929,0.363215,0,No
1,1,1,1,1,2,1,1,2,8,0.287174,0.294461,0,No
2,2,4,2,2,4,2,2,4,8,0.342672,0.355554,0,No
2,2,4,1,2,3,2,2,4,8,0.293058,0.303008,0,No
1,1,1,1,1,2,1,1,2,9,0.255767,0.261015,0,No
1,1,1,1,1,2,1,1,2,8,0.32342,0.334424,0,No
1,1,1,1,1,2,1,1,2,8,0.323426,0.334429,0,No
1,1,1,1,1,2,1,1,2,8,0.331571,0.343073,0,No
1,1,1,1,1,2,1,1,2,9,0.268721,0.277328,0,No
9,9,81,4,2,6,9,9,18,8,0.325078,0.336647,0,No
5,5,25,5,2,7,5,5,10,8,0.330961,0.343854,0,No
1,1,1,1,1,2,1,1,2,8,0.32342,0.334424,0,No
4,4,16,4,4,8,4,4,8,8,0.33123,0.342606,0,No
1,1,1,1,1,2,1,1,2,8,0.301584,0.314486,0,No
1,1,1,1,1,2,1,1,2,8,0.32342,0.334424,0,No
1,1,1,1,1,2,1,1,2,8,0.303688,0.310784,0,No
1,1,1,1,1,2,1,1,2,8,0.284308,0.291246,0,No
1,1,1,1,1,2,1,1,2,8,0.30359,0.310474,0,No
3,3,9,2,2,4,3,3,6,8,0.330967,0.343859,0,No
2,2,4,2,2,4,2,2,4,8,0.344408,0.357419,0,No
5,5,25,3,2,5,5,5,10,8,0.32581,0.336851,0,No
1,1,1,1,1,2,1,1,2,9,0.279309,0.28665,0,No
1,1,1,1,1,2,1,1,2,8,0.27122,0.279026,0,No
1,1,1,1,1,2,1,1,2,8,0.27122,0.279026,0,No
3,3,9,3,3,6,3,3,6,8,0.329338,0.340205,0,No
1,1,1,1,1,2,1,1,2,8,0.27122,0.279026,0,No
2,2,4,1,1,2,2,2,4,8,0.317439,0.327445,0,No
1,1,1,1,1,2,1,1,2,9,0.254413,0.260022,0,No
2,2,4,1,1,2,2,2,4,8,0.27122,0.279026,0,No
1,1,1,1,1,2,1,1,2,8,0.289252,0.299287,0,No
4,4,16,4,4,8,4,4,8,8,0.325059,0.333567,0,No
2,2,4,1,1,2,2,2,4,8,0.339941,0.352199,0,No
5,5,25,2,3,5,5,5,10,8,0.306618,0.316783,0,No
2,2,4,2,2,4,2,2,4,8,0.282612,0.29246,0,No
1,1,1,1,1,2,1,1,2,8,0.303655,0.312962,0,No
1,1,1,1,1,2,1,1,2,8,0.284255,0.291831,0,No
3,3,9,2,2,4,3,3,6,8,0.312962,0.321647,0,No
1,1,1,1,1,2,1,1,2,8,0.279689,0.286598,0,No
2,2,4,2,2,4,2,2,4,8,0.302509,0.310813,0,No
3,3,9,3,3,6,3,3,6,8,0.342417,0.354879,0,No
1,1,1,1,1,2,1,1,2,8,0.271903,0.280398,0,No
1,1,1,1,1,2,1,1,2,8,0.339934,0.352194,0,No
7,7,49,3,3,6,7,7,14,8,0.344693,0.358075,0,No
2,2,4,1,1,2,2,2,4,8,0.313497,0.320213,0,No
1,1,1,1,1,2,1,1,2,9,0.250334,0.255138,0,No
2,2,4,2,2,4,2,2,4,8,0.303137,0.310452,0,No
1,1,1,1,1,2,1,1,2,8,0.282673,0.28976,0,No
2,2,4,1,1,2,2,2,4,9,0.252172,0.257216,0,No
1,1,1,1,1,2,1,1,2,8,0.285645,0.292647,0,No
2,2,4,2,2,4,2,2,4,8,0.308916,0.316165,0,No
2,2,4,1,1,2,2,2,4,8,0.277981,0.285017,0,No
1,1,1,1,1,2,1,1,2,8,0.291436,0.298416,0,No
4,4,16,4,3,7,4,4,8,8,0.310265,0.318402,0,No
1,1,1,1,1,2,1,1,2,7,0.296305,0.304855,0,No
1,1,1,1,1,2,1,1,2,9,0.303807,0.312038,0,No
2,2,4,1,1,2,2,2,4,8,0.296444,0.303647,0,No
1,1,1,1,1,2,1,1,2,8,0.258848,0.264107,0,No
1,1,1,1,1,2,1,1,2,8,0.27122,0.279026,0,No
1,1,1,1,1,2,1,1,2,8,0.331571,0.343073,0,No
2,2,4,2,2,4,2,2,4,8,0.283561,0.293008,0,No
1,1,1,1,1,2,1,1,2,8,0.277024,0.283891,0,No
1,1,1,1,1,2,1,1,2,7,0.327819,0.338512,0,No
1,1,1,1,1,2,1,1,2,7,0.327826,0.338517,0,No
1,1,1,1,1,2,1,1,2,8,0.295965,0.304324,0,No
1,1,1,1,1,2,1,1,2,8,0.313497,0.320213,0,No
1,1,1,1,1,2,1,1,2,8,0.32342,0.334424,0,No
2,2,4,2,2,4,2,2,4,8,0.318405,0.328432,0,No
1,1,1,1,1,2,1,1,2,8,0.303688,0.310784,0,No
2,2,4,2,2,4,2,2,4,8,0.315083,0.329711,0,No
2,2,4,2,2,4,2,2,4,8,0.310722,0.31812,0,No
2,2,4,2,2,4,2,2,4,8,0.308208,0.320489,0,No
2,2,4,2,2,4,2,2,4,7,0.307685,0.316957,0,No
6,6,36,1,2,3,6,6,12,7,0.342218,0.354868,0,No
1,1,1,1,1,2,1,1,2,8,0.310033,0.318684,0,No
1,1,1,1,1,2,1,1,2,8,0.317445,0.327454,0,No
4,4,16,1,4,5,4,4,8,8,0.318049,0.325312,0,No
5,5,25,1,2,3,5,5,10,7,0.342218,0.354868,0,No
2,2,4,1,1,2,2,2,4,8,0.293088,0.300485,0,No
2,2,4,1,1,2,2,2,4,7,0.296305,0.304855,0,No
2,2,4,1,1,2,2,2,4,8,0.339934,0.352194,0,No
2,2,4,1,1,2,2,2,4,8,0.296166,0.303813,0,No
2,2,4,1,1,2,2,2,4,7,0.296305,0.304855,0,No
2,2,4,2,2,4,2,2,4,7,0.342218,0.354868,0,No
1,1,1,1,1,2,1,1,2,9,0.268721,0.277328,0,No
2,2,4,1,1,2,2,2,4,8,0.293133,0.30075,0,No
7,7,49,2,4,6,7,7,14,8,0.312778,0.320314,0,No
1,1,1,1,1,2,1,1,2,8,0.30338,0.311471,0,No
1,1,1,1,1,2,1,1,2,8,0.277096,0.285605,0,No
1,1,1,1,1,2,1,1,2,8,0.331571,0.343073,0,No
3,3,9,2,2,4,3,3,6,8,0.339955,0.352243,0,No
2,2,4,2,1,3,2,2,4,7,0.327819,0.338512,0,No
1,1,1,1,1,2,1,1,2,8,0.282772,0.289734,0,No
1,1,1,1,1,2,1,1,2,8,0.288934,0.297717,0,No
1,1,1,1,1,2,1,1,2,8,0.317292,0.324388,0,No
4,4,16,3,4,7,4,4,8,7,0.347692,0.36109,0,No
1,1,1,1,1,2,1,1,2,8,0.303655,0.312962,0,No
1,1,1,1,1,2,1,1,2,7,0.327819,0.338512,0,No
2,2,4,2,2,4,2,2,4,8,0.307708,0.315606,0,No
1,1,1,1,1,2,1,1,2,8,0.32342,0.334424,0,No
1,1,1,1,1,2,1,1,2,8,0.339934,0.352194,0,No
1,1,1,1,1,2,1,1,2,8,0.288929,0.297713,0,No
3,3,9,2,3,5,3,3,6,8,0.315718,0.324991,0,No
1,1,1,1,1,2,1,1,2,7,0.2963,0.30485,0,No
2,1,2,1,2,3,2,2,4,8,0.317634,0.327651,0,No
2,1,2,2,2,4,2,2,4,7,0.327901,0.338634,0,No
1,1,1,1,1,2,1,1,2,8,0.339934,0.352194,0,No
1,1,1,1,1,2,1,1,2,8,0.313848,0.32086,0,No
2,2,4,2,2,4,2,2,4,8,0.321658,0.33154,0,No
1,1,1,1,1,2,1,1,2,8,0.317298,0.324393,0,No
2,2,4,1,1,2,2,2,4,8,0.339934,0.352194,0,No
1,1,1,1,1,2,1,1,2,8,0.296438,0.303643,0,No
1,1,1,1,1,2,1,1,2,8,0.339934,0.352194,0,No
2,2,4,1,2,3,2,2,4,8,0.319544,0.330579,0,No
1,1,1,1,1,2,1,1,2,8,0.282954,0.289913,0,No
1,1,1,1,1,2,1,1,2,8,0.308542,0.315798,0,No
1,1,1,1,1,2,1,1,2,9,0.268641,0.276936,0,No
1,1,1,1,1,2,1,1,2,8,0.339934,0.352194,0,No
1,1,1,1,1,2,1,1,2,8,0.296171,0.303818,0,No
3,3,9,2,2,4,3,3,6,7,0.332236,0.343545,0,No
1,1,1,1,1,2,1,1,2,8,0.277096,0.285605,0,No
1,1,1,1,1,2,1,1,2,8,0.303655,0.312962,0,No
1,1,1,1,1,2,1,1,2,7,0.327819,0.338512,0,No
4,4,16,2,2,4,4,4,8,8,0.30546,0.314682,0,No
3,3,9,2,2,4,3,3,6,8,0.352003,0.366286,0,No
2,2,4,1,1,2,2,2,4,8,0.265287,0.271053,0,No
2,2,4,2,2,4,2,2,4,8,0.299561,0.30661,0,No
1,1,1,1,1,2,1,1,2,8,0.267303,0.27344,0,No
2,2,4,2,2,4,2,2,4,9,0.265945,0.272191,0,No
1,1,1,1,1,2,1,1,2,8,0.307813,0.314411,0,No
1,1,1,1,1,2,1,1,2,8,0.296438,0.303643,0,No
4,3,12,4,2,6,4,4,8,8,0.31053,0.319149,0,No
1,1,1,1,1,2,1,1,2,8,0.303655,0.312962,0,No
1,1,1,1,1,2,1,1,2,8,0.32342,0.334424,0,No
1,1,1,1,1,2,1,1,2,7,0.296305,0.304855,0,No
1,1,1,1,1,2,1,1,2,7,0.2963,0.30485,0,No
1,1,1,1,1,2,1,1,2,8,0.25328,0.257731,0,No
1,1,1,1,1,2,1,1,2,8,0.296166,0.303813,0,No
1,1,1,1,1,2,1,1,2,7,0.327819,0.338512,0,No
1,1,1,1,1,2,1,1,2,7,0.327819,0.338512,0,No
1,1,1,1,1,2,1,1,2,8,0.287174,0.294461,0,No
1,1,1,1,1,2,1,1,2,8,0.317445,0.327454,0,No
3,3,9,3,3,6,3,3,6,8,0.341636,0.354193,0,No
1,1,1,1,1,2,1,1,2,8,0.339934,0.352194,0,No
2,2,4,1,1,2,2,2,4,8,0.309325,0.317943,0,No
1,1,1,1,1,2,1,1,2,8,0.288163,0.299063,0,No
1,1,1,1,1,2,1,1,2,8,0.32342,0.334424,0,No
1,1,1,1,1,2,1,1,2,9,0.267014,0.27338,0,No
2,2,4,1,1,2,2,2,4,9,0.259742,0.266039,0,No
3,3,9,1,2,3,3,3,6,8,0.310197,0.318739,0,No
1,1,1,1,1,2,1,1,2,8,0.339934,0.352194,0,No
1,1,1,1,1,2,1,1,2,8,0.323426,0.334429,0,No
1,1,1,1,1,2,1,1,2,8,0.278743,0.288253,0,No
1,1,1,1,1,2,1,1,2,7,0.327826,0.338517,0,No
1,1,1,1,1,2,1,1,2,7,0.327819,0.338512,0,No
1,1,1,1,1,2,1,1,2,9,0.264662,0.27058,0,No
1,1,1,1,1,2,1,1,2,8,0.310028,0.318679,0,No
1,1,1,1,1,2,1,1,2,8,0.271899,0.280395,0,No
1,1,1,1,1,2,1,1,2,7,0.296305,0.304855,0,No
1,1,1,1,1,2,1,1,2,8,0.303375,0.311466,0,No
3,3,9,1,3,4,3,3,6,8,0.324145,0.331645,0,No
2,2,4,2,2,4,2,2,4,8,0.289581,0.297231,0,No
1,1,1,1,1,2,1,1,2,8,0.282729,0.289788,0,No
5,5,25,5,5,10,5,5,10,8,0.338149,0.349474,0,No
2,2,4,2,2,4,2,2,4,8,0.324849,0.335627,0,No
3,3,9,1,1,2,3,3,6,8,0.339934,0.352194,0,No
1,1,1,1,1,2,1,1,2,8,0.310028,0.318679,0,No
2,2,4,2,2,4,2,2,4,8,0.317552,0.327839,0,No
2,2,4,2,2,4,2,2,4,8,0.335622,0.347572,0,No
2,2,4,2,1,3,2,2,4,7,0.327819,0.338512,0,No
4,4,16,2,3,5,4,4,8,8,0.333933,0.344704,0,No
1,1,1,1,1,2,1,1,2,9,0.259683,0.265536,0,No
1,1,1,1,1,2,1,1,2,7,0.296305,0.304855,0,No
1,1,1,1,1,2,1,1,2,8,0.293224,0.30019,0,No
2,2,4,2,2,4,2,2,4,8,0.338243,0.351497,0,No
1,1,1,1,1,2,1,1,2,8,0.339934,0.352194,0,No
2,2,4,2,1,3,2,2,4,9,0.250842,0.255927,0,No
1,1,1,1,1,2,1,1,2,8,0.317901,0.325044,0,No
1,1,1,1,1,2,1,1,2,8,0.317445,0.327454,0,No
2,2,4,1,1,2,2,2,4,8,0.331578,0.343078,0,No
1,1,1,1,1,2,1,1,2,8,0.274647,0.281458,0,No
2,2,4,2,2,4,2,2,4,8,0.312813,0.321739,0,No
1,1,1,1,1,2,1,1,2,8,0.339934,0.352194,0,No
2,2,4,1,1,2,2,2,4,9,0.22256,0.226982,0,No
6,6,36,3,2,5,6,6,12,8,0.343203,0.35581,0,No
1,1,1,1,1,2,1,1,2,8,0.279565,0.286561,0,No
1,1,1,1,1,2,1,1,2,7,0.327819,0.338512,0,No
2,2,4,1,2,3,2,2,4,8,0.320227,0.328602,0,No
1,1,1,1,1,2,1,1,2,8,0.301584,0.314486,0,No
4,4,16,1,1,2,4,4,8,8,0.32342,0.334424,0,No
1,1,1,1,1,2,1,1,2,8,0.301584,0.314486,0,No
2,2,4,2,1,3,2,2,4,8,0.339934,0.352194,0,No
8,8,64,2,7,9,8,8,16,7,0.348424,0.362496,0,No
2,2,4,2,2,4,2,2,4,8,0.272781,0.281354,0,No
1,1,1,1,1,2,1,1,2,7,0.2963,0.30485,0,No
2,2,4,2,2,4,2,2,4,8,0.29553,0.304065,0,No
4,4,16,1,1,2,4,4,8,8,0.309325,0.317943,0,No
2,2,4,2,1,3,2,2,4,8,0.287605,0.295192,0,No
1,1,1,1,1,2,1,1,2,8,0.304631,0.311247,0,No
1,1,1,1,1,2,1,1,2,8,0.301584,0.314486,0,No
1,1,1,1,1,2,1,1,2,8,0.277096,0.285605,0,No
1,1,1,1,1,2,1,1,2,7,0.327819,0.338512,0,No
1,1,1,1,1,2,1,1,2,8,0.305116,0.311592,0,No
2,2,4,1,2,3,2,2,4,7,0.329937,0.340306,0,No
1,1,1,1,1,2,1,1,2,8,0.339934,0.352194,0,No
1,1,1,1,1,2,1,1,2,8,0.278743,0.288253,0,No
1,1,1,1,1,2,1,1,2,8,0.278743,0.288253,0,No
1,1,1,1,1,2,1,1,2,8,0.278743,0.288253,0,No
1,1,1,1,1,2,1,1,2,7,0.2963,0.30485,0,No
1,1,1,1,1,2,1,1,2,7,0.327819,0.338512,0,No
1,1,1,1,1,2,1,1,2,8,0.309325,0.317943,0,No
2,2,4,2,2,4,2,2,4,7,0.352621,0.366966,0,No
4,4,16,1,3,4,4,4,8,8,0.361359,0.37701,0,No
1,1,1,1,1,2,1,1,2,8,0.339934,0.352194,0,No
5,5,25,1,3,4,5,5,10,7,0.333398,0.344277,0,No
1,1,1,1,1,2,1,1,2,8,0.310028,0.318679,0,No
1,1,1,1,1,2,1,1,2,8,0.302675,0.30967,0,No
1,1,1,1,1,2,1,1,2,9,0.260412,0.266106,0,No
2,2,4,2,2,4,2,2,4,8,0.34963,0.363916,0,No
3,3,9,2,1,3,3,3,6,8,0.278743,0.288253,0,No
1,1,1,1,1,2,1,1,2,8,0.2876,0.295187,0,No
6,6,36,2,6,8,6,6,12,8,0.336635,0.347531,0,No
2,2,4,2,2,4,2,2,4,8,0.306668,0.315424,0,No
1,1,1,1,1,2,1,1,2,8,0.286894,0.294149,0,No
2,2,4,1,1,2,2,2,4,8,0.331578,0.343078,0,No
1,1,1,1,1,2,1,1,2,8,0.323426,0.334429,0,No
4,4,16,3,2,5,4,4,8,8,0.338243,0.351497,0,No
4,4,16,2,1,3,4,4,8,9,0.24858,0.253023,0,No
1,1,1,1,1,2,1,1,2,8,0.283495,0.292907,0,No
1,1,1,1,1,2,1,1,2,8,0.339934,0.352194,0,No
2,2,4,1,1,2,2,2,4,8,0.301589,0.314491,0,No
1,1,1,1,1,2,1,1,2,9,0.246932,0.250705,0,No
1,1,1,1,1,2,1,1,2,8,0.283486,0.292899,0,No
1,1,1,1,1,2,1,1,2,8,0.298534,0.305391,0,No
1,1,1,1,1,2,1,1,2,9,0.219429,0.22277,0,No
1,1,1,1,1,2,1,1,2,8,0.30338,0.311471,0,No
1,1,1,1,1,2,1,1,2,8,0.256903,0.262046,0,No
1,1,1,1,1,2,1,1,2,8,0.293179,0.30018,0,No
2,2,4,1,1,2,2,2,4,9,0.278702,0.285801,0,No
1,1,1,1,1,2,1,1,2,8,0.339934,0.352194,0,No
4,4,16,3,4,7,4,4,8,8,0.324948,0.333526,0,No
1,1,1,1,1,2,1,1,2,8,0.339934,0.352194,0,No
1,1,1,1,1,2,1,1,2,9,0.276056,0.283078,0,No
1,1,1,1,1,2,1,1,2,8,0.277389,0.284283,0,No
1,1,1,1,1,2,1,1,2,9,0.265766,0.272424,0,No
1,1,1,1,1,2,1,1,2,8,0.310722,0.317507,0,No
1,1,1,1,1,2,1,1,2,8,0.279689,0.286598,0,No
1,1,1,1,1,2,1,1,2,8,0.305078,0.312168,0,No
2,2,4,1,1,2,2,2,4,8,0.303585,0.310469,0,No
3,3,9,3,3,6,3,3,6,8,0.328868,0.337856,0,No
1,1,1,1,1,2,1,1,2,8,0.287605,0.295192,0,No
2,2,4,2,2,4,2,2,4,8,0.324188,0.335221,0,No
3,3,9,2,2,4,3,3,6,8,0.318845,0.326165,0,No
1,1,1,1,1,2,1,1,2,9,0.251823,0.256849,0,No
1,1,1,1,1,2,1,1,2,8,0.28565,0.292652,0,No
1,1,1,1,1,2,1,1,2,8,0.317298,0.324393,0,No
3,3,9,3,2,5,3,3,6,8,0.339934,0.352214,0,No
1,1,1,1,1,2,1,1,2,9,0.263403,0.271075,0,No
1,1,1,1,1,2,1,1,2,8,0.317298,0.324393,0,No
1,1,1,1,1,2,1,1,2,8,0.287605,0.295192,0,No
1,1,1,1,1,2,1,1,2,9,0.220692,0.224139,0,No
1,1,1,1,1,2,1,1,2,8,0.258883,0.26458,0,No
2,2,4,1,1,2,2,2,4,7,0.296305,0.304855,0,No
1,1,1,1,1,2,1,1,2,8,0.299835,0.307302,0,No
1,1,1,1,1,2,1,1,2,8,0.2828,0.289824,0,No
3,3,9,3,3,6,3,3,6,8,0.317038,0.323916,0,No
1,1,1,1,1,2,1,1,2,7,0.296305,0.304855,0,No
1,1,1,1,1,2,1,1,2,8,0.2828,0.289824,0,No
1,1,1,1,1,2,1,1,2,7,0.296305,0.304855,0,No
2,2,4,2,2,4,2,2,4,8,0.343196,0.355801,0,No
1,1,1,1,1,2,1,1,2,8,0.252766,0.257758,0,No
1,1,1,1,1,2,1,1,2,9,0.244312,0.248589,0,No
1,1,1,1,1,2,1,1,2,7,0.296305,0.304855,0,No
3,3,9,3,3,6,3,3,6,7,0.312172,0.320662,0,No
1,1,1,1,1,2,1,1,2,8,0.309331,0.317947,0,No
1,1,1,1,1,2,1,1,2,8,0.309977,0.317107,0,No
1,1,1,1,1,2,1,1,2,7,0.312584,0.319273,0,No
1,1,1,1,1,2,1,1,2,8,0.339934,0.352194,0,No
4,4,16,2,4,6,4,4,8,8,0.327706,0.336848,0,No
2,2,4,1,2,3,2,2,4,8,0.302809,0.309591,0,No
1,1,1,1,1,2,1,1,2,8,0.30068,0.307389,0,No
2,2,4,1,1,2,2,2,4,8,0.278739,0.288248,0,No
4,4,16,1,1,2,4,4,8,8,0.278743,0.288253,0,No
9,9,81,6,6,12,9,9,18,7,0.372108,0.389677,0,No
1,1,1,1,1,2,1,1,2,7,0.296305,0.304855,0,No
1,1,1,1,1,2,1,1,2,7,0.327826,0.338517,0,No
1,1,1,1,1,2,1,1,2,7,0.327819,0.338512,0,No
1,1,1,1,1,2,1,1,2,8,0.323426,0.334429,0,No
1,1,1,1,1,2,1,1,2,9,0.271531,0.278836,0,No
1,1,1,1,1,2,1,1,2,8,0.271899,0.280395,0,No
1,1,1,1,1,2,1,1,2,9,0.268641,0.276936,0,No
1,1,1,1,1,2,1,1,2,8,0.304132,0.310938,0,No
1,1,1,1,1,2,1,1,2,8,0.310033,0.318684,0,No
1,1,1,1,1,2,1,1,2,8,0.323426,0.334429,0,No
1,1,1,1,1,2,1,1,2,8,0.295688,0.30275,0,No
2,2,4,2,2,4,2,2,4,8,0.340185,0.352467,0,No
3,3,9,2,1,3,3,3,6,9,0.276051,0.283073,0,No
2,2,4,2,1,3,2,2,4,8,0.301584,0.314486,0,No
4,4,16,3,4,7,4,4,8,8,0.318446,0.32591,0,No
1,1,1,1,1,2,1,1,2,8,0.30338,0.311471,0,No
1,1,1,1,1,2,1,1,2,8,0.283274,0.290435,0,No
1,1,1,1,1,2,1,1,2,9,0.230528,0.234079,0,No
1,1,1,1,1,2,1,1,2,7,0.327819,0.338512,0,No
1,1,1,1,1,2,1,1,2,9,0.262298,0.268199,0,No
5,5,25,1,2,3,5,5,10,7,0.332236,0.343545,0,No
1,1,1,1,1,2,1,1,2,7,0.327813,0.338503,0,No
1,1,1,1,1,2,1,1,2,8,0.303661,0.312967,0,No
2,2,4,1,1,2,2,2,4,8,0.331571,0.343073,0,No
2,2,4,1,2,3,2,2,4,8,0.305931,0.31386,0,No
2,2,4,1,2,3,2,2,4,8,0.30586,0.314983,0,No
1,1,1,1,1,2,1,1,2,7,0.327819,0.338512,0,No
2,2,4,2,2,4,2,2,4,8,0.316609,0.32539,0,No
5,5,25,3,4,7,5,5,10,8,0.330794,0.341298,0,No
4,4,16,2,3,5,4,4,8,8,0.343354,0.355972,0,No
1,1,1,1,1,2,1,1,2,8,0.30365,0.312952,0,No
1,1,1,1,1,2,1,1,2,9,0.271531,0.278836,0,No
1,1,1,1,1,2,1,1,2,8,0.301584,0.314486,0,No
1,1,1,1,1,2,1,1,2,8,0.267882,0.274231,0,No
1,1,1,1,1,2,1,1,2,9,0.249062,0.253753,0,No
1,1,1,1,1,2,1,1,2,8,0.30359,0.310474,0,No
1,1,1,1,1,2,1,1,2,8,0.310028,0.318679,0,No
2,2,4,2,1,3,2,2,4,8,0.310028,0.318679,0,No
3,3,9,2,3,5,3,3,6,8,0.321258,0.329113,0,No
9,9,81,1,2,3,9,9,18,8,0.310773,0.317656,0,No
1,1,1,1,1,2,1,1,2,8,0.304452,0.311259,0,No
1,1,1,1,1,2,1,1,2,8,0.306151,0.312648,0,No
5,5,25,4,4,8,5,5,10,8,0.317239,0.32459,0,No
3,3,9,1,2,3,3,3,6,8,0.319054,0.326591,0,No
1,1,1,1,1,2,1,1,2,8,0.301584,0.314486,0,No
1,1,1,1,1,2,1,1,2,8,0.288929,0.297713,0,No
3,3,9,2,3,5,3,3,6,8,0.30592,0.312455,0,No
1,1,1,1,1,2,1,1,2,8,0.29596,0.304319,0,No
1,1,1,1,1,2,1,1,2,8,0.268219,0.275191,0,No
1,1,1,1,1,2,1,1,2,8,0.277096,0.285605,0,No
1,1,1,1,1,2,1,1,2,8,0.258483,0.265635,0,No
2,2,4,1,2,3,2,2,4,8,0.313111,0.319827,0,No
1,1,1,1,1,2,1,1,2,9,0.248964,0.254033,0,No
1,1,1,1,1,2,1,1,2,8,0.278743,0.288253,0,No
1,1,1,1,1,2,1,1,2,9,0.24184,0.245239,0,No
1,1,1,1,1,2,1,1,2,7,0.327819,0.338512,0,No
1,1,1,1,1,2,1,1,2,8,0.27455,0.283664,0,No
2,2,4,1,1,2,2,2,4,8,0.301589,0.314491,0,No
1,1,1,1,1,2,1,1,2,7,0.312589,0.319278,0,No
4,4,16,3,3,6,4,4,8,8,0.318512,0.32789,0,No
2,2,4,2,2,4,2,2,4,8,0.292235,0.301496,0,No
5,4,20,3,3,6,5,5,10,8,0.3203,0.330914,0,No
3,3,9,2,3,5,3,3,6,8,0.328135,0.338614,0,No
5,5,25,2,4,6,5,5,10,7,0.325711,0.338174,0,No
2,2,4,2,2,4,2,2,4,8,0.317221,0.325469,0,No
2,2,4,2,2,4,2,2,4,8,0.340797,0.353316,0,No
1,1,1,1,1,2,1,1,2,8,0.308542,0.315798,0,No
2,2,4,1,1,2,2,2,4,8,0.30359,0.310474,0,No
2,2,4,2,2,4,2,2,4,8,0.340199,0.352517,0,No
1,1,1,1,1,2,1,1,2,8,0.27455,0.283664,0,No
2,2,4,1,1,2,2,2,4,8,0.268219,0.275191,0,No
1,1,1,1,1,2,1,1,2,7,0.296305,0.304855,0,No
5,5,25,2,4,6,5,5,10,7,0.322766,0.330149,0,No
11,10,110,3,5,8,11,11,22,7,0.331946,0.341408,0,No
1,1,1,1,1,2,1,1,2,8,0.32342,0.334424,0,No
1,1,1,1,1,2,1,1,2,8,0.313497,0.320213,0,No
1,1,1,1,1,2,1,1,2,8,0.304452,0.311259,0,No
2,2,4,1,1,2,2,2,4,8,0.304126,0.310713,0,No
1,1,1,1,1,2,1,1,2,9,0.223983,0.228789,0,No
3,3,9,1,2,3,3,3,6,8,0.322601,0.330134,0,No
3,3,9,1,3,4,3,3,6,8,0.301089,0.309726,0,No
3,3,9,2,2,4,3,3,6,8,0.327455,0.338576,0,No
1,1,1,1,1,2,1,1,2,8,0.27737,0.284635,0,No
1,1,1,1,1,2,1,1,2,8,0.323426,0.334429,0,No
2,2,4,2,1,3,2,2,4,9,0.268637,0.276931,0,No
4,4,16,3,2,5,4,4,8,9,0.270618,0.279168,0,No
1,1,1,1,1,2,1,1,2,7,0.296305,0.304855,0,No
1,1,1,1,1,2,1,1,2,9,0.268641,0.276936,0,No
2,2,4,1,1,2,2,2,4,9,0.268641,0.276936,0,No
4,4,16,3,3,6,4,4,8,8,0.302321,0.312225,0,No
1,1,1,1,1,2,1,1,2,8,0.339934,0.352194,0,No
2,2,4,1,1,2,2,2,4,7,0.296305,0.304855,0,No
1,1,1,1,1,2,1,1,2,9,0.268641,0.276936,0,No
2,1,2,1,2,3,2,2,4,8,0.314665,0.321368,0,No
1,1,1,1,1,2,1,1,2,9,0.276056,0.283078,0,No
1,1,1,1,1,2,1,1,2,9,0.268641,0.276936,0,No
8,7,56,2,5,7,8,8,16,8,0.349587,0.363903,0,No
1,1,1,1,1,2,1,1,2,8,0.301589,0.314491,0,No
1,1,1,1,1,2,1,1,2,9,0.26023,0.265915,0,No
1,1,1,1,1,2,1,1,2,9,0.303801,0.312033,0,No
1,1,1,1,1,2,1,1,2,8,0.309325,0.317943,0,No
1,1,1,1,1,2,1,1,2,8,0.32342,0.334424,0,No
1,1,1,1,1,2,1,1,2,8,0.32342,0.334424,0,No
10,8,80,1,3,4,10,10,20,8,0.308481,0.316768,0,No
1,1,1,1,1,2,1,1,2,9,0.244305,0.248584,0,No
5,5,25,1,4,5,5,5,10,8,0.321737,0.331396,0,No
1,1,1,1,1,2,1,1,2,8,0.271899,0.280395,0,No
1,1,1,1,1,2,1,1,2,8,0.323426,0.334429,0,No
3,3,9,3,3,6,3,3,6,8,0.302734,0.30937,0,No
1,1,1,1,1,2,1,1,2,8,0.32342,0.334424,0,No
2,2,4,2,1,3,2,2,4,8,0.271899,0.280395,0,No
5,5,25,3,2,5,5,5,10,8,0.313198,0.322823,0,No
1,1,1,1,1,2,1,1,2,8,0.271691,0.278346,0,No
2,2,4,1,1,2,2,2,4,9,0.280785,0.287922,0,No
1,1,1,1,1,2,1,1,2,8,0.303661,0.312967,0,No
1,1,1,1,1,2,1,1,2,7,0.327819,0.338512,0,No
2,2,4,2,2,4,2,2,4,8,0.312939,0.321428,0,No
1,1,1,1,1,2,1,1,2,8,0.308542,0.315798,0,No
1,1,1,1,1,2,1,1,2,7,0.327819,0.338512,0,No
1,1,1,1,1,2,1,1,2,9,0.265704,0.272578,0,No
1,1,1,1,1,2,1,1,2,8,0.331571,0.343073,0,No
1,1,1,1,1,2,1,1,2,8,0.283486,0.292899,0,No
1,1,1,1,1,2,1,1,2,8,0.32342,0.334424,0,No
1,1,1,1,1,2,1,1,2,9,0.265849,0.272237,0,No
1,1,1,1,1,2,1,1,2,9,0.253115,0.258182,0,No
1,1,1,1,1,2,1,1,2,8,0.32342,0.334424,0,No
1,1,1,1,1,2,1,1,2,9,0.252176,0.257221,0,No
2,2,4,2,2,4,2,2,4,8,0.342102,0.354638,0,No
7,7,49,1,7,8,7,7,14,8,0.330493,0.341933,0,No
2,2,4,1,2,3,2,2,4,8,0.322778,0.332634,0,No
3,3,9,1,3,4,3,3,6,8,0.336854,0.349171,0,No
1,1,1,1,1,2,1,1,2,8,0.29001,0.297121,0,No
1,1,1,1,1,2,1,1,2,7,0.327819,0.338512,0,No
3,3,9,1,3,4,3,3,6,8,0.312566,0.319106,0,No
2,2,4,1,1,2,2,2,4,8,0.27455,0.283664,0,No
1,1,1,1,1,2,1,1,2,8,0.310033,0.318684,0,No
1,1,1,1,1,2,1,1,2,8,0.339934,0.352194,0,No
1,1,1,1,1,2,1,1,2,8,0.323426,0.334429,0,No
1,1,1,1,1,2,1,1,2,8,0.310028,0.318679,0,No
1,1,1,1,1,2,1,1,2,8,0.286995,0.295346,0,No
1,1,1,1,1,2,1,1,2,8,0.296991,0.30415,0,No
1,1,1,1,1,2,1,1,2,9,0.2472,0.252853,0,No
2,2,4,1,1,2,2,2,4,8,0.274329,0.282188,0,No
1,1,1,1,1,2,1,1,2,8,0.310717,0.317502,0,No
1,1,1,1,1,2,1,1,2,8,0.29191,0.299154,0,No
1,1,1,1,1,2,1,1,2,8,0.32342,0.334424,0,No
1,1,1,1,1,2,1,1,2,8,0.303655,0.312962,0,No
1,1,1,1,1,2,1,1,2,8,0.282851,0.289957,0,No
2,2,4,2,2,4,2,2,4,8,0.285855,0.292971,0,No
1,1,1,1,1,2,1,1,2,8,0.339934,0.352194,0,No
1,1,1,1,1,2,1,1,2,8,0.274334,0.282192,0,No
1,1,1,1,1,2,1,1,2,9,0.255037,0.260003,0,No
1,1,1,1,1,2,1,1,2,8,0.301589,0.314491,0,No
3,3,9,1,3,4,3,3,6,8,0.340579,0.353641,0,No
1,1,1,1,1,2,1,1,2,8,0.29234,0.299883,0,No
1,1,1,1,1,2,1,1,2,8,0.339934,0.352194,0,No
2,2,4,2,1,3,2,2,4,9,0.244305,0.248584,0,No
1,1,1,1,1,2,1,1,2,8,0.294007,0.301287,0,No
1,1,1,1,1,2,1,1,2,7,0.327819,0.338512,0,No
1,1,1,1,1,2,1,1,2,7,0.327819,0.338512,0,No
1,1,1,1,1,2,1,1,2,8,0.323426,0.334429,0,No
2,2,4,1,1,2,2,2,4,9,0.268641,0.276936,0,No
1,1,1,1,1,2,1,1,2,8,0.301589,0.314491,0,No
2,2,4,2,2,4,2,2,4,7,0.33223,0.343535,0,No
1,1,1,1,1,2,1,1,2,7,0.327819,0.338512,0,No
1,1,1,1,1,2,1,1,2,8,0.29741,0.304429,0,No
1,1,1,1,1,2,1,1,2,8,0.314583,0.32146,0,No
7,7,49,3,3,6,7,7,14,8,0.332787,0.344352,0,No
1,1,1,1,1,2,1,1,2,8,0.301589,0.314491,0,No
1,1,1,1,1,2,1,1,2,8,0.26663,0.273152,0,No
1,1,1,1,1,2,1,1,2,9,0.268721,0.277328,0,No
4,4,16,2,2,4,4,4,8,8,0.346281,0.360278,0,No
2,2,4,1,1,2,2,2,4,7,0.327826,0.338517,0,No
1,1,1,1,1,2,1,1,2,8,0.323426,0.334429,0,No
1,1,1,1,1,2,1,1,2,8,0.32342,0.334424,0,No
1,1,1,1,1,2,1,1,2,8,0.339934,0.352194,0,No
1,1,1,1,1,2,1,1,2,8,0.339934,0.352194,0,No
1,1,1,1,1,2,1,1,2,8,0.291406,0.298481,0,No
1,1,1,1,1,2,1,1,2,8,0.306448,0.313104,0,No
2,2,4,2,2,4,2,2,4,7,0.312212,0.319781,0,No
1,1,1,1,1,2,1,1,2,8,0.275285,0.282167,0,No
2,2,4,1,2,3,2,2,4,8,0.309718,0.316399,0,No
1,1,1,1,1,2,1,1,2,9,0.258593,0.264042,0,No
1,1,1,1,1,2,1,1,2,8,0.27122,0.279026,0,No
1,1,1,1,1,2,1,1,2,9,0.272424,0.279226,0,No
1,1,1,1,1,2,1,1,2,9,0.25011,0.255058,0,No
1,1,1,1,1,2,1,1,2,8,0.264457,0.270739,0,No
1,1,1,1,1,2,1,1,2,8,0.309331,0.317947,0,No
2,2,4,1,1,2,2,2,4,8,0.311306,0.32231,0,No
1,1,1,1,1,2,1,1,2,9,0.2478,0.25225,0,No
2,2,4,2,2,4,2,2,4,8,0.332742,0.344411,0,No
2,1,2,2,2,4,2,2,4,8,0.331952,0.342506,0,No
1,1,1,1,1,2,1,1,2,8,0.309331,0.317947,0,No
4,4,16,2,2,4,4,4,8,8,0.338243,0.351497,0,No
1,1,1,1,1,2,1,1,2,9,0.266601,0.273003,0,No
1,1,1,1,1,2,1,1,2,8,0.288163,0.299063,0,No
1,1,1,1,1,2,1,1,2,8,0.268223,0.275194,0,No
1,1,1,1,1,2,1,1,2,8,0.290014,0.297093,0,No
1,1,1,1,1,2,1,1,2,7,0.327826,0.338517,0,No
2,2,4,2,2,4,2,2,4,8,0.326165,0.337197,0,No
1,1,1,1,1,2,1,1,2,8,0.339934,0.352194,0,No
1,1,1,1,1,2,1,1,2,8,0.268637,0.27511,0,No
1,1,1,1,1,2,1,1,2,7,0.327819,0.338512,0,No
1,1,1,1,1,2,1,1,2,8,0.315759,0.323487,0,No
2,2,4,1,1,2,2,2,4,7,0.327819,0.338512,0,No
2,2,4,1,1,2,2,2,4,8,0.303655,0.312962,0,No
1,1,1,1,1,2,1,1,2,8,0.306657,0.315385,0,No
1,1,1,1,1,2,1,1,2,8,0.28699,0.295341,0,No
1,1,1,1,1,2,1,1,2,8,0.286532,0.293667,0,No
1,1,1,1,1,2,1,1,2,8,0.276687,0.284068,0,No
1,1,1,1,1,2,1,1,2,9,0.266156,0.272654,0,No
3,3,9,3,2,5,3,3,6,8,0.30522,0.312463,0,No
1,1,1,1,1,2,1,1,2,8,0.295402,0.302692,0,No
4,4,16,4,4,8,4,4,8,8,0.339353,0.35306,0,No
4,4,16,2,2,4,4,4,8,8,0.310745,0.319752,0,No
5,5,25,3,3,6,5,5,10,8,0.33582,0.3468,0,No
1,1,1,1,1,2,1,1,2,8,0.288163,0.299063,0,No
1,1,1,1,1,2,1,1,2,8,0.339934,0.352194,0,No
2,2,4,1,1,2,2,2,4,8,0.256907,0.262048,0,No
2,2,4,2,2,4,2,2,4,7,0.339299,0.352072,0,No
1,1,1,1,1,2,1,1,2,8,0.317298,0.324393,0,No
1,1,1,1,1,2,1,1,2,8,0.309331,0.317947,0,No
3,2,6,3,3,6,3,3,6,8,0.306872,0.31421,0,No
2,2,4,1,1,2,2,2,4,8,0.331571,0.343073,0,No
5,5,25,5,2,7,5,5,10,8,0.316938,0.327224,0,No
1,1,1,1,1,2,1,1,2,8,0.258883,0.26458,0,No
5,5,25,2,3,5,5,5,10,8,0.346127,0.359789,0,No
1,1,1,1,1,2,1,1,2,8,0.32342,0.334424,0,No
1,1,1,1,1,2,1,1,2,8,0.27122,0.279026,0,No
1,1,1,1,1,2,1,1,2,8,0.289773,0.2969,0,No
1,1,1,1,1,2,1,1,2,8,0.339934,0.352194,0,No
3,3,9,1,1,2,3,3,6,8,0.32342,0.334424,0,No
1,1,1,1,1,2,1,1,2,8,0.32342,0.334424,0,No
1,1,1,1,1,2,1,1,2,8,0.32342,0.334424,0,No
1,1,1,1,1,2,1,1,2,8,0.32342,0.334424,0,No
1,1,1,1,1,2,1,1,2,8,0.32342,0.334424,0,No
1,1,1,1,1,2,1,1,2,8,0.32342,0.334424,0,No
1,1,1,1,1,2,1,1,2,8,0.32342,0.334424,0,No
1,1,1,1,1,2,1,1,2,8,0.32342,0.334424,0,No
1,1,1,1,1,2,1,1,2,8,0.301584,0.314486,0,No
1,1,1,1,1,2,1,1,2,8,0.287605,0.295192,0,No
1,1,1,1,1,2,1,1,2,9,0.242796,0.246517,0,No
5,5,25,4,4,8,5,5,10,8,0.353769,0.368351,0,No
1,1,1,1,1,2,1,1,2,8,0.307819,0.314416,0,No
4,4,16,4,4,8,4,4,8,8,0.333451,0.34604,0,No
1,1,1,1,1,2,1,1,2,8,0.301584,0.314486,0,No
1,1,1,1,1,2,1,1,2,8,0.32342,0.334424,0,No
1,1,1,1,1,2,1,1,2,8,0.271899,0.280395,0,No
2,2,4,1,1,2,2,2,4,8,0.317292,0.324388,0,No
3,3,9,2,2,4,3,3,6,8,0.309409,0.316861,0,No
1,1,1,1,1,2,1,1,2,8,0.32342,0.334424,0,No
1,1,1,1,1,2,1,1,2,8,0.301584,0.314486,0,No
1,1,1,1,1,2,1,1,2,8,0.323426,0.334429,0,No
1,1,1,1,1,2,1,1,2,8,0.308542,0.315798,0,No
1,1,1,1,1,2,1,1,2,8,0.281414,0.288457,0,No
1,1,1,1,1,2,1,1,2,8,0.271224,0.279029,0,No
1,1,1,1,1,2,1,1,2,8,0.314583,0.32146,0,No
1,1,1,1,1,2,1,1,2,8,0.288163,0.299063,0,No
1,1,1,1,1,2,1,1,2,8,0.303375,0.311466,0,No
1,1,1,1,1,2,1,1,2,8,0.30359,0.310474,0,No
1,1,1,1,1,2,1,1,2,8,0.302847,0.310171,0,No
1,1,1,1,1,2,1,1,2,8,0.305001,0.311358,0,No
2,2,4,2,2,4,2,2,4,7,0.302761,0.312306,0,No
1,1,1,1,1,2,1,1,2,8,0.323426,0.334429,0,No
1,1,1,1,1,2,1,1,2,8,0.317292,0.324388,0,No
3,3,9,1,1,2,3,3,6,9,0.209714,0.212678,0,No
1,1,1,1,1,2,1,1,2,8,0.301589,0.314491,0,No
4,4,16,3,3,6,4,4,8,7,0.330781,0.342124,0,No
1,1,1,1,1,2,1,1,2,8,0.339934,0.352194,0,No
1,1,1,1,1,2,1,1,2,8,0.280066,0.287114,0,No
2,2,4,2,2,4,2,2,4,8,0.28996,0.299034,0,No
1,1,1,1,1,2,1,1,2,8,0.323414,0.334415,0,No
1,1,1,1,1,2,1,1,2,8,0.317292,0.324388,0,No
1,1,1,1,1,2,1,1,2,7,0.2963,0.30485,0,No
2,2,4,1,2,3,2,2,4,8,0.323457,0.334488,0,No
1,1,1,1,1,2,1,1,2,9,0.303801,0.312033,0,No
1,1,1,1,1,2,1,1,2,8,0.279099,0.286801,0,No
1,1,1,1,1,2,1,1,2,8,0.281828,0.289886,0,No
1,1,1,1,1,2,1,1,2,8,0.32342,0.334424,0,No
3,3,9,3,2,5,3,3,6,8,0.305937,0.31414,0,No
1,1,1,1,1,2,1,1,2,8,0.303661,0.312967,0,No
3,3,9,1,1,2,3,3,6,8,0.32342,0.334424,0,No
1,1,1,1,1,2,1,1,2,8,0.317292,0.324388,0,No
2,2,4,2,1,3,2,2,4,8,0.317292,0.324388,0,No
1,1,1,1,1,2,1,1,2,8,0.339934,0.352194,0,No
2,2,4,1,1,2,2,2,4,8,0.269852,0.27628,0,No
2,2,4,2,2,4,2,2,4,7,0.338881,0.352135,0,No
1,1,1,1,1,2,1,1,2,9,0.258864,0.26428,0,No
1,1,1,1,1,2,1,1,2,8,0.32342,0.334424,0,No
1,1,1,1,1,2,1,1,2,8,0.301584,0.314486,0,No
1,1,1,1,1,2,1,1,2,8,0.294012,0.301292,0,No
1,1,1,1,1,2,1,1,2,8,0.288934,0.297717,0,No
1,1,1,1,1,2,1,1,2,8,0.278493,0.285418,0,No
1,1,1,1,1,2,1,1,2,8,0.32342,0.334424,0,No
1,1,1,1,1,2,1,1,2,8,0.288934,0.297717,0,No
3,3,9,2,2,4,3,3,6,8,0.339941,0.352224,0,No
1,1,1,1,1,2,1,1,2,8,0.339934,0.352194,0,No
1,1,1,1,1,2,1,1,2,8,0.331578,0.343078,0,No
1,1,1,1,1,2,1,1,2,8,0.303655,0.312962,0,No
1,1,1,1,1,2,1,1,2,8,0.302589,0.309511,0,No
4,4,16,3,1,4,4,4,8,8,0.301584,0.314486,0,No
1,1,1,1,1,2,1,1,2,9,0.268721,0.277328,0,No
1,1,1,1,1,2,1,1,2,8,0.294611,0.302087,0,No
1,1,1,1,1,2,1,1,2,8,0.323426,0.334429,0,No
1,1,1,1,1,2,1,1,2,8,0.301589,0.314491,0,No
2,2,4,2,1,3,2,2,4,8,0.32342,0.334424,0,No
1,1,1,1,1,2,1,1,2,8,0.264457,0.270739,0,No
1,1,1,1,1,2,1,1,2,8,0.303375,0.311466,0,No
1,1,1,1,1,2,1,1,2,7,0.327819,0.338512,0,No
1,1,1,1,1,2,1,1,2,7,0.327819,0.338512,0,No
2,2,4,1,1,2,2,2,4,8,0.27455,0.283664,0,No
1,1,1,1,1,2,1,1,2,8,0.27189,0.28038,0,No
1,1,1,1,1,2,1,1,2,9,0.253793,0.258648,0,No
1,1,1,1,1,2,1,1,2,8,0.304446,0.311255,0,No
1,1,1,1,1,2,1,1,2,8,0.317292,0.324388,0,No
1,1,1,1,1,2,1,1,2,8,0.301589,0.314491,0,No
1,1,1,1,1,2,1,1,2,8,0.287605,0.295192,0,No
1,1,1,1,1,2,1,1,2,8,0.288163,0.299063,0,No
4,4,16,2,3,5,4,4,8,8,0.332301,0.343025,0,No
1,1,1,1,1,2,1,1,2,7,0.312589,0.319278,0,No
1,1,1,1,1,2,1,1,2,8,0.309325,0.317943,0,No
1,1,1,1,1,2,1,1,2,8,0.301594,0.314494,0,No
2,2,4,2,2,4,2,2,4,8,0.307685,0.320435,0,No
2,2,4,2,2,4,2,2,4,7,0.299125,0.307804,0,No
1,1,1,1,1,2,1,1,2,8,0.32342,0.334424,0,No
6,6,36,1,1,2,6,6,12,7,0.296305,0.304855,0,No
1,1,1,1,1,2,1,1,2,7,0.296305,0.304855,0,No
1,1,1,1,1,2,1,1,2,8,0.323426,0.334429,0,No
2,2,4,1,1,2,2,2,4,9,0.254413,0.260022,0,No
1,1,1,1,1,2,1,1,2,8,0.32342,0.334424,0,No
4,4,16,4,3,7,4,4,8,8,0.325288,0.336518,0,No
2,2,4,1,1,2,2,2,4,9,0.254417,0.260027,0,No
1,1,1,1,1,2,1,1,2,8,0.323426,0.334429,0,No
4,4,16,3,2,5,4,4,8,8,0.279003,0.287691,0,No
5,5,25,3,2,5,5,5,10,8,0.323881,0.335064,0,No
1,1,1,1,1,2,1,1,2,9,0.254413,0.260022,0,No
3,2,6,2,2,4,3,3,6,8,0.323881,0.335064,0,No
1,1,1,1,1,2,1,1,2,9,0.255725,0.261981,0,No
1,1,1,1,1,2,1,1,2,8,0.323414,0.334415,0,No
2,2,4,2,2,4,2,2,4,8,0.323758,0.33471,0,No
4,4,16,1,1,2,4,4,8,9,0.244309,0.248587,0,No
1,1,1,1,1,2,1,1,2,8,0.309325,0.317943,0,No
1,1,1,1,1,2,1,1,2,8,0.32342,0.334424,0,No
1,1,1,1,1,2,1,1,2,8,0.323426,0.334429,0,No
3,3,9,3,3,6,3,3,6,7,0.355494,0.370175,0,No
2,2,4,2,2,4,2,2,4,8,0.310253,0.317129,0,No
1,1,1,1,1,2,1,1,2,8,0.323426,0.334429,0,No
1,1,1,1,1,2,1,1,2,8,0.301578,0.314477,0,No
6,6,36,1,3,4,6,6,12,8,0.346802,0.361167,0,No
1,1,1,1,1,2,1,1,2,8,0.339934,0.352194,0,No
1,1,1,1,1,2,1,1,2,8,0.301584,0.314486,0,No
1,1,1,1,1,2,1,1,2,7,0.312589,0.319278,0,No
1,1,1,1,1,2,1,1,2,8,0.272372,0.279134,0,No
1,1,1,1,1,2,1,1,2,8,0.288168,0.299068,0,No
1,1,1,1,1,2,1,1,2,9,0.268641,0.276936,0,No
1,1,1,1,1,2,1,1,2,8,0.27455,0.283664,0,No
4,4,16,3,2,5,4,4,8,7,0.31809,0.330229,0,No
1,1,1,1,1,2,1,1,2,8,0.287605,0.295192,0,No
2,2,4,2,2,4,2,2,4,8,0.331791,0.343277,0,No
1,1,1,1,1,2,1,1,2,8,0.310028,0.318679,0,No
1,1,1,1,1,2,1,1,2,8,0.311306,0.32231,0,No
1,1,1,1,1,2,1,1,2,8,0.309325,0.317943,0,No
1,1,1,1,1,2,1,1,2,8,0.274554,0.283667,0,No
1,1,1,1,1,2,1,1,2,7,0.327819,0.338512,0,No
1,1,1,1,1,2,1,1,2,8,0.302193,0.308972,0,No
1,1,1,1,1,2,1,1,2,8,0.339934,0.352194,0,No
4,4,16,2,1,3,4,4,8,8,0.339934,0.352194,0,No
1,1,1,1,1,2,1,1,2,8,0.278743,0.288253,0,No
2,2,4,2,1,3,2,2,4,7,0.327819,0.338512,0,No
1,1,1,1,1,2,1,1,2,8,0.268219,0.275191,0,No
2,2,4,1,1,2,2,2,4,8,0.32342,0.334424,0,No
5,5,25,2,3,5,5,5,10,8,0.325208,0.334565,0,No
2,2,4,1,1,2,2,2,4,9,0.268641,0.276936,0,No
1,1,1,1,1,2,1,1,2,8,0.301584,0.314486,0,No
2,2,4,2,2,4,2,2,4,8,0.340803,0.353326,0,No
2,2,4,1,2,3,2,2,4,7,0.320209,0.327383,0,No
1,1,1,1,1,2,1,1,2,8,0.313502,0.320218,0,No
2,2,4,2,2,4,2,2,4,8,0.338243,0.351497,0,No
1,1,1,1,1,2,1,1,2,7,0.296305,0.304855,0,No
1,1,1,1,1,2,1,1,2,8,0.32342,0.334424,0,No
2,2,4,1,1,2,2,2,4,9,0.240765,0.24429,0,No
1,1,1,1,1,2,1,1,2,8,0.323426,0.334429,0,No
2,2,4,1,1,2,2,2,4,8,0.304126,0.310933,0,No
1,1,1,1,1,2,1,1,2,8,0.302193,0.308972,0,No
1,1,1,1,1,2,1,1,2,8,0.27455,0.283664,0,No
9,9,81,1,7,8,9,9,18,7,0.337087,0.349224,0,No
10,9,90,2,8,10,10,10,20,7,0.364578,0.380366,0,No
1,1,1,1,1,2,1,1,2,7,0.327819,0.338512,0,No
2,2,4,1,1,2,2,2,4,8,0.277096,0.285605,0,No
11,10,110,1,10,11,11,11,22,7,0.35257,0.366347,0,No
1,1,1,1,1,2,1,1,2,9,0.268641,0.276936,0,No
3,3,9,1,2,3,3,3,6,8,0.309303,0.316378,0,No
2,2,4,1,1,2,2,2,4,8,0.301589,0.314491,0,No
1,1,1,1,1,2,1,1,2,8,0.301584,0.314486,0,No
1,1,1,1,1,2,1,1,2,9,0.268721,0.277328,0,No
1,1,1,1,1,2,1,1,2,8,0.285039,0.292315,0,No
1,1,1,1,1,2,1,1,2,7,0.296305,0.304855,0,No
2,2,4,1,2,3,2,2,4,8,0.315071,0.324396,0,No
1,1,1,1,1,2,1,1,2,8,0.331571,0.343073,0,No
1,1,1,1,1,2,1,1,2,8,0.2876,0.295187,0,No
1,1,1,1,1,2,1,1,2,9,0.263407,0.269134,0,No
1,1,1,1,1,2,1,1,2,8,0.32342,0.334424,0,No
1,1,1,1,1,2,1,1,2,8,0.306657,0.315385,0,No
2,2,4,1,1,2,2,2,4,7,0.327819,0.338512,0,No
1,1,1,1,1,2,1,1,2,8,0.286532,0.293667,0,No
1,1,1,1,1,2,1,1,2,8,0.266426,0.272715,0,No
1,1,1,1,1,2,1,1,2,8,0.253269,0.257787,0,No
1,1,1,1,1,2,1,1,2,8,0.32342,0.334424,0,No
1,1,1,1,1,2,1,1,2,8,0.255163,0.26021,0,No
1,1,1,1,1,2,1,1,2,7,0.327819,0.338512,0,No
4,4,16,1,4,5,4,4,8,8,0.344415,0.357951,0,No
2,2,4,2,2,4,2,2,4,8,0.330961,0.343854,0,No
1,1,1,1,1,2,1,1,2,8,0.317445,0.327454,0,No
2,2,4,2,2,4,2,2,4,8,0.312979,0.324985,0,No
3,3,9,2,1,3,3,3,6,8,0.339934,0.352194,0,No
1,1,1,1,1,2,1,1,2,8,0.310722,0.317507,0,No
2,2,4,1,1,2,2,2,4,9,0.268641,0.276936,0,No
2,2,4,1,2,3,2,2,4,8,0.295504,0.303077,0,No
1,1,1,1,1,2,1,1,2,8,0.339941,0.352199,0,No
1,1,1,1,1,2,1,1,2,8,0.270172,0.276647,0,No
1,1,1,1,1,2,1,1,2,9,0.268641,0.276936,0,No
1,1,1,1,1,2,1,1,2,8,0.303661,0.312967,0,No
1,1,1,1,1,2,1,1,2,8,0.310033,0.318684,0,No
1,1,1,1,1,2,1,1,2,8,0.32342,0.334424,0,No
1,1,1,1,1,2,1,1,2,9,0.280678,0.287955,0,No
2,2,4,1,1,2,2,2,4,8,0.307813,0.314411,0,No
5,5,25,3,5,8,5,5,10,8,0.362356,0.378239,0,No
1,1,1,1,1,2,1,1,2,8,0.272359,0.278828,0,No
1,1,1,1,1,2,1,1,2,8,0.281619,0.289092,0,No
2,2,4,2,2,4,2,2,4,8,0.309538,0.315995,0,No
1,1,1,1,1,2,1,1,2,8,0.301584,0.314486,0,No
1,1,1,1,1,2,1,1,2,8,0.331571,0.343073,0,No
1,1,1,1,1,2,1,1,2,8,0.323426,0.334429,0,No
1,1,1,1,1,2,1,1,2,8,0.258848,0.264107,0,No
1,1,1,1,1,2,1,1,2,8,0.288153,0.295426,0,No
1,1,1,1,1,2,1,1,2,8,0.273183,0.279701,0,No
1,1,1,1,1,2,1,1,2,7,0.327826,0.338517,0,No
1,1,1,1,1,2,1,1,2,8,0.309325,0.317943,0,No
1,1,1,1,1,2,1,1,2,8,0.339934,0.352194,0,No
1,1,1,1,1,2,1,1,2,7,0.327819,0.338512,0,No
1,1,1,1,1,2,1,1,2,8,0.30748,0.313776,0,No
1,1,1,1,1,2,1,1,2,7,0.327826,0.338517,0,No
2,2,4,2,2,4,2,2,4,8,0.340043,0.352341,0,No
1,1,1,1,1,2,1,1,2,8,0.309325,0.317943,0,No
1,1,1,1,1,2,1,1,2,9,0.260059,0.26552,0,No
1,1,1,1,1,2,1,1,2,8,0.271903,0.280398,0,No
3,3,9,1,2,3,3,3,6,8,0.273432,0.280103,0,No
1,1,1,1,1,2,1,1,2,8,0.32342,0.334424,0,No
1,1,1,1,1,2,1,1,2,9,0.265932,0.272147,0,No
1,1,1,1,1,2,1,1,2,8,0.339934,0.352194,0,No
1,1,1,1,1,2,1,1,2,7,0.327819,0.338512,0,No
1,1,1,1,1,2,1,1,2,8,0.339934,0.352194,0,No
1,1,1,1,1,2,1,1,2,8,0.288929,0.297713,0,No
2,2,4,1,1,2,2,2,4,8,0.301578,0.314477,0,No
1,1,1,1,1,2,1,1,2,8,0.310033,0.318684,0,No
1,1,1,1,1,2,1,1,2,8,0.302198,0.308977,0,No
1,1,1,1,1,2,1,1,2,9,0.256938,0.26228,0,No
3,3,9,1,3,4,3,3,6,7,0.334654,0.345804,0,No
7,7,49,1,6,7,7,7,14,7,0.346788,0.36127,0,No
3,3,9,1,3,4,3,3,6,8,0.345797,0.358946,0,No
1,1,1,1,1,2,1,1,2,7,0.327819,0.338512,0,No
1,1,1,1,1,2,1,1,2,7,0.327819,0.338512,0,No
1,1,1,1,1,2,1,1,2,8,0.27455,0.283664,0,No
3,3,9,1,1,2,3,3,6,7,0.327819,0.338512,0,No
4,4,16,1,3,4,4,4,8,8,0.313416,0.320704,0,No
2,2,4,2,2,4,2,2,4,8,0.342136,0.354775,0,No
13,13,169,1,7,8,13,13,26,7,0.353667,0.3685,0,No
6,6,36,2,6,8,6,6,12,8,0.329465,0.340458,0,No
1,1,1,1,1,2,1,1,2,7,0.327819,0.338512,0,No
5,5,25,3,4,7,5,5,10,7,0.345188,0.359102,0,No
2,2,4,1,1,2,2,2,4,8,0.32342,0.334424,0,No
1,1,1,1,1,2,1,1,2,7,0.327819,0.338512,0,No
2,2,4,2,2,4,2,2,4,8,0.283679,0.291786,0,No
1,1,1,1,1,2,1,1,2,8,0.310028,0.318679,0,No
2,2,4,1,1,2,2,2,4,8,0.310028,0.318679,0,No
2,2,4,2,2,4,2,2,4,8,0.331959,0.342516,0,No
4,4,16,3,3,6,4,4,8,8,0.329281,0.340572,0,No
2,2,4,1,1,2,2,2,4,8,0.288934,0.297717,0,No
28,27,756,2,2,4,28,28,56,8,0.344603,0.357396,0,No
2,2,4,2,2,4,2,2,4,8,0.310496,0.317216,0,No
1,1,1,1,1,2,1,1,2,8,0.32342,0.334424,0,No
1,1,1,1,1,2,1,1,2,8,0.32342,0.334424,0,No
2,2,4,2,2,4,2,2,4,8,0.323518,0.334576,0,No
1,1,1,1,1,2,1,1,2,8,0.32342,0.334424,0,No
2,2,4,2,2,4,2,2,4,8,0.296325,0.304945,0,No
1,1,1,1,1,2,1,1,2,8,0.303375,0.311466,0,No
2,2,4,2,2,4,2,2,4,8,0.330961,0.343854,0,No
2,1,2,1,2,3,2,2,4,8,0.327455,0.338576,0,No
3,3,9,3,3,6,3,3,6,7,0.321585,0.328748,0,No
1,1,1,1,1,2,1,1,2,8,0.310033,0.318684,0,No
1,1,1,1,1,2,1,1,2,8,0.271224,0.279029,0,No
4,4,16,3,3,6,4,4,8,8,0.321907,0.331759,0,No
1,1,1,1,1,2,1,1,2,8,0.310028,0.318679,0,No
1,1,1,1,1,2,1,1,2,8,0.32342,0.334424,0,No
1,1,1,1,1,2,1,1,2,8,0.32342,0.334424,0,No
1,1,1,1,1,2,1,1,2,8,0.27455,0.283664,0,No
2,2,4,1,1,2,2,2,4,8,0.309325,0.317943,0,No
2,2,4,1,1,2,2,2,4,8,0.32342,0.334424,0,No
2,2,4,2,2,4,2,2,4,8,0.317889,0.326166,0,No
1,1,1,1,1,2,1,1,2,8,0.301589,0.314491,0,No
1,1,1,1,1,2,1,1,2,8,0.339941,0.352199,0,No
3,3,9,3,3,6,3,3,6,7,0.322534,0.331579,0,No
4,4,16,2,2,4,4,4,8,8,0.31271,0.321535,0,No
1,1,1,1,1,2,1,1,2,8,0.306448,0.313104,0,No
1,1,1,1,1,2,1,1,2,8,0.323426,0.334429,0,No
2,2,4,2,2,4,2,2,4,8,0.294881,0.30564,0,No
2,2,4,2,2,4,2,2,4,8,0.3235,0.334545,0,No
3,3,9,2,3,5,3,3,6,8,0.314334,0.323453,0,No
7,7,49,5,5,10,7,7,14,8,0.335496,0.347852,0,No
2,2,4,1,1,2,2,2,4,8,0.271903,0.280398,0,No
2,2,4,2,2,4,2,2,4,8,0.269205,0.275715,0,No
1,1,1,1,1,2,1,1,2,8,0.32342,0.334424,0,No
1,1,1,1,1,2,1,1,2,9,0.236009,0.239115,0,No
1,1,1,1,1,2,1,1,2,8,0.310722,0.317507,0,No
4,4,16,3,3,6,4,4,8,8,0.332586,0.344522,0,No
2,2,4,1,1,2,2,2,4,8,0.28349,0.292904,0,No
1,1,1,1,1,2,1,1,2,8,0.32342,0.334424,0,No
1,1,1,1,1,2,1,1,2,8,0.2876,0.295187,0,No
2,2,4,2,2,4,2,2,4,8,0.308074,0.31484,0,No
5,5,25,3,4,7,5,5,10,8,0.354902,0.369804,0,No
1,1,1,1,1,2,1,1,2,8,0.296438,0.303643,0,No
1,1,1,1,1,2,1,1,2,8,0.268219,0.275191,0,No
1,1,1,1,1,2,1,1,2,8,0.32342,0.334424,0,No
1,1,1,1,1,2,1,1,2,9,0.268721,0.277328,0,No
1,1,1,1,1,2,1,1,2,8,0.314583,0.32146,0,No
1,1,1,1,1,2,1,1,2,8,0.303655,0.312962,0,No
3,3,9,1,1,2,3,3,6,8,0.310028,0.318679,0,No
2,2,4,2,2,4,2,2,4,8,0.344408,0.357419,0,No
1,1,1,1,1,2,1,1,2,9,0.256996,0.262015,0,No
1,1,1,1,1,2,1,1,2,8,0.3113,0.3223,0,No
1,1,1,1,1,2,1,1,2,8,0.315759,0.323487,0,No
5,5,25,4,4,8,5,5,10,8,0.323672,0.332362,0,No
3,3,9,3,3,6,3,3,6,8,0.335635,0.349096,0,No
1,1,1,1,1,2,1,1,2,8,0.301584,0.314486,0,No
2,2,4,1,1,2,2,2,4,8,0.283486,0.292899,0,No
1,1,1,1,1,2,1,1,2,8,0.300569,0.30749,0,No
4,4,16,3,4,7,4,4,8,8,0.326721,0.339395,0,No
1,1,1,1,1,2,1,1,2,8,0.301584,0.314486,0,No
2,2,4,2,2,4,2,2,4,8,0.305394,0.312517,0,No
2,2,4,2,2,4,2,2,4,8,0.338243,0.351497,0,No
1,1,1,1,1,2,1,1,2,8,0.288163,0.299063,0,No
1,1,1,1,1,2,1,1,2,8,0.339934,0.352194,0,No
2,2,4,1,1,2,2,2,4,8,0.288163,0.299063,0,No
8,8,64,2,4,6,8,8,16,8,0.342906,0.356874,0,No
1,1,1,1,1,2,1,1,2,8,0.339934,0.352194,0,No
3,3,9,3,3,6,3,3,6,8,0.293602,0.303182,0,No
1,1,1,1,1,2,1,1,2,8,0.311312,0.322315,0,No
1,1,1,1,1,2,1,1,2,8,0.296171,0.303818,0,No
1,1,1,1,1,2,1,1,2,8,0.339934,0.352194,0,No
1,1,1,1,1,2,1,1,2,8,0.278743,0.288253,0,No
1,1,1,1,1,2,1,1,2,8,0.305116,0.311592,0,No
1,1,1,1,1,2,1,1,2,8,0.323426,0.334429,0,No
1,1,1,1,1,2,1,1,2,8,0.310033,0.318684,0,No
2,2,4,1,2,3,2,2,4,8,0.325319,0.3366,0,No
1,1,1,1,1,2,1,1,2,8,0.301589,0.314491,0,No
1,1,1,1,1,2,1,1,2,8,0.32342,0.334424,0,No
1,1,1,1,1,2,1,1,2,8,0.288168,0.299068,0,No
1,1,1,1,1,2,1,1,2,8,0.339934,0.352194,0,No
1,1,1,1,1,2,1,1,2,8,0.288168,0.299068,0,No
2,2,4,1,1,2,2,2,4,8,0.301589,0.314491,0,No
2,2,4,1,2,3,2,2,4,8,0.338189,0.350948,0,No
1,1,1,1,1,2,1,1,2,8,0.292345,0.299887,0,No
1,1,1,1,1,2,1,1,2,8,0.288934,0.297717,0,No
6,6,36,1,4,5,6,6,12,8,0.316926,0.325428,0,No
1,1,1,1,1,2,1,1,2,8,0.301589,0.314491,0,No
1,1,1,1,1,2,1,1,2,7,0.327819,0.338512,0,No
1,1,1,1,1,2,1,1,2,8,0.306657,0.315385,0,No
2,2,4,1,2,3,2,2,4,7,0.336363,0.346863,0,No
1,1,1,1,1,2,1,1,2,9,0.27946,0.286689,0,No
1,1,1,1,1,2,1,1,2,8,0.301589,0.314491,0,No
1,1,1,1,1,2,1,1,2,9,0.284336,0.292278,0,No
1,1,1,1,1,2,1,1,2,8,0.310717,0.317502,0,No
2,2,4,1,1,2,2,2,4,8,0.339934,0.352194,0,No
1,1,1,1,1,2,1,1,2,8,0.310028,0.318679,0,No
1,1,1,1,1,2,1,1,2,8,0.30338,0.311471,0,No
1,1,1,1,1,2,1,1,2,8,0.339934,0.352194,0,No
2,2,4,1,1,2,2,2,4,8,0.278743,0.288253,0,No
1,1,1,1,1,2,1,1,2,8,0.27455,0.283664,0,No
2,2,4,1,1,2,2,2,4,9,0.257831,0.263353,0,No
1,1,1,1,1,2,1,1,2,7,0.327819,0.338512,0,No
1,1,1,1,1,2,1,1,2,8,0.310033,0.318684,0,No
1,1,1,1,1,2,1,1,2,8,0.301589,0.314491,0,No
1,1,1,1,1,2,1,1,2,7,0.327813,0.338503,0,No
1,1,1,1,1,2,1,1,2,8,0.310028,0.318679,0,No
1,1,1,1,1,2,1,1,2,8,0.254171,0.259319,0,No
2,2,4,1,2,3,2,2,4,8,0.274241,0.281926,0,No
1,1,1,1,1,2,1,1,2,8,0.32342,0.334424,0,No
4,4,16,1,2,3,4,4,8,8,0.336323,0.348407,0,No
2,2,4,1,1,2,2,2,4,8,0.32342,0.334424,0,No
2,2,4,1,1,2,2,2,4,8,0.27122,0.279026,0,No
4,4,16,1,2,3,4,4,8,8,0.323881,0.335064,0,No
2,2,4,1,1,2,2,2,4,8,0.254171,0.259319,0,No
5,5,25,1,2,3,5,5,10,8,0.299246,0.308726,0,No
2,2,4,2,2,4,2,2,4,8,0.271449,0.279259,0,No
1,1,1,1,1,2,1,1,2,8,0.265069,0.270914,0,No
1,1,1,1,1,2,1,1,2,8,0.303585,0.310469,0,No
1,1,1,1,1,2,1,1,2,8,0.276853,0.283752,0,No
2,2,4,1,2,3,2,2,4,8,0.301419,0.308213,0,No
2,2,4,2,2,4,2,2,4,7,0.313278,0.320016,0,No
2,2,4,1,1,2,2,2,4,8,0.288163,0.299063,0,No
1,1,1,1,1,2,1,1,2,8,0.293133,0.30075,0,No
1,1,1,1,1,2,1,1,2,8,0.317445,0.327454,0,No
2,2,4,2,2,4,2,2,4,8,0.315089,0.329716,0,No
1,1,1,1,1,2,1,1,2,8,0.301589,0.314491,0,No
3,3,9,2,2,4,3,3,6,7,0.332236,0.343545,0,No
1,1,1,1,1,2,1,1,2,8,0.278743,0.288253,0,No
3,3,9,1,2,3,3,3,6,8,0.344283,0.357109,0,No
2,2,4,2,2,4,2,2,4,8,0.338243,0.351497,0,No
1,1,1,1,1,2,1,1,2,8,0.278743,0.288253,0,No
1,1,1,1,1,2,1,1,2,8,0.339934,0.352194,0,No
1,1,1,1,1,2,1,1,2,9,0.268637,0.276931,0,No
1,1,1,1,1,2,1,1,2,8,0.317445,0.327454,0,No
1,1,1,1,1,2,1,1,2,9,0.268641,0.276936,0,No
1,1,1,1,1,2,1,1,2,8,0.279744,0.286783,0,No
1,1,1,1,1,2,1,1,2,9,0.266659,0.272921,0,No
4,4,16,2,4,6,4,4,8,8,0.329236,0.338144,0,No
1,1,1,1,1,2,1,1,2,8,0.294469,0.301552,0,No
1,1,1,1,1,2,1,1,2,8,0.301584,0.314486,0,No
1,1,1,1,1,2,1,1,2,8,0.296125,0.303073,0,No
1,1,1,1,1,2,1,1,2,7,0.296305,0.304855,0,No
1,1,1,1,1,2,1,1,2,9,0.274303,0.281233,0,No
1,1,1,1,1,2,1,1,2,8,0.303407,0.310006,0,No
2,2,4,2,2,4,2,2,4,8,0.342342,0.354886,0,No
6,5,30,5,5,10,6,6,12,8,0.352884,0.36767,0,No
1,1,1,1,1,2,1,1,2,8,0.339934,0.352194,0,No
6,6,36,5,3,8,6,6,12,8,0.345209,0.359841,0,No
1,1,1,1,1,2,1,1,2,8,0.288168,0.299068,0,No
2,2,4,1,1,2,2,2,4,7,0.2963,0.30485,0,No
1,1,1,1,1,2,1,1,2,7,0.327819,0.338512,0,No
1,1,1,1,1,2,1,1,2,8,0.303375,0.311466,0,No
1,1,1,1,1,2,1,1,2,8,0.301584,0.314486,0,No
1,1,1,1,1,2,1,1,2,8,0.301589,0.314491,0,No
3,3,9,1,3,4,3,3,6,8,0.341533,0.355258,0,No
1,1,1,1,1,2,1,1,2,9,0.253115,0.258182,0,No
2,2,4,1,1,2,2,2,4,8,0.32342,0.334424,0,No
3,3,9,1,3,4,3,3,6,8,0.342651,0.355478,0,No
4,4,16,1,4,5,4,4,8,7,0.331494,0.342112,0,No
1,1,1,1,1,2,1,1,2,8,0.278743,0.288253,0,No
2,2,4,2,2,4,2,2,4,8,0.320697,0.329394,0,No
1,1,1,1,1,2,1,1,2,7,0.327819,0.338512,0,No
1,1,1,1,1,2,1,1,2,8,0.339934,0.352194,0,No
2,2,4,1,1,2,2,2,4,7,0.327819,0.338512,0,No
1,1,1,1,1,2,1,1,2,8,0.277601,0.284747,0,No
1,1,1,1,1,2,1,1,2,8,0.339934,0.352194,0,No
1,1,1,1,1,2,1,1,2,8,0.331571,0.343073,0,No
1,1,1,1,1,2,1,1,2,8,0.301584,0.314486,0,No
1,1,1,1,1,2,1,1,2,8,0.32342,0.334424,0,No
1,1,1,1,1,2,1,1,2,9,0.266272,0.272882,0,No
1,1,1,1,1,2,1,1,2,9,0.268721,0.277328,0,No
1,1,1,1,1,2,1,1,2,8,0.301584,0.314486,0,No
1,1,1,1,1,2,1,1,2,9,0.260552,0.266141,0,No
1,1,1,1,1,2,1,1,2,8,0.32342,0.334424,0,No
1,1,1,1,1,2,1,1,2,7,0.327819,0.338512,0,No
3,3,9,3,2,5,3,3,6,8,0.324028,0.334961,0,No
1,1,1,1,1,2,1,1,2,8,0.287605,0.295192,0,No
4,4,16,3,2,5,4,4,8,8,0.335193,0.345963,0,No
3,3,9,3,2,5,3,3,6,8,0.338243,0.351497,0,No
2,2,4,2,2,4,2,2,4,8,0.327832,0.339198,0,No
4,4,16,2,3,5,4,4,8,8,0.319753,0.326837,0,No
4,4,16,4,4,8,4,4,8,8,0.35344,0.36794,0,No
6,6,36,6,3,9,6,6,12,8,0.353037,0.367442,0,No
1,1,1,1,1,2,1,1,2,8,0.32342,0.334424,0,No
1,1,1,1,1,2,1,1,2,8,0.303688,0.310784,0,No
1,1,1,1,1,2,1,1,2,8,0.271899,0.280395,0,No
1,1,1,1,1,2,1,1,2,8,0.258848,0.264107,0,No
2,2,4,1,1,2,2,2,4,8,0.331571,0.343073,0,No
1,1,1,1,1,2,1,1,2,8,0.339934,0.352194,0,No
1,1,1,1,1,2,1,1,2,9,0.262241,0.268868,0,No
1,1,1,1,1,2,1,1,2,9,0.268641,0.276936,0,No
1,1,1,1,1,2,1,1,2,8,0.310028,0.318679,0,No
1,1,1,1,1,2,1,1,2,8,0.323426,0.334429,0,No
1,1,1,1,1,2,1,1,2,8,0.287605,0.295192,0,No
1,1,1,1,1,2,1,1,2,8,0.32342,0.334424,0,No
2,2,4,2,1,3,2,2,4,8,0.309325,0.317943,0,No
3,3,9,1,2,3,3,3,6,8,0.328482,0.339644,0,No
1,1,1,1,1,2,1,1,2,8,0.298534,0.305391,0,No
3,3,9,2,2,4,3,3,6,8,0.305679,0.313002,0,No
1,1,1,1,1,2,1,1,2,8,0.311312,0.322315,0,No
1,1,1,1,1,2,1,1,2,8,0.288163,0.299063,0,No
1,1,1,1,1,2,1,1,2,9,0.268721,0.277328,0,No
2,2,4,1,1,2,2,2,4,8,0.339941,0.352199,0,No
3,3,9,2,2,4,3,3,6,8,0.318488,0.327558,0,No
1,1,1,1,1,2,1,1,2,8,0.306657,0.315385,0,No
3,3,9,2,2,4,3,3,6,7,0.297503,0.306002,0,No
1,1,1,1,1,2,1,1,2,8,0.303375,0.311466,0,No
1,1,1,1,1,2,1,1,2,9,0.268637,0.276931,0,No
7,7,49,1,5,6,7,7,14,7,0.356318,0.370921,0,No
1,1,1,1,1,2,1,1,2,8,0.295965,0.304324,0,No
1,1,1,1,1,2,1,1,2,8,0.28349,0.292904,0,No
7,7,49,2,3,5,7,7,14,7,0.334195,0.345818,0,No
1,1,1,1,1,2,1,1,2,8,0.331571,0.343073,0,No
2,2,4,2,2,4,2,2,4,7,0.328217,0.338872,0,No
1,1,1,1,1,2,1,1,2,9,0.268641,0.276936,0,No
1,1,1,1,1,2,1,1,2,8,0.339934,0.352194,0,No
2,2,4,1,1,2,2,2,4,8,0.278748,0.288256,0,No
1,1,1,1,1,2,1,1,2,8,0.303655,0.312962,0,No
1,1,1,1,1,2,1,1,2,8,0.280641,0.287963,0,No
6,6,36,5,4,9,6,6,12,8,0.32115,0.331204,0,No
1,1,1,1,1,2,1,1,2,8,0.339934,0.352194,0,No
2,2,4,2,2,4,2,2,4,7,0.329745,0.340907,0,No
1,1,1,1,1,2,1,1,2,9,0.250845,0.25593,0,No
1,1,1,1,1,2,1,1,2,9,0.256613,0.261967,0,No
1,1,1,1,1,2,1,1,2,8,0.309325,0.317943,0,No
3,3,9,1,2,3,3,3,6,9,0.272554,0.281597,0,No
1,1,1,1,1,2,1,1,2,8,0.309331,0.317947,0,No
2,2,4,2,2,4,2,2,4,8,0.328368,0.339723,0,No
1,1,1,1,1,2,1,1,2,8,0.30268,0.309675,0,No
2,2,4,2,2,4,2,2,4,8,0.304229,0.313521,0,No
2,2,4,1,1,2,2,2,4,8,0.279689,0.286598,0,No
1,1,1,1,1,2,1,1,2,8,0.301584,0.314486,0,No
1,1,1,1,1,2,1,1,2,8,0.303385,0.311474,0,No
1,1,1,1,1,2,1,1,2,8,0.311312,0.322315,0,No
1,1,1,1,1,2,1,1,2,8,0.309068,0.315818,0,No
1,1,1,1,1,2,1,1,2,8,0.297711,0.304473,0,No
1,1,1,1,1,2,1,1,2,9,0.254908,0.260671,0,No
2,2,4,2,2,4,2,2,4,8,0.30978,0.323438,0,No
1,1,1,1,1,2,1,1,2,9,0.265708,0.272581,0,No
1,1,1,1,1,2,1,1,2,8,0.317445,0.327454,0,No
1,1,1,1,1,2,1,1,2,9,0.253793,0.258648,0,No
1,1,1,1,1,2,1,1,2,8,0.294479,0.3016,0,No
1,1,1,1,1,2,1,1,2,9,0.253797,0.258651,0,No
1,1,1,1,1,2,1,1,2,9,0.25212,0.257194,0,No
2,2,4,1,1,2,2,2,4,9,0.243837,0.24751,0,No
1,1,1,1,1,2,1,1,2,9,0.268721,0.277328,0,No
2,2,4,2,2,4,2,2,4,8,0.310315,0.324453,0,No
3,3,9,1,1,2,3,3,6,8,0.302842,0.310166,0,No
1,1,1,1,1,2,1,1,2,8,0.32342,0.334424,0,No
1,1,1,1,1,2,1,1,2,9,0.276056,0.283078,0,No
1,1,1,1,1,2,1,1,2,9,0.242824,0.247184,0,No
1,1,1,1,1,2,1,1,2,8,0.290622,0.298005,0,No
1,1,1,1,1,2,1,1,2,7,0.327819,0.338512,0,No
1,1,1,1,1,2,1,1,2,8,0.264645,0.270428,0,No
1,1,1,1,1,2,1,1,2,8,0.287605,0.295192,0,No
1,1,1,1,1,2,1,1,2,9,0.253736,0.258629,0,No
1,1,1,1,1,2,1,1,2,8,0.301589,0.314491,0,No
3,3,9,2,3,5,3,3,6,7,0.326865,0.33697,0,No
1,1,1,1,1,2,1,1,2,8,0.2828,0.289824,0,No
1,1,1,1,1,2,1,1,2,7,0.296305,0.304855,0,No
1,1,1,1,1,2,1,1,2,7,0.312584,0.319273,0,No
3,3,9,2,2,4,3,3,6,8,0.341117,0.35347,0,No
1,1,1,1,1,2,1,1,2,8,0.339934,0.352194,0,No
1,1,1,1,1,2,1,1,2,8,0.26663,0.273152,0,No
1,1,1,1,1,2,1,1,2,7,0.296305,0.304855,0,No
2,2,4,2,2,4,2,2,4,8,0.346281,0.360278,0,No
1,1,1,1,1,2,1,1,2,9,0.250558,0.25517,0,No
1,1,1,1,1,2,1,1,2,8,0.339934,0.352194,0,No
1,1,1,1,1,2,1,1,2,8,0.331571,0.343073,0,No
1,1,1,1,1,2,1,1,2,8,0.303375,0.311466,0,No
1,1,1,1,1,2,1,1,2,7,0.327826,0.338517,0,No
2,2,4,1,1,2,2,2,4,9,0.25212,0.257194,0,No
1,1,1,1,1,2,1,1,2,8,0.288168,0.299068,0,No
1,1,1,1,1,2,1,1,2,8,0.278748,0.288256,0,No
1,1,1,1,1,2,1,1,2,9,0.269107,0.277075,0,No
1,1,1,1,1,2,1,1,2,8,0.285029,0.29199,0,No
2,2,4,2,2,4,2,2,4,8,0.286167,0.293437,0,No
1,1,1,1,1,2,1,1,2,8,0.292671,0.300192,0,No
2,1,2,2,2,4,2,2,4,8,0.33825,0.351502,0,No
2,2,4,2,1,3,2,2,4,8,0.301589,0.314491,0,No
3,3,9,3,3,6,3,3,6,8,0.312755,0.326791,0,No
2,2,4,1,1,2,2,2,4,8,0.29612,0.303068,0,No
1,1,1,1,1,2,1,1,2,8,0.271899,0.280395,0,No
1,1,1,1,1,2,1,1,2,8,0.271899,0.280395,0,No
2,2,4,2,2,4,2,2,4,8,0.332963,0.343626,0,No
3,3,9,3,3,6,3,3,6,8,0.318138,0.325205,0,No
4,4,16,2,3,5,4,4,8,8,0.345035,0.357938,0,No
3,3,9,2,2,4,3,3,6,8,0.325897,0.337177,0,No
2,2,4,1,1,2,2,2,4,8,0.339934,0.352194,0,No
1,1,1,1,1,2,1,1,2,9,0.258303,0.26386,0,No
1,1,1,1,1,2,1,1,2,8,0.288163,0.299063,0,No
6,6,36,3,5,8,6,6,12,8,0.346042,0.359784,0,No
2,2,4,2,1,3,2,2,4,8,0.317292,0.324388,0,No
2,2,4,1,1,2,2,2,4,8,0.339934,0.352194,0,No
1,1,1,1,1,2,1,1,2,8,0.258883,0.26458,0,No
1,1,1,1,1,2,1,1,2,8,0.32342,0.334424,0,No
5,5,25,2,4,6,5,5,10,8,0.337494,0.349059,0,No
3,3,9,1,1,2,3,3,6,9,0.235495,0.238581,0,No
3,3,9,2,3,5,3,3,6,8,0.317203,0.324421,0,No
1,1,1,1,1,2,1,1,2,8,0.311306,0.32231,0,No
1,1,1,1,1,2,1,1,2,8,0.339934,0.352194,0,No
1,1,1,1,1,2,1,1,2,9,0.253725,0.258605,0,No
1,1,1,1,1,2,1,1,2,7,0.296305,0.304855,0,No
1,1,1,1,1,2,1,1,2,7,0.296305,0.304855,0,No
1,1,1,1,1,2,1,1,2,8,0.306448,0.313104,0,No
1,1,1,1,1,2,1,1,2,8,0.314583,0.32146,0,No
1,1,1,1,1,2,1,1,2,8,0.301584,0.314486,0,No
2,2,4,1,1,2,2,2,4,8,0.301589,0.314491,0,No
1,1,1,1,1,2,1,1,2,8,0.303402,0.310001,0,No
1,1,1,1,1,2,1,1,2,8,0.323426,0.334429,0,No
1,1,1,1,1,2,1,1,2,9,0.271946,0.278617,0,No
2,2,4,1,1,2,2,2,4,8,0.315759,0.323487,0,No
1,1,1,1,1,2,1,1,2,8,0.276319,0.283389,0,No
1,1,1,1,1,2,1,1,2,8,0.302847,0.310171,0,No
1,1,1,1,1,2,1,1,2,8,0.339941,0.352199,0,No
1,1,1,1,1,2,1,1,2,8,0.339934,0.352194,0,No
1,1,1,1,1,2,1,1,2,8,0.339941,0.352199,0,No
2,2,4,1,1,2,2,2,4,8,0.303661,0.312967,0,No
1,1,1,1,1,2,1,1,2,8,0.281828,0.289886,0,No
1,1,1,1,1,2,1,1,2,8,0.275414,0.282368,0,No
2,2,4,1,1,2,2,2,4,8,0.339941,0.352199,0,No
1,1,1,1,1,2,1,1,2,8,0.288934,0.297717,0,No
1,1,1,1,1,2,1,1,2,8,0.276279,0.283498,0,No
1,1,1,1,1,2,1,1,2,8,0.313502,0.320218,0,No
1,1,1,1,1,2,1,1,2,8,0.286359,0.293536,0,No
1,1,1,1,1,2,1,1,2,8,0.29902,0.30606,0,No
1,1,1,1,1,2,1,1,2,9,0.241344,0.246172,0,No
1,1,1,1,1,2,1,1,2,9,0.268645,0.276939,0,No
1,1,1,1,1,2,1,1,2,9,0.268721,0.277328,0,No
1,1,1,1,1,2,1,1,2,8,0.288168,0.299068,0,No
1,1,1,1,1,2,1,1,2,8,0.278743,0.288253,0,No
2,2,4,2,2,4,2,2,4,8,0.306684,0.3144,0,No
2,2,4,1,1,2,2,2,4,9,0.268641,0.276936,0,No
1,1,1,1,1,2,1,1,2,9,0.232571,0.236263,0,No
2,2,4,1,1,2,2,2,4,8,0.309331,0.317947,0,No
1,1,1,1,1,2,1,1,2,8,0.317292,0.324388,0,No
1,1,1,1,1,2,1,1,2,8,0.310033,0.318684,0,No
1,1,1,1,1,2,1,1,2,8,0.262415,0.267999,0,No
1,1,1,1,1,2,1,1,2,8,0.301589,0.314491,0,No
2,2,4,1,1,2,2,2,4,8,0.294611,0.302087,0,No
1,1,1,1,1,2,1,1,2,8,0.304126,0.310713,0,No
1,1,1,1,1,2,1,1,2,8,0.339934,0.352194,0,No
2,2,4,2,2,4,2,2,4,8,0.315485,0.32217,0,No
1,1,1,1,1,2,1,1,2,9,0.261875,0.267717,0,No
2,2,4,1,2,3,2,2,4,8,0.304132,0.312192,0,No
1,1,1,1,1,2,1,1,2,8,0.272363,0.278831,0,No
1,1,1,1,1,2,1,1,2,8,0.268497,0.274821,0,No
1,1,1,1,1,2,1,1,2,8,0.276813,0.28356,0,No
1,1,1,1,1,2,1,1,2,8,0.284939,0.291935,0,No
1,1,1,1,1,2,1,1,2,8,0.295596,0.303244,0,No
1,1,1,1,1,2,1,1,2,8,0.331571,0.343073,0,No
1,1,1,1,1,2,1,1,2,8,0.339934,0.352194,0,No
1,1,1,1,1,2,1,1,2,8,0.32342,0.334424,0,No
1,1,1,1,1,2,1,1,2,8,0.287605,0.295192,0,No
2,2,4,2,2,4,2,2,4,8,0.302417,0.312687,0,No
1,1,1,1,1,2,1,1,2,8,0.315759,0.323487,0,No
2,2,4,2,2,4,2,2,4,7,0.310949,0.319025,0,No
1,1,1,1,1,2,1,1,2,7,0.327819,0.338512,0,No
5,5,25,2,4,6,5,5,10,8,0.350398,0.364856,0,No
1,1,1,1,1,2,1,1,2,8,0.303688,0.310784,0,No
2,2,4,1,2,3,2,2,4,8,0.305187,0.313423,0,No
1,1,1,1,1,2,1,1,2,8,0.309325,0.317943,0,No
1,1,1,1,1,2,1,1,2,7,0.296305,0.304855,0,No
1,1,1,1,1,2,1,1,2,7,0.296305,0.304855,0,No
3,3,9,1,3,4,3,3,6,7,0.314375,0.32298,0,No
1,1,1,1,1,2,1,1,2,8,0.308542,0.315798,0,No
1,1,1,1,1,2,1,1,2,8,0.303693,0.310789,0,No
1,1,1,1,1,2,1,1,2,7,0.296305,0.304855,0,No
4,4,16,1,3,4,4,4,8,8,0.321767,0.330422,0,No
4,4,16,1,4,5,4,4,8,7,0.332813,0.343493,0,No
1,1,1,1,1,2,1,1,2,8,0.287726,0.294881,0,No
1,1,1,1,1,2,1,1,2,8,0.339934,0.352194,0,No
2,2,4,2,2,4,2,2,4,8,0.307347,0.314269,0,No
1,1,1,1,1,2,1,1,2,8,0.32342,0.334424,0,No
3,3,9,2,2,4,3,3,6,8,0.328767,0.339994,0,No
1,1,1,1,1,2,1,1,2,8,0.301584,0.314486,0,No
1,1,1,1,1,2,1,1,2,8,0.32342,0.334424,0,No
1,1,1,1,1,2,1,1,2,8,0.32342,0.334424,0,No
2,2,4,1,1,2,2,2,4,8,0.301589,0.314491,0,No
1,1,1,1,1,2,1,1,2,9,0.261779,0.267666,0,No
1,1,1,1,1,2,1,1,2,8,0.293138,0.300755,0,No
3,3,9,1,3,4,3,3,6,7,0.354379,0.369964,0,No
1,1,1,1,1,2,1,1,2,8,0.288168,0.299068,0,No
1,1,1,1,1,2,1,1,2,9,0.268641,0.276936,0,No
3,3,9,2,2,4,3,3,6,8,0.290464,0.298052,0,No
1,1,1,1,1,2,1,1,2,8,0.310028,0.318679,0,No
1,1,1,1,1,2,1,1,2,7,0.327819,0.338512,0,No
1,1,1,1,1,2,1,1,2,8,0.301584,0.314486,0,No
2,2,4,2,2,4,2,2,4,9,0.280245,0.28917,0,No
2,2,4,1,1,2,2,2,4,8,0.301584,0.314486,0,No
1,1,1,1,1,2,1,1,2,8,0.310028,0.318679,0,No
2,2,4,2,2,4,2,2,4,8,0.294408,0.306363,0,No
1,1,1,1,1,2,1,1,2,8,0.288173,0.299071,0,No
1,1,1,1,1,2,1,1,2,8,0.299466,0.306438,0,No
1,1,1,1,1,2,1,1,2,8,0.309331,0.317947,0,No
2,2,4,2,2,4,2,2,4,8,0.343666,0.35637,0,No
2,2,4,2,2,4,2,2,4,8,0.310451,0.318111,0,No
1,1,1,1,1,2,1,1,2,8,0.339934,0.352194,0,No
1,1,1,1,1,2,1,1,2,9,0.269103,0.277072,0,No
2,2,4,2,2,4,2,2,4,8,0.324725,0.33557,0,No
4,4,16,4,4,8,4,4,8,8,0.355405,0.370053,0,No
4,4,16,3,3,6,4,4,8,8,0.316632,0.325858,0,No
2,2,4,2,2,4,2,2,4,8,0.330961,0.343854,0,No
1,1,1,1,1,2,1,1,2,8,0.302842,0.310166,0,No
1,1,1,1,1,2,1,1,2,8,0.306657,0.315385,0,No
1,1,1,1,1,2,1,1,2,8,0.32342,0.334424,0,No
3,3,9,3,2,5,3,3,6,8,0.342342,0.354886,0,No
1,1,1,1,1,2,1,1,2,8,0.339934,0.352194,0,No
1,1,1,1,1,2,1,1,2,8,0.277389,0.284283,0,No
1,1,1,1,1,2,1,1,2,8,0.277389,0.284283,0,No
1,1,1,1,1,2,1,1,2,9,0.249769,0.254586,0,No
3,3,9,2,2,4,3,3,6,7,0.315672,0.322801,0,No
1,1,1,1,1,2,1,1,2,8,0.301584,0.314486,0,No
2,2,4,1,1,2,2,2,4,8,0.317292,0.324388,0,No
1,1,1,1,1,2,1,1,2,7,0.327819,0.338512,0,No
2,2,4,1,1,2,2,2,4,8,0.30946,0.31614,0,No
1,1,1,1,1,2,1,1,2,8,0.302198,0.308977,0,No
1,1,1,1,1,2,1,1,2,7,0.296305,0.304855,0,No
1,1,1,1,1,2,1,1,2,7,0.327826,0.338517,0,No
3,3,9,1,2,3,3,3,6,8,0.332385,0.344,0,No
3,3,9,1,2,3,3,3,6,7,0.332236,0.343545,0,No
4,4,16,1,3,4,4,4,8,8,0.310592,0.318092,0,No
1,1,1,1,1,2,1,1,2,9,0.259818,0.265917,0,No
5,5,25,4,2,6,5,5,10,7,0.31809,0.330229,0,No
5,5,25,4,2,6,5,5,10,8,0.338243,0.351497,0,No
1,1,1,1,1,2,1,1,2,8,0.32342,0.334424,0,No
2,2,4,2,1,3,2,2,4,7,0.2963,0.30485,0,No
3,3,9,2,1,3,3,3,6,7,0.2963,0.30485,0,No
1,1,1,1,1,2,1,1,2,8,0.310722,0.317507,0,No
1,1,1,1,1,2,1,1,2,7,0.327826,0.338517,0,No
2,2,4,1,2,3,2,2,4,8,0.329433,0.339833,0,No
1,1,1,1,1,2,1,1,2,8,0.288163,0.299063,0,No
1,1,1,1,1,2,1,1,2,8,0.303688,0.310784,0,No
1,1,1,1,1,2,1,1,2,8,0.339934,0.352194,0,No
2,2,4,1,2,3,2,2,4,7,0.352621,0.366966,0,No
1,1,1,1,1,2,1,1,2,8,0.339934,0.352194,0,No
1,1,1,1,1,2,1,1,2,8,0.303375,0.311466,0,No
1,1,1,1,1,2,1,1,2,8,0.288934,0.297717,0,No
2,2,4,2,2,4,2,2,4,8,0.327455,0.338576,0,No
1,1,1,1,1,2,1,1,2,9,0.268721,0.277328,0,No
1,1,1,1,1,2,1,1,2,8,0.32342,0.334424,0,No
1,1,1,1,1,2,1,1,2,8,0.27122,0.279026,0,No
5,4,20,5,3,8,5,5,10,8,0.32792,0.339211,0,No
2,2,4,2,2,4,2,2,4,8,0.318488,0.325905,0,No
7,7,49,5,6,11,7,7,14,8,0.33514,0.345802,0,No
1,1,1,1,1,2,1,1,2,8,0.288934,0.297717,0,No
2,1,2,2,1,3,2,2,4,8,0.32342,0.334424,0,No
3,3,9,2,1,3,3,3,6,8,0.288929,0.297713,0,No
4,4,16,2,3,5,4,4,8,8,0.329752,0.341349,0,No
2,2,4,1,1,2,2,2,4,8,0.309331,0.317947,0,No
1,1,1,1,1,2,1,1,2,8,0.32342,0.334424,0,No
1,1,1,1,1,2,1,1,2,8,0.32342,0.334424,0,No
1,1,1,1,1,2,1,1,2,8,0.278666,0.285579,0,No
1,1,1,1,1,2,1,1,2,8,0.305121,0.311597,0,No
1,1,1,1,1,2,1,1,2,8,0.32342,0.334424,0,No
2,2,4,1,1,2,2,2,4,8,0.323426,0.334429,0,No
4,4,16,2,2,4,4,4,8,8,0.324645,0.335481,0,No
6,6,36,3,3,6,6,6,12,7,0.33967,0.352687,0,No
1,1,1,1,1,2,1,1,2,7,0.327819,0.338512,0,No
5,5,25,3,5,8,5,5,10,8,0.308682,0.315986,0,No
1,1,1,1,1,2,1,1,2,8,0.315759,0.323487,0,No
1,1,1,1,1,2,1,1,2,8,0.277389,0.284283,0,No
1,1,1,1,1,2,1,1,2,8,0.339934,0.352194,0,No
1,1,1,1,1,2,1,1,2,8,0.301589,0.308538,0,No
1,1,1,1,1,2,1,1,2,8,0.281712,0.288655,0,No
1,1,1,1,1,2,1,1,2,8,0.309325,0.317943,0,No
1,1,1,1,1,2,1,1,2,9,0.256432,0.261764,0,No
3,3,9,3,2,5,3,3,6,7,0.3358,0.346415,0,No
3,3,9,3,3,6,3,3,6,7,0.337895,0.348454,0,No
3,3,9,2,2,4,3,3,6,8,0.308888,0.315312,0,No
4,4,16,3,4,7,4,4,8,8,0.346408,0.359604,0,No
1,1,1,1,1,2,1,1,2,8,0.309325,0.317943,0,No
1,1,1,1,1,2,1,1,2,8,0.270773,0.27742,0,No
3,3,9,1,1,2,3,3,6,8,0.272115,0.278724,0,No
1,1,1,1,1,2,1,1,2,8,0.299835,0.307302,0,No
2,2,4,2,2,4,2,2,4,8,0.305865,0.319015,0,No
4,2,8,2,2,4,4,4,8,8,0.293663,0.300754,0,No
1,1,1,1,1,2,1,1,2,8,0.2977,0.304458,0,No
1,1,1,1,1,2,1,1,2,8,0.339934,0.352194,0,No
1,1,1,1,1,2,1,1,2,8,0.32342,0.334424,0,No
2,2,4,2,1,3,2,2,4,8,0.27122,0.279026,0,No
1,1,1,1,1,2,1,1,2,8,0.283495,0.292907,0,No
1,1,1,1,1,2,1,1,2,8,0.307819,0.314416,0,No
1,1,1,1,1,2,1,1,2,8,0.288163,0.299063,0,No
1,1,1,1,1,2,1,1,2,8,0.309331,0.317947,0,No
1,1,1,1,1,2,1,1,2,8,0.29338,0.300813,0,No
3,3,9,2,3,5,3,3,6,8,0.322028,0.331771,0,No
1,1,1,1,1,2,1,1,2,9,0.270815,0.277408,0,No
1,1,1,1,1,2,1,1,2,9,0.268641,0.276936,0,No
1,1,1,1,1,2,1,1,2,9,0.268641,0.276936,0,No
1,1,1,1,1,2,1,1,2,8,0.339934,0.352194,0,No
1,1,1,1,1,2,1,1,2,8,0.309325,0.317943,0,No
1,1,1,1,1,2,1,1,2,8,0.310028,0.318679,0,No
1,1,1,1,1,2,1,1,2,8,0.269617,0.276137,0,No
3,3,9,2,3,5,3,3,6,8,0.315211,0.322358,0,No
1,1,1,1,1,2,1,1,2,9,0.258887,0.26472,0,No
1,1,1,1,1,2,1,1,2,9,0.268641,0.276936,0,No
1,1,1,1,1,2,1,1,2,8,0.303375,0.311466,0,No
1,1,1,1,1,2,1,1,2,8,0.303375,0.311466,0,No
2,2,4,2,2,4,2,2,4,7,0.329911,0.340912,0,No
1,1,1,1,1,2,1,1,2,8,0.274545,0.283659,0,No
1,1,1,1,1,2,1,1,2,8,0.304452,0.311259,0,No
2,2,4,1,1,2,2,2,4,8,0.29595,0.30471,0,No
1,1,1,1,1,2,1,1,2,8,0.331565,0.343064,0,No
1,1,1,1,1,2,1,1,2,8,0.29595,0.30471,0,No
3,3,9,3,3,6,3,3,6,7,0.340016,0.352695,0,No
1,1,1,1,1,2,1,1,2,8,0.331578,0.343078,0,No
1,1,1,1,1,2,1,1,2,8,0.331571,0.343073,0,No
1,1,1,1,1,2,1,1,2,8,0.331571,0.343073,0,No
5,5,25,2,2,4,5,5,10,8,0.33379,0.345453,0,No
1,1,1,1,1,2,1,1,2,8,0.288929,0.297713,0,No
1,1,1,1,1,2,1,1,2,8,0.306657,0.315385,0,No
6,4,24,3,3,6,6,6,12,8,0.324917,0.33587,0,No
2,2,4,1,1,2,2,2,4,8,0.301589,0.314491,0,No
2,2,4,2,2,4,2,2,4,8,0.303623,0.311717,0,No
1,1,1,1,1,2,1,1,2,8,0.30338,0.311471,0,No
3,3,9,2,2,4,3,3,6,9,0.283203,0.29396,0,No
1,1,1,1,1,2,1,1,2,8,0.303661,0.312967,0,No
1,1,1,1,1,2,1,1,2,8,0.30338,0.311471,0,No
1,1,1,1,1,2,1,1,2,8,0.27122,0.279026,0,No
1,1,1,1,1,2,1,1,2,8,0.277046,0.284249,0,No
3,3,9,2,3,5,3,3,6,8,0.340926,0.353277,0,No
3,3,9,1,3,4,3,3,6,8,0.320968,0.329113,0,No
3,3,9,1,2,3,3,3,6,7,0.33161,0.341859,0,No
1,1,1,1,1,2,1,1,2,7,0.327819,0.338512,0,No
4,4,16,2,2,4,4,4,8,8,0.309831,0.318702,0,No
2,2,4,1,2,3,2,2,4,8,0.308721,0.315685,0,No
2,2,4,2,2,4,2,2,4,8,0.317074,0.324566,0,No
1,1,1,1,1,2,1,1,2,7,0.327819,0.338512,0,No
6,6,36,2,5,7,6,6,12,7,0.341028,0.352668,0,No
2,2,4,2,2,4,2,2,4,7,0.331224,0.342603,0,No
1,1,1,1,1,2,1,1,2,7,0.327819,0.338512,0,No
1,1,1,1,1,2,1,1,2,7,0.327819,0.338512,0,No
2,2,4,1,1,2,2,2,4,8,0.27455,0.283664,0,No
1,1,1,1,1,2,1,1,2,9,0.268721,0.277328,0,No
2,2,4,1,2,3,2,2,4,7,0.327901,0.338628,0,No
1,1,1,1,1,2,1,1,2,8,0.278743,0.288253,0,No
3,3,9,3,3,6,3,3,6,7,0.334306,0.346077,0,No
2,2,4,2,2,4,2,2,4,8,0.298174,0.307277,0,No
1,1,1,1,1,2,1,1,2,9,0.257512,0.262713,0,No
1,1,1,1,1,2,1,1,2,8,0.317451,0.327459,0,No
1,1,1,1,1,2,1,1,2,7,0.327819,0.338512,0,No
1,1,1,1,1,2,1,1,2,8,0.288163,0.299063,0,No
1,1,1,1,1,2,1,1,2,8,0.317445,0.327454,0,No
1,1,1,1,1,2,1,1,2,8,0.288168,0.299068,0,No
1,1,1,1,1,2,1,1,2,8,0.306453,0.313109,0,No
1,1,1,1,1,2,1,1,2,9,0.2575,0.262956,0,No
2,2,4,1,1,2,2,2,4,8,0.288168,0.299068,0,No
1,1,1,1,1,2,1,1,2,8,0.309466,0.316145,0,No
1,1,1,1,1,2,1,1,2,7,0.327819,0.338512,0,No
2,2,4,1,2,3,2,2,4,9,0.266564,0.272989,0,No
1,1,1,1,1,2,1,1,2,8,0.323426,0.334429,0,No
1,1,1,1,1,2,1,1,2,8,0.278743,0.288253,0,No
1,1,1,1,1,2,1,1,2,8,0.339941,0.352199,0,No
1,1,1,1,1,2,1,1,2,8,0.317901,0.325044,0,No
1,1,1,1,1,2,1,1,2,9,0.240823,0.244416,0,No
1,1,1,1,1,2,1,1,2,8,0.313497,0.320213,0,No
9,8,72,5,3,8,9,9,18,8,0.330839,0.342467,0,No
1,1,1,1,1,2,1,1,2,8,0.303661,0.312967,0,No
1,1,1,1,1,2,1,1,2,8,0.296171,0.303818,0,No
5,5,25,2,1,3,5,5,10,8,0.317292,0.324388,0,No
2,2,4,2,1,3,2,2,4,7,0.327819,0.338512,0,No
1,1,1,1,1,2,1,1,2,8,0.270035,0.276759,0,No
2,2,4,2,1,3,2,2,4,8,0.317292,0.324388,0,No
1,1,1,1,1,2,1,1,2,8,0.32342,0.334424,0,No
1,1,1,1,1,2,1,1,2,8,0.301589,0.314491,0,No
1,1,1,1,1,2,1,1,2,8,0.268345,0.275546,0,No
1,1,1,1,1,2,1,1,2,8,0.301584,0.314486,0,No
7,7,49,2,1,3,7,7,14,8,0.271899,0.280395,0,No
2,2,4,2,1,3,2,2,4,8,0.271899,0.280395,0,No
2,2,4,2,2,4,2,2,4,8,0.324688,0.335603,0,No
1,1,1,1,1,2,1,1,2,8,0.283081,0.290002,0,No
2,2,4,1,1,2,2,2,4,8,0.32342,0.334424,0,No
1,1,1,1,1,2,1,1,2,8,0.288934,0.297717,0,No
1,1,1,1,1,2,1,1,2,8,0.32342,0.334424,0,No
1,1,1,1,1,2,1,1,2,7,0.296305,0.304855,0,No
1,1,1,1,1,2,1,1,2,8,0.323426,0.334429,0,No
2,2,4,2,2,4,2,2,4,8,0.30932,0.321254,0,No
5,5,25,4,2,6,5,5,10,8,0.324102,0.335055,0,No
2,2,4,2,1,3,2,2,4,8,0.32342,0.334424,0,No
1,1,1,1,1,2,1,1,2,7,0.327819,0.338512,0,No
5,5,25,5,4,9,5,5,10,8,0.343617,0.356724,0,No
4,4,16,3,1,4,4,4,8,8,0.32342,0.334424,0,No
1,1,1,1,1,2,1,1,2,8,0.317298,0.324393,0,No
1,1,1,1,1,2,1,1,2,9,0.268721,0.277328,0,No
1,1,1,1,1,2,1,1,2,8,0.298534,0.305391,0,No
1,1,1,1,1,2,1,1,2,8,0.304626,0.311242,0,No
1,1,1,1,1,2,1,1,2,9,0.303801,0.312033,0,No
1,1,1,1,1,2,1,1,2,9,0.268641,0.276936,0,No
1,1,1,1,1,2,1,1,2,8,0.323426,0.334429,0,No
1,1,1,1,1,2,1,1,2,8,0.274545,0.283659,0,No
1,1,1,1,1,2,1,1,2,8,0.301589,0.314491,0,No
1,1,1,1,1,2,1,1,2,8,0.27122,0.279026,0,No
4,4,16,4,1,5,4,4,8,8,0.299745,0.307615,0,No
1,1,1,1,1,2,1,1,2,8,0.288929,0.297713,0,No
2,2,4,1,1,2,2,2,4,8,0.307852,0.314154,0,No
1,1,1,1,1,2,1,1,2,8,0.296433,0.30351,0,No
6,6,36,3,5,8,6,6,12,7,0.355021,0.369583,0,No
1,1,1,1,1,2,1,1,2,8,0.30338,0.311471,0,No
1,1,1,1,1,2,1,1,2,8,0.32342,0.334424,0,No
1,1,1,1,1,2,1,1,2,8,0.275414,0.282368,0,No
3,3,9,2,1,3,3,3,6,8,0.323414,0.334415,0,No
1,1,1,1,1,2,1,1,2,8,0.254152,0.258825,0,No
1,1,1,1,1,2,1,1,2,8,0.309983,0.317112,0,No
2,2,4,2,2,4,2,2,4,8,0.327675,0.33951,0,No
1,1,1,1,1,2,1,1,2,8,0.296438,0.303643,0,No
2,2,4,1,1,2,2,2,4,8,0.331571,0.343073,0,No
4,4,16,2,1,3,4,4,8,8,0.32342,0.334424,0,No
1,1,1,1,1,2,1,1,2,8,0.263574,0.26993,0,No
1,1,1,1,1,2,1,1,2,8,0.27212,0.278807,0,No
1,1,1,1,1,2,1,1,2,9,0.254413,0.260022,0,No
2,2,4,1,1,2,2,2,4,8,0.288934,0.297717,0,No
2,2,4,1,2,3,2,2,4,8,0.300712,0.307655,0,No
1,1,1,1,1,2,1,1,2,8,0.278184,0.28526,0,No
1,1,1,1,1,2,1,1,2,8,0.301584,0.308533,0,No
2,2,4,1,1,2,2,2,4,8,0.301584,0.308533,0,No
7,7,49,2,3,5,7,7,14,8,0.301669,0.311336,0,No
1,1,1,1,1,2,1,1,2,8,0.297467,0.304363,0,No
1,1,1,1,1,2,1,1,2,8,0.296991,0.30415,0,No
1,1,1,1,1,2,1,1,2,8,0.314583,0.32146,0,No
1,1,1,1,1,2,1,1,2,8,0.317895,0.325039,0,No
1,1,1,1,1,2,1,1,2,8,0.339934,0.352194,0,No
2,2,4,2,2,4,2,2,4,8,0.320685,0.328475,0,No
3,3,9,3,2,5,3,3,6,7,0.332236,0.343545,0,No
1,1,1,1,1,2,1,1,2,8,0.339934,0.352194,0,No
1,1,1,1,1,2,1,1,2,8,0.310717,0.317502,0,No
1,1,1,1,1,2,1,1,2,7,0.327819,0.338512,0,No
2,2,4,2,2,4,2,2,4,8,0.310394,0.319035,0,No
1,1,1,1,1,2,1,1,2,8,0.301584,0.314486,0,No
1,1,1,1,1,2,1,1,2,8,0.310028,0.318679,0,No
1,1,1,1,1,2,1,1,2,8,0.291905,0.299149,0,No
1,1,1,1,1,2,1,1,2,8,0.292525,0.300085,0,No
1,1,1,1,1,2,1,1,2,8,0.279241,0.286909,0,No
1,1,1,1,1,2,1,1,2,9,0.280946,0.288054,0,No
1,1,1,1,1,2,1,1,2,8,0.306437,0.313195,0,No
2,2,4,2,2,4,2,2,4,8,0.322436,0.330248,0,No
1,1,1,1,1,2,1,1,2,9,0.272155,0.278948,0,No
1,1,1,1,1,2,1,1,2,9,0.276051,0.283073,0,No
1,1,1,1,1,2,1,1,2,8,0.317292,0.324388,0,No
1,1,1,1,1,2,1,1,2,9,0.253175,0.258355,0,No
3,3,9,2,3,5,3,3,6,8,0.314554,0.323255,0,No
1,1,1,1,1,2,1,1,2,8,0.278548,0.285463,0,No
2,2,4,2,2,4,2,2,4,8,0.283731,0.292561,0,No
1,1,1,1,1,2,1,1,2,8,0.24776,0.252088,0,No
1,1,1,1,1,2,1,1,2,8,0.30359,0.310474,0,No
5,5,25,1,4,5,5,5,10,8,0.312252,0.319627,0,No
2,2,4,1,1,2,2,2,4,8,0.310033,0.318684,0,No
1,1,1,1,1,2,1,1,2,8,0.303688,0.310784,0,No
3,3,9,3,3,6,3,3,6,8,0.338942,0.35128,0,No
1,1,1,1,1,2,1,1,2,9,0.244305,0.248584,0,No
2,2,4,2,2,4,2,2,4,8,0.313198,0.322823,0,No
1,1,1,1,1,2,1,1,2,8,0.331578,0.343078,0,No
1,1,1,1,1,2,1,1,2,8,0.255955,0.260644,0,No
1,1,1,1,1,2,1,1,2,8,0.271899,0.280395,0,No
1,1,1,1,1,2,1,1,2,8,0.339934,0.352194,0,No
1,1,1,1,1,2,1,1,2,8,0.269175,0.275469,0,No
1,1,1,1,1,2,1,1,2,8,0.271894,0.28039,0,No
2,2,4,2,2,4,2,2,4,8,0.29332,0.301988,0,No
1,1,1,1,1,2,1,1,2,8,0.288934,0.297717,0,No
2,2,4,1,2,3,2,2,4,7,0.297337,0.30618,0,No
1,1,1,1,1,2,1,1,2,8,0.301584,0.314486,0,No
1,1,1,1,1,2,1,1,2,8,0.339934,0.352194,0,No
2,2,4,2,2,4,2,2,4,8,0.31812,0.325271,0,No
1,1,1,1,1,2,1,1,2,8,0.30338,0.311471,0,No
1,1,1,1,1,2,1,1,2,8,0.323426,0.334429,0,No
1,1,1,1,1,2,1,1,2,8,0.32342,0.334424,0,No
1,1,1,1,1,2,1,1,2,8,0.25671,0.26183,0,No
2,1,2,2,2,4,2,2,4,8,0.298174,0.310964,0,No
2,2,4,2,2,4,2,2,4,8,0.298388,0.305528,0,No
1,1,1,1,1,2,1,1,2,9,0.247462,0.251403,0,No
5,5,25,4,3,7,5,5,10,8,0.335542,0.347367,0,No
3,3,9,2,2,4,3,3,6,8,0.286845,0.294033,0,No
4,4,16,3,4,7,4,4,8,8,0.324287,0.333096,0,No
1,1,1,1,1,2,1,1,2,7,0.296305,0.304855,0,No
3,3,9,1,2,3,3,3,6,8,0.292671,0.300185,0,No
11,11,121,5,9,14,11,11,22,7,0.348075,0.362151,0,No
1,1,1,1,1,2,1,1,2,8,0.29193,0.29898,0,No
1,1,1,1,1,2,1,1,2,8,0.32342,0.334424,0,No
1,1,1,1,1,2,1,1,2,8,0.315759,0.323487,0,No
1,1,1,1,1,2,1,1,2,9,0.253793,0.258648,0,No
3,3,9,2,2,4,3,3,6,8,0.323899,0.334924,0,No
1,1,1,1,1,2,1,1,2,9,0.268717,0.277323,0,No
1,1,1,1,1,2,1,1,2,8,0.258883,0.26458,0,No
1,1,1,1,1,2,1,1,2,9,0.259988,0.266702,0,No
1,1,1,1,1,2,1,1,2,8,0.266426,0.272715,0,No
1,1,1,1,1,2,1,1,2,8,0.269852,0.27628,0,No
1,1,1,1,1,2,1,1,2,8,0.305926,0.312614,0,No
5,5,25,3,3,6,5,5,10,8,0.332372,0.344891,0,No
1,1,1,1,1,2,1,1,2,9,0.265932,0.272147,0,No
1,1,1,1,1,2,1,1,2,8,0.288163,0.299063,0,No
1,1,1,1,1,2,1,1,2,8,0.339934,0.352194,0,No
1,1,1,1,1,2,1,1,2,8,0.339934,0.352194,0,No
2,2,4,2,1,3,2,2,4,8,0.314583,0.32146,0,No
2,2,4,2,2,4,2,2,4,8,0.301222,0.308256,0,No
1,1,1,1,1,2,1,1,2,8,0.267806,0.274183,0,No
5,5,25,4,3,7,5,5,10,7,0.334012,0.345611,0,No
5,5,25,3,4,7,5,5,10,8,0.328811,0.338196,0,No
1,1,1,1,1,2,1,1,2,7,0.327819,0.338512,0,No
1,1,1,1,1,2,1,1,2,8,0.281345,0.288421,0,No
2,2,4,1,1,2,2,2,4,9,0.249019,0.253703,0,No
1,1,1,1,1,2,1,1,2,9,0.250842,0.255927,0,No
1,1,1,1,1,2,1,1,2,8,0.32342,0.334424,0,No
1,1,1,1,1,2,1,1,2,8,0.288168,0.299068,0,No
1,1,1,1,1,2,1,1,2,8,0.32342,0.334424,0,No
1,1,1,1,1,2,1,1,2,8,0.339934,0.352194,0,No
2,2,4,1,1,2,2,2,4,9,0.268721,0.277328,0,No
1,1,1,1,1,2,1,1,2,8,0.288163,0.299063,0,No
1,1,1,1,1,2,1,1,2,8,0.301589,0.314491,0,No
1,1,1,1,1,2,1,1,2,8,0.303661,0.312967,0,No
1,1,1,1,1,2,1,1,2,8,0.323426,0.334429,0,No
1,1,1,1,1,2,1,1,2,8,0.293542,0.300706,0,No
1,1,1,1,1,2,1,1,2,8,0.323426,0.334429,0,No
1,1,1,1,1,2,1,1,2,7,0.327819,0.338512,0,No
1,1,1,1,1,2,1,1,2,8,0.289749,0.297209,0,No
2,2,4,2,2,4,2,2,4,8,0.300564,0.307642,0,No
2,2,4,1,1,2,2,2,4,8,0.331571,0.343073,0,No
1,1,1,1,1,2,1,1,2,8,0.331571,0.343073,0,No
2,2,4,2,1,3,2,2,4,8,0.284213,0.291548,0,No
1,1,1,1,1,2,1,1,2,8,0.32342,0.334424,0,No
1,1,1,1,1,2,1,1,2,8,0.32342,0.334424,0,No
1,1,1,1,1,2,1,1,2,8,0.32342,0.334424,0,No
2,1,2,2,1,3,2,2,4,8,0.32342,0.334424,0,No
5,5,25,1,2,3,5,5,10,8,0.328761,0.339989,0,No
2,2,4,2,2,4,2,2,4,8,0.329211,0.341152,0,No
9,9,81,3,3,6,9,9,18,7,0.341561,0.3546,0,No
8,8,64,2,2,4,8,8,16,8,0.328761,0.339989,0,No
1,1,1,1,1,2,1,1,2,8,0.283632,0.290705,0,No
4,4,16,3,2,5,4,4,8,8,0.332043,0.343524,0,No
1,1,1,1,1,2,1,1,2,8,0.331571,0.343073,0,No
1,1,1,1,1,2,1,1,2,9,0.262298,0.268199,0,No
1,1,1,1,1,2,1,1,2,8,0.331571,0.343073,0,No
3,3,9,2,2,4,3,3,6,8,0.343216,0.356243,0,No
5,5,25,3,1,4,5,5,10,7,0.327819,0.338512,0,No
1,1,1,1,1,2,1,1,2,8,0.281809,0.289524,0,No
2,2,4,2,2,4,2,2,4,8,0.3159,0.323863,0,No
2,2,4,2,2,4,2,2,4,8,0.285363,0.29299,0,No
1,1,1,1,1,2,1,1,2,8,0.283486,0.292899,0,No
1,1,1,1,1,2,1,1,2,8,0.28349,0.292904,0,No
1,1,1,1,1,2,1,1,2,8,0.283486,0.292899,0,No
1,1,1,1,1,2,1,1,2,8,0.28349,0.292904,0,No
3,3,9,2,1,3,3,3,6,8,0.28349,0.292904,0,No
1,1,1,1,1,2,1,1,2,8,0.323426,0.334429,0,No
1,1,1,1,1,2,1,1,2,7,0.296305,0.304855,0,No
1,1,1,1,1,2,1,1,2,8,0.323426,0.334429,0,No
1,1,1,1,1,2,1,1,2,8,0.281828,0.289886,0,No
2,2,4,2,2,4,2,2,4,8,0.2942,0.303441,0,No
3,3,9,3,3,6,3,3,6,7,0.335503,0.346438,0,No
2,2,4,1,2,3,2,2,4,8,0.307635,0.316549,0,No
1,1,1,1,1,2,1,1,2,9,0.268637,0.276931,0,No
1,1,1,1,1,2,1,1,2,8,0.32342,0.334424,0,No
3,3,9,3,3,6,3,3,6,8,0.335754,0.348675,0,No
1,1,1,1,1,2,1,1,2,8,0.32342,0.334424,0,No
1,1,1,1,1,2,1,1,2,8,0.311306,0.32231,0,No
2,2,4,1,2,3,2,2,4,8,0.338243,0.351497,0,No
3,3,9,2,2,4,3,3,6,8,0.33258,0.344488,0,No
12,12,144,7,7,14,12,12,24,7,0.372213,0.389296,0,No
12,12,144,6,8,14,12,12,24,7,0.36443,0.380419,0,No
1,1,1,1,1,2,1,1,2,8,0.32342,0.334424,0,No
2,2,4,2,2,4,2,2,4,8,0.326171,0.337207,0,No
3,3,9,2,2,4,3,3,6,8,0.293577,0.301684,0,No
2,2,4,2,2,4,2,2,4,9,0.272441,0.281302,0,No
1,1,1,1,1,2,1,1,2,8,0.309331,0.317947,0,No
4,4,16,2,3,5,4,4,8,8,0.320872,0.328171,0,No
1,1,1,1,1,2,1,1,2,8,0.288934,0.297717,0,No
1,1,1,1,1,2,1,1,2,8,0.287605,0.295192,0,No
3,3,9,1,2,3,3,3,6,9,0.286706,0.294385,0,No
1,1,1,1,1,2,1,1,2,8,0.281828,0.289886,0,No
1,1,1,1,1,2,1,1,2,8,0.301589,0.314491,0,No
1,1,1,1,1,2,1,1,2,8,0.311312,0.322315,0,No
2,2,4,1,2,3,2,2,4,8,0.312521,0.323985,0,No
1,1,1,1,1,2,1,1,2,9,0.263273,0.269549,0,No
1,1,1,1,1,2,1,1,2,8,0.313497,0.320213,0,No
1,1,1,1,1,2,1,1,2,8,0.32342,0.334424,0,No
1,1,1,1,1,2,1,1,2,8,0.303688,0.310784,0,No
1,1,1,1,1,2,1,1,2,7,0.327819,0.338512,0,No
1,1,1,1,1,2,1,1,2,8,0.266139,0.272079,0,No
1,1,1,1,1,2,1,1,2,7,0.2963,0.30485,0,No
2,2,4,2,2,4,2,2,4,7,0.31545,0.32252,0,No
2,2,4,2,1,3,2,2,4,7,0.327819,0.338512,0,No
1,1,1,1,1,2,1,1,2,8,0.339941,0.352199,0,No
1,1,1,1,1,2,1,1,2,7,0.296305,0.304855,0,No
1,1,1,1,1,2,1,1,2,8,0.309325,0.317943,0,No
1,1,1,1,1,2,1,1,2,7,0.296305,0.304855,0,No
1,1,1,1,1,2,1,1,2,7,0.327819,0.338512,0,No
1,1,1,1,1,2,1,1,2,7,0.2963,0.30485,0,No
1,1,1,1,1,2,1,1,2,9,0.269103,0.277072,0,No
1,1,1,1,1,2,1,1,2,7,0.327819,0.338512,0,No
8,8,64,3,2,5,8,8,16,7,0.352621,0.366966,0,No
2,2,4,1,2,3,2,2,4,8,0.305438,0.317839,0,No
1,1,1,1,1,2,1,1,2,8,0.274545,0.283659,0,No
1,1,1,1,1,2,1,1,2,8,0.301589,0.314491,0,No
1,1,1,1,1,2,1,1,2,8,0.278743,0.288253,0,No
2,2,4,2,2,4,2,2,4,7,0.331224,0.342603,0,No
4,4,16,3,1,4,4,4,8,8,0.278743,0.288253,0,No
1,1,1,1,1,2,1,1,2,8,0.27455,0.283664,0,No
1,1,1,1,1,2,1,1,2,8,0.302198,0.308977,0,No
2,2,4,1,1,2,2,2,4,7,0.327819,0.338512,0,No
2,2,4,1,1,2,2,2,4,9,0.240043,0.243522,0,No
1,1,1,1,1,2,1,1,2,8,0.32342,0.334424,0,No
1,1,1,1,1,2,1,1,2,8,0.27455,0.283664,0,No
1,1,1,1,1,2,1,1,2,8,0.310717,0.317502,0,No
1,1,1,1,1,2,1,1,2,9,0.239249,0.24402,0,No
2,2,4,2,2,4,2,2,4,8,0.340063,0.352361,0,No
2,2,4,2,2,4,2,2,4,8,0.345692,0.358823,0,No
1,1,1,1,1,2,1,1,2,8,0.288168,0.299068,0,No
2,2,4,2,2,4,2,2,4,8,0.330961,0.343854,0,No
1,1,1,1,1,2,1,1,2,8,0.282804,0.289975,0,No
4,4,16,3,2,5,4,4,8,8,0.32828,0.340062,0,No
1,1,1,1,1,2,1,1,2,8,0.301584,0.314486,0,No
1,1,1,1,1,2,1,1,2,8,0.29037,0.297494,0,No
13,13,169,2,2,4,13,13,26,7,0.335793,0.346406,0,No
3,3,9,2,3,5,3,3,6,8,0.306789,0.313859,0,No
2,2,4,1,2,3,2,2,4,7,0.328147,0.338813,0,No
1,1,1,1,1,2,1,1,2,8,0.29037,0.297494,0,No
1,1,1,1,1,2,1,1,2,8,0.288168,0.299068,0,No
1,1,1,1,1,2,1,1,2,8,0.274329,0.282188,0,No
1,1,1,1,1,2,1,1,2,9,0.278707,0.285806,0,No
1,1,1,1,1,2,1,1,2,8,0.288163,0.299063,0,No
1,1,1,1,1,2,1,1,2,7,0.296305,0.304855,0,No
2,2,4,2,1,3,2,2,4,8,0.32342,0.334424,0,No
1,1,1,1,1,2,1,1,2,8,0.323426,0.334429,0,No
1,1,1,1,1,2,1,1,2,8,0.323426,0.334429,0,No
1,1,1,1,1,2,1,1,2,9,0.268717,0.277323,0,No
3,3,9,2,3,5,3,3,6,8,0.3107,0.320224,0,No
1,1,1,1,1,2,1,1,2,8,0.268219,0.275191,0,No
4,4,16,4,4,8,4,4,8,7,0.326671,0.335598,0,No
3,3,9,2,2,4,3,3,6,8,0.293264,0.303789,0,No
1,1,1,1,1,2,1,1,2,8,0.30592,0.312609,0,No
1,1,1,1,1,2,1,1,2,8,0.29983,0.307297,0,No
1,1,1,1,1,2,1,1,2,7,0.2963,0.30485,0,No
1,1,1,1,1,2,1,1,2,7,0.296305,0.304855,0,No
1,1,1,1,1,2,1,1,2,7,0.296305,0.304855,0,No
1,1,1,1,1,2,1,1,2,8,0.29983,0.307297,0,No
1,1,1,1,1,2,1,1,2,9,0.272059,0.279013,0,No
1,1,1,1,1,2,1,1,2,8,0.301589,0.314491,0,No
2,2,4,1,1,2,2,2,4,8,0.32342,0.334424,0,No
1,1,1,1,1,2,1,1,2,8,0.32342,0.334424,0,No
2,2,4,2,2,4,2,2,4,8,0.344401,0.357409,0,No
1,1,1,1,1,2,1,1,2,8,0.301589,0.314491,0,No
1,1,1,1,1,2,1,1,2,8,0.32342,0.334424,0,No
1,1,1,1,1,2,1,1,2,8,0.339934,0.352194,0,No
6,6,36,2,5,7,6,6,12,8,0.329777,0.340732,0,No
6,6,36,5,4,9,6,6,12,8,0.344484,0.357866,0,No
3,3,9,1,2,3,3,3,6,8,0.305586,0.312811,0,No
2,2,4,2,2,4,2,2,4,8,0.299445,0.306314,0,No
1,1,1,1,1,2,1,1,2,8,0.302842,0.310166,0,No
1,1,1,1,1,2,1,1,2,8,0.303375,0.311466,0,No
2,2,4,1,1,2,2,2,4,8,0.311306,0.32231,0,No
1,1,1,1,1,2,1,1,2,8,0.287731,0.294949,0,No
1,1,1,1,1,2,1,1,2,8,0.339934,0.352194,0,No
2,2,4,2,2,4,2,2,4,8,0.32972,0.34012,0,No
1,1,1,1,1,2,1,1,2,8,0.301584,0.314486,0,No
1,1,1,1,1,2,1,1,2,8,0.301594,0.314494,0,No
1,1,1,1,1,2,1,1,2,8,0.296438,0.303643,0,No
1,1,1,1,1,2,1,1,2,8,0.268219,0.275191,0,No
1,1,1,1,1,2,1,1,2,9,0.303801,0.312033,0,No
3,3,9,3,3,6,3,3,6,8,0.326103,0.336796,0,No
2,2,4,2,2,4,2,2,4,8,0.349637,0.363925,0,No
2,2,4,1,1,2,2,2,4,9,0.269103,0.277072,0,No
1,1,1,1,1,2,1,1,2,8,0.32342,0.334424,0,No
2,2,4,1,1,2,2,2,4,8,0.301589,0.314491,0,No
1,1,1,1,1,2,1,1,2,8,0.301589,0.314491,0,No
1,1,1,1,1,2,1,1,2,8,0.294484,0.301605,0,No
1,1,1,1,1,2,1,1,2,8,0.32342,0.334424,0,No
3,3,9,1,2,3,3,3,6,8,0.340518,0.352976,0,No
3,3,9,3,3,6,3,3,6,8,0.305378,0.3133,0,No
2,1,2,1,2,3,2,2,4,8,0.299041,0.307871,0,No
1,1,1,1,1,2,1,1,2,8,0.32342,0.334424,0,No
1,1,1,1,1,2,1,1,2,8,0.323426,0.334429,0,No
3,3,9,1,3,4,3,3,6,8,0.320276,0.329005,0,No
1,1,1,1,1,2,1,1,2,8,0.281809,0.289524,0,No
3,3,9,2,3,5,3,3,6,8,0.346267,0.360107,0,No
1,1,1,1,1,2,1,1,2,8,0.313497,0.320213,0,No
1,1,1,1,1,2,1,1,2,8,0.301584,0.314486,0,No
2,2,4,1,1,2,2,2,4,8,0.315765,0.323492,0,No
